acantha |1. (Bot.)  A prickle. 2. (Zoöl.)  A spine or prickly fin. 3. (Anat.)  The vertebral column; the spinous process of a vertebra. Dunglison.
acanthaceous |1. Armed with prickles, as a plant. 2. (Bot.)  Of, pertaining to, or resembling, the family of plants of which the acanthus is the type.
acanthine |Of, pertaining to, or resembling, the plant acanthus.
acanthocarpous |Having the fruit covered with spines.
acanthocephala |A group of intestinal worms, having the proboscis armed with recurved spines.
acanthocephalous |Having a spiny head, as one of the Acanthocephala.
acanthophorous |Spine-bearing. Gray.
acanthopodious |Having spinous petioles.
acanthopteri |A group of teleostean fishes having spiny fins. See Acanthopterygii.
acanthopterous |1. (Zoöl.)  Spiny-winged. 2. (Zoöl.)  Acanthopterygious.
acanthopterygian |Belonging to the order of fishes having spinose fins, as the perch. -- n.  A spiny-finned fish.
acanthopterygii |An order of fishes having some of the rays of the dorsal, ventral, and anal fins unarticulated and spinelike, as the perch.
acanthopterygious |Having fins in which the rays are hard and spinelike; spiny- finned.
acanthus |1. (Bot.)  A genus of herbaceous prickly plants, found in the south of Europe, Asia Minor, and India; bear's-breech. 2. (Arch.)  An ornament resembling the foliage or leaves of the acanthus (Acanthus spinosus); -- used in the capitals of the Corinthian and Composite orders.
acapsular |Having no capsule.
acardiac |Without a heart; as, an acardiac fetus.
acaridan |One of a group of arachnids, including the mites and ticks.
acarina |The group of Arachnida which includes the mites and ticks. Many species are parasitic, and cause diseases like the itch and mange.
acarine |Of or caused by acari or mites; as, acarine diseases.
acaroid |Shaped like or resembling a mite.
acarpellous |Having no carpels.
acarpous |Not producing fruit; unfruitful.
acarus |A genus including many species of small mites.
acatalectic |Not defective; complete; as, an acatalectic verse. -- n.  A verse which has the complete number of feet and syllables.
acatalepsy |Incomprehensibility of things; the doctrine held by the ancient Skeptic philosophers, that human knowledge never amounts to certainty, but only to probability.
acataleptic |Incapable of being comprehended; incomprehensible.
acater |See Caterer. [Obs.]
acates |See Cates. [Obs.]
acaudate |Tailless.
acaulescent |Having no stem or caulis, or only a very short one concealed in the ground. Gray.
acauline |Same as Acaulescent.
acaulose |Same as Acaulescent.
acaulous |Same as Acaulescent.
accadian |Pertaining to a race supposed to have lived in Babylonia before the Assyrian conquest. -- Ac*ca\"di*an, n., Ac\"cad, n. Sayce.
accede |1. To approach; to come forward; -- opposed to recede. [Obs.] T. Gale. 2. To enter upon an office or dignity; to attain. Edward IV., who had acceded to the throne in the year 1461. T. Warton. If Frederick had acceded to the supreme power. Morley. 3. To become a party by associating one's self with others; to give one's adhesion. Hence, to agree or assent to a proposal or a view; as, he acceded to my request. The treaty of Hanover in 1725 . . . to which the Dutch afterwards acceded. Chesterfield. Syn. -- To agree; assent; consent; comply; acquiesce; concur.
accedence |The act of acceding.
acceder |One who accedes.
accelerando |Gradually accelerating the movement.
accelerate |1. To cause to move faster; to quicken the motion of; to add to the speed of; -- opposed to retard. 2. To quicken the natural or ordinary progression or process of; as, to accelerate the growth of a plant, the increase of wealth, etc. 3. To hasten, as the occurence of an event; as, to accelerate our departure. Accelerated motion (Mech.), motion with a continually increasing velocity. -- Accelerating force, the force which causes accelerated motion. Nichol. Syn. -- To hasten; expedite; quicken; dispatch; forward; advance; further.
acceleration |The act of accelerating, or the state of being accelerated; increase of motion or action; as, a falling body moves toward the earth with an acceleration of velocity; -- opposed to retardation. A period of social improvement, or of intellectual advancement, contains within itself a principle of acceleration. I. Taylor. (Astr. & Physics.) Acceleration of the moon, the increase of the moon's mean motion in its orbit, in consequence of which its period of revolution is now shorter than in ancient times. -- Acceleration and retardation of the tides. See Priming of the tides, under Priming. -- Diurnal acceleration of the fixed stars, the amount by which their apparent diurnal motion exceeds that of the sun, in consequence of which they daily come to the meridian of any place about three minutes fifty-six seconds of solar time earlier than on the day preceding. -- Acceleration of the planets, the increasing velocity of their motion, in proceeding from the apogee to the perigee of their orbits.
accelerative |Relating to acceleration; adding to velocity; quickening. Reid.
accelerator |One who, or that which, accelerates. Also as an adj.; as, accelerator nerves.
acceleratory |Accelerative.
accelerograph |An apparatus for studying the combustion of powder in guns, etc.
accelerometer |An apparatus for measuring the velocity imparted by gunpowder.
accend |To set on fire; to kindle. [Obs.] Fotherby.
accendibility |Capacity of being kindled, or of becoming inflamed; inflammability.
accendible |Capable of being inflamed or kindled; combustible; inflammable. Ure.
accension |The act of kindling or the state of being kindled; ignition. Locke.
accensor |One of the functionaries who light and trim the tapers.
accent |1. A superior force of voice or of articulative effort upon some particular syllable of a word or a phrase, distinguishing it from the others. Note: Many English words have two accents, the primary and the secondary; the primary being uttered with a greater stress of voice than the secondary; as in as'pira''tion, where the chief stress is on the third syllable, and a slighter stress on the first. Some words, as an'tiap'o-plec''tic, in-com'pre-hen'si-bil''i-ty, have two secondary accents. See Guide to Pron., tt 30-46. 2. A mark or character used in writing, and serving to regulate the pronunciation; esp.: (a) a mark to indicate the nature and place of the spoken accent; (b) a mark to indicate the quality of sound of the vowel marked; as, the French accents. Note: In the ancient Greek the acute accent (') meant a raised tone or pitch, the grave (`), the level tone or simply the negation of accent, the circumflex ( ~ or ^) a tone raised and then depressed. In works on elocution, the first is often used to denote the rising inflection of the voice; the second, the falling inflection; and the third (^), the compound or waving inflection. In dictionaries, spelling books, and the like, the acute accent is used to designate the syllable which receives the chief stress of voice. 3. Modulation of the voice in speaking; manner of speaking or pronouncing; peculiar or characteristic modification of the voice; tone; as, a foreign accent; a French or a German accent. \"Beguiled you in a plain accent.\" Shak. \"A perfect accent.\" Thackeray. The tender accent of a woman's cry. Prior. 4. A word; a significant tone; (pl.) expressions in general; speech. Winds! on your wings to Heaven her accents bear, Such words as Heaven alone is fit to hear. Dryden. 5. (Pros.)  Stress laid on certain syllables of a verse. 6. (Mus.) (a) A regularly recurring stress upon the tone to mark the beginning, and, more feebly, the third part of the measure. (b) A special emphasis of a tone, even in the weaker part of the measure. (c) The rythmical accent, which marks phrases and sections of a period. (d) The expressive emphasis and shading of a passage. J. S. Dwight. 7. (Math.) (a) A mark placed at the right hand of a letter, and a little above it, to distinguish magnitudes of a similar kind expressed by the same letter, but differing in value, as y', y''. (b) (Trigon.) A mark at the right hand of a number, indicating minutes of a degree, seconds, etc.; as, 12'27'', i. e., twelve minutes twenty seven seconds. (c) (Engin.) A mark used to denote feet and inches; as, 6' 10'' is six feet ten inches.\n\n1. To express the accent of (either by the voice or by a mark); to utter or to mark with accent. 2. To mark emphatically; to emphasize.
accentless |Without accent.
accentor |1. (Mus.)  One who sings the leading part; the director or leader. [Obs.] 2. (Zoöl.)  A genus of European birds (so named from their sweet notes), including the hedge warbler. In America sometimes applied to the water thrushes.
accentuable |Capable of being accented.
accentual |Of or pertaining to accent; characterized or formed by accent.
accentuality |The quality of being accentual.
accentually |In an accentual manner; in accordance with accent.
accentuate |1. To pronounce with an accent or with accents. 2. To bring out distinctly; to make prominent; to emphasize. In Bosnia, the struggle between East and West was even more accentuated. London Times. 3. To mark with the written accent.
accentuation |Act of accentuating; applications of accent. Specifically (Eccles. Mus.),  pitch or modulation of the voice in reciting portions of the liturgy.
accept |1. To receive with a consenting mind (something offered); as, to accept a gift; -- often followed by of. If you accept them, then their worth is great. Shak. To accept of ransom for my son. Milton. She accepted of a treat. Addison. 2. To receive with favor; to approve. The Lord accept thy burnt sacrifice. Ps. xx. 3. Peradventure he will accept of me. Gen. xxxii. 20. 3. To receive or admit and agree to; to assent to; as, I accept your proposal, amendment, or excuse. 4. To take by the mind; to understand; as, How are these words to be accepted 5. (Com.)  To receive as obligatory and promise to pay; as, to accept a bill of exchange. Bouvier. 6. In a deliberate body, to receive in acquittance of a duty imposed; as, to accept the report of a committee. [This makes it the property of the body, and the question is then on its adoption.] To accept a bill (Law), to agree (on the part of the drawee) to pay it when due. -- To accept service (Law), to agree that a writ or process shall be considered as regularly served, when it has not been. -- To accept the person (Eccl.), to show favoritism. \"God accepteth no man's person.\" Gal. ii. 6. Syn. -- To receive; take; admit. See Receive.\n\nAccepted. [Obs.] Shak.
acceptability |The quality of being acceptable; acceptableness. \"Acceptability of repentance.\" Jer. Taylor.
acceptable |Capable, worthy, or sure of being accepted or received with pleasure; pleasing to a receiver; gratifying; agreeable; welcome; as, an acceptable present, one acceptable to us.
acceptableness |The quality of being acceptable, or suitable to be favorably received; acceptability.
acceptably |In an acceptable manner; in a manner to please or give satisfaction.
acceptance |1. The act of accepting; a receiving what is offered, with approbation, satisfaction, or acquiescence; esp., favorable reception; approval; as, the acceptance of a gift, office, doctrine, etc. They shall come up with acceptance on mine altar. Isa. lx. 7. 2. State of being accepted; acceptableness. \"Makes it assured of acceptance.\" Shak. 3. (Com.) (a) An assent and engagement by the person on whom a bill of exchange is drawn, to pay it when due according to the terms of the acceptance. (b) The bill itself when accepted. 4. An agreeing to terms or proposals by which a bargain is concluded and the parties are bound; the reception or taking of a thing bought as that for which it was bought, or as that agreed to be delivered, or the taking possession as owner. 5. (Law)  An agreeing to the action of another, by some act which binds the person in law. Note: What acts shall amount to such an acceptance is often a question of great nicety and difficulty. Mozley & W. Note: In modern law, proposal and acceptance are the constituent elements into which all contracts are resolved. Acceptance of a bill of exchange, check, draft, or order, is an engagement to pay it according to the terms. This engagement is usually made by writing the word \"accepted\" across the face of the bill. Acceptance of goods, under the statute of frauds, is an intelligent acceptance by a party knowing the nature of the transaction. 6. Meaning; acceptation. [Obs.] Acceptance of persons, partiality, favoritism. See under Accept.
acceptancy |Acceptance. [R.] Here's a proof of gift, But here's no proof, sir, of acceptancy. Mrs. Browning.
acceptant |Accepting; receiving.\n\nAn accepter. Chapman.
acceptation |1. Acceptance; reception; favorable reception or regard; state of being acceptable. [Obs.] This is saying worthy of all acceptation. 1 Tim. i. 15. Some things . . . are notwithstanding of so great dignity and acceptation with God. Hooker. 2. The meaning in which a word or expression is understood, or generally received; as, term is to be used according to its usual acceptation. My words, in common acceptation, Could never give this provocation. Gay.
acceptedly |In a accepted manner; admittedly.
accepter |1. A person who accepts; a taker. 2. A respecter; a viewer with partiality. [Obs.] God is no accepter of persons. Chillingworth. 3. (Law)  An acceptor.
acceptilation |Gratuitous discharge; a release from debt or obligation without payment; free remission.
acception |Acceptation; the received meaning. [Obs.] Here the word \"baron\" is not to be taken in that restrictive sense to which the modern acception hath confined it. Fuller. Acception of persons or faces (Eccl.), favoritism; partiality. [Obs.] Wyclif.
acceptive |1. Fit for acceptance. 2. Ready to accept. [Obs.] B. Jonson.
acceptor |One who accepts; specifically (Law & Com.),  one who accepts an order or a bill of exchange; a drawee after he has accepted.
access |1. A coming to, or near approach; admittance; admission; accessibility; as, to gain access to a prince. I did repel his letters, and denied His access to me. Shak. 2. The means, place, or way by which a thing may be approached; passage way; as, the access is by a neck of land. \"All access was thronged.\" Milton. 3. Admission to sexual intercourse. During coverture, access of the husband shall be presumed, unless the contrary be shown. Blackstone. 4. Increase by something added; addition; as, an access of territory. [In this sense accession is more generally used.] I, from the influence of thy looks, receive Access in every virtue. Milton. 5. An onset, attack, or fit of disease. The first access looked like an apoplexy. Burnet. 6. A paroxysm; a fit of passion; an outburst; as, an access of fury. [A Gallicism]
accessarily |In the manner of an accessary.
accessariness |The state of being accessary.
accessary |Accompanying, as a subordinate; additional; accessory; esp., uniting in, or contributing to, a crime, but not as chief actor. See Accessory. To both their deaths thou shalt be accessary. Shak. Amongst many secondary and accessary causes that support monarchy, these are not of least reckoning. Milton.\n\nOne who, not being present, contributes as an assistant or instigator to the commission of an offense. Accessary before the fact (Law), one who commands or counsels an offense, not being present at its commission. -- Accessary after the fact, one who, after an offense, assists or shelters the offender, not being present at the commission of the offense. Note: This word, as used in law, is spelt accessory by Blackstone and many others; but in this sense is spelt accessary by Bouvier, Burrill, Burns, Whishaw, Dane, and the Penny Cyclopedia; while in other senses it is spelt accessory. In recent text-books on criminal law the distinction is not preserved, the spelling being either accessary or accessory.
accessibility |The quality of being accessible, or of admitting approach; receptibility. Langhorne.
accessible |1. Easy of access or approach; approachable; as, an accessible town or mountain, an accessible person. 2. Open to the influence of; -- with to. \"Minds accessible to reason.\" Macaulay. 3. Obtainable; to be got at. The best information . . . at present accessible. Macaulay.
accessibly |In an accessible manner.
accession |1. A coming to; the act of acceding and becoming joined; as, a king's accession to a confederacy. 2. Increase by something added; that which is added; augmentation from without; as, an accession of wealth or territory. The only accession which the Roman empire received was the province of Britain. Gibbon. 3. (Law) (a) A mode of acquiring property, by which the owner of a corporeal substance which receives an addition by growth, or by labor, has a right to the part or thing added, or the improvement (provided the thing is not changed into a different species). Thus, the owner of a cow becomes the owner of her calf. (b) The act by which one power becomes party to engagements already in force between other powers. Kent. 4. The act of coming to or reaching a throne, an office, or dignity; as, the accession of the house of Stuart; -- applied especially to the epoch of a new dynasty. 5. (Med.)  The invasion, approach, or commencement of a disease; a fit or paroxysm. Syn. -- Increase; addition; augmentation; enlargement.
accessional |Pertaining to accession; additional. [R.] Sir T. Browne.
accessive |Additional.
accessorial |Of or pertaining to an accessory; as, accessorial agency, accessorial guilt.
accessorily |In the manner of an accessory; auxiliary.
accessoriness |The state of being accessory, or connected subordinately.
accessory |Accompanying as a subordinate; aiding in a secondary way; additional; connected as an incident or subordinate to a principal; contributing or contributory; said of persons and things, and, when of persons, usually in a bad sense; as, he was accessory to the riot; accessory sounds in music. Note: Ash accents the antepenult; and this is not only more regular, but preferable, on account of easiness of pronunciation. Most orhoëpists place the accent on the first syllable. Syn. -- Accompanying; contributory; auxiliary; subsidiary; subservient; additional; acceding.\n\n1. That which belongs to something else deemed the principal; something additional and subordinate. \"The aspect and accessories of a den of banditti.\" Carlyle. 2. (Law)  Same as Accessary, n. 3. (Fine Arts)  Anything that enters into a work of art without being indispensably necessary, as mere ornamental parts. Elmes. Syn. -- Abettor; accomplice; ally; coadjutor. See Abettor.
acciaccatura |A short grace note, one semitone below the note to which it is prefixed; -- used especially in organ music. Now used as equivalent to the short appoggiatura.
accidence |1. The accidents, of inflections of words; the rudiments of grammar. Milton. 2. The rudiments of any subject. Lowell.
accident |1. Literally, a befalling; an event that takes place without one's foresight or expectation; an undesigned, sudden, and unexpected event; chance; contingency; often, an undesigned and unforeseen occurrence of an afflictive or unfortunate character; a casualty; a mishap; as, to die by an accident. Of moving accidents by flood and field. Shak. Thou cam'st not to thy place by accident: It is the very place God meant for thee. Trench. 2. (Gram.)  A property attached to a word, but not essential to it, as gender, number, case. 3. (Her.)  A point or mark which may be retained or omitted in a coat of arms. 4. (Log.) (a) A property or quality of a thing which is not essential to it, as whiteness in paper; an attribute. (b) A quality or attribute in distinction from the substance, as sweetness, softness. 5. Any accidental property, fact, or relation; an accidental or nonessential; as, beauty is an accident. This accident, as I call it, of Athens being situated some miles from the sea. J. P. Mahaffy. 6. Unusual appearance or effect. [Obs.] Chaucer. Note: Accident, in Law, is equivalent to casus, or such unforeseen, extraordinary, extraneous interference as is out of the range of ordinary calculation.
accidental |1. Happening by chance, or unexpectedly; taking place not according to the usual course of things; casual; fortuitous; as, an accidental visit. 2. Nonessential; not necessary belonging; incidental; as, are accidental to a play. Accidental chords (Mus.), those which contain one or more tones foreign to their proper harmony. -- Accidental colors (Opt.), colors depending on the hypersensibility of the retina of the eye for complementary colors. They are purely subjective sensations of color which often result from the contemplation of actually colored bodies. -- Accidental point (Persp.), the point in which a right line, drawn from the eye, parallel to a given right line, cuts the perspective plane; so called to distinguish it from the principal point, or point of view, where a line drawn from the eye perpendicular to the perspective plane meets this plane. -- Accidental lights (Paint.), secondary lights; effects of light other than ordinary daylight, such as the rays of the sun darting through a cloud, or between the leaves of trees; the effect of moonlight, candlelight, or burning bodies. Fairholt. Syn. -- Casual; fortuitous; contingent; occasional; adventitious. -- Accidental, Incidental, Casual, Fortuitous, Contingent. We speak of a thing as accidental when it falls out as by chance, and not in the regular course of things; as, an accidental meeting, an accidental advantage, etc. We call a thing incidental when it falls, as it were, into some regular course of things, but is secondary, and forms no essential part thereof; as, an incremental remark, an incidental evil, an incidental benefit. We speak of a thing as casual, when it falls out or happens, as it were, by mere chance, without being prearranged or premeditated; as, a casual remark or encounter; a casual observer. An idea of the unimportant is attached to what is casual. Fortuitous is applied to what occurs without any known cause, and in opposition to what has been foreseen; as, a fortuitous concourse of atoms. We call a thing contingent when it is such that, considered in itself, it may or may not happen, but is dependent for its existence on something else; as, the time of my coming will be contingent on intelligence yet to be received.\n\n1. A property which is not essential; a nonessential; anything happening accidentally. He conceived it just that accidentals . . . should sink with the substance of the accusation. Fuller. 2. pl. (Paint.)  Those fortuitous effects produced by luminous rays falling on certain objects so that some parts stand forth in abnormal brightness and other parts are cast into a deep shadow. 3. (Mus.)  A sharp, flat, or natural, occurring not at the commencement of a piece of music as the signature, but before a particular note.
accidentalism |Accidental character or effect. Ruskin.
accidentality |The quality of being accidental; accidentalness. [R.] Coleridge.
accidentally |In an accidental manner; unexpectedly; by chance; unintentionally; casually; fortuitously; not essentially.
accidentalness |The quality of being accidental; casualness.
accidie |Sloth; torpor. [Obs.] \"The sin of accidie.\" Chaucer.
accipenser |See Acipenser.
accipient |A receiver. [R.] Bailey
accipiter |1. (Zoöl.)  A genus of rapacious birds; one of the Accipitres or Raptores. 2. (Surg.)  A bandage applied over the nose, resembling the claw of a hawk.
accipitral |Pertaining to, or of the nature of, a falcon or hawk; hawklike. Lowell.
accipitres |The order that includes rapacious birds. They have a hooked bill, and sharp, strongly curved talons. There are three families, represented by the vultures, the falcons or hawks, and the owls.
accipitrine |Like or belonging to the Accipitres; raptorial; hawklike.
accismus |Affected refusal; coyness.
accite |To cite; to summon. [Obs.] Our heralds now accited all that were Endamaged by the Elians. Chapman.
acclaim |1. To applaud. \"A glad acclaiming train.\" Thomson. 2. To declare by acclamations. While the shouting crowd Acclaims thee king of traitors. Smollett. 3. To shout; as, to acclaim my joy.\n\nTo shout applause.\n\nAcclamation. [Poetic] Milton.
acclaimer |One who acclaims.
acclamation |1. A shout of approbation, favor, or assent; eager expression of approval; loud applause. On such a day, a holiday having been voted by acclamation, an ordinary walk would not satisfy the children. Southey. 2. (Antiq.)  A representation, in sculpture or on medals, of people expressing joy. Acclamation medals are those on which laudatory acclamations are recorded. Elmes.
acclamatory |Pertaining to, or expressing approval by, acclamation.
acclimatable |Capable of being acclimated.
acclimatation |Acclimatization.
acclimate |To habituate to a climate not native; to acclimatize. J. H. Newman.
acclimatement |Acclimation. [R.]
acclimation |The process of becoming, or the state of being, acclimated, or habituated to a new climate; acclimatization.
acclimatizable |Capable of being acclimatized.
acclimatization |The act of acclimatizing; the process of inuring to a new climate, or the state of being so inured. Darwin.
acclimatize |To inure or habituate to a climate different from that which is natural; to adapt to the peculiarities of a foreign or strange climate; said of man, the inferior animals, or plants.
acclimature |The act of acclimating, or the state of being acclimated. [R.] Caldwell.
acclive |Acclivous. [Obs.]
acclivitous |Acclivous. I. Taylor.\n\nAcclivous.  I. Taylor.
acclivity |A slope or inclination of the earth, as the side of a hill, considered as ascending, in opposition to declivity, or descending; an upward slope; ascent.
acclivous |Sloping upward; rising as a hillside; -- opposed to declivous.
accloy |To fill to satiety; to stuff full; to clog; to overload; to burden. See Cloy. [Obs.] Chaucer.
accoast |To lie or sail along the coast or side of; to accost. [Obs.] Whether high towering or accosting low. Spenser.
accoil |1. To gather together; to collect. [Obs.] Spenser. 2. (Naut.)  To coil together. Ham. Nav. Encyc.
accolade |1. A ceremony formerly used in conferring knighthood, consisting am embrace, and a slight blow on the shoulders with the flat blade of a sword. 2. (Mus.)  A brace used to join two or more staves.
accombination |A combining together. [R.]
accommodable |That may be accommodated, fitted, or made to agree. [R.] I. Watts.
accommodableness |The quality or condition of being accommodable. [R.] Todd.
accommodate |1. To render fit, suitable, or correspondent; to adapt; to conform; as, to accommodate ourselves to circumstances. \"They accomodate their counsels to his inclination.\" Addison. 2. To bring into agreement or harmony; to reconcile; to compose; to adjust; to settle; as, to accommodate differences, a dispute, etc. 3. To furnish with something desired, needed, or convenient; to favor; to oblige; as, to accommodate a friend with a loan or with lodgings. 4. To show the correspondence of; to apply or make suit by analogy; to adapt or fit, as teachings to accidental circumstances, statements to facts, etc.; as, to accommodate prophecy to events. Syn. -- To suit; adapt; conform; adjust; arrange.\n\nTo adapt one's self; to be conformable or adapted. [R.] Boyle.\n\nSuitable; fit; adapted; as, means accommodate to end. [Archaic] Tillotson.
accommodately |Suitably; fitly. [R.]
accommodateness |Fitness. [R.]
accommodating |Affording, or disposed to afford, accommodation; obliging; as an accommodating man, spirit, arrangement.
accommodation |1. The act of fitting or adapting, or the state of being fitted or adapted; adaptation; adjustment; -- followed by to. \"The organization of the body with accommodation to its functions.\" Sir M. Hale. 2. Willingness to accommodate; obligingness. 3. Whatever supplies a want or affords ease, refreshment, or convenience; anything furnished which is desired or needful; -- often in the plural; as, the accomodations -- that is, lodgings and food -- at an inn. Sir W. Scott. 4. An adjustment of differences; state of agreement; reconciliation; settlement. \"To come to terms of accommodation.\" Macaulay. 5. The application of a writer's language, on the ground of analogy, to something not originally referred to or intended. Many of those quotations from the Old Testament were probably intended as nothing more than accommodations. Paley. 6. (Com.) (a) A loan of money. (b) An accommodation bill or note. Accommodation bill, or note (Com.), a bill of exchange which a person accepts, or a note which a person makes and delivers to another, not upon a consideration received, but for the purpose of raising money on credit. -- Accommodation coach, or train, one running at moderate speed and stopping at all or nearly all stations. -- Accommodation ladder (Naut.), a light ladder hung over the side of a ship at the gangway, useful in ascending from, or descending to, small boats.
accommodator |He who, or that which, accommodates. Warburton.
accompanable |Sociable. [Obs.] Sir P. Sidney.
accompanier |He who, or that which, accompanies. Lamb.
accompaniment |That which accompanies; something that attends as a circumstance, or which is added to give greater completeness to the principal thing, or by way of ornament, or for the sake of symmetry. Specifically: (Mus.)  A part performed by instruments, accompanying another part or parts performed by voices; the subordinate part, or parts, accompanying the voice or a principal instrument; also, the harmony of a figured bass. P. Cyc.
accompanist |The performer in music who takes the accompanying part. Busby.
accompany |1. To go with or attend as a companion or associate; to keep company with; to go along with; -- followed by with or by; as, he accompanied his speech with a bow. The Persian dames, . . . In sumptuous cars, accompanied his march. Glover. They are never alone that are accompanied with noble thoughts. Sir P. Sidney. He was accompanied by two carts filled with wounded rebels. Macaulay. 2. To cohabit with. [Obs.] Sir T. Herbert. Syn. -- To attend; escort; go with. -- To Accompany, Attend, Escort. We accompany those with whom we go as companions. The word imports an equality of station. We attend those whom we wait upon or follow. The word conveys an idea of subordination. We escort those whom we attend with a view to guard and protect. A gentleman accompanies a friend to some public place; he attends or escorts a lady.\n\n1. To associate in a company; to keep company. [Obs.] Bacon. Men say that they will drive away one another, . . . and not accompany together. Holland. 2. To cohabit (with). [Obs.] Milton. 3. (Mus.)  To perform an accompanying part or parts in a composition.
accompletive |Tending to accomplish. [R.]
accomplice |1. A cooperator. [R.] Success unto our valiant general, And happiness to his accomplices! Shak. 2. (Law)  An associate in the commission of a crime; a participator in an offense, whether a principal or an accessory. \"And thou, the cursed accomplice of his treason.\" Johnson. Note: It is followed by with or of before a person and by in (or sometimes of) before the crime; as, A was an accomplice with B in the murder of C. Dryden uses it with to before a thing. \"Suspected for accomplice to the fire.\" Dryden. Syn. -- Abettor; accessory; assistant; associate; confederate; coadjutor; ally; promoter. See Abettor.
accompliceship |The state of being an accomplice. [R.] Sir H. Taylor.
accomplicity |The act or state of being an accomplice. [R.]
accomplish |1. To complete, as time or distance. That He would accomplish seventy years in the desolations of Jerusalem. Dan. ix. 2. He had accomplished half a league or more. Prescott. 2. To bring to an issue of full success; to effect; to perform; to execute fully; to fulfill; as, to accomplish a design, an object, a promise. This that is written must yet be accomplished in me. Luke xxii. 37. 3. To equip or furnish thoroughly; hence, to complete in acquirements; to render accomplished; to polish. The armorers accomplishing the knights. Shak. It [the moon] is fully accomplished for all those ends to which Providence did appoint it. Wilkins. These qualities . . . go to accomplish a perfect woman. Cowden Clarke. 4. To gain; to obtain. [Obs.] Shak. Syn. -- To do; perform; fulfill; realize; effect; effectuate; complete; consummate; execute; achieve; perfect; equip; furnish. -- To Accomplish, Effect, Execute, Achieve, Perform. These words agree in the general idea of carrying out to some end proposed. To accomplish (to fill up to the measure of the intention) generally implies perseverance and skill; as, to accomplish a plan proposed by one's self, an object, a design, an undertaking. \"Thou shalt accomplish my desire.\" 1 Kings v. 9. He . . . expressed his desire to see a union accomplished between England and Scotland. Macaulay. To effect (to work out) is much like accomplish. It usually implies some degree of difficulty contended with; as, he effected or accomplished what he intended, his purpose, but little. \"What he decreed, he effected.\" Milton. To work in close design by fraud or guile What force effected not. Milton. To execute (to follow out to the end, to carry out, or into effect) implies a set mode of operation; as, to execute the laws or the orders of another; to execute a work, a purpose, design, plan, project. To perform is much like to do, though less generally applied. It conveys a notion of protracted and methodical effort; as, to perform a mission, a part, a task, a work. \"Thou canst best perform that office.\" Milton. The Saints, like stars, around his seat Perform their courses still. Keble. To achieve (to come to the end or arrive at one's purpose) usually implies some enterprise or undertaking of importance, difficulty, and excellence.
accomplishable |Capable of being accomplished; practicable. Carlyle.
accomplished |1. Completed; effected; established; as, an accomplished fact. 2. Complete in acquirements as the result usually of training; -- commonly in a good sense; as, an accomplished scholar, an accomplished villain. They . . . show themselves accomplished bees. Holland. Daughter of God and man, accomplished Eve. Milton.
accomplisher |One who accomplishes.
accomplishment |1. The act of accomplishing; entire performance; completion; fulfillment; as, the accomplishment of an enterprise, of a prophecy, etc. 2. That which completes, perfects, or equips thoroughly; acquirement; attainment; that which constitutes excellence of mind, or elegance of manners, acquired by education or training. \"My new accomplishment of dancing.\" Churchill. \"Accomplishments befitting a station.\" Thackeray. Accomplishments have taken virtue's place, And wisdom falls before exterior grace. Cowper.
accompt |See Account. Note: Accompt, accomptant, etc., are archaic forms.
accomptable |See Accountable.
accomptant |See Accountant.
accord |1. Agreement or concurrence of opinion, will, or action; harmony of mind; consent; assent. A mediator of an accord and peace between them. Bacon. These all continued with one accord in prayer. Acts i. 14. 2. Harmony of sounds; agreement in pitch and tone; concord; as, the accord of tones. Those sweet accords are even the angels' lays. Sir J. Davies. 3. Agreement, harmony, or just correspondence of things; as, the accord of light and shade in painting. 4. Voluntary or spontaneous motion or impulse to act; -- preceded by own; as, of one's own accord. That which groweth of its own accord of thy harvest thou shalt not reap. Lev. xxv. 5. Of his own accord he went unto you. 2 Cor. vii. 17. 5. (Law)  An agreement between parties in controversy, by which satisfaction for an injury is stipulated, and which, when executed, bars a suit. Blackstone. With one accord, with unanimity. They rushed with one accord into the theater. Acts xix. 29.\n\n1. To make to agree or correspond; to suit one thing to another; to adjust; -- followed by to. [R.] Her hands accorded the lute's music to the voice. Sidney. 2. To bring to an agreement, as persons; to reconcile; to settle, adjust, harmonize, or compose, as things; as, to accord suits or controversies. When they were accorded from the fray. Spenser. All which particulars, being confessedly knotty and difficult can never be accorded but by a competent stock of critical learning. South. 3. To grant as suitable or proper; to concede; to award; as, to accord to one due praise. \"According his desire.\" Spenser.\n\n1. To agree; to correspond; to be in harmony; -- followed by with, formerly also by to; as, his disposition accords with his looks. My heart accordeth with my tongue. Shak. Thy actions to thy words accord. Milton. 2. To agree in pitch and tone.
accordable |1. Agreeing. [Obs.] Chaucer. 2. Reconcilable; in accordance.
accordance |Agreement; harmony; conformity. \"In strict accordance with the law.\" Macaulay. Syn. -- Harmony; unison; coincidence.
accordancy |Accordance. [R.] Paley.
accordant |Agreeing; consonant; harmonious; corresponding; conformable; -- followed by with or to. Strictly accordant with true morality. Darwin. And now his voice accordant to the string. Coldsmith.
accordantly |In accordance or agreement; agreeably; conformably; -- followed by with or to.
accorder |One who accords, assents, or concedes. [R.]
according |Agreeing; in agreement or harmony; harmonious. \"This according voice of national wisdom.\" Burke. \"Mind and soul according well.\" Tennyson. According to him, every person was to be bought. Macaulay. Our zeal should be according to knowledge. Sprat. Note: According to has been called a prepositional phrase, but strictly speaking, according is a participle in the sense of agreeing, acceding, and to alone is the preposition. According as, precisely as; the same as; corresponding to the way in which. According as is an adverbial phrase, of which the propriety has been doubted; but good usage sanctions it. See According, adv. Is all things well, According as I gave directions Shak. The land which the Lord will give you according as he hath promised. Ex. xii. 25. p. 13\n\nAccordingly; correspondingly. [Obs.] Shak.
accordingly |1. Agreeably; correspondingly; suitably; in a manner conformable. Behold, and so proceed accordingly. Shak. 2. In natural sequence; consequently; so. Syn. -- Consequently; therefore; wherefore; hence; so. -- Accordingly, Consequently, indicate a connection between two things, the latter of which is done on account of the former. Accordingly marks the connection as one of simple accordance or congruity, leading naturally to the result which followed; as, he was absent when I called, and I accordingly left my card; our preparations were all finished, and we accordingly set sail. Consequently all finished, and we accordingly set sail. Consequently marks a closer connection, that of logical or causal sequence; as, the papers were not ready, and consequently could not be signed.
accordion |A small, portable, keyed wind instrument, whose tones are generated by play of the wind upon free metallic reeds.
accordionist |A player on the accordion.
accordment |Agreement; reconcilement. [Obs.] Gower.
accorporate |To unite; to attach; to incorporate. [Obs.] Milton.
accost |1. To join side to side; to border; hence, to sail along the coast or side of. [Obs.] \"So much [of Lapland] as accosts the sea.\" Fuller. 2. To approach; to make up to. [Archaic] Shak. 3. To speak to first; to address; to greet. \"Him, Satan thus accosts.\" Milton.\n\nTo adjoin; to lie alongside. [Obs.] \"The shores which to the sea accost.\" Spenser.\n\nAddress; greeting. [R.] J. Morley.
accostable |Approachable; affable. [R.] Hawthorne.
accosted |Supported on both sides by other charges; also, side by side.
accouchement |Delivery in childbed
accoucheur |A man who assists women in childbirth; a man midwife; an obstetrician.
accoucheuse |A midwife. [Recent] Dunglison.
account |1. A reckoning; computation; calculation; enumeration; a record of some reckoning; as, the Julian account of time. A beggarly account of empty boxes. Shak. 2. A registry of pecuniary transactions; a written or printed statement of business dealings or debts and credits, and also of other things subjected to a reckoning or review; as, to keep one's account at the bank. 3. A statement in general of reasons, causes, grounds, etc., explanatory of some event; as, no satisfactory account has been given of these phenomena. Hence, the word is often used simply for reason, ground, consideration, motive, etc.; as, on no account, on every account, on all accounts. 4. A statement of facts or occurrences; recital of transactions; a relation or narrative; a report; a description; as, an account of a battle. \"A laudable account of the city of London.\" Howell. 5. A statement and explanation or vindication of one's conduct with reference to judgment thereon. Give an account of thy stewardship. Luke xvi. 2. 6. An estimate or estimation; valuation; judgment. \"To stand high in your account.\" Shak. 7. Importance; worth; value; advantage; profit. \"Men of account.\" Pope. \"To turn to account.\" Shak. Account current, a running or continued account between two or more parties, or a statement of the particulars of such an account. -- In account with, in a relation requiring an account to be kept. -- On account of, for the sake of; by reason of; because of. -- On one's own account, for one's own interest or behalf. -- To make account, to have an opinion or expectation; to reckon. [Obs.] s other part . . . makes account to find no slender arguments for this assertion out of those very scriptures which are commonly urged against it. Milton. -- To make account of, to hold in estimation; to esteem; as, he makes small account of beauty. -- To take account of, or to take into account, to take into consideration; to notice. \"Of their doings, God takes no account.\" Milton . -- A writ of account (Law), a writ which the plaintiff brings demanding that the defendant shall render his just account, or show good cause to the contrary; -- called also an action of account. Cowell. Syn. -- Narrative; narration; relation; recital; description; explanation; rehearsal. -- Account, Narrative, Narration, Recital. These words are applied to different modes of rehearsing a series of events. Account turns attention not so much to the speaker as to the fact related, and more properly applies to the report of some single event, or a group of incidents taken as whole; as, an account of a battle, of a shipwreck, etc. A narrative is a continuous story of connected incidents, such as one friend might tell to another; as, a narrative of the events of a siege, a narrative of one's life, etc. Narration is usually the same as narrative, but is sometimes used to describe the mode of relating events; as, his powers of narration are uncommonly great. Recital denotes a series of events drawn out into minute particulars, usually expressing something which peculiarly interests the feelings of the speaker; as, the recital of one's wrongs, disappointments, sufferings, etc. 1. To reckon; to compute; to count. [Obs.] The motion of . . . the sun whereby years are accounted. Sir T. Browne. 2. To place to one's account; to put to the credit of; to assign; -- with to. [R.] Clarendon. 3. To value, estimate, or hold in opinion; to judge or consider; to deem. Accounting that God was able to raise him up. Heb. xi. 19. 4. To recount; to relate. [Obs.] Chaucer.\n\n1. To render or receive an account or relation of particulars; as, an officer must account with or to the treasurer for money received. 2. To render an account; to answer in judgment; -- with for; as, we must account for the use of our opportunities. 3. To give a satisfactory reason; to tell the cause of; to explain; - - with for; as, idleness accounts for poverty. To account of, to esteem; to prize; to value. Now used only in the passive. \"I account of her beauty.\" Shak. Newer was preaching more accounted of than in the sixteenth century. Canon Robinson.
account book |A book in which accounts are kept. Swift.
accountability |The state of being accountable; liability to be called on to render an account; accountableness. \"The awful idea of accountability.\" R. Hall.
accountable |1. Liable to be called on to render an account; answerable; as, every man is accountable to God for his conduct. 2. Capable of being accounted for; explicable. [R.] True religion . . . intelligible, rational, and accountable, -- not a burden but a privilege. B. Whichcote. Syn. -- Amenable; responsible; liable; answerable.
accountableness |The quality or state of being accountable; accountability.
accountably |In an accountable manner.
accountancy |The art or employment of an accountant.
accountant |1. One who renders account; one accountable. 2. A reckoner. 3. One who is skilled in, keeps, or adjusts, accounts; an officer in a public office, who has charge of the accounts. Accountatn general, the head or superintending accountant in certain public offices. Also, formerly, an officer in the English court of chancery who received the moneys paid into the court, and deposited them in the Bank of England.\n\nAccountable. [Obs.] Shak.
accountantship |The office or employment of an accountant.
accouple |To join; to couple. [R.] The Englishmen accoupled themselves with the Frenchmen. Hall.
accouplement |1. The act of coupling, or the state of being coupled; union. [R.] Caxton. 2. That which couples, as a tie or brace. [R.]
accourage |To encourage. [Obs.]
accourt |To treat courteously; to court. [Obs.] Spenser.
accouter |To furnish with dress, or equipments, esp. those for military service; to equip; to attire; to array. Bot accoutered like young men. Shak. For this, in rags accoutered are they seen. Dryden. Accoutered with his burden and his staff. Wordsworth.
accouterments |Dress; trappings; equipment; specifically, the devices and equipments worn by soldiers. How gay with all the accouterments of war!
accoutre |To furnish with dress, or equipments, esp. those for military service; to equip; to attire; to array. Bot accoutered like young men. Shak. For this, in rags accoutered are they seen. Dryden. Accoutered with his burden and his staff. Wordsworth.
accoutrements |Dress; trappings; equipment; specifically, the devices and equipments worn by soldiers. How gay with all the accouterments of war!
accoy |1. To render quiet; to soothe. [Obs.] Chaucer. 2. To subdue; to tame; to daunt. [Obs.] Then is your careless courage accoyed. Spenser.
accredit |1. To put or bring into credit; to invest with credit or authority; to sanction. His censure will . . . accredit his praises. Cowper. These reasons . . . which accredit and fortify mine opinion. Shelton. 2. To send with letters credential, as an ambassador, envoy, or diplomatic agent; to authorize, as a messenger or delegate. Beton . . . was accredited to the Court of France. Froude. 3. To believe; to credit; to put trust in. The version of early Roman history which was accredited in the fifth century. Sir G. C. Lewis. He accredited and repeated stories of apparitions and witchcraft. Southey. 4. To credit; to vouch for or consider (some one) as doing something, or (something) as belonging to some one. To accredit (one) with (something), to attribute something to him; as, Mr. Clay was accredited with these views; they accredit him with a wise saying.
accreditation |The act of accrediting; as, letters of accreditation.
accrementitial |Pertaining to accremention.
accrementition |The process of generation by development of blastema, or fission of cells, in which the new formation is in all respect like the individual from which it proceeds.
accresce |1. To accrue. [R.] 2. To increase; to grow. [Obs.] Gillespie.
accrescence |Continuous growth; an accretion. [R.] The silent accrescence of belief from the unwatched depositions of a general, never contradicted hearsy. Coleridge.
accrescent |1. Growing; increasing. Shuckford. 2. (Bot.)  Growing larger after flowering. Gray.
accrete |1. To grow together. 2. To adhere; to grow (to); to be added; -- with to.\n\nTo make adhere; to add. Earle.\n\n1. Characterized by accretion; made up; as, accrete matter. 2. (Bot.)  Grown together. Gray.
accretion |1. The act of increasing by natural growth; esp. the increase of organic bodies by the internal accession of parts; organic growth. Arbuthnot. 2. The act of increasing, or the matter added, by an accession of parts externally; an extraneous addition; as, an accretion of earth. A mineral . . . augments not by grown, but by accretion. Owen. To strip off all the subordinate parts of his as a later accretion. Sir G. C. Lewis. 3. Concretion; coherence of separate particles; as, the accretion of particles so as to form a solid mass. 4. A growing together of parts naturally separate, as of the fingers toes. Dana. 5. (Law) (a) The adhering of property to something else, by which the owner of one thing becomes possessed of a right to another; generally, gain of land by the washing up of sand or sail from the sea or a river, or by a gradual recession of the water from the usual watermark. (b) Gain to an heir or legatee, failure of a coheir to the same succession, or a co-legatee of the same thing, to take his share. Wharton. Kent.
accretive |Relating to accretion; increasing, or adding to, by growth. Glanvill.
accriminate |To accuse of a crime. [Obs.] -- Ac*crim`i*na\"tion, n. [Obs.]
accroach |1. To hook, or draw to one's self as with a hook. [Obs.] 2. To usurp, as jurisdiction or royal prerogatives. They had attempted to accroach to themselves royal power. Stubbs.
accroachment |An encroachment; usurpation. [Obs.] Bailey.
accrual |Accrument. [R.]
accrue |1. To increase; to augment. And though power failed, her courage did accrue. Spenser. 2. To come to by way of increase; to arise or spring as a growth or result; to be added as increase, profit, or damage, especially as the produce of money lent. \"Interest accrues to principal.\" Abbott. The great and essential advantages accruing to society from the freedom of the press. Junius.\n\nSomething that accrues; advantage accruing. [Obs.]
accruer |The act of accruing; accretion; as, title by accruer.
accrument |The process of accruing, or that which has accrued; increase. Jer. Taylor.
accubation |The act or posture of reclining on a couch, as practiced by the ancients at meals.
accumb |To recline, as at table. [Obs.] Bailey.
accumbency |The state of being accumbent or reclining. [R.]
accumbent |1. Leaning or reclining, as the ancients did at their meals. The Roman.. accumbent posture in eating. Arbuthnot. 2. (Bot.)  Lying against anything, as one part of a leaf against another leaf. Gray. Accumbent cotyledons have their edges placed against the caulicle. Eaton.\n\nOne who reclines at table.
accumber |To encumber. [Obs.] Chaucer.
accumulate |To heap up in a mass; to pile up; to collect or bring together; to amass; as, to accumulate a sum of money. Syn. -- To collect; pile up; store; amass; gather; aggregate; heap together; hoard.\n\nTo grow or increase in quantity or number; to increase greatly. Ill fares the land, to hastening ills a prey, Where wealth accumulates, and men decay. Goldsmith.\n\nCollected; accumulated. Bacon.
accumulation |1. The act of accumulating, the state of being accumulated, or that which is accumulated; as, an accumulation of earth, of sand, of evils, of wealth, of honors. 2. (Law)  The concurrence of several titles to the same proof. Accumulation of energy or power, the storing of energy by means of weights lifted or masses put in motion; electricity stored. -- An accumulation of degrees (Eng. Univ.), the taking of several together, or at smaller intervals than usual or than is allowed by the rules.
accumulative |Characterized by accumulation; serving to collect or amass; cumulative; additional. -- Ac*cu\"mu*la*tive*ly, adv. -- Ac*cu\"mu*la*tive*ness, n.
accumulator |1. One who, or that which, accumulates, collects, or amasses. 2. (Mech.)  An apparatus by means of which energy or power can be stored, such as the cylinder or tank for storing water for hydraulic elevators, the secondary or storage battery used for accumulating the energy of electrical charges, etc. 3. A system of elastic springs for relieving the strain upon a rope, as in deep-sea dredging.
accuracy |The state of being accurate; freedom from mistakes, this exemption arising from carefulness; exact conformity to truth, or to a rule or model; precision; exactness; nicety; correctness; as, the value of testimony depends on its accuracy. The professed end [of logic] is to teach men to think, to judge, and to reason, with precision and accuracy. Reid. The accuracy with which the piston fits the sides. Lardner.
accurate |1. In exact or careful conformity to truth, or to some standard of requirement, the result of care or pains; free from failure, error, or defect; exact; as, an accurate calculator; an accurate measure; accurate expression, knowledge, etc. 2. Precisely fixed; executed with care; careful. [Obs.] Those conceive the celestial bodies have more accurate influences upon these things below. Bacon. Syn. -- Correct; exact; just; nice; particular. -- Accurate, Correct, Exact, Precise. We speak of a thing as correct with reference to some rule or standard of comparison; as, a correct account, a correct likeness, a man of correct deportment. We speak of a thing as accurate with reference to the care bestowed upon its execution, and the increased correctness to be expected therefrom; as, an accurate statement, an accurate detail of particulars. We speak of a thing as exact with reference to that perfected state of a thing in which there is no defect and no redundance; as, an exact coincidence, the exact truth, an exact likeness. We speak of a thing as precise when we think of it as strictly conformed to some rule or model, as if cut down thereto; as a precise conformity instructions; precisely right; he was very precise in giving his directions.
accurately |In an accurate manner; exactly; precisely; without error or defect.
accurateness |The state or quality of being accurate; accuracy; exactness; nicety; precision.
accurse |To devote to destruction; to imprecate misery or evil upon; to curse; to execrate; to anathematize. And the city shall be accursed. Josh. vi. 17. Thro' you, my life will be accurst. Tennyson.
accursed |Doomed to destruction or misery; cursed; hence, bad enough to be under the curse; execrable; detestable; exceedingly hateful; -- as, an accursed deed. Shak. -- Ac*curs\"ed*ly, adv. -- Ac*curs\"ed*ness, n.
accurst |Doomed to destruction or misery; cursed; hence, bad enough to be under the curse; execrable; detestable; exceedingly hateful; -- as, an accursed deed. Shak. -- Ac*curs\"ed*ly, adv. -- Ac*curs\"ed*ness, n.
accusable |Liable to be accused or censured; chargeable with a crime or fault; blamable; -- with of.
accusal |Accusation. [R.] Byron.
accusant |An accuser. Bp. Hall.
accusation |1. The act of accusing or charging with a crime or with a lighter offense. We come not by the way of accusation To taint that honor every good tongue blesses. Shak. 2. That of which one is accused; the charge of an offense or crime, or the declaration containing the charge. [They] set up over his head his accusation. Matt. xxvii. 37. Syn. -- Impeachment; crimination; censure; charge.
accusatival |Pertaining to the accusative case.
accusative |1. Producing accusations; accusatory. \"This hath been a very accusative age.\" Sir E. Dering. 2. (Gram.)  Applied to the case (as the fourth case of Latin and Greek nouns) which expresses the immediate object on which the action or influence of a transitive verb terminates, or the immediate object of motion or tendency to, expressed by a preposition. It corresponds to the objective case in English.\n\nThe accusative case.
accusatively |1. In an accusative manner. 2. In relation to the accusative case in grammar.
accusatorial |Accusatory.
accusatorially |By way accusation.
accusatory |Pertaining to, or containing, an accusation; as, an accusatory libel. Grote.
accuse |Accusation. [Obs.] Shak.\n\n1. To charge with, or declare to have committed, a crime or offense; (Law)  to charge with an offense, judicially or by a public process; - - with of; as, to accuse one of a high crime or misdemeanor. Neither can they prove the things whereof they now accuse me. Acts xxiv. 13. We are accused of having persuaded Austria and Sardinia to lay down their arms. Macaulay. 2. To charge with a fault; to blame; to censure. Their thoughts the meanwhile accusing or else excusing one another. Rom. ii. 15. 3. To betray; to show. Etym: [L.] Sir P. Sidney. Syn. -- To charge; blame; censure; reproach; criminate; indict; impeach; arraign. -- To Accuse, Charge, Impeach, Arraign. These words agree in bringing home to a person the imputation of wrongdoing. To accuse is a somewhat formal act, and is applied usually (though not exclusively) to crimes; as, to accuse of treason. Charge is the most generic. It may refer to a crime, a dereliction of duty, a fault, etc.; more commonly it refers to moral delinquencies; as, to charge with dishonesty or falsehood. To arraign is to bring (a person) before a tribunal for trial; as, to arraign one before a court or at the bar public opinion. To impeach is officially to charge with misbehavior in office; as, to impeach a minister of high crimes. Both impeach and arraign convey the idea of peculiar dignity or impressiveness.
accused |Charged with offense; as, an accused person. Note: Commonly used substantively; as, the accused, one charged with an offense; the defendant in a criminal case.
accusement |Accusation. [Obs.] Chaucer.
accuser |One who accuses; one who brings a charge of crime or fault.
accusingly |In an accusing manner.
accustom |To make familiar by use; to habituate, familiarize, or inure; - - with to. I shall always fear that he who accustoms himself to fraud in little things, wants only opportunity to practice it in greater. Adventurer. Syn. -- To habituate; inure; exercise; train.\n\n1. To be wont. [Obs.] Carew. 2. To cohabit. [Obs.] We with the best men accustom openly; you with the basest commit private adulteries. Milton.\n\nCustom. [Obs.] Milton.
accustomable |Habitual; customary; wonted. \"Accustomable goodness.\" Latimer.
accustomably |According to custom; ordinarily; customarily. Latimer.
accustomance |Custom; habitual use. [Obs.] Boyle.
accustomarily |Customarily. [Obs.]
accustomary |Usual; customary. [Archaic] Featley.
accustomed |1. Familiar through use; usual; customary. \"An accustomed action.\" Shak. 2. Frequented by customers. [Obs.] \"A well accustomed shop.\" Smollett.
accustomedness |Habituation. Accustomedness to sin hardens the heart. Bp. Pearce.
ace |1. A unit; a single point or spot on a card or die; the card or die so marked; as, the ace of diamonds. 2. Hence: A very small quantity or degree; a particle; an atom; a jot. I 'll not wag an ace further. Dryden. To bate an ace, to make the least abatement. [Obs.] -- Within an ace of, very near; on the point of. W. Irving.
aceldama |The potter's field, said to have lain south of Jerusalem, purchased with the bribe which Judas took for betraying his Master, and therefore called the field of blood. Fig.: A field of bloodshed. The system of warfare . . . which had already converted immense tracts into one universal aceldama. De Quincey.
acentric |Not centered; without a center.
acephal |One of the Acephala.
acephala |That division of the Mollusca which includes the bivalve shells, like the clams and oysters; -- so called because they have no evident head. Formerly the group included the Tunicata, Brachiopoda, and sometimes the Bryozoa. See Mollusca.
acephalan |Same as Acephal.\n\nBelonging to the Acephala.
acephali |1. A fabulous people reported by ancient writers to have heads. 2. (Eccl. Hist.) (a) A Christian sect without a leader. (b) Bishops and certain clergymen not under regular diocesan control. 3. A class of levelers in the time of K. Henry I.
acephalist |One who acknowledges no head or superior. Dr. Gauden.
acephalocyst |A larval entozoön in the form of a subglobular or oval vesicle, or hy datid, filled with fluid, sometimes found in the tissues of man and the lower animals; -- so called from the absence of a head or visible organs on the vesicle. These cysts are the immature stages of certain tapeworms. Also applied to similar cysts of different origin.
acephalocystic |Pertaining to, or resembling, the acephalocysts.
acephalous |1. Headless. 2. (Zoöl.)  Without a distinct head; -- a term applied to bivalve mollusks. 3. (Bot.)  Having the style spring from the base, instead of from the apex, as is the case in certain ovaries. 4. Without a leader or chief. 5. Wanting the beginning. A false or acephalous structure of sentence. De Quincey. 6. (Pros.)  Deficient and the beginning, as a line of poetry. Brande.
acequia |A canal or trench for irrigating land. [Sp. Amer.]
acerate |A combination of aceric acid with a salifiable base.\n\nAcerose; needle-shaped.
acerb |Sour, bitter, and harsh to the taste, as unripe fruit; sharp and harsh.
acerbate |To sour; to imbitter; to irritate.
acerbic |Sour or severe.
acerbitude |Sourness and harshness. [Obs.] Bailey.
acerbity |1. Sourness of taste, with bitterness and astringency, like that of unripe fruit. 2. Harshness, bitterness, or severity; as, acerbity of temper, of language, of pain. Barrow.
aceric |Pertaining to, or obtained from, the maple; as, aceric acid. Ure.
acerose |(a) Having the nature of chaff; chaffy. (b) Needle-shaped, having a sharp, rigid point, as the leaf of the pine.
acerous |Same as Acerose.\n\n(a) Destitute of tentacles, as certain mollusks. (b) Without antennæ, as some insects.
acerval |Pertaining to a heap. [Obs.]
acervate |To heap up. [Obs.]\n\nHeaped, or growing in heaps, or closely compacted clusters.
acervation |A heaping up; accumulation. [R.] Johnson.
acervative |Heaped up; tending to heap up.
acervose |Full of heaps. [R.] Bailey.
acervuline |Resembling little heaps.
acescence |The quality of being acescent; the process of acetous fermentation; a moderate degree of sourness. Johnson.
acescency |The quality of being acescent; the process of acetous fermentation; a moderate degree of sourness. Johnson.
acescent |Turning sour; readily becoming tart or acid; slightly sour. Faraday.\n\nA substance liable to become sour.
acetable |An acetabulum; or about one eighth of a pint. [Obs.] Holland.
acetabular |Cup-shaped; saucer-shaped; acetabuliform.
acetabulifera |The division of Cephalopoda in which the arms are furnished with cup-shaped suckers, as the cuttlefishes, squids, and octopus; the Dibranchiata. See Cephalopoda.
acetabuliferous |Furnished with fleshy cups for adhering to bodies, as cuttlefish, etc.
acetabuliform |Shaped like a shallow; saucer-shaped; as, an acetabuliform calyx. Gray.
acetabulum |1. (Rom. Antiq.)  A vinegar cup; socket of the hip bone; a measure of about one eighth of a pint, etc. 2. (Anat.) (a) The bony cup which receives the head of the thigh bone. (b) The cavity in which the leg of an insect is inserted at its articulation with the body. (c) A sucker of the sepia or cuttlefish and related animals. (d) The large posterior sucker of the leeches. (e) One of the lobes of the placenta in ruminating animals.
acetal |A limpid, colorless, inflammable liquid from the slow oxidation of alcohol under the influence of platinum black.
acetaldehyde |Acetic aldehyde. See Aldehyde.
acetamide |A white crystalline solid, from ammonia by replacement of an equivalent of hydrogen by acetyl.
acetanilide |A compound of aniline with acetyl, used to allay fever or pain; -- called also antifebrine.
acetarious |Used in salads; as, acetarious plants.
acetary |An acid pulp in certain fruits, as the pear. Grew.
acetate |A salt formed by the union of acetic acid with a base or positive radical; as, acetate of lead, acetate of potash.
acetated |Combined with acetic acid.
acetic |(a) Of a pertaining to vinegar; producing vinegar; producing vinegar; as, acetic fermentation. (b) Pertaining to, containing, or derived from, acetyl, as acetic ether, acetic acid. The latter is the acid to which the sour taste of vinegar is due.
acetification |The act of making acetous or sour; the process of converting, or of becoming converted, into vinegar.
acetifier |An apparatus for hastening acetification. Knight.
acetify |To convert into acid or vinegar.\n\nTo turn acid. Encyc. Dom. Econ.
acetimeter |An instrument for estimating the amount of acetic acid in vinegar or in any liquid containing acetic acid.
acetimetry |The act or method of ascertaining the strength of vinegar, or the proportion of acetic acid contained in it. Ure.
acetin |A combination of acetic acid with glycerin. Brande & C.
acetize |To acetify. [R.]
acetol |Methyl ketol; also, any of various homologues of the same.
acetometer |Same as Acetimeter. Brande & C.
acetonaemia |A morbid condition characterized by the presence of acetone in the blood, as in diabetes.
acetone |A volatile liquid consisting of three parts of carbon, six of hydrogen, and one of oxygen; pyroacetic spirit, -- obtained by the distillation of certain acetates, or by the destructive distillation of citric acid, starch, sugar, or gum, with quicklime. Note: The term in also applied to a number of bodies of similar constitution, more frequently called ketones. See Ketone.
acetonemia |A morbid condition characterized by the presence of acetone in the blood, as in diabetes.
acetonic |Of or pertaining to acetone; as, acetonic bodies.
acetonuria |Excess of acetone in the urine, as in starvation or diabetes.
acetophenone |A crystalline ketone, CH3COC6H5, which may be obtained by the dry distillation of a mixture of the calcium salts of acetic and benzoic acids. It is used as a hypnotic under the name of hypnone.
acetose |Sour like vinegar; acetous.
acetosity |The quality of being acetous; sourness.
acetous |1. Having a sour taste; sour; acid. \"An acetous spirit.\" Boyle. \"A liquid of an acetous kind.\" Bp. Lowth. 2. Causing, or connected with, acetification; as, acetous fermentation. Acetous acid, a name formerly given to vinegar.
acetyl |A complex, hypothetical radical, composed of two parts of carbon to three of hydrogen and one of oxygen. Its hydroxide is acetic acid.
acetylene |A gaseous compound of carbon and hydrogen, in the proportion of two atoms of the former to two of the latter. It is a colorless gas, with a peculiar, unpleasant odor, and is produced for use as an illuminating gas in a number of ways, but chiefly by the action of water on calcium carbide. Its light is very brilliant. Watts.
ach |A name given to several species of plants; as, smallage, wild celery, parsley. [Obs.] Holland.
achaean |Of or pertaining to Achaia in Greece; also, Grecian. -- n.  A native of Achaia; a Greek.
achaian |Of or pertaining to Achaia in Greece; also, Grecian. -- n.  A native of Achaia; a Greek.
acharnement |Savage fierceness; ferocity.
achate |An agate. [Obs.] Evelyn.\n\n1. Purchase; bargaining. [Obs.] Chaucer. 2. pl.  Provisions. Same as Cates. [Obs.] Spenser.
achatina |A genus of land snails, often large, common in the warm parts of America and Africa.
achatour |Purveyor; acater. [Obs.] Chaucer.
ache |A name given to several species of plants; as, smallage, wild celery, parsley. [Obs.] Holland.\n\nContinued pain, as distinguished from sudden twinges, or spasmodic pain. \"Such an ache in my bones.\" Shak. Note: Often used in composition, as, a headache, an earache, a toothache.\n\nTo suffer pain; to have, or be in, pain, or in continued pain; to be distressed. \"My old bones ache.\" Shak. The sins that in your conscience ache. Keble.
achean |See Achæan, Achaian.
achene |A small, dry, indehiscent fruit, containing a single seed, as in the buttercup; -- called a naked seed by the earlier botanists. [Written also akene and achænium.]
achenial |Pertaining to an achene.
achenium |A small, dry, indehiscent fruit, containing a single seed, as in the buttercup; -- called a naked seed by the earlier botanists. [Written also akene and achænium.]
acheron |A river in the Nether World or infernal regions; also, the infernal regions themselves. By some of the English poets it was supposed to be a flaming lake or gulf. Shak.
acherontic |Of or pertaining to Acheron; infernal; hence, dismal, gloomy; moribund.
achievable |Capable of being achieved. Barrow.
achievance |Achievement. [Obs.] Sir T. Elyot.
achieve |1. To carry on to a final close; to bring out into a perfected state; to accomplish; to perform; -- as, to achieve a feat, an exploit, an enterprise. Supposing faculties and powers to be the same, far more may be achieved in any line by the aid of a capital, invigorating motive than without it. I. Taylor. 2. To obtain, or gain, as the result of exertion; to succeed in gaining; to win. Some are born great, some achieve greatness. Shak. Thou hast achieved our liberty. Milton. Note: [[Obs]., with a material thing as the aim.] Show all the spoils by valiant kings achieved. Prior. He hath achieved a maid That paragons description. Shak. 3. To finish; to kill. [Obs.] Shak. Syn. -- To accomplish; effect; fulfill; complete; execute; perform; realize; obtain. See Accomplish.
achievement |1. The act of achieving or performing; an obtaining by exertion; successful performance; accomplishment; as, the achievement of his object. 2. A great or heroic deed; something accomplished by valor, boldness, or praiseworthy exertion; a feat. [The exploits] of the ancient saints . . . do far surpass the most famous achievements of pagan heroes. Barrow. The highest achievements of the human intellect. Macaulay. 3. (Her.)  An escutcheon or ensign armorial; now generally applied to the funeral shield commonly called hatchment. Cussans.
achiever |One who achieves; a winner.
achillean |Resembling Achilles, the hero of the Iliad; invincible. ACHILLES' TENDON A*chil\"les' ten\"don, n. Etym: [L. Achillis tendo.] (Anat.)  The strong tendon formed of the united tendons of the large muscles in the calf of the leg, an inserted into the bone of the heel; -- so called from the mythological account of Achilles being held by the heel when dipped in the River Styx.
achilous |Without a lip.
aching |That aches; continuously painful. See Ache. -- Ach\"ing*ly, adv. The aching heart, the aching head. Longfellow.
achiote |Seeds of the annotto tree; also, the coloring matter, annotto.
achlamydate |Not possessing a mantle; -- said of certain gastropods.
achlamydeous |Naked; having no floral envelope, neither calyx nor corolla.
acholia |Deficiency or want of bile.
acholous |Lacking bile.
achromatic |1. (Opt.)  Free from color; transmitting light without decomposing it into its primary colors. 2. (Biol.)  Uncolored; not absorbing color from a fluid; -- said of tissue. Achromatic lens (Opt.), a lens composed usually of two separate lenses, a convex and concave, of substances having different refractive and dispersive powers, as crown and flint glass, with the curvatures so adjusted that the chromatic aberration produced by the one is corrected by other, and light emerges from the compound lens undecomposed. -- Achromatic prism. See Prism. -- Achromatic telescope, or microscope, one in which the chromatic aberration is corrected, usually by means of a compound or achromatic object glass, and which gives images free from extraneous color.
achromatically |In an achromatic manner.
achromaticity |Achromatism.
achromatin |Tissue which is not stained by fluid dyes. W. Flemming.
achromatism |The state or quality of being achromatic; as, the achromatism of a lens; achromaticity. Nichol.
achromatization |The act or process of achromatizing.
achromatize |To deprive of color; to make achromatic.
achromatopsy |Color blindness; inability to distinguish colors; Daltonism.
achromatous |Lacking, or deficient in, color; as, achromatous blood.
achromic |Free from color; colorless; as, in Physiol. Chem., the achromic point of a starch solution acted upon by an amylolytic enzyme is the point at which it fails to give any color with iodine.
achronic |See Acronyc.
achroodextrin |Dextrin not colorable by iodine. See Dextrin.
achrooedextrin |Dextrin not colorable by iodine. See Dextrin.
achroous |Colorless; achromatic.
achrophony |The use of a picture symbol of an object to represent phonetically the initial sound of the name of the object.
achylous |Without chyle.
achymous |Without chyme.
acicula |One of the needlelike or bristlelike spines or prickles of some animals and plants; also, a needlelike crystal.
acicular |Needle-shaped; slender like a needle or bristle, as some leaves or crystals; also, having sharp points like needless. A*cic\"u*lar*ly, adv.
aciculate |(a) Furnished with aciculæ. (b) Acicular. (c) Marked with fine irregular streaks as if scratched by a needle. Lindley.
aciculated |(a) Furnished with aciculæ. (b) Acicular. (c) Marked with fine irregular streaks as if scratched by a needle. Lindley.
aciculiform |Needle-shaped; acicular.
aciculite |Needle ore. Brande & C.
acid |1. Sour, sharp, or biting to the taste; tart; having the taste of vinegar: as, acid fruits or liquors. Also fig.: Sour-tempered. He was stern and his face as acid as ever. A. Trollope. 2. Of or pertaining to an acid; as, acid reaction.\n\n1. A sour substance. 2. (Chem.)  One of a class of compounds, generally but not always distinguished by their sour taste, solubility in water, and reddening of vegetable blue or violet colors. They are also characterized by the power of destroying the distinctive properties of alkalies or bases, combining with them to form salts, at the same time losing their own peculiar properties. They all contain hydrogen, united with a more negative element or radical, either alone, or more generally with oxygen, and take their names from this negative element or radical. Those which contain no oxygen are sometimes called hydracids in distinction from the others which are called oxygen acids or oxacids. Note: In certain cases, sulphur, selenium, or tellurium may take the place of oxygen, and the corresponding compounds are called respectively sulphur acids or sulphacids, selenium acids, or tellurium acids. When the hydrogen of an acid is replaced by a positive element or radical, a salt is formed, and hence acids are sometimes named as salts of hydrogen; as hydrogen nitrate for nitric acid, hydrogen sulphate for sulphuric acid, etc. In the old chemistry the name acid was applied to the oxides of the negative or nonmetallic elements, now sometimes called anhydrides.
acid process |That variety of either the Bessemer or the open-hearth process in which the converter or hearth is lined with acid, that is, highly siliceous, material. Opposed to basic process.
acidic |Containing a high percentage of silica; -- opposed to basic. an acidic solution.
acidiferous |Containing or yielding an acid.
acidifiable |Capable of being acidified, or converted into an acid.
acidific |Producing acidity; converting into an acid. Dana.
acidification |The act or process of acidifying, or changing into an acid.
acidifier |A simple or compound principle, whose presence is necessary to produce acidity, as oxygen, chlorine, bromine, iodine, etc.
acidify |1. To make acid; to convert into an acid; as, to acidify sugar. 2. To sour; to imbitter. His thin existence all acidified into rage. Carlyle.
acidimeter |An instrument for ascertaining the strength of acids. Ure.
acidimetry |The measurement of the strength of acids, especially by a chemical process based on the law of chemical combinations, or the fact that, to produce a complete reaction, a certain definite weight of reagent is required. -- Ac`id*i*met\"ric*al, a.
acidity |The quality of being sour; sourness; tartness; sharpness to the taste; as, the acidity of lemon juice.
acidly |Sourly; tartly.
acidness |Acidity; sourness.
acidulate |To make sour or acid in a moderate degree; to sour somewhat. Arbuthnot.
acidulent |Having an acid quality; sour; acidulous. \"With anxious, acidulent face.\" Carlyle.
acidulous |Slightly sour; sub-acid; sourish; as, an acidulous tincture. E. Burke. Acidulous mineral waters, such as contain carbonic anhydride.
acierage |The process of coating the surface of a metal plate (as a stereotype plate) with steellike iron by means of voltaic electricity; steeling.
aciform |Shaped like a needle.
acinaceous |Containing seeds or stones of grapes, or grains like them.
acinaces |A short sword or saber.
acinaciform |Scimeter-shaped; as, an acinaciform leaf.
acinesia |Same as Akinesia.
acinetae |A group of suctorial Infusoria, which in the adult stage are stationary. See Suctoria.
acinetiform |Resembling the Acinetæ.
aciniform |1. Having the form of a cluster of grapes; clustered like grapes. 2. Full of small kernels like a grape.
acinose |Consisting of acini, or minute granular concretions; as, acinose or acinous glands. Kirwan.
acinous |Consisting of acini, or minute granular concretions; as, acinose or acinous glands. Kirwan.
acinus |1. (Bot.) (a) One of the small grains or drupelets which make up some kinds of fruit, as the blackberry, raspberry, etc. (b) A grapestone. 2. (Anat.)  One of the granular masses which constitute a racemose or compound gland, as the pancreas; also, one of the saccular recesses in the lobules of a racemose gland. Quain.
acipenser |A genus of ganoid fishes, including the sturgeons, having the body armed with bony scales, and the mouth on the under side of the head. See Sturgeon.
aciurgy |Operative surgery.
acknow |1. To recognize. [Obs.] \"You will not be acknown, sir.\" B. Jonson. 2. To acknowledge; to confess. [Obs.] Chaucer. To be acknown (often with of or on), to acknowledge; to confess. [Obs.] We say of a stubborn body that standeth still in the denying of his fault, This man will not acknowledge his fault, or, He will not be acknown of his fault. Sir T. More.
acknowledge |1. To of or admit the knowledge of; to recognize as a fact or truth; to declare one's belief in; as, to acknowledge the being of a God. I acknowledge my transgressions. Ps. li. 3. For ends generally acknowledged to be good. Macaulay. 2. To own or recognize in a particular character or relationship; to admit the claims or authority of; to give recognition to. In all thy ways acknowledge Him. Prov. iii. 6. By my soul, I'll ne'er acknowledge thee. Shak. 3. To own with gratitude or as a benefit or an obligation; as, to acknowledge a favor, the receipt of a letter. They his gifts acknowledged none. Milton. 4. To own as genuine; to assent to, as a legal instrument, to give it validity; to avow or admit in legal form; as, to acknowledgea deed. Syn. -- To avow; proclaim; recognize; own; admit; allow; concede; confess. -- Acknowledge, Recognize. Acknowledge is opposed to keep back, or conceal, and supposes that something had been previously known to us (though perhaps not to others) which we now feel bound to lay open or make public. Thus, a man acknowledges a secret marriage; one who has done wrong acknowledges his fault; and author acknowledges his obligation to those who have aided him; we acknowledge our ignorance. Recognize supposes that we have either forgotten or not had the evidence of a thing distinctly before our minds, but that now we know it (as it were) anew, or receive and admit in on the ground of the evidence it brings. Thus, we recognize a friend after a long absence. We recognize facts, principles, truths, etc., when their evidence is brought up fresh to the mind; as, bad men usually recognize the providence of God in seasons of danger. A foreign minister, consul, or agent, of any kind, is recognized on the ground of his producing satisfactory credentials. See also Confess.
acknowledgedly |Confessedly.
acknowledger |One who acknowledges.
acknowledgment |1. The act of acknowledging; admission; avowal; owning; confession. \"An acknowledgment of fault.\" Froude. 2. The act of owning or recognized in a particular character or relationship; recognition as regards the existence, authority, truth, or genuineness. Immediately upon the acknowledgment of the Christian faith, the eunuch was baptized by Philip. Hooker. 3. The owning of a benefit received; courteous recognition; expression of thanks. Shak. 4. Something given or done in return for a favor, message, etc. Smollett. 5. A declaration or avowal of one's own act, to give it legal validity; as, the acknowledgment of a deed before a proper officer. Also, the certificate of the officer attesting such declaration. Acknowledgment money, in some parts of England, a sum paid by copyhold tenants, on the death of their landlords, as an acknowledgment of their new lords. Cowell. Syn. -- Confession; concession; recognition; admission; avowal; recognizance.
aclinic |Without inclination or dipping; -- said the magnetic needle balances itself horizontally, having no dip. The aclinic line is also termed the magnetic equator. Prof. August.
acme |1. The top or highest point; the culmination. The very acme and pitch of life for epic poetry. Pope. The moment when a certain power reaches the acme of its supremacy. I. Taylor. 2. (Med.)  The crisis or height of a disease. 3. Mature age; full bloom of life. B. Jonson.
acne |A pustular affection of the skin, due to changes in the sebaceous glands.
acnodal |Pertaining to acnodes.
acnode |An isolated point not upon a curve, but whose coördinates satisfy the equation of the curve so that it is considered as belonging to the curve.
acock |In a cocked or turned up fashion.
acockbill |(a) Hanging at the cathead, ready to let go, as an anchor. (b) Topped up; having one yardarm higher than the other.
acold |Cold. [Obs.] \"Poor Tom's acold.\" Shak.
acologic |Pertaining to acology.
acology |Materia medica; the science of remedies.
acolothist |See Acolythist.
acolyctine |An organic base, in the form of a white powder, obtained from Aconitum lycoctonum. Eng. Cyc.
acolyte |1. (Eccl.)  One who has received the highest of the four minor orders in the Catholic church, being ordained to carry the wine and water and the lights at the Mass. 2. One who attends; an assistant. \"With such chiefs, and with James and John as acolytes.\" Motley.
acolyth |Same as Acolyte.
acolythist |An acolyte. [Obs.]
aconddylose |Being without joints; jointless.
acondylous |Being without joints; jointless.
aconital |Of the nature of aconite.
aconite |1. (Bot.)  The herb wolfsbane, or monkshood; -- applied to any plant of the genus Aconitum (tribe Hellebore), all the species of which are poisonous. 2. An extract or tincture obtained from Aconitum napellus, used as a poison and medicinally. Winter aconite, a plant (Eranthis hyemalis) allied to the aconites.
aconitia |Same as Aconitine.
aconitic |Of or pertaining to aconite.
aconitine |An intensely poisonous alkaloid, extracted from aconite.
aconitum |The poisonous herb aconite; also, an extract from it. Strong As aconitum or rash gunpowder. Shak.
acontia |Threadlike defensive organs, composed largely of nettling cells (cnidæ), thrown out of the mouth or special pores of certain Actiniæ when irritated.
acontias |Anciently, a snake, called dart snake; now, one of a genus of reptiles closely allied to the lizards.
acopic |Relieving weariness; restorative.
acorn |1. The fruit of the oak, being an oval nut growing in a woody cup or cupule. 2. (Naut.)  A cone-shaped piece of wood on the point of the spindle above the vane, on the mast-head. 3. (Zoöl.)  See Acorn-shell.
acorn cup |The involucre or cup in which the acorn is fixed.
acorn-shell |One of the sessile cirripeds; a barnacle of the genus Balanus. See Barnacle.
acorned |1. Furnished or loaded with acorns. 2. Fed or filled with acorns. [R.] Shak.
acosmism |A denial of the existence of the universe as distinct from God.
acosmist |One who denies the existence of the universe, or of a universe as distinct from God. G. H. Lewes.
acotyledon |A plant which has no cotyledons, as the dodder and all flowerless plants.
acotyledonous |Having no seed lobes, as the dodder; also applied to plants which have no true seeds, as ferns, mosses, etc.
acouchy |A small species of agouti (Dasyprocta acouchy).
acoumeter |An instrument for measuring the acuteness of the sense of hearing. Itard.
acoumetry |The measuring of the power or extent of hearing.
acoustic |Pertaining to the sense of hearing, the organs of hearing, or the science of sounds; auditory. Acoustic duct, the auditory duct, or external passage of the ear. -- Acoustic telegraph, a telegraph making audible signals; a telephone. -- Acoustic vessels, brazen tubes or vessels, shaped like a bell, used in ancient theaters to propel the voices of the actors, so as to render them audible to a great distance.\n\nA medicine or agent to assist hearing.
acoustical |Of or pertaining to acoustics.
acoustically |In relation to sound or to hearing. Tyndall.
acoustician |One versed in acoustics. Tyndall.
acoustics |The science of sounds, teaching their nature, phenomena, and laws. Acoustics, then, or the science of sound, is a very considerable branch of physics. Sir J. Herschel. Note: The science is, by some writers, divided, into diacoustics, which explains the properties of sounds coming directly from the ear; and catacoustica, which treats of reflected sounds or echoes.
acquaint |Acquainted. [Obs.]\n\n1. To furnish or give experimental knowledge of; to make (one) to know; to make familiar; -- followed by with. Before a man can speak on any subject, it is necessary to be acquainted with it. Locke. A man of sorrows and acquainted with grief. Isa. liii. 3. 2. To communicate notice to; to inform; to make cognizant; -- followed by with (formerly, also, by of), or by that, introducing the intelligence; as, to acquaint a friend with the particulars of an act. Acquaint her here of my son Paris' love. Shak. I must acquaint you that I have received New dated letters from Northumberland. Shak. 3. To familiarize; to accustom. [Obs.] Evelyn. To be acquainted with, to be possessed of personal knowledge of; to be cognizant of; to be more or less familiar with; to be on terms of social intercourse with. Syn. -- To inform; apprise; communicate; advise.
acquaintable |Easy to be acquainted with; affable. [Obs.] Rom. of R.
acquaintance |1. A state of being acquainted, or of having intimate, or more than slight or superficial, knowledge; personal knowledge gained by intercourse short of that of friendship or intimacy; as, I know the man; but have no acquaintance with him. Contract no friendship, or even acquaintance, with a guileful man. Sir W. Jones. 2. A person or persons with whom one is acquainted. Montgomery was an old acquaintance of Ferguson. Macaulay. Note: In this sense the collective term acquaintance was formerly both singular and plural, but it is now commonly singular, and has the regular plural acquaintances. To be of acquaintance, to be intimate. -- To take acquaintance of or with, to make the acquaintance of. [Obs.] Syn. -- Familiarity; intimacy; fellowship; knowledge. -- Acquaintance, Familiarity, Intimacy. These words mark different degrees of closeness in social intercourse. Acquaintance arises from occasional intercourse; as, our acquaintance has been a brief one. We can speak of a slight or an intimate acquaintance. Familiarity is the result of continued acquaintance. It springs from persons being frequently together, so as to wear off all restraint and reserve; as, the familiarity of old companions. Intimacy is the result of close connection, and the freest interchange of thought; as, the intimacy of established friendship. Our admiration of a famous man lessens upon our nearer acquaintance with him. Addison. We contract at last such a familiarity with them as makes it difficult and irksome for us to call off our minds. Atterbury. It is in our power to confine our friendships and intimacies to men of virtue. Rogers.
acquaintanceship |A state of being acquainted; acquaintance. Southey.
acquaintant |An acquaintance. [R.] Swift.
acquainted |Personally known; familiar. See To be acquainted with, under Acquaint, v. t.
acquaintedness |State of being acquainted; degree of acquaintance. [R.] Boyle.
acquest |1. Acquisition; the thing gained. [R.] Bacon. 2. (Law)  Property acquired by purchase, gift, or otherwise than by inheritance. Bouvier.
acquiesce |1. To rest satisfied, or apparently satisfied, or to rest without opposition and discontent (usually implying previous opposition or discontent); to accept or consent by silence or by omitting to object; -- followed by in, formerly also by with and to. They were compelled to acquiesce in a government which they did not regard as just. De Quincey. 2. To concur upon conviction; as, to acquiesce in an opinion; to assent to; usually, to concur, not heartily but so far as to forbear opposition. Syn. -- To submit; comply; yield; assent; agree; consent; accede; concur; conform; accept tacitly.
acquiescence |1. A silent or passive assent or submission, or a submission with apparent content; -- distinguished from avowed consent on the one hand, and on the other, from opposition or open discontent; quiet satisfaction. 2. (Crim. Law) (a) Submission to an injury by the party injured. (b) Tacit concurrence in the action of another. Wharton. p. 17
acquiescency |The quality of being acquiescent; acquiescence.
acquiescent |Resting satisfied or submissive; disposed tacitly to submit; assentive; as, an acquiescent policy.
acquiescently |In an acquiescent manner.
acquiet |To quiet. [Obs.] Acquiet his mind from stirring you against your own peace. Sir A. Sherley.
acquirability |The quality of being acquirable; attainableness. [R.] Paley.
acquirable |Capable of being acquired.
acquire |To gain, usually by one's own exertions; to get as one's own; as, to acquire a title, riches, knowledge, skill, good or bad habits. No virtue is acquired in an instant, but step by step. Barrow. Descent is the title whereby a man, on the death of his ancestor, acquires his estate, by right of representation, as his heir at law. Blackstone. Syn. -- To obtain; gain; attain; procure; win; earn; secure. See Obtain.
acquirement |The act of acquiring, or that which is acquired; attainment. \"Rules for the acquirement of a taste.\" Addison. His acquirements by industry were . . . enriched and enlarged by many excellent endowments of nature. Hayward. Syn. -- Acquisition, Acquirement. Acquirement is used in opposition to a natural gift or talent; as, eloquence, and skill in music and painting, are acquirements; genius is the gift or endowment of nature. It denotes especially personal attainments, in opposition to material or external things gained, which are more usually called acquisitions; but this distinction is not always observed.
acquirer |A person who acquires.
acquiry |Acquirement. [Obs.] Barrow.
acquisite |Acquired. [Obs.] Burton.
acquisition |1. The act or process of acquiring. The acquisition or loss of a province. Macaulay. 2. The thing acquired or gained; an acquirement; a gain; as, learning is an acquisition. Syn. -- See Acquirement.
acquisitive |1. Acquired. [Obs.] He died not in his acquisitive, but in his native soil. Wotton. 2. Able or disposed to make acquisitions; acquiring; as, an acquisitive person or disposition.
acquisitively |In the way of acquisition.
acquisitiveness |1. The quality of being acquisitive; propensity to acquire property; desire of possession. 2. (Phren.)  The faculty to which the phrenologists attribute the desire of acquiring and possessing. Combe.
acquisitor |One who acquires.
acquist |Acquisition; gain. Milton.
acquit |Acquitted; set free; rid of. [Archaic] Shak.\n\n1. To discharge, as a claim or debt; to clear off; to pay off; to requite. A responsibility that can never be absolutely acquitted. I. Taylor. 2. To pay for; to atone for. [Obs.] Shak. 3. To set free, release or discharge from an obligation, duty, liability, burden, or from an accusation or charge; -- now followed by of before the charge, formerly by from; as, the jury acquitted the prisoner; we acquit a man of evil intentions. 4. Reflexively: (a) To clear one's self.k. (b) To bear or conduct one's self; to perform one's part; as, the soldier acquitted himself well in battle; the orator acquitted himself very poorly. Syn. -- To absolve; clear; exonerate; exonerate; exculpate; release; discharge. See Absolve.
acquitment |Acquittal. [Obs.] Milton.
acquittal |1. The act of acquitting; discharge from debt or obligation; acquittance. 2. (Law)  A setting free, or deliverance from the charge of an offense, by verdict of a jury or sentence of a court. Bouvier.
acquittance |1. The clearing off of debt or obligation; a release or discharge from debt or other liability. 2. A writing which is evidence of a discharge; a receipt in full, which bars a further demand. You can produce acquittances For such a sum, from special officers. Shak.\n\nTo acquit. [Obs.] Shak.
acquitter |One who acquits or releases.
acrania |1. (Physiol.)  Partial or total absence of the skull. 2. pl. (Zoöl.)  The lowest group of Vertebrata, including the amphioxus, in which no skull exists.
acranial |Wanting a skull.
acrase |1. To craze. [Obs.] Grafton. 2. To impair; to destroy. [Obs.] Hacket.
acrasia |Excess; intemperance. [Obs. except in Med.] Farindon.
acraspeda |A group of acalephs, including most of the larger jellyfishes; the Discophora.
acrasy |Excess; intemperance. [Obs. except in Med.] Farindon.
acraze |1. To craze. [Obs.] Grafton. 2. To impair; to destroy. [Obs.] Hacket.
acre |1. Any field of arable or pasture land. [Obs.] 2. A piece of land, containing 160 square rods, or 4,840 square yards, or 43,560 square feet. This is the English statute acre. That of the United States is the same. The Scotch acre was about 1.26 of the English, and the Irish 1.62 of the English. Note: The acre was limited to its present definite quantity by statutes of Edward I., Edward III., and Henry VIII. Broad acres, many acres, much landed estate. [Rhetorical] -- God's acre, God's field; the churchyard. I like that ancient Saxon phrase, which calls The burial ground, God's acre. Longfellow.
acreable |Of an acre; per acre; as, the acreable produce.
acreage |Acres collectively; as, the acreage of a farm or a country.
acred |Possessing acres or landed property; -- used in composition; as, large-acred men.
acrid |1. Sharp and harsh, or bitter and not, to the taste; pungent; as, acrid salts. 2. Causing heat and irritation; corrosive; as, acrid secretions. 3. Caustic; bitter; bitterly irritating; as, acrid temper, mind, writing. Acrid poison, a poison which irritates, corrodes, or burns the parts to which it is applied.
acridity |The quality of being acrid or pungent; irritant bitterness; acrimony; as, the acridity of a plant, of a speech.
acridly |In an acid manner.
acridness |The quality of being acrid or pungent; irritant bitterness; acrimony; as, the acridity of a plant, of a speech.
acrimonious |1. Acrid; corrosive; as, acrimonious gall. [Archaic] Harvey. 2. Caustic; bitter-tempered' sarcastic; as, acrimonious dispute, language, temper.
acrimoniously |In an acrimonious manner.
acrimoniousness |The quality of being acrimonious; asperity; acrimony.
acrimony |1. A quality of bodies which corrodes or destroys others; also, a harsh or biting sharpness; as, the acrimony of the juices of certain plants. [Archaic] Bacon. 2. Sharpness or severity, as of language or temper; irritating bitterness of disposition or manners. John the Baptist set himself with much acrimony and indignation to baffle this senseless arrogant conceit of theirs. South. Syn. -- Acrimony, Asperity, Harshness, Tartness. These words express different degrees of angry feeling or language. Asperity and harshness arise from angry feelings, connected with a disregard for the feelings of others. Harshness usually denotes needless severity or an undue measure of severity. Acrimony is a biting sharpness produced by an imbittered spirit. Tartness denotes slight asperity and implies some degree of intellectual readiness. Tartness of reply; harshness of accusation; acrimony of invective. In his official letters he expressed, with great acrimony, his contempt for the king's character. Macaulay. It is no very cynical asperity not to confess obligations where no benefit has been received. Johnson. A just reverence of mankind prevents the growth of harshness and brutality. Shaftesbury.
acrisia |1. Inability to judge. 2. (Med.)  Undecided character of a disease. [Obs.]
acrisy |1. Inability to judge. 2. (Med.)  Undecided character of a disease. [Obs.]
acrita |The lowest groups of animals, in which no nervous system has been observed.
acritan |Of or pertaining to the Acrita. -- n. An individual of the Acrita.
acrite |Acritan. Owen.
acritical |Having no crisis; giving no indications of a crisis; as, acritical symptoms, an acritical abscess.
acritochromacy |Color blindness; achromatopsy.
acritude |Acridity; pungency joined with heat. [Obs.]
acrity |Sharpness; keenness. [Obs.]
acroamatic |Communicated orally; oral; -- applied to the esoteric teachings of Aristotle, those intended for his genuine disciples, in distinction from his exoteric doctrines, which were adapted to outsiders or the public generally. Hence: Abstruse; profound.
acroamatical |Communicated orally; oral; -- applied to the esoteric teachings of Aristotle, those intended for his genuine disciples, in distinction from his exoteric doctrines, which were adapted to outsiders or the public generally. Hence: Abstruse; profound.
acroatic |Same as Acroamatic.
acrobat |One who practices rope dancing, high vaulting, or other daring gymnastic feats.
acrobatic |Pertaining to an acrobat. -- Ac`ro*bat\"ic*al*ly, adv.
acrobatism |Feats of the acrobat; daring gymnastic feats; high vaulting.
acrocarpous |(a) Having a terminal fructification; having the fruit at the end of the stalk. (b) Having the fruit stalks at the end of a leafy stem, as in certain mosses.
acrocephalic |Characterized by a high skull.
acrocephaly |Loftiness of skull.
acroceraunian |Of or pertaining to the high mountain range of \"thunder- smitten\" peaks (now Kimara), between Epirus and Macedonia. Shelley.
acrodactylum |The upper surface of the toes, individually.
acrodont |One of a group of lizards having the teeth immovably united to the top of the alveolar ridge. -- a. Of or pertaining to the acrodonts.
acrogen |A plant of the highest class of cryptograms, including the ferns, etc. See Cryptogamia. The Age of Acrogens (Geol.), the age of coal plants, or the carboniferous era.
acrogenous |Increasing by growth from the extremity; as, an acrogenous plant.
