lowlander |A native or inhabitant of the Lowlands, especially of the Lowlands of Scotland, as distinguished from Highlander.
lowlihead |A lowly state. [R.] Tennyson.
lowlihood |A lowly state. [R.] Tennyson.
lowlily |In a lowly place or manner; humbly. [Obs. or R.] Thinking lowlily of himself and highly of those better than himself. J. C. Shairp.
lowliness |1. The state or quality of being lowly; humility; humbleness of mind. Walk . . . with all lowliness and meekness. Eph. iv. 1, 2. 2. Low condition, especially as to manner of life. The lowliness of my fortune has not brought me to flatter vice. Dryden.
lowly |1. Not high; not elevated in place; low. \"Lowly lands.\" Dryden. 2. Low in rank or social importance. One common right the great and lowly claims. Pope. 3. Not lofty or sublime; humble. These rural poems, and their lowly strain. Dryden. 4. Having a low esteem of one's own worth; humble; meek; free from pride. Take my yoke upon you, and learn of me, for I am meek and lowly in heart. Matt. xi. 29.\n\n1. In a low manner; humbly; meekly; modestly. \"Be lowly wise.\" Milton. 2. In a low condition; meanly. I will show myself highly fed, and lowly taught. Shak.
lown |A low fellow. [Obs.]
lowness |The state or quality of being low.
lowry |An open box car used on railroads. Compare Lorry.
loxodromic |Pertaining to sailing on rhumb lines; as, loxodromic tables. Loxodromic curve or line (Geom.), a line on the surface of a sphere, which always makes an equal angle with every meridian; the rhumb line. It is the line on which a ship sails when her course is always in the direction of one and the same point of the compass.
loxodromics |The art or method of sailing on the loxodromic or rhumb line.
loxodromism |The act or process of tracing a loxodromic curve; the act of moving as if in a loxodromic curve.
loxodromy |The science of loxodromics. [R.]
loy |A long, narrow spade for stony lands.
loyal |1. Faithful to law; upholding the lawful authority; faithful and true to the lawful government; faithful to the prince or sovereign to whom one is subject; unswerving in allegiance. Welcome, sir John ! But why come you in arms -To help King Edward in his time of storm, As every loyal subject ought to do. Shak. 2. True to any person or persons to whom one owes fidelity, especially as a wife to her husband, lovers to each other, and friend to friend; constant; faithful to a cause or a principle. Your true and loyal wife. Shak. Unhappy both, but loyaltheir loves. Dryden.
loyalist |A person who adheres to his sovereign or to the lawful authority; especially, one who maintains his allegiance to his prince or government, and defends his cause in times of revolt or revolution.
loyally |In a loyal manner; faithfully.
loyalness |Loyalty. [R.] Stow.
loyalty |The state or quality of being loyal; fidelity to a superior, or to duty, love, etc. He had such loyalty to the king as the law required. Clarendon. Not withstanding all the subtle bait With which those Amazons his love still craved, To his one love his loyalty he saved. Spenser. Note: \"Loyalty . . . expresses, properly, that fidelity which one owes according to law, and does not necessarily include that attachment to the royal person, which, happily, we in England have been able further to throw into the word.\" Trench. Syn. -- Allegiance; fealty. See Allegiance.
lozenge |1. (Her.) (a) A diamond-shaped figure usually with the upper and lower angles slightly acute, borne upon a shield or escutcheon. Cf. Fusil. (b) A form of the escutcheon used by women instead of the shield which is used by men. 2. A figure with four equal sides, having two acute and two obtuse angles; a rhomb. 3. Anything in the form of lozenge. 4. A small cake of sugar and starch, flavored, and often medicated. -- originally in the form of a lozenge. Lozenge coach, the coach of a dowager, having her coat of arms painted on a lozenge. [Obs.] Walpole. -- Lozenge-molding (Arch.), a kind of molding, used in Norman architecture, characterized by lozenge-shaped ornaments.
lozenge-shaped |Having the form of a lozenge or rhomb. The lozenged panes of a very small latticed window. C. Bronté.
lozenged |Having the form of a lozenge or rhomb. The lozenged panes of a very small latticed window. C. Bronté.
lozengy |Divided into lozenge-shaped compartments, as the field or a bearing, by lines drawn in the direction of the bend sinister.
lu |See Loo.
lubbard |A lubber. [Obs.] Swift.\n\nLubberly.
lubber |A heavy, clumsy, or awkward fellow; a sturdy drone; a clown. Lingering lubbers lose many a penny. Tusser. Land lubber, a name given in contempt by sailors to a person who lives on land. -- Lubber grasshopper (Zoöl.), a large, stout, clumsy grasshopper; esp., Brachystola magna, from the Rocky Mountain plains, and Romalea microptera, which is injurious to orange trees in Florida. -- Lubber's hole (Naut.), a hole in the floor of the \"top,\" next the mast, through which sailors may go aloft without going over the rim by the futtock shrouds. It is considered by seamen as only fit to be used by lubbers. Totten. -- Lubber's line, point, or mark, a line or point in the compass case indicating the head of the ship, and consequently the course which the ship is steering.
lubberly |Like a lubber; clumsy. A great lubberly boy. Shak.\n\nClumsily; awkwardly. Dryden.
lubric |1. Having a smooth surface; slippery. [R.] 2. Lascivious; wanton; lewd. [R.] This lubric and adulterate age. Dryden.
lubrical |1. Having a smooth surface; slippery. [R.] 2. Lascivious; wanton; lewd. [R.] This lubric and adulterate age. Dryden.
lubricant |Lubricating.\n\nThat which lubricates; specifically, a substance, as oil, grease, plumbago, etc., used for reducing the friction of the working parts of machinery.
lubricate |1. To make smooth or slippery; as, mucilaginous and saponaceous remedies lubricate the parts to which they are applied. S. Sharp. Supples, lubricates, and keeps in play, The various movements of this nice machine. Young. 2. To apply a lubricant to, as oil or tallow.
lubrication |The act of lubricating; the act of making slippery.
lubricator |1. One who, or that which, lubricates. \" Lubricator of the fibers.\" Burke. 2. A contrivance, as an oil cup, for supplying a lubricant to machinery.
lubricitate |See Lubricate.
lubricity |1. Smoothness; freedom from friction; also, property, which diminishes friction; as, the lubricity of oil. Ray. 2. Slipperiness; instability; as, the lubricity of fortune. L'Estrange. 3. Lasciviousness; propensity to lewdness; lewdness; lechery; incontinency. Sir T. Herbert. As if wantonness and lubricity were essential to that poem. Dryden.
lubricous |Lubric.
lubrifaction |The act of lubricating, or making smooth. Ray. Bacon.
lubrification |The act of lubricating, or making smooth. Ray. Bacon.
lucarne |A dormer window.
lucchese |A native or inhabitant of Lucca, in Tuscany; in the plural, the people of Lucca.
luce |A pike when full grown. Halliwell.
lucency |The quality of being lucent.
lucent |Shining; bright; resplendent. \" The sun's lucent orb.\" Milton.
lucern |1. A sort of hunting dog; -- perhaps from Lucerne, in Switzerland. My lucerns, too, or dogs inured to hunt Beasts of most rapine. Chapman. 2. An animal whose fur was formerly much in req [Written also lusern and luzern.] The polecat, mastern, and the richskinned lucern I know to chase. Beau. & Fl.\n\nA leguminous plant (Medicago sativa), having bluish purple cloverlike flowers, cultivated for fodder; -- called also alfalfa. [Written also lucerne.]\n\nA lamp. [Obs.] Lydgate.
lucernal |Of or pertaining to a lamp. Lucernal microscope, a form of the microscope in which the object is illuminated by means of a lamp, and its image is thrown upon a plate of ground glass connected with the instrument, or on a screen independent of it.
lucernaria |A genus of acalephs, having a bell-shaped body with eight groups of short tentacles around the margin. It attaches itself by a sucker at the base of the pedicel.
lucernarian |Of or pertaining to the Lucernarida. -- n.  One of the Lucernarida.
lucernarida |(a) A division of acalephs, including Lucernaria and allied genera; - - called also Calycozoa. (b) A more extensive group of acalephs, including both the true lucernarida and the Discophora.
lucerne |See Lucern, the plant.
lucid |1. Shining; bright; resplendent; as, the lucid orbs of heaven. Lucid, like a glowworm. Sir I. Newton. A court compact of lucid marbles. Tennyson. 2. Clear; transparent. \" Lucid streams.\" Milton. 3. Presenting a clear view; easily understood; clear. A lucid and interesting abstract of the debate. Macaulay. 4. Bright with the radiance of intellect; not darkened or confused by delirium or madness; marked by the regular operations of reason; as, a lucid interval. Syn. -- Luminous; bright; clear; transparent; sane; reasonable. See Luminous.
lucidity |The quality or state of being lucid.
lucidly |In a lucid manner.
lucidness |The quality of being lucid; lucidity.
lucifer |1. The planet Venus, when appearing as the morning star; -- applied in Isaiah by a metaphor to a king of Babylon. How art thou fallen from heaven, O Lucifer, son of the morning ! how art thou cut down to the ground which didst weaken the nations ! Is. xiv. 12. Tertullian and Gregory the Great understood this passage of Isaiah in reference to the fall of Satan; in consequence of which the name Lucifer has since been applied to, Satan. Kitto. 2. Hence, Satan. How wretched Is that poor man that hangs on princes' favors! . . . When he falls, he falls like Lucifer, Never to hope again. Shak. 3. A match made of a sliver of wood tipped with a combustible substance, and ignited by friction; -- called also lucifer match, and locofoco. See Locofoco. 4. (Zoöl.)  A genus of free-swimming macruran Crustacea, having a slender body and long appendages.
luciferian |1. Of or pertaining to Lucifer; having the pride of Lucifer; satanic; devilish. 2. Of or pertaining to the Luciferians or their leader.\n\nOne of the followers of Lucifer, bishop of Cagliari, in the fourth century, who separated from the orthodox churches because they would not go as far as he did in opposing the Arians.
luciferous |Giving light; affording light or means of discovery. Boyle.
luciferously |In a luciferous manner.
lucific |Producing light. Grew.
luciform |Having, in some respects, the nature of light; resembling light. Berkeley.
lucifrian |Luciferian; satanic. [Obs.] Marston.
lucimeter |an instrument for measuring the intensity of light; a photometer.
luck |That which happens to a person; an event, good or ill, affecting one's interests or happiness, and which is deemed casual; a course or series of such events regarded as occurring by chance; chance; hap; fate; fortune; often, one's habitual or characteristic fortune; as, good, bad, ill, or hard luck. Luck is often used for good luck; as, luck is better than skill. If thou dost play with him at any game, Thou art sure to lose; and of that natural luck, He beats thee 'gainst the odds. Shak. Luck penny, a small sum given back for luck to one who pays money. [Prov. Eng.] -- To be is luck, to receive some good, or to meet with some success, in an unexpected manner, or as the result of circumstances beyond one's control; to be fortunate.
luckily |In a lucky manner; by good fortune; fortunately; -- used in a good sense; as, they luckily escaped injury.
luckiness |1. The state or quality of being lucky; as, the luckiness of a man or of an event. 2. Good fortune; favorable issue or event. Locke.
luckless |Being without luck; unpropitious; unfortunate; unlucky; meeting with ill success or bad fortune; as, a luckless gamester; a luckless maid. Prayers made and granted in a luckless hour. Dryden. -- Luck\"less*ly, adv. -- Lock\"less*ness, n.
lucky |1. Favored by luck; fortunate; meeting with good success or good fortune; -- said of persons; as, a lucky adventurer. \" Lucky wight.\" Spenser. 2. Producing, or resulting in, good by chance, or unexpectedly; favorable; auspicious; fortunate; as, a lucky mistake; a lucky cast; a lucky hour. We doubt not of a fair and lucky war. Shak. Syn. -- Successful; fortunate; prosperous; auspicious.
lucky proach |See Fatherlasher.
lucrative |1. Yielding lucre; gainful; profitable; making increase of money or goods; as, a lucrative business or office. The trade of merchandise being the most lucrative, may bear usury at a good rate. Bacon. 2. Greedy of gain [Obs.] Such diligence as the most part of our lucrative lawyers do use, in deferring and prolonging of matters and actions from term to term. Latimer.
lucratively |In a lucrative manner.
lucre |Gain in money or goods; profit; riches; -- often in an ill sense. The lust of lucre and the dread of death. Pope.
lucriferous |Gainful; profitable. [Obs.] Boyle.
lucrific |Producing profit; gainful. [Obs.]
luctation |Effort to overcome in contest; struggle; endeavor. [R.] Farindon.
luctual |Producing grief; saddening. [Obs.] Sir G. Buck.
lucubrate |To study by candlelight or a lamp; to study by night.\n\nTo elaborate, perfect, or compose, by night study or by laborious endeavor.
lucubration |1. The act of lucubrating, or studying by candlelight; nocturnal study; meditation. After long lucubration I have hit upon such an expedient. Goldsmith. 2. That which is composed by night; that which is produced by meditation in retirement; hence (loosely) any literary composition. Thy lucubrations have been perused by several of our friends. Tatler.
lucubrator |One who studies by night; also, one who produces lucubrations.
lucubratory |Composed by candlelight, or by night; of or pertaining to night studies; laborious or painstaking. Pope.
lucule |A spot or fleck on the sun brighter than the surrounding surface.
luculent |1. Lucid; clear; transparent. Thomson. 2. Clear; evident; luminous. \" Most luculent testimonies.\" Hooker. 3. Bright; shining in beauty. [Obs.] Most debonair and luculent lady. B. Jonson.
luculently |In a luculent manner; clearly.
lucullite |A variety of black limestone, often polished for ornamental purposes.
lucuma |An American genus of sapotaceous trees bearing sweet and edible fruits. Note: Lucuma mammosum is called natural marmalade in the West Indies; L. Caimito, of Peru, furnishes a delicious fruit called lucuma and caimito.
luddite |One of a number of riotous persons in England, who for six years (1811-17) tried to prevent the use of labor-saving machinery by breaking it, burning factories, etc.; -- so called from Ned Lud, a half-witted man who some years previously had broken stocking frames. J. & H. Smith. H. Martineau.
ludibrious |Sportive; ridiculous; wanton. [Obs.] Tooker.
ludibund |Sportive. [Obs.] -- Lu\"di*bund*ness, n. [Obs.] Dr. H. More.
ludicrous |Adapted to excite laughter, without scorn or contempt; sportive. Broome. A chapter upon German rhetoric would be in the same ludicrous predicament as Van Troil's chapter on the snakes of Iceland, which delivers its business in one summary sentence, announcing, that snakes in Iceland -- there are none. De Quincey. Syn. -- Laughable; sportive; burlesque; comic; droll; ridiculous. -- Ludicrous, Laughable, Ridiculous. We speak of a thing as ludicrous when it tends to produce laughter; as laughable when the impression is somewhat stronger; as ridiculous when more or less contempt is mingled with the merriment created. -- Lu\"di*crous*ly, adv. -- Lu\"di*crous*ness, n.
ludification |The act of deriding.
ludificatory |Making sport; tending to excite derision. [Obs.]
ludlamite |A mineral occurring in small, green, transparent, monoclinic crystals. It is a hydrous phosphate of iron.
ludlow group |A subdivision of the British Upper Silurian lying below the Old Red Sandstone; -- so named from the Ludlow, in Western England. See the Chart of Geology.
ludwigite |A borate of iron and magnesia, occurring in fibrous masses of a blackish green color.
lues |Disease, especially of a contagious kind. Lues venerea, syphilis; -- called also simply lues.
luff |(a) The side of a ship toward the wind. (b) The act of sailing a ship close to the wind. (c) The roundest part of a ship's bow. (d) The forward or weather leech of a sail, especially of the jib, spanker, and other fore-and-aft sails. Luff tackle, a purchase composed of a double and single block and fall, used for various purposes. Totten. -- Luff upon luff, a luff tackle attached to the fall of another luff tackle. R. H. Dana, Jr.\n\nTo turn the head of a vessel toward the wind; to sail nearer the wind; to turn the tiller so as to make the vessel sail nearer the wind. To luff round, or To luff alee, to make the extreme of this movement, for the purpose of throwing the ship's head into the wind.
luffa |(a) A small genus of tropical cucurbitaceous plants having white flowers, the staminate borne in racemes, and large fruits with a dry fibrous pericarp. The fruit of several species and the species themselves, esp. L. Ægyptiaca, are called dishcloth gourds. (b) Any plant of this genus, or its fruit. (c) The fibrous skeleton of the fruit, used as a sponge and in the manufacture of caps and women's hats; -- written also loofah.
luffer |See Louver.
lug |1. The ear, or its lobe. [Scot. & Prov. Eng.] 2. That which projects like an ear, esp. that by which anything is supported, carried, or grasped, or to which a support is fastened; an ear; as, the lugs of a kettle; the lugs of a founder's flask; the lug (handle) of a jug. 3. (Mach.)  A projecting piece to which anything, as a rod, is attached, or against which anything, as a wedge or key, bears, or through which a bolt passes, etc. 4. (Harness)  The leather loop or ear by which a shaft is held up. 5. (Zoöl.)  The lugworm. Lug bolt (Mach.), a bolt terminating in a long, flat extension which takes the place of a head; a strap bolt.\n\nTo pull with force; to haul; to drag along; to carry with difficulty, as something heavy or cumbersome. Dryden. They must divide the image among them, and so lug off every one his share. Collier.\n\nTo move slowly and heavily.\n\n1. The act of lugging; as, a hard lug; that which is lugged; as, the pack is a heavy lug.[Colloq.] 2. Anything which moves slowly. [Obs.] Ascham.\n\n1. A rod or pole. [Prov. Eng.] Wright. 2. A measure of length, being 16 [Obs.] \" Eight lugs of ground.\" Spenser. Chimney lug, or Lug pole, a pole on which a kettle is hung over the fire, either in a chimney or in the open air. [Local, U.S.] Whittier.
luggage |That which is lugged; anything cumbrous and heavy to be carried; especially, a traveler's trunks, baggage, etc., or their contents. I am gathering up my luggage, and preparing for my journey. Swift. What do you mean, To dote thus on such luggage! Shak. Syn. -- Plunder; baggage. Luggage van, a vehicle for carrying luggage; a railway car, or compartment of a car, for carrying luggage. [Eng.]
lugger |A small vessel having two or three masts, and a running bowsprit, and carrying lugsails. See Illustration in Appendix. Totten.\n\nAn Indian falcon (Falco jugger), similar to the European lanner and the American prairie falcon.
lugmark |A mark cut into the ear of an animal to identify it; an earmark.
lugsail |A square sail bent upon a yard that hangs obliquely to the mast and is raised or lowered with the sail. Totten.
lugubrious |Mournful; indicating sorrow, often ridiculously or feignedly; doleful; woful; pitiable; as, a whining tone and a lugubrious look. Crossbones, scythes, hourglasses, and other lugubrious emblems of mortality. Hawthorne. -- Lu*gu\"bri*ous*ly, adv. -- Lu*gu\"bri*ous*ness, n.
lugworm |A large marine annelid (Arenicola marina) having a row of tufted gills along each side of the back. It is found burrowing in sandy beaches, both in America and Europe, and is used for bait by European fishermen. Called also lobworm, and baitworm.
luke |Moderately warm; not hot; tepid. -- Luke\"ness, n. [Obs.] Nine penn'orth o'brandy and water luke. Dickens.
lukewarm |Moderately warm; neither cold nor hot; tepid; not ardent; not zealous; cool; indifferent. \" Lukewarm blood.\" Spenser. \" Lukewarm patriots.\" Addison. An obedience so lukewarm and languishing that it merits not the name of passion. Dryden. -- Luce\"warm`ly, adv. -- Luce\"warm`ness, n.
lull |To cause to rest by soothing influences; to compose; to calm; to soothe; to quiet. \" To lull him soft asleep.\" Spenser. Such sweet compulsion doth in music lie, To lull the daughters of necessity. Milton.\n\nTo become gradually calm; to subside; to cease or abate for a time; as, the storm lulls.\n\n1. The power or quality of soothing; that which soothes; a lullaby. [R.] Young. 2. A temporary cessation of storm or confusion.
lullaby |1. A song to quiet babes or lull them to sleep; that which quiets. Shak. 2. Hence: Good night; good-by. [Obs.] Shak.
luller |One who, or that which, lulls.
lullingly |In a lulling manner; soothingly.
lum |1. A chimney. [Prov. Eng. & Scot.] Burns. 2. A ventilating chimney over the shaft of a mine. 3. A woody valley; also, a deep pool. [Prov. Eng.]
lumachel |A grayish brown limestone, containing fossil shells, which reflect a beautiful play of colors. It is also called fire marble, from its fiery reflections.
lumachella |A grayish brown limestone, containing fossil shells, which reflect a beautiful play of colors. It is also called fire marble, from its fiery reflections.
lumbaginous |Of or pertaining to lumbago.
lumbago |A rheumatic pain in the loins and the small of the back.
lumbal |Of, pertaining to, or near, the loins; as, the lumbar arteries. Lumbar region (Anat.), the region of the loin; specifically, a region between the hypochondriac and ilias regions, and outside of the umbilical region.
lumbar |Of, pertaining to, or near, the loins; as, the lumbar arteries. Lumbar region (Anat.), the region of the loin; specifically, a region between the hypochondriac and ilias regions, and outside of the umbilical region.
lumber |1. A pawnbroker's shop, or room for storing articles put in pawn; hence, a pledge, or pawn. [Obs.] They put all the little plate they had in the lumber, which is pawning it, till the ships came. Lady Murray. 2. Old or refuse household stuff; things cumbrous, or bulky and useless, or of small value. 3. Timber sawed or split into the form of beams, joists, boards, planks, staves, hoops, etc.; esp., that which is smaller than heavy timber. [U.S.] Lumber kiln, a room in which timber or lumber is dried by artificial heat. [U.S.] -- Lumber room, a room in which unused furniture or other lumber is kept. [U.S.] -- Lumber wagon, a heavy rough wagon, without springs, used for general farmwork, etc.\n\n1. To heap together in disorder. \" Stuff lumbered together.\" Rymer. 2. To fill or encumber with lumber; as, to lumber up a room.\n\n1. To move heavily, as if burdened. 2. Etym: [Cf. dial. Sw. lomra to resound.]  To make a sound as if moving heavily or clumsily; to rumble. Cowper. 3. To cut logs in the forest, or prepare timber for market. [U.S.]
lumber state |Maine; -- a nickname.
lumberer |One employed in lumbering, cutting, and getting logs from the forest for lumber; a lumberman. [U.S.] Lumberers have a notion that he (the woodpecker) is harmful to timber. Lowell.
lumbering |The business of cutting or getting timber or logs from the forest for lumber. [U.S.]
lumberman |One who is engaged in lumbering as a business or employment. [U.S.]
lumbosacral |Of or pertaining to the loins and sacrum; as, the lumbosacral nerve, a branch of one of the lumber nerves which passes over the sacrum.
lumbric |An earthworm, or a worm resembling an earthworm.
lumbrical |Resembling a worm; as, the lumbrical muscles of the hands of the hands and feet. -- n.  A lumbrical muscle.
lumbriciform |Resembling an earthworm; vermiform.
lumbricoid |Like an earthworm; belonging to the genus Lumbricus, or family Lumbricidæ.
lumbricus |A genus of annelids, belonging to the Oligochæta, and including the common earthworms. See Earthworm.
lumen |1. (Photom.) (a) A unit of illumination, being the amount of illumination of a unit area of spherical surface, due to a light of unit intensity placed at the center of the sphere. (b) A unit of light flux, being the flux through one square meter of surface the illumination of which is uniform and of unit brightness. 2.  (Biol.) An opening, space, or cavity, esp. a tubular cavity; a vacuole.
luminant |Luminous. [R.]
luminary |1. Any body that gives light, especially one of the heavenly bodies. \" Radiant luminary.\" Skelton. Where the great luminary . . . Dispenses light from far. Milton. 2. One who illustrates any subject, or enlightens mankind; as, Newton was a distinguished luminary.
luminate |To illuminate. [Obs.]
lumination |Illumination. [Obs.]
lumine |To illumine. [Obs.] Spenser.
luminescence |1. (Physics) Any emission of light not ascribable directly to incandescence, and therefore occurring at low temperatures, as in phosphorescence and fluorescence or other luminous radiation resulting from vital processes, chemical action, friction, solution, or the influence of light or of ultraviolet or cathode rays, etc. 2.  (Zoöl.) (a) The faculty or power of voluntarily producing light, as in the firefly and glowworm. (b) The light thus produced; luminosity; phosphorescence.
luminescent |Shining with a light due to any of the various causes which produce luminescence.
luminiferous |Producing light; yielding light; transmitting light; as, the luminiferous ether.
luminosity |The quality or state of being luminous; luminousness.
luminous |1. Shining; emitting or reflecting light; brilliant; bright; as, the is a luminous body; a luminous color. Fire burneth wood, making it . . . luminous. Bacon. The mountains lift . . . their lofty and luminous heads. Longfellow. 2. Illuminated; full of light; bright; as, many candles made the room luminous. Up the staircase moved a luminous space in the darkness. Longfellow. 3. Enlightened; intelligent; also, clear; intelligible; as, a luminous mind. \" Luminous eloquence.\" Macaulay. \" A luminous statement.\" Brougham. Luminous paint, a paint made up with some phosphorescent substance, as sulphide of calcium, which after exposure to a strong light is luminous in the dark for a time. Syn. -- Lucid; clear; shining; perspicuous. -- Lu\"mi*nous*ly, adv. -- Lu\"mi*nous*ness, n.
lummox |A fat, ungainly, stupid person; an awkward bungler. [Law.]
lump |1. A small mass of matter of irregular shape; an irregular or shapeless mass; as, a lump of coal; a lump of iron ore. \" A lump of cheese.\" Piers Plowman. \" This lump of clay.\" Shak. 2. A mass or aggregation of things. 3. (Firearms)  A projection beneath the breech end of a gun barrel. In the lump, In a lump, the whole together; in gross. They may buy them in the lump. Addison. -- Lump coal, coal in large lumps; -- the largest size brought from the mine. -- Lump sum, a gross sum without a specification of items; as, to award a lump sum in satisfaction of all claims and damages.\n\n1. To throw into a mass; to unite in a body or sum without distinction of particulars. The expenses ought to be lumped together. Ayliffe. 2. To take in the gross; to speak of collectively. Not forgetting all others, . . . whom for brevity, but out of no resentment you, I lump all together. Sterne. 3. To get along with as one can, although displeased; as, if he does n't like it, he can lump it. [Law]
lumper |The European eelpout; -- called also lumpen.\n\n1. One who lumps. 2. A laborer who is employed to load or unload vessels when in harbor.
lumpfish |A large, thick, clumsy, marine fish (Cyclopterus lumpus) of Europe and America. The color is usually translucent sea green, sometimes purplish. It has a dorsal row of spiny tubercles, and three rows on each side, but has no scales. The ventral fins unite and form a ventral sucker for adhesion to stones and seaweeds. Called also lumpsucker, cock-paddle, sea owl.
lumping |Bulky; heavy. Arbuthnot.
lumpish |Like a lump; inert; gross; heavy; dull; spiritless. \" Lumpish, heavy, melancholy.\" Shak. -- Lump\"ish*ly, adv. -- Lump\"ish*ness, n.
lumpsucker |The lumprish.
lumpy |Full of lumps, or small compact masses.
lumpy-jaw |Actinomycosis. [Colloq.]
luna |1. The moon. 2. (Alchemy)  Silver. Luna cornea (Old Chem.), horn silver, or fused silver chloride, a tough, brown, translucent mass; -- so called from its resemblance to horn. Luna moth (Zoöl.), a very large and beautiful American moth (Actias luna). Its wings are delicate light green, with a stripe of purple along the front edge of the anterior wings, the other margins being edged with pale yellow. Each wing has a lunate spot surrounded by rings of light yellow, blue, and black. The caterpillar commonly feeds on the hickory, sassafras, and maple.
lunacy |1. Insanity or madness; properly, the kind of insanity which is broken by intervals of reason, -- formerly supposed to be influenced by the changes of the moon; any form of unsoundness of mind, except idiocy; mental derangement or alienation. Brande. Burrill. Your kindred shuns your house As beaten hence by your strange lunacy. Shak. 2. A morbid suspension of good sense or judgment, as through fanaticism. Dr. H. More. Syn. -- Derangement; craziness; mania. See Insanity.
lunar |1. Of or pertaining to the moon; as, lunar observations. 2. Resembling the moon; orbed. Dryden. 3. Measured by the revolutions of the moon; as, a lunar month. 4. Influenced by the moon, as in growth, character, or properties; as, lunar herbs. Bacon. Lunar caustic (Med. Chem.), silver nitrate prepared to be used as a cautery; -- so named because silver was called luna by the ancient alchemists. -- Lunar cycle. Same as Metonic cycle. See under Cycle. -- Lunar distance, the angular distance of the moon from the sun, a star, or a planet, employed for determining longitude by the lunar method. -- Lunar method, the method of finding a ship's longitude by comparing the local time of taking (by means of a sextant or circle) a given lunar distance, with the Greenwich time corresponding to the same distance as ascertained from a nautical almanac, the difference of these times being the longitude. -- Lunar month. See Month. -- Lunar observation, an observation of a lunar distance by means of a sextant or circle, with the altitudes of the bodies, and the time, for the purpose of computing the longitude. -- Lunar tables. (a) (Astron.) Tables of the moon's motions, arranged for computing the moon's true place at any time past or future. (b) (Navigation) Tables for correcting an observed lunar distance on account of refraction and parallax. -- Lunar year, the period of twelve lunar months, or 354 days, 8 hours, 48 minutes, and 34.38 seconds.\n\n1. (Astron.)  A lunar distance. 2. (Anat.)  The middle bone of the proximal series of the carpus; -- called also semilunar, and intermedium.
lunarian |An inhabitant of the moon.
lunary |Lunar. [Obs.] Fuller.\n\n(a) The herb moonwort or \"honesty\". (b) A low fleshy fern (Botrychium Lunaria) with lunate segments of the leaf or frond.
lunate |Crescent-shaped; as, a lunate leaf; a lunate beak; a lunated cross. Gray.
lunated |Crescent-shaped; as, a lunate leaf; a lunate beak; a lunated cross. Gray.
lunatic |1. Affected by lunacy; insane; mad. Lord, have mercy on my son; for he is lunatic. Wyclif (Matt. xvii. 15). 2. Of or pertaining to, or suitable for, an insane person; evincing lunacy; as, lunatic gibberish; a lunatic asylum.\n\nA person affected by lunacy; an insane person, esp. one who has lucid intervals; a madman; a person of unsound mind. The lunatic, the lover, and the poet, Are of imagination all compact. Shak.
lunation |The period of a synodic revolution of the moon, or the time from one new moon to the next; varying in length, at different times, from about 29
lunch |A luncheon; specifically, a light repast between breakfast and dinner.\n\nTo take luncheon. Smart.
luncheon |1. A lump of food. [Prov. Eng.] 2. A portion of food taken at any time except at a regular meal; an informal or light repast, as between breakfast and dinner.\n\nTo take luncheon. Beaconsfield.
lune |1. Anything in the shape of a half moon. [R.] 2. (Geom.)  A figure in the form of a crescent, bounded by two intersecting arcs of circles. 3. A fit of lunacy or madness; a period of frenzy; a crazy or unreasonable freak. [Obs.] These dangerous, unsafe lunes i' the king. Shak.
lunet |A little moon or satellite. [Obs.] Bp. Hall.
lunette |1. (Fort.)  A fieldwork consisting of two faces, forming a salient angle, and two parallel flanks. See Bastion. 2. (Far.)  A half horseshoe, which wants the sponge. 3. A kind of watch crystal which is more than ordinarily flattened in the center; also, a species of convexoconcave lens for spectacles. 4. A piece of felt to cover the eye of a vicious horse. 5. (Arch.)  Any surface of semicircular or segmental form; especially, the piece of wall between the curves of a vault and its springing line. 6. An iron shoe at the end of the stock of a gun carriage. Lunette window (Arch.), a window which fills or partly fills a lunette.
lung |An organ for aërial respiration; -- commonly in the plural. My lungs began to crow like chanticleer. Shak. Note: In all air-breathing vertebrates the lungs are developed from the ventral wall of the esophagus as a pouch which divides into two sacs. In amphibians and many reptiles the lungs retain very nearly this primitive saclike character, but in the higher forms the connection with the esophagus becomes elongated into the windpipe and the inner walls of the sacs become more and more divided, until, in the mammals, the air spaces become minutely divided into tubes ending in small air cells, in the walls of which the blood circulates in a fine network of capillaries. In mammals the lungs are more or less divided into lobes, and each lung occupies a separate cavity in the thorax. See Respiration. Lung fever (Med.), pneumonia. -- Lung flower (Bot.), a species of gentian (G. Pneumonanthe). -- Lung lichen (Bot.), tree lungwort. See under Lungwort. Lung sac (Zoöl.), one of the breathing organs of spiders and snails.
lung-grown |Having lungs that adhere to the pleura.
lunge |A sudden thrust or pass, as with a sword.\n\nTo make a lunge.\n\nTo cause to go round in a ring, as a horse, while holding his halter. Thackeray.\n\nSame as Namaycush.
lunged |Having lungs, or breathing organs similar to lungs.
lungfish |Any fish belonging to the Dipnoi; -- so called because they have both lungs and gills.
lungie |A guillemot. [Written also longie.] [Prov. Eng. & Scot.] Sir W. Scott.
lungis |A lingerer; a dull, drowsy fellow. [Obs.]
lungless |Being without lungs.
lungoor |A long-tailed monkey (Semnopithecus schislaceus), from the mountainous districts of India.
lungworm |Any one of several species of parasitic nematoid worms which infest the lungs and air passages of cattle, sheep, and other animals, often proving fatal. The lungworm of cattle (Strongylus micrurus) and that of sheep (S. filaria) are the best known.
lungwort |(a) An herb of the genus Pulmonaria (P. officinalis), of Europe; -- so called because the spotted appearance of the leaves resembles that of a diseased lung. (b) Any plant of the genus Mertensia (esp. M. Virginica and M. Sibirica) plants nearly related to Pulmonaria. The American lungwort is Mertensia Virginica, Virginia cowslip. Gray. Cow's lungwort mullein. -- Sea lungwort, Mertensia maritima, found on the seacoast of Northern Europe and America. -- Tree lungwort, a lichen (Sticta pulmonacea) growing on trees and rocks. The thallus is lacunose, and in appearance somewhat resembles the lungs, for diseases of which it was once thought a remedy.
lunicurrent |Having relation to changes in currents that depend on the moon's phases. Bache.
luniform |Resembling the moon in shape.
lunisolar |Resulting from the united action, or pertaining to the mutual relations, of the sun and moon. Lunisolar precession (Astron.), that portion of the annual precession of the equinoxes which depends on the joint action of the sun and moon. -- Lunisolar year, a period of time, at the end of which, in the Julian calendar, the new and full moons and the eclipses recur on the same days of the week and month and year as in the previous period. It consists of 532 common years, being the least common multiple of the numbers of years in the cycle of the sun and the cycle of the moon.
lunistice |The farthest point of the moon's northing and southing, in its monthly revolution. [Obs.]
lunitidal |Pertaining to tidal movements dependent on the moon. Bache. Lunitidal interval. See Retard, n.
lunt |1. The match cord formerly used in firing cannon. 2. A puff of smoke. [Scotch.] Burns.
lunula |Same as Lunule.
lunular |Having a form like that of the new moon; shaped like a crescent.
lunulate |Resembling a small crescent. Gray.
lunulated |Resembling a small crescent. Gray.
lunule |1. (Anat.)  Anything crescent-shaped; a crescent-shaped part or mark; a lunula, a lune. 2. (Chem.)  A lune. See Lune. 3. (Zoöl.) (a) A small or narrow crescent. (b) A special area in front of the beak of many bivalve shells. It sometimes has the shape of a double crescent, but is oftener heart- shaped. See Illust. of Bivalve.
lunulet |A small spot, shaped like a half-moon or crescent; as, the lunulet on the wings of many insects.
lunulite |Any bryozoan of the genus Lunulites, having a more or less circular form.
luny |Crazy; mentally unsound. [Written also loony.] [Law, U.S.]
lupercal |Of or pertaining to the Lupercalia.\n\nA grotto on the Palatine Hill sacred to Lupercus, the Lycean Pan.
lupercalia |A feast of the Romans in honor of Lupercus, or Pan.
lupine |A leguminous plant of the genus Lupinus, especially L. albus, the seeds of which have been used for food from ancient times. The common species of the Eastern United States is L. perennis. There are many species in California.\n\nWolfish; ravenous. Gauden.
lupinin |A glucoside found in the seeds of several species of lupine, and extracted as a yellowish white crystalline substance.
lupinine |An alkaloid found in several species of lupine (Lupinus luteus, L. albus, etc.), and extracted as a bitter crystalline substance.
lupulin |1. (Chem.)  A bitter principle extracted from hops. 2. The fine yellow resinous powder found upon the strobiles or fruit of hops, and containing this bitter principle. [Written also lupuline.]
lupuline |An alkaloid extracted from hops as a colorless volatile liquid.
lupulinic |Pertaining to, or obtained from, hops; specifically, designating an acid obtained by the decomposition of lupulin.
lupus |1. (Med.)  A cutaneous disease occurring under two distinct forms. Note: Lupus erythematosus is characterized by an eruption of red patches, which become incrusted, leaving superficial scars. L. vulgaris is marked by the development of nodules which often ulcerate deeply and produce great deformity. Formerly the latter was often confounded with cancer, and some varieties of cancer were included under Lupus. 2. (Astron.)  The Wolf, a constellation situated south of Scorpio.
lurcation |Gluttony; gormandizing. [Obs.]
lurch |To swallow or eat greedily; to devour; hence, to swallow up. [Obs.] Too far off from great cities, which may hinder business; too near them, which lurcheth all provisions, and maketh everything dear. Bacon.\n\n1. An old game played with dice and counters; a variety of the game of tables. 2. A double score in cribbage for the winner when his adversary has been left in the lurch. Lady --- has cried her eyes out on losing a lurch. Walpole. To leave one in the lurch. (a) In the game of cribbage, to leave one's adversary so far behind that the game is won before he has scored thirty-one. (b) To leave one behind; hence, to abandon, or fail to stand by, a person in a difficulty. Denham. But though thou'rt of a different church, I will not leave thee in the lurch. Hudibras.\n\n1. To leave in the lurch; to cheat. [Obs.] Never deceive or lurch the sincere communicant. South. 2. To steal; to rob. [Obs.] And in the brunt of seventeen battles since He lurched all swords of the garland. Shak.\n\nA sudden roll of a ship to one side, as in heavy weather; hence, a swaying or staggering movement to one side, as that by a drunken man. Fig.: A sudden and capricious inclination of the mind.\n\nTo roll or sway suddenly to one side, as a ship or a drunken man.\n\n1. To withdraw to one side, or to a private place; to lurk. L'Estrange. 2. To dodge; to shift; to play tricks. I . . . am fain to shuffle, to hedge, and to lurch. Shak.
lurcher |1. One that lurches or lies in wait; one who watches to pilfer, or to betray or entrap; a poacher. 2. (Zoöl.)  One of a mongrel breed of dogs said to have been a cross between the sheep dog, greyhound, and spaniel. It hunts game silently, by scent, and is often used by poachers.\n\nA glutton; a gormandizer. [Obs.]
lurchline |The line by which a fowling net was pulled over so as to inclose the birds.
lurdan |Stupid; blockish. [Obs.]\n\nA blockhead. [Obs.]
lure |1. A contrivance somewhat resembling a bird, and often baited with raw meat; -- used by falconers in recalling hawks. Shak. 2. Any enticement; that which invites by the prospect of advantage or pleasure; a decoy. Milton. 3. (Hat Making)  A velvet smoothing brush. Knight.\n\nTo draw to the lure; hence, to allure or invite by means of anything that promises pleasure or advantage; to entice; to attract. I am not lured with love. Piers Plowman. And various science lures the learned eye. Gay.\n\nTo recall a hawk or other animal.
lurg |A large marine annelid (Nephthys cæca), inhabiting the sandy shores of Europe and America. It is whitish, with a pearly luster, and grows to the length of eight or ten inches.
lurid |1. Pale yellow; ghastly pale; wan; gloomy; dismal. Fierce o'er their beauty blazed the lurid flame. Thomson. Wrapped in drifts of lurid smoke On the misty river tide. Tennyson. 2. (Bot.)  Having a brown color tonged with red, as of flame seen through smoke. 3. (Zoöl.)  Of a color tinged with purple, yellow, and gray.
lurk |1. To lie hid; to lie in wait. Like wild beasts, lurking in loathsome den. Spenser. Let us . . . lurk privily for the innocent. Prov. i. 11. 2. To keep out of sight. The defendant lurks and wanders about in Berks. Blackstone.
lurker |1. One who lurks. 2. A small fishing boat. [Prov. Eng.]
lurry |A confused heap; a throng, as of persons; a jumble, as of sounds. [Obs.] To turn prayer into a kind of lurry. Milton.
luscious |1. Sweet; delicious; very grateful to the taste; toothsome; excessively sweet or rich. And raisins keep their luscious, native taste. Dryden. 2. Cloying; fulsome. He had a tedious, luscious way of talking. Jeffrey. 3. Gratifying a depraved sense; obscene. [R.] Steele. -- Lus\"cious*ly, adv. -- Lus\"cious*ness, n.
lusern |A lynx. See 1st Lucern and Loup-cervier.
lush |Full of juice or succulence. Tennyson. How lush and lusty the grass looks! how green! Shak.
lushburg |See Lussheburgh. [Obs.]
lusitanian |Pertaining to Lusitania, the ancient name of the region almost coinciding with Portugal. -- n.  One of the people of Lusitania.
lusk |Lazy; slothful. [Obs.]\n\nA lazy fellow; a lubber. [Obs.] T. Kendall.\n\nTo be idle or unemployed. [Obs.]
luskish |Inclined to be lazy. Marston. -- Lusk\"*ish*ly, adv. -Lusk\"ish*ness, n. [Obs.] Spenser.
lusorious |Used in play; sportive; playful. [Obs.] Bp. Sanderson.
lusory |Used in play; sportive; playful. [Obs.] Bp. Sanderson.
lussheburgh |A spurious coin of light weight imported into England from Luxemburg, or Lussheburgh, as it was formerly called. [Obs.] God wot, no Lussheburghes payen ye. Chaucer.
lust |1. Pleasure [Obs.] \" Lust and jollity.\" Chaucer. 2. Inclination; desire. [Obs.] For little lust had she to talk of aught. Spenser. My lust to devotion is little. Bp. Hall. 3. Longing desire; eagerness to possess or enjoy; -- in a had sense; as, the lust of gain. The lust of reigning. Milton. 4. Licentious craving; sexual appetite. Milton. 5. Hence: Virility; vigor; active power. [Obs.] Bacon.\n\n1. To list; to like. [Obs.] Chaucer. \" Do so if thou lust. \" Latimer. Note: In earlier usage lust was impersonal. In the water vessel he it cast When that him luste. Chaucer. 2. To have an eager, passionate, and especially an inordinate or sinful desire, as for the gratification of the sexual appetite or of covetousness; -- often with after. Whatsoever thy soul lusteth after. Deut. xii. 15. Whosoever looketh on a woman to lust after her, hath committed adultery with her already in his heart. Matt. v. 28. The spirit that dwelleth in us lusteth to envy. James iv. 5.
luster |One who lusts.\n\nA period of five years; a lustrum. Both of us have closed the tenth luster. Bolingbroke.\n\n1. Brilliancy; splendor; brightness; glitter. The right mark and very true luster of the diamond. Sir T. More. The scorching sun was mounted high, In all its luster, to the noonday sky. Addison. Note: There is a tendency to limit the use of luster, in this sense, to the brightness of things which do not shine with their own light, or at least do not blaze or glow with heat. One speaks of the luster of a diamond, or of silk, or even of the stars, but not often now of the luster of the sun, a coal of fire, or the like. 2. Renown; splendor; distinction; glory. His ancestors continued about four hundred years, rather without obscurity than with any great luster. Sir H. Wotton. 3. A candlestick, chandelier, girandole, or the like, generally of an ornamental character. Pope. 4. (Min.)  The appearance of the surface of a mineral as affected by, or dependent upon, peculiarities of its reflecting qualities. Note: The principal kinds of luster recognized are: metallic, adamantine, vitreous, resinous, greasy, pearly, and silky. With respect to intensity, luster is characterized as splendent, shining, glistening, glimmering, and dull. 5. A substance which imparts luster to a surface, as plumbago and some of the glazes. 6. A fabric of wool and cotton with a lustrous surface, -- used for women's dresses. Luster ware, earthenware decorated by applying to the glazing metallic oxides, which acquire brilliancy in the process of baking.\n\nTo make lustrous. [R. & Poetic] Flooded and lustered with her loosened gold. Lowell.
lustering |1. The act or process of imparting a luster, as to pottery. 2. The brightening of a metal in the crucible when it becomes pure, as in certain refining processes.
lusterless |Destitute of luster; dim; dull.
lustful |1. Full of lust; excited by lust Spenser. Tillotson. 2. Exciting lust; characterized by lust or sensuality. \" Lustful orgies.\" Milton. 3. Strong; lusty. [Obs.] \" Lustful health.\" Sackville. Syn. -- sensual; fleshly; carnal; inordinate; licentious; lewd; unchaste; impure; libidinous; lecherous. -- Lust\"ful*ly, adv. -- Lust\"ful*ness, n.
lustic |Lusty; vigorous. [Obs.]
lustihead |See Lustihood. [Obs.] Chaucer.
lustihood |State of being lusty; vigor of body. \" Full of lustihood.\" Tennyson.
lustily |In a lusty or vigorous manner.
lustiness |State of being lusty; vigor; strength.
lustless |1. Lacking vigor; weak; spiritless. [Obs.] Spenser. 2. Free from sexual lust.
lustral |1. Of or pertaining to, or used for, purification; as, lustral days; lustral water. 2. Of or pertaining to a lustrum.
lustrate |To make clear or pure by means of a propitiatory offering; to purify. We must purge, and cleanse, and lustrate the whole city. Hammond.
lustration |1. The act of lustrating or purifying. And holy water for lustration bring. Dryden. 2. (Antiq.)  A sacrifice, or ceremony, by which cities, fields, armies, or people, defiled by crimes, pestilence, or other cause of uncleanness, were purified.
lustre |A period of five years; a lustrum. Both of us have closed the tenth luster. Bolingbroke.\n\n1. Brilliancy; splendor; brightness; glitter. The right mark and very true luster of the diamond. Sir T. More. The scorching sun was mounted high, In all its luster, to the noonday sky. Addison. Note: There is a tendency to limit the use of luster, in this sense, to the brightness of things which do not shine with their own light, or at least do not blaze or glow with heat. One speaks of the luster of a diamond, or of silk, or even of the stars, but not often now of the luster of the sun, a coal of fire, or the like. 2. Renown; splendor; distinction; glory. His ancestors continued about four hundred years, rather without obscurity than with any great luster. Sir H. Wotton. 3. A candlestick, chandelier, girandole, or the like, generally of an ornamental character. Pope. 4. (Min.)  The appearance of the surface of a mineral as affected by, or dependent upon, peculiarities of its reflecting qualities. Note: The principal kinds of luster recognized are: metallic, adamantine, vitreous, resinous, greasy, pearly, and silky. With respect to intensity, luster is characterized as splendent, shining, glistening, glimmering, and dull. 5. A substance which imparts luster to a surface, as plumbago and some of the glazes. 6. A fabric of wool and cotton with a lustrous surface, -- used for women's dresses. Luster ware, earthenware decorated by applying to the glazing metallic oxides, which acquire brilliancy in the process of baking.\n\nTo make lustrous. [R. & Poetic] Flooded and lustered with her loosened gold. Lowell.\n\nSame as Luster.
lustreless |Destitute of luster; dim; dull.
lustrical |Pertaining to, or used for, purification.
lustring |A kind of glossy silk fabric. See Lutestring.
lustrous |Bright; shining; luminous. \" Good sparks and lustrous.\" Shak. -- Lus\"trous*ly, adv.
lustrum |A lustration or purification, especially the purification of the whole Roman people, which was made by the censors once in five years. Hence: A period of five years.
lustwort |See Sundew.
lusty |1. Exhibiting lust or vigor; stout; strong; vigorous; robust; healthful; able of body. Neither would their old men, so many as were yet vigorous and lusty, be left at home. Milton. 2. Beautiful; handsome; pleasant. [Obs.] Spenser. 3. Of large size; big. [Obs.] \" Three lusty vessels.\" Evelyn. Hence, sometimes, pregnant. [Obs. or Prov.] 4. Lustful; lascivious. [Obs.] Milton.
lusus naturae |Sport or freak of nature; a deformed or unnatural production.
lutanist |A person that plays on the lute. Johnson.
lutarious |Of, pertaining to, or like, mud; living in mud. [Obs.] Grew.
lutation |The act or method of luting vessels.
lute |1. (Chem.)  A cement of clay or other tenacious infusible substance for sealing joints in apparatus, or the mouths of vessels or tubes, or for coating the bodies of retorts, etc., when exposed to heat; -- called also luting. 2. A packing ring, as of rubber, for fruit jars, etc. 3. (Brick Making)  A straight-edged piece of wood for striking off superfluous clay from mold.\n\nTo close or seal with lute; as, to lute on the cover of a crucible; to lute a joint.\n\nA stringed instrument formerly much in use. It consists of four parts, namely, the table or front, the body, having nine or ten ribs or \"sides,\" arranged like the divisions of a melon, the neck, which has nine or ten frets or divisions, and the head, or cross, in which the screws for tuning are inserted. The strings are struck with the right hand, and with the left the stops are pressed.\n\nTo sound, as a lute. Piers Plowman. Keats.\n\nTo play on a lute, or as on a lute. Knaves are men That lute and flute fantastic tenderness. Tennyson.
lute-backed |Having a curved spine.
lutecium |A metallic element separated from ytterbium in 1907, by Urbain in Paris and by von Welsbach in Vienna. Symbol, Lu; at. wt. 174.0.
luteic |(a) Pertaining to, or derived from, weld (Reseda luteola). (b) Pertaining to, or designating, an acid resembling luteolin, but obtained from the flowers of Euphorbia cyparissias.
lutein |A substance of a strongly marked yellow color, extracted from the yelk of eggs, and from the tissue of the corpus luteum.
lutenist |Same as Lutanist.
luteo- |A combining form signifying orange yellow or brownish yellow.
luteocobaltic |Pertaining to, or designating, certain compounds of cobalt having a yellow color. Cf. Cobaltic. Luteocobaltic chloride (Chem.), a brilliant reddish yellow crystalline compound, Co2Cl6(NH3)12, obtained by the action of ammonium chloride on an ammoniacal solution of cobaltic chloride.
luteolin |A yellow dyestuff obtained from the foliage of the dyer's broom (Reseda luteola).
luteous |Yellowish; more or less like buff.
luter |One who plays on a lute.\n\nOne who applies lute.
lutescent |Of a yellowish color.
lutestring |A plain, stout, lustrous silk, used for ladies' dresses and for ribbon. Goldsmith.
luth |The leatherback.
lutheran |Of or pertaining to Luther; adhering to the doctrines of Luther or the Lutheran Church.\n\nOne who accepts or adheres to the doctrines of Luther or the Lutheran Church.
lutheranism |The doctrines taught by Luther or held by the Lutheran Church.
lutherism |The doctrines taught by Luther or held by the Lutheran Church.
luthern |A dormer window. See Dormer.
lutidine |Any one of several metameric alkaloids, C5H3N.(CH3)2, of the pyridine series, obtained from bone oil as liquids, and having peculiar pungent odors. These alkaloids are also called respectively dimethyl pyridine, ethyl pyridine, etc.
luting |See Lute, a cement.
lutist |One who plays on a lute.
lutose |Covered with clay; miry.
lutulence |The state or quality of being lutulent.
lutulent |Muddy; turbid; thick. [Obs.]
luwack |See Paradoxure.
lux |To put out of joint; to luxate. [Obs.]
luxate |Luxated. [Obs.]\n\nTo displace, or remove from its proper place, as a joint; to put out of joint; to dislocate.
luxation |The act of luxating, or the state of being luxated; a dislocation.
luxe |Luxury. [Obs.] Shenstone. Édition de luxe (. Etym: [F.] (Printing) A sumptuous edition as regards paper, illustrations, binding, etc.
luxive |Given to luxury; voluptuous. [Obs.]
luxullianite |A kind of granite from Luxullian, Cornwall, characterized by the presence of radiating groups of minute tourmaline crystals.
luxuriance |The state or quality of being luxuriant; rank, vigorous growth; excessive abundance produced by rank growth. \"Tropical luxuriance.\" B. Taylor.
luxuriancy |The state or quality of being luxuriant; luxuriance. Flowers grow up in the garden in the greatest luxuriancy and profusion. Spectator.
luxuriant |Exuberant in growth; rank; excessive; very abundant; as, a luxuriant growth of grass; luxuriant foliage. Prune the luxuriant, the uncouth refine. Pope. Luxuriant flower (Bot.), one in which the floral envelopes are overdeveloped at the expense of the essential organs.
luxuriantly |In a luxuriant manner.
luxuriate |1. To grow exuberantly; to grow to superfluous abundance. \" Corn luxuriates in a better mold.\" Burton. 2. To feed or live luxuriously; as, the herds luxuriate in the pastures. 3. To indulge with unrestrained delight and freedom; as, to luxuriate in description.
luxuriation |The act or process luxuriating.
luxuriety |Luxuriance. [Obs.]
luxurious |Of or pertaining to luxury; ministering to luxury; supplied with the conditions of luxury; as, a luxurious life; a luxurious table; luxurious ease. \" Luxurious cities. \" Milton. -- Lux*u\"ri*ous*ly, adv. -- Lux*u\"ri*ous*ness, n.
luxurist |One given to luxury. [Obs.] Sir W. Temple.
luxury |1. A free indulgence in costly food, dress, furniture, or anything expensive which gratifies the appetites or tastes. Riches expose a man to pride and luxury. Spectator. 2. Anything which pleases the senses, and is also costly, or difficult to obtain; an expensive rarity; as, silks, jewels, and rare fruits are luxuries; in some countries ice is a great luxury. He cut the side of a rock for a garden, and, by laying on it earth, furnished out a kind of luxury for a hermit. Addison. 3. Lechery; lust. [Obs.] Shak. Luxury is in wine and drunkenness. Chaucer. 4. Luxuriance; exuberance. [Obs.] Bacon. Syn. -- Voluptuousness; epicurism; effeminacy; sensuality; lasciviousness; dainty; delicacy; gratification.
luz |A bone of the human body which was supposed by certain Rabbinical writers to be indestructible. Its location was a matter of dispute. Brande & C.
lyam |A leash. [Obs.]
lycanthrope |1. A human being fabled to have been changed into a wolf; a werewolf. 2. One affected with lycanthropy.
lycanthropia |See Lycanthropy, 2.
lycanthropic |Pertaining to lycanthropy.
lycanthropist |One affected by the disease lycanthropy.
lycanthropous |Lycanthropic.
lycanthropy |1. The supposed act of turning one's self or another person into a wolf. Lowell. 2. (Med.)  A kind of erratic melancholy, in which the patient imagines himself a wolf, and imitates the actions of that animal.
lycee |A French lyceum, or secondary school supported by the French government, for preparing students for the university.
lyceum |1. A place of exercise with covered walks, in the suburbs of Athens, where Aristotle taught philosophy. 2. A house or apartment appropriated to instruction by lectures or disquisitions. 3. A higher school, in Europe, which prepares youths for the university. 4. An association for debate and literary improvement.
lych gate |. See under Lich.
lyche |Like. [Obs.] Chaucer.
lychee |See Litchi.
lychnis |A genus of Old World plants belonging to the Pink family (Caryophyllaceæ). Most of the species have brilliantly colored flowers and cottony leaves, which may have anciently answered as wicks for lamps. The botanical name is in common use for the garden species. The corn cockle (Lychnis Githago) is a common weed in wheat fields.
lychnobite |One who labors at night and sleeps in the day.
lychnoscope |Same as Low side window, under Low, a.
lycine |A weak base identical with betaine; -- so called because found in the boxthorn (Lycium barbarum). See Betaine.
lycoperdon |A genus of fungi, remarkable for the great quantity of spores, forming a fine dust, which is thrown out like smoke when the plant is compressed or burst; puffball.
lycopod |A plant of the genus Lycopodium.
lycopode |Same as Lycopodium powder. See under Lycopodium.
lycopodiaceous |Belonging, or relating, to the Lycopodiaceæ, an order of cryptogamous plants (called also club mosses) with branching stems, and small, crowded, one-nerved, and usually pointed leaves.
lycopodite |An old name for a fossil club moss.
lycopodium |A genus of mosslike plants, the type of the order Lycopodiaceæ; club moss. Lycopodium powder, a fine powder or dust composed of the spores of Lycopodium, and other plants of the order Lycopodiaceæ. It is highly inflammable, and is sometimes used in the manufacture of fireworks, and the artificial representation of lightning.
lycotropous |Campylotropous.
lyddite |A high explosive consisting principally of picric acid, used as a shell explosive in the British service; -- so named from the proving grounds at Lydd, England.
lyden |See Leden. [Obs.] Chaucer.
lydian |Of or pertaining to Lydia, a country of Asia Minor, or to its inhabitants; hence, soft; effeminate; -- said especially of one of the ancient Greek modes or keys, the music in which was of a soft, pathetic, or voluptuous character. Softly sweet in Lydian measures, Soon he soothed his soul to pleasures. Dryden. Lydian stone, a flint slate used by the ancients to try gold and silver; a touchstone. See Basanite.
lydine |A violet dye derived from aniline.
lye |A strong caustic alkaline solution of potassium salts, obtained by leaching wood ashes. It is much used in making soap, etc.\n\nA short side line, connected with the main line; a turn-out; a siding. [Eng.]\n\nA falsehood. [Obs.] See Lie.
lyencephala |A group of Mammalia, including the marsupials and monotremes; - - so called because the corpus callosum is rudimentary.
lyencephalous |Pertaining to, or characteristic of, the Lyencephala.
lyerman |The cicada.
lygodium |A genus of ferns with twining or climbing fronds, bearing stalked and variously-lobed divisions in pairs. Note: Lygodium palmatum, much prized for indoor ornament, inhabits shaded and moist grassy places, from Massachusetts to Virginia and Kentucky, and sparingly southwards.
lying |of Lie, to tell a falsehood.\n\nof Lie, to be supported horizontally. Lying panel (Arch.), a panel in which the grain of the wood is horizontal. [R.] -- Lying to (Naut.), having the sails so disposed as to counteract each other.
lying-in |1. The state attending, and consequent to, childbirth; confinement. 2. The act of bearing a child.
lyingly |In a lying manner; falsely.
lyken |To please; -- chiefly used impersonally. [Obs.] \" Sith it lyketh you.\" Chaucer.
lym |A dog held in a leam; a bloodhound; a limehound. [Obs.] Shak.
lymail |See Limaille. [Obs.] Chaucer.
lyme grass |A coarse perennial grass of several species of Elymus, esp. E. Canadensis, and the European E. arenarius.
lymhound |A dog held in a leam; a bloodhound; a limehound. [Obs.] Shak.
lymph |1. A spring of water; hence, water, or a pure, transparent liquid like water. A fountain bubbled up, whose lymph serene Nothing of earthly mixture might distain. Trench. 2. (Anat.)  An alkaline colorless fluid, contained in the lymphatic vessels, coagulable like blood, but free from red blood corpuscles. It is absorbed from the various tissues and organs of the body, and is finally discharged by the thoracic and right lymphatic ducts into the great veins near the heart. 3. (Med.)  A fibrinous material exuded from the blood vessels in inflammation. In the process of healing it is either absorbed, or is converted into connective tissue binding the inflamed surfaces together. Lymph corpuscles (Anat.), finely granular nucleated cells, identical with the colorless blood corpuscles, present in the lymph and chyle. -- Lymph duct (Anat.), a lymphatic. -- Lymph heart. See Note under Heart, n., 1.
lymph node |A lymphatic gland. M.
lymphadenitis |Inflammation of the lymphatic glands; -- called also lymphitis.
lymphadenoma |See Lymphoma.
lymphangeitis |Inflammation of the lymphatic vessels. [Written also lymphangitis.]
lymphangial |Of or pertaining to the lymphatics, or lymphoid tissue; lymphatic.
lymphate |Frightened into madness; raving. [Obs.]
lymphated |Frightened into madness; raving. [Obs.]
lymphatic |pertaining to, containing, or conveying lymph. 2. Madly enthusiastic; frantic. [Obs.] \" Lymphatic rapture. \" Sir T. Herbert. Etym: [See Lymphate.] Lymphatic gland (Anat.), one of the solid glandlike bodies connected with the lymphatics or the lacteals; -- called also lymphatic ganglion, and conglobate gland. -- Lymphatic temperament (Old Physiol.), a temperament in which the lymphatic system seems to predominate, that is, a system in which the complexion lacks color and the tissues seem to be of loose texture; hence, a temperament lacking energy, inactive, indisposed to exertion or excitement. See Temperament.\n\n1. (Anat.)  One of the lymphatic or absorbent vessels, which carry lymph and discharge it into the veins; lymph duct; lymphatic duct. 2. A mad enthusiast; a lunatic. [Obs.]
lymphitis |See Lymphadenitis.
lymphogenic |Connected with, or formed in, the lymphatic glands.
lymphography |A description of the lymphatic vessels, their origin and uses.
lymphoid |Resembling lymph; also, resembling a lymphatic gland; adenoid; as, lymphoid tissue.
lymphoma |A tumor having a structure resembling that of a lymphatic gland; -- called also lymphadenoma. Malignant lymphoma, a fatal disease characterized by the formation in various parts of the body of new growths resembling lymphatic glands in structure.
lymphy |Containing, or like, lymph.
lyn |A waterfall. See Lin. [Scot.]
lyncean |Of or pertaining to the lynx.
lynch |To inflict punishment upon, especially death, without the forms of law, as when a mob captures and hangs a suspected person. See Lynch law.
lynch law |. The act or practice by private persons of inflicting punishment for crimes or offenses, without due process of law. Note: The term Lynch law is said to be derived from a Virginian named Lynch, who took the law into his own hands. But the origin of the term is very doubtful.
lyncher |One who assists in lynching.
lynde |See Linden.
lynden |See Linden.
lyne |Linen. [Obs.] Spenser.
lynx |1. (Zoöl.)  Any one of several species of feline animals of the genus Felis, and subgenus Lynx. They have a short tail, and usually a pencil of hair on the tip of the ears. Note: Among the well-known species are the European lynx (Felis borealis); the Canada lynx or loup-cervier (F. Canadensis); the bay lynx of America (F. rufa), and its western spotted variety (var. maculata); and the pardine lynx (F. pardina) of Southern Europe. 2. (Astron.)  One of the northern constellations.
lynx-eyed |Having acute sight.
lyonnaise |Applied to boiled potatoes cut into small pieces and heated in oil or butter. They are usually flavored with onion and parsley.
lyopomata |An order of brachiopods, in which the valves of shell are not articulated by a hinge. It includes the Lingula, Discina, and allied forms. [Written also Lyopoma.]
lyra |1. (Astron.)  A northern constellation, the Harp, containing a white star of the first magnitude, called Alpha Lyræ, or Vega. 2. (Anat.)  The middle portion of the ventral surface of the fornix of the brain; -- so called from the arrangement of the lines with which it is marked in the human brain.
lyraid |Same as Lyrid.
lyrate |1. (Bot.)  Lyre-shaped, or spatulate and oblong, with small lobes toward the base; as, a lyrate leaf. 2. (Zoöl.)  Shaped like a lyre, as the tail of the blackcock, or that of the lyre bird.
lyrated |1. (Bot.)  Lyre-shaped, or spatulate and oblong, with small lobes toward the base; as, a lyrate leaf. 2. (Zoöl.)  Shaped like a lyre, as the tail of the blackcock, or that of the lyre bird.
lyre |1. (Mus.)  A stringed instrument of music; a kind of harp much used by the ancients, as an accompaniment to poetry. Note: The lyre was the peculiar instrument of Apollo, the tutelary god of music and poetry. It gave name to the species of verse called lyric, to which it originally furnished an accompaniment 2. (Astron.)  One of the constellations; Lyra. See Lyra. Lyre bat (Zoöl.), a small bat (Megaderma lyra), inhabiting India and Ceylon. It is remarkable for the enormous size and curious shape of the nose membrane and ears. -- Lyre turtle (Zoöl.), the leatherback.
lyre bird |Any one of two or three species of Australian birds of the genus Menura. The male is remarkable for having the sixteen tail feathers very long and, when spread, arranged in the form of a lyre. The common lyre bird (Menura superba), inhabiting New South Wales, is about the size of a grouse. Its general color is brown, with rufous color on the throat, wings, tail coverts and tail. Called also lyre pheasant and lyre-tail.
lyric |1. Of or pertaining to a lyre or harp. 2. Fitted to be sung to the lyre; hence, also, appropriate for song; -- said especially of poetry which expresses the individual emotions of the poet. \"Sweet lyric song.\" Milton.\n\n1. A lyric poem; a lyrical composition. 2. A composer of lyric poems. [R.] Addison. 3. A verse of the kind usually employed in lyric poetry; -- used chiefly in the plural. 4. pl.  The words of a song.
lyrical |1. Of or pertaining to a lyre or harp. 2. Fitted to be sung to the lyre; hence, also, appropriate for song; -- said especially of poetry which expresses the individual emotions of the poet. \"Sweet lyric song.\" Milton.
lyrically |In a lyrical manner.
lyricism |A lyric composition. Gray.
lyrid |One of the group of shooting stars which come into the air in certain years on or about the 19th of April; -- so called because the apparent path among the stars the stars if produced back wards crosses the constellation Lyra.
lyrie |A European fish (Peristethus cataphractum), having the body covered with bony plates, and having three spines projecting in front of the nose; -- called also noble, pluck, pogge, sea poacher, and armed bullhead.
lyriferous |Having a lyre-shaped shoulder girdle, as certain fishes.
lyrism |The act of playing on a lyre or harp. G. Eliot.
lyrist |A musician who plays on the harp or lyre; a composer of lyrical poetry. Shelley.
lysimeter |An instrument for measuring the water that percolates through a certain depth of soil. Knight.
lysis |The resolution or favorable termination of a disease, coming on gradually and not marked by abrupt change. Note: It is usually contrasted with crisis, in which the improvement is sudden and marked; as, pneumonia ends by crisis, typhoid fever by lysis.
lyssa |Hydrophobia. Note: The plural (Lyssæ) has been used to signify the pustules supposed to be developed under the tongue in hydrophobia.
lyterian |Termination a disease; indicating the end of a disease.
lythe |The European pollack; -- called also laith, and leet. [Scot.]\n\nSoft; flexible. [Obs.] Spenser.
lythonthriptic |See Lithontriptic.
lythontriptic |See Lithontriptic.
lytta |A fibrous and muscular band lying within the longitudinal axis of the tongue in many mammals, as the dog.
m |1. M, the thirteenth letter of the English alphabet, is a vocal consonant, and from the manner of its formation, is called the labio- nasal consonant. See Guide to Pronunciation, §§ 178-180, 242. The letter M came into English from the Greek, through the Latin, the form of the Greek letter being further derived from the Phonician, and ultimately, it is believed, from the Egyptian. Etymologically M is related to n, in lime, linden; emmet, ant; also to b. M is readily followed by b and p. the position of the lips in the formation of both letters being the same. The relation of b and m is the same as that of d and t to n. and that of g and k to ng. 2. As a numeral, M stands for one thousand, both in English and Latin.\n\n1. (Print.) A quadrat, the face or top of which is a perfect square; also, the size of such a square in any given size of type, used as the unit of measurement for that type: 500 m's of pica would be a piece of matter whose length and breadth in pica m's multiplied together produce that number. [Written also em.] 2. (law) A brand or stigma, having the shape of an M, formerly impressed on one convicted of manslaughter and admitted to the benefit of clergy. M roof (Arch.), a kind of roof formed by the junction of two common roofs with a valley between them, so that the section resembles the letter M.
ma |1. A child's word for mother. 2. [Hind.] In Oriental countries, a respectful form of address given to a woman; mother. Balfour (Cyc. of India).\n\nBut; -- used in cautionary phrases; as, \"Vivace, ma non troppo presto\" (i. e., lively, but not too quick). Moore (Encyc. of Music).
maa |The common European gull (Larus canus); -- called also mar. See New, a gull.
maad |Made.  Chaucer.
maalin |(a) The sparrow hawk. (b) The kestrel. MA'AM Ma'am, n.  Madam; my lady; -- a colloquial contraction of madam often used in direct address, and sometimes as an appellation.
maara shell |A large, pearly, spiral, marine shell (Turbo margaritaceus), from the Pacific Islands. It is used as an ornament.
maasha |An East Indian coin, of about one tenth of the weight of a rupee.
maat |Dejected; sorrowful; downcast. [Obs.] \"So piteous and so maat.\" Chaucer.
mab |1. A slattern. [Prov. Eng.] 2. The name of a female fairy, esp. the queen of the fairies; and hence, sometimes, any fairy. Shak.
mabble |To wrap up. [Obs.]
mabby |A spirituous liquor or drink distilled from potatoes; -- used in the Barbadoes.
mabolo |A kind of persimmon tree (Diospyros discolor) from the Philippine Islands, now introduced into the East and West Indies. It bears an edible fruit as large as a quince.
mac |A prefix, in names of Scotch origin, signifying son.
macaco |Any one of several species of lemurs, as the ruffed lemur (Lemur macaco), and the ring-tailed lemur (L. catta).
macacus |A genus of monkeys, found in Asia and the East Indies. They have short tails and prominent eyebrows.
macadam road |A macadamized road.
macadamization |The process or act of macadamizing.
macadamize |To cover, as a road, or street, with small, broken stones, so as to form a smooth, hard, convex surface.
macao |A macaw.
macaque |Any one of several species of short-tailed monkeys of the genus Macacus; as, M. maurus, the moor macaque of the East Indies.
macaranga gum |A gum of a crimson color, obtained from a tree (Macaranga Indica) that grows in the East Indies. It is used in taking impressions of coins, medallions, etc., and sometimes as a medicine. Balfour (Cyc. of India).
macarize |To congratulate. [Oxford Univ. Cant]  Whately.
macaroni |1. Long slender tubes made of a paste chiefly of wheat flour, and used as an article of food; Italian or Genoese paste. A paste similarly prepared is largely used as food in Persia, India, and China, but is not commonly made tubular like the Italian macaroni.  Balfour (Cyc. of India). 2. A medley; something droll or extravagant. 3. A sort of droll or fool. [Obs.] Addison. 4. A finical person; a fop; -- applied especially to English fops of about 1775. Goldsmith. 5. pl. (U. S. Hist.) The designation of a body of Maryland soldiers in the Revolutionary War, distinguished by a rich uniform.  W. Irving.
macaronian |1. Pertaining to, or like, macaroni (originally a dish of mixed food); hence, mixed; confused; jumbled. 2. Of or pertaining to the burlesque composition called macaronic; as, macaronic poetry.
macaronic |1. Pertaining to, or like, macaroni (originally a dish of mixed food); hence, mixed; confused; jumbled. 2. Of or pertaining to the burlesque composition called macaronic; as, macaronic poetry.\n\n1. A heap of thing confusedly mixed together; a jumble. 2. A kind of burlesque composition, in which the vernacular words of one or more modern languages are intermixed with genuine Latin words, and with hybrid formed by adding Latin terminations to other roots.
macaroon |1. A small cake, composed chiefly of the white of eggs, almonds, and sugar. 2. A finical fellow, or macaroni. [Obs.]
macartney |A fire-backed pheasant. See Fireback.
macassar oil |A kind of oil formerly used in dressing the hair; -- so called because originally obtained from Macassar, a district of the Island of Celebes. Also, an imitation of the same, of perfumed castor oil and olive oil.
macauco |Any one of several species of small lemurs, as Lemur murinus, which resembles a rat in size.
macavahu |A small Brazilian monkey (Callithrix torquatus), -- called also collared teetee.
macaw |Any parrot of the genus Sittace, or Macrocercus. About eighteen species are known, all of them American. They are large and have a very long tail, a strong hooked bill, and a naked space around the eyes. The voice is harsh, and the colors are brilliant and strongly contrasted. Macaw bush (Bot.), a West Indian name for a prickly kind of nightshade (Solanum mammosum). --Macaw palm, Macaw tree (Bot.), a tropical American palm (Acrocomia fusiformis and other species) having a prickly stem and pinnately divided leaves. Its nut yields a yellow butter, with the perfume of violets, which is used in making violet soap. Called also grugru palm.
maccabean |Of or pertaining to Judas Maccabeus or to the Maccabees; as, the Maccabean princes; Maccabean times.
maccabees |1. The name given in later times to the Asmonæans, a family of Jewish patriots, who headed a religious revolt in the reign of Antiochus IV., 168-161 B. C., which led to a period of freedom for Israel. Schaff-Herzog. 2. The name of two ancient historical books, which give accounts of Jewish affairs in or about the time of the Maccabean princes, and which are received as canonical books in the Roman Catholic Church, but are included in the Apocrypha by Protestants. Also applied to three books, two of which are found in some MSS. of the Septuagint.
maccaboy |A kind of snuff.
macco |A gambling game in vogue in the eighteenth century. Thackeray.
maccoboy |A kind of snuff.
mace |A money of account in China equal to one tenth of a tael; also, a weight of 57.98 grains. S. W. Williams.\n\nA kind of spice; the aril which partly covers nutmegs. See Nutmeg. Note: Red mace is the aril of Myristica tingens, and white mace that of M. Otoba, -- East Indian trees of the same genus with the nutmeg tree.\n\n1. A heavy staff or club of metal; a spiked club; -- used as weapon in war before the general use of firearms, especially in the Middle Ages, for breaking metal armor. Chaucer. Death with his mace petrific . . . smote. Milton. 2. Hence: A staff borne by, or carried before, a magistrate as an ensign of his authority. \"Swayed the royal mace.\" Wordsworth. 3. An officer who carries a mace as an emblem of authority. Macaulay. 4. A knobbed mallet used by curriers in dressing leather to make it supple. 5. (Billiards)  A rod for playing billiards, having one end suited to resting on the table and pushed with one hand. Mace bearer, an officer who carries a mace before person in authority.
macedoine |A kind of mixed dish, as of cooked vegetables with white sauce, sweet jelly with whole fruit, etc. Also, fig., a medley.
macedonian |Belonging, or relating, to Macedonia. -- n.  A native or inhabitant of Macedonia.\n\nOne of a certain religious sect, followers of Macedonius, Bishop of Constantinople, in the fourth century, who held that the Holy Ghost was a creature, like the angels, and a servant of the Father and the Son.
macedonianism |The doctrines of Macedonius.
macer |A mace bearer; an officer of a court. P. Plowman.
macerate |1. To make lean; to cause to waste away. [Obs. or R.] Harvey. 2. To subdue the appetites of by poor and scanty diet; to mortify. Baker. 3. To soften by steeping in a liquid, with or without heat; to wear away or separate the parts of by steeping; as, to macerate animal or vegetable fiber.
macerater |One who, or that which, macerates; an apparatus for converting paper or fibrous matter into pulp.
maceration |The act or process of macerating.
machaerodus |A genus of extinct mammals allied to the cats, and having in the upper jaw canine teeth of remarkable size and strength; -- hence called saber-toothed tigers.
machairodus |A genus of extinct mammals allied to the cats, and having in the upper jaw canine teeth of remarkable size and strength; -- hence called saber-toothed tigers.
machete |A large heavy knife resembling a broadsword, often two or three feet in length, -- used by the inhabitants of Spanish America as a hatchet to cut their way through thickets, and for various other purposes. J. Stevens.
machiavelian |Of or pertaining to Machiavel, or to his supposed principles; politically cunning; characterized by duplicity or bad faith; crafty.\n\nOne who adopts the principles of Machiavel; a cunning and unprincipled politician.
machiavelianism |The supposed principles of Machiavel, or practice in conformity to them; political artifice, intended to favor arbitrary power.
machiavelism |The supposed principles of Machiavel, or practice in conformity to them; political artifice, intended to favor arbitrary power.
machicolated |Having machicolations. \"Machicolated turrets.\" C. Kingsley.
machicolation |1. (Mil. Arh.)  An opening between the corbels which support a projecting parapet, or in the floor of a gallery or the roof of a portal, shooting or dropping missiles upen assailants attacking the base of the walls. Also, the construction of such defenses, in general, when of this character. See Illusts. of Battlement and Castle. 2. The act of discharging missiles or pouring burning or melted substances upon assailants through such apertures.
machicoulis |Same as Machicolation.
machinal |Of or pertaining to machines.
machinate |To plan; to contrive; esp., to form a scheme with the purpose of doing harm; to contrive artfully; to plot. \"How long will you machinate!\" Sandys.\n\nTo contrive, as a plot; to plot; as, to machinate evil.
machination |1. The act of machinating. Shak. 2. That which is devised; a device; a hostile or treacherous scheme; an artful design or plot. Devilish machinations come to naught. Milton. His ingenious machinations had failed. Macaulay.
machinator |One who machinates, or forms a scheme with evil designs; a plotter or artful schemer. Glanvill. Sir W. Scott.
machine |1. In general, any combination of bodies so connected that their relative motions are constrained, and by means of which force and motion may be transmitted and modified, as a screw and its nut, or a lever arranged to turn about a fulcrum or a pulley about its pivot, etc.; especially, a construction, more or less complex, consisting of a combination of moving parts, or simple mechanical elements, as wheels, levers, cams, etc., with their supports and connecting framework, calculated to constitute a prime mover, or to receive force and motion from a prime mover or from another machine, and transmit, modify, and apply them to the production of some desired mechanical effect or work, as weaving by a loom, or the excitation of electricity by an electrical machine. Note: The term machine is most commonly applied to such pieces of mechanism as are used in the industrial arts, for mechanically shaping, dressing, and combining materials for various purposes, as in the manufacture of cloth, etc. Where the effect is chemical, or other than mechanical, the contrivance is usually denominated an apparatus, not a machine; as, a bleaching apparatus. Many large, powerful, or specially important pieces of mechanism are called engines; as, a steam engine, fire engine, graduating engine, etc. Although there is no well-settled distinction between the terms engine and machine among practical men, there is a tendency to restrict the application of the former to contrivances in which the operating part is not distinct from the motor. 2. Any mechanical contrivance, as the wooden horse with which the Greeks entered Troy; a coach; a bicycle. Dryden. Southey. Thackeray. 3. A person who acts mechanically or at will of another. 4. A combination of persons acting together for a common purpose, with the agencies which they use; as, the social machine. The whole machine of government ought not to bear upon the people with a weight so heavy and oppressive. Landor. 5. A political organization arranged and controlled by one or more leaders for selfish, private or partisan ends. [Political Cant] 6. Supernatural agency in a poem, or a superhuman being introduced to perform some exploit. Addison. Elementary machine, a name sometimes given to one of the simple mechanical powers. See under Mechanical. -- Infernal machine. See under Infernal. -- Machine gun.See under Gun. -- Machine screw, a screw or bolt adapted for screwing into metal, in distinction from one which is designed especially to be screwed into wood. -- Machine shop, a workshop where machines are made, or where metal is shaped by cutting, filing, turning, etc. -- Machine tool, a machine for cutting or shaping wood, metal, etc., by means of a tool; especially, a machine, as a lathe, planer, drilling machine, etc., designed for a more or less general use in a machine shop, in distinction from a machine for producing a special article as in manufacturing. -- Machine twist, silken thread especially adapted for use in a sewing machine. -- Machine work, work done by a machine, in contradistinction to that done by hand labor.\n\nTo subject to the action of machinery; to effect by aid of machinery; to print with a printing machine.
machiner |One who or operates a machine; a machinist. [R.]
machining |Of or pertaining to the machinery of a poem; acting or used as a machine.[Obs.] Dryden.
machinist |1. A constrictor of machines and engines; one versed in the principles of machines. 2. One skilled in the use of machine tools. 3. A person employed to shift scenery in a theater.
macho |The striped mullet of California (Mugil cephalus, or Mexicanus).
macilency |Leanness.[Obs.] Sandys.
macilent |Lean; thin. [Obs.] Bailey.
macintosh |Same as Mackintosh.
mackerel |A pimp; also, a bawd. [Obs.] Halliwell.\n\nAny species of the genus Scomber, and of several related genera. They are finely formed and very active oceanic fishes. Most of them are highly prized for food. Note: The common mackerel (Scomber scombrus), which inhabits both sides of the North Atlantic, is one of the most important food fishes. It is mottled with green and blue. The Spanish mackerel (Scomberomorus maculatus), of the American coast, is covered with bright yellow circular spots. Bull mackerel, Chub mackerel. (Zoöl.) See under Chub. -- Frigate mackerel. See under Frigate. -- Horse mackerel . See under Horse. -- Mackerel bird (Zoöl.), the wryneck; -- so called because it arrives in England at the time when mackerel are in season. -- Mackerel cock (Zoöl.), the Manx shearwater; -- so called because it precedes the appearance of the mackerel on the east coast of Ireland. -- Mackerel guide. (Zoöl.) See Garfish (a). -- Mackerel gull (Zoöl.) any one of several species of gull which feed upon or follow mackerel, as the kittiwake. -- Mackerel midge (Zoöl.), a very small oceanic gadoid fish of the North Atlantic. It is about an inch and a half long and has four barbels on the upper jaw. It is now considered the young of the genus Onos, or Motella. -- Mackerel plow, an instrument for creasing the sides of lean mackerel to improve their appearance. Knight. -- Mackerel shark (Zoöl.), the porbeagle. -- Mackerel sky, or Mackerel-back sky, a sky flecked with small white clouds; a cirro-cumulus. See Cloud. Mackerel sky and mare's-tails Make tall ships carry low sails. Old Rhyme.
mackinaw |A thick blanket formerly in common use in the western part of the United States.
mackinaw blanket |A thick blanket formerly in common use in the western part of the United States.
mackinaw boat |A flat-bottomed boat with a pointed prow and square stern, using oars or sails or both, used esp. on the upper Great Lakes and their tributaries.
mackinaw coat |A short, heavy, double-breasted plaid coat, the design of which is large and striking. [Local, U. S.]
mackinaw trout |The namaycush.
mackintosh |A waterproof outer garment; -- so called from the name of the inventor.
mackle |Same Macule.\n\nTo blur, or be blurred, in printing, as if there were a double impression.
macle |(a) Chiastolite; -- so called from the tessellated appearance of a cross section. See Chiastolite. (b) A crystal having a similar tessellated appearance. (c) A twin crystal.
macled |1. (Min.) (a) Marked like macle (chiastolite). (b) Having a twin structure. See Twin, a. 2. See Mascled.
maclurea |A genus of spiral gastropod shells, often of large size, characteristic of the lower Silurian rocks.
maclurin |See Morintannic.
macrame lace |A coarse lace made of twine, used especially in decorating furniture.
macrencephalic |Having a large brain.
macrencephalous |Having a large brain.
macro- |A combining form signifying long, large, great; as macrodiagonal, macrospore.
macro-chemistry |The science which treats of the chemical properties, actions or relations of substances in quantity; -- distinguished from micro- chemistry.
macrobiotic |Long-lived. Dunglison.
macrobiotics |The art of prolonging life.
macrocephalous |1. Having a large head. 2. (Bot.)  Having the cotyledons of a dicotyledonous embryo confluent, and forming a large mass compared with the rest of the body. Henslow.
macrochires |A division of birds including the swifts and humming birds. So called from the length of the distal part of the wing.
macrocosm |The great world; that part of the universe which is exterior to man; -- contrasted with microcosm, or man. See Microcosm.
macrocosmic |Of or pertaining to the macrocosm. Tylor.
macrocystis |An immensely long blackish seaweed of the Pacific (Macrocystis pyrifera), having numerous almond-shaped air vessels.
macrodactyl |One of a group of wading birds (Macrodactyli) having very long toes. [Written also macrodactyle.]
macrodactylic |Having long toes.
macrodactylous |Having long toes.
macrodiagonal |The longer of two diagonals, as of a rhombic prism. See Crystallization.
macrodome |A dome parallel to the longer lateral axis of an orthorhombic crystal. See Dome, n., 4.
macrodont |Having large teeth. -- n.  A macrodont animal.
macrofarad |See Megafarad. [R.]
macroglossia |Enlargement or hypertrophy of the tongue.
macrognathic |Long-jawed. Huxley.
macrograph |A picture of an object as seen by the naked eye (that is, unmagnified); as, a macrograph of a metallic fracture.
macrography |Examination or study with the naked eye, as distinguished from micrography.
macrology |Long and tedious talk without much substance; superfluity of words.
macrometer |An instrument for determining the size or distance of inaccessible objects by means of two reflectors on a common sextant.
macron |A short, straight, horizontal mark [-], placed over vowels to denote that they are to be pronounced with a long sound; as, a, in dame; e, in seam, etc.
macropetalous |Having long or large petals.
macrophyllous |Having long or large leaves.
macropinacoid |One of the two planes of an orthorhombic crystal which are parallel to the vertical and longer lateral (macrodiagonal) axes.
macropod |Any one of a group of maioid crabs remarkable for the length of their legs; -- called also spider crab.
macropodal |Having long or large feet, or a long stem.
macropodian |A macropod.
macropodous |Having long legs or feet.
macroprism |A prism of an orthorhombic crystal between the macropinacoid and the unit prism; the corresponding pyramids are called macropyramids.
macropteres |A division of birds; the Longipennes.
macropterous |Having long wings.
macropus |genus of marsupials including the common kangaroo.
macropyramid |See Macroprism.
macroscopic |Visible to the unassisted eye; -- as opposed to microscopic. -- Mac`ro*scop\"ic*al*ly, adv.
macroscopical |Visible to the unassisted eye; -- as opposed to microscopic. -- Mac`ro*scop\"ic*al*ly, adv.
macrosporangium |A sporangium or conceptacle containing only large spores; -- opposed to microsporangium. Both are found in the genera Selaginella, Isoctes, and Marsilia, plants remotely allied to ferns.
macrospore |One of the specially large spores of certain flowerless plants, as Selaginella, etc.
macrosporic |Of or pertaining to macrospores.
macrotone |Same as Macron.
macrotous |Large-eared.
macroura |Same as Macrura, Macrural, etc.
macroural |Same as Macrura, Macrural, etc.
macrozooespore |A large motile spore having four vibratile cilia; -- found in certain green algæ.
macrozoospore |A large motile spore having four vibratile cilia; -- found in certain green algæ.
macrura |A subdivision of decapod Crustacea, having the abdomen largely developed. It includes the lobster, prawn, shrimp, and many similar forms. Cf. Decapoda.
macrural |Same as Macrurous.
macruran |One of the Macrura.
macruroid |Like or pertaining to the Macrura.
macrurous |Of or pertaining to the Macrura; having a long tail.
mactation |The act of killing a victim for sacrifice. [Obs.]
mactra |Any marine bivalve shell of the genus Mactra, and allied genera. Many species are known. Some of them are used as food, as Mactra stultorum, of Europe. See Surf clam, under Surf.
macula |1. A spot, as on the skin, or on the surface of the sun or of some other luminous orb. 2. (Zoöl.)  A rather large spot or blotch of color.
maculate |To spot; to stain; to blur. Maculate the honor of their people. Sir T. Elyot.\n\nMarked with spots or maculæ; blotched; hence, defiled; impure; as, most maculate thoughts. Shak.
maculated |Having spots or blotches; maculate.
maculation |The act of spotting; a spot; a blemish. Shak.
maculatory |Causing a spot or stain. T. Adams.
