marplot |One who, by his officious
marque |A license to pass the limits of a jurisdiction, or boundary of a country, for the purpose of making reprisals. Letters of marque, Letters of marque and reprisal, a license or extraordinary commission granted by a government to a private person to fit out a privateer or armed ship to cruise at sea and make prize of the enemy's ships and merchandise. The ship so commissioned is sometimes called a letter of marque.
marquee |A large field tent; esp., one adapted to the use of an officer of high rank. [Written also markee.]
marquess |A marquis. Lady marquess, a marchioness. [Obs.] Shak.
marquetry |Inlaid work; work inlaid with pieces of wood, shells, ivory, and the like, of several colors.
marquis |A nobleman in England, France, and Germany, of a rank next below that of duke. Originally, the marquis was an officer whose duty was to guard the marches or frontiers of the kingdom. The office has ceased, and the name is now a mere title conferred by patent.
marquisate |The seigniory, dignity, or lordship of a marquis; the territory governed by a marquis.
marquisdom |A marquisate. [Obs.] \"Nobles of the marquisdom of Saluce.\" Holinshed.
marquise |The wife of a marquis; a marchioness.
marquisship |A marquisate.
marram |A coarse grass found on sandy beaches (Ammophila arundinacea). See Beach grass, under Beach.
marrer |One who mars or injures.
marriable |Marriageable. [R.] Coleridge.
marriage |1. The act of marrying, or the state of being married; legal union of a man and a woman for life, as husband and wife; wedlock; matrimony. Marriage is honorable in all. Heb. xiii. 4. 2. The marriage vow or contract. [Obs.] Chaucer. 3. A feast made on the occasion of a marriage. The kingdom of heaven is like unto a certain king which made a marriage for his son. Matt. xxii. 2. 4. Any intimate or close union. Marriage brokage. (a) The business of bringing about marriages. (b) The payment made or demanded for the procurement of a marriage. -- Marriage favors, knots of white ribbons, or bunches of white flowers, worn at weddings. -- Marriage settlement (Law), a settlement of property in view, and in consideration, of marriage. Syn. -- Matrimony; wedlock; wedding; nuptials. -- Marriage, Matrimony, Wedlock. Marriage is properly the act which unites the two parties, and matrimony the state into which they enter. Marriage is, however, often used for the state as well as the act. Wedlock is the old Anglo-Saxon term for matrimony.
marriageability |The quality or state of being marriageable.
marriageable |Fit for, or capable of, marriage; of an age at which marriage is allowable. -- Mar\"riage*a*ble*ness, n.
married |1. Being in the state of matrimony; wedded; as, a married man or woman. 2. Of or pertaining to marriage; connubial; as, the married state.
marrier |One who marries.
marron |1. A large chestnut. [Obs.] Holland. 2. A chestnut color; maroon. 3. (Pyrotechny & Mil.)  A paper or pasteboard box or shell, wound about with strong twine, filled with an explosive, and ignited with a fuse, -- used to make a noise like a cannon. [Written also maroon.]
marroon |Same as 1st Maroon.
marrot |(a) The razor-billed auk. See Auk. (b) The common guillemot. (c) The puffin. [Prov. Eng.] [Written also marrott, and morrot.]
marrow |1. (Anat.)  The tissue which fills the cavities of most bones; the medulla. In the larger cavities it is commonly very fatty, but in the smaller cavities it is much less fatty, and red or reddish in color. 2. The essence; the best part. It takes from our achievements . . . The pith and marrow of our attribute. Shak. 3. Etym: [OE. maru, maro; -- perh. a different word; cf. Gael. maraon together.]  One of a pair; a match; a companion; an intimate associate. [Scot.] Chopping and changing I can not commend, With thief or his marrow, for fear of ill end. Tusser. Marrow squash (Bot.), a name given to several varieties of squash, esp. to the Boston marrow, an ovoid fruit, pointed at both ends, and with reddish yellow flesh, and to the vegetable marrow, a variety of an ovoid form, and having a soft texture and fine grain resembling marrow. -- Spinal marrow. (Anat.) See Spinal cord, under Spinal.\n\nTo fill with, or as with, marrow of fat; to glut.
marrowbone |A bone containing marrow; pl. ludicrously, knee bones or knees; as, to get down on one's marrowbones, i. e., to kneel.
marrowfat |A rich but late variety of pea.
marrowish |Of the nature of, or like, marrow.
marrowless |Destitute of marrow.
marrowy |Full of marrow; pithy.
marrubium |A genus of bitter aromatic plants, sometimes used in medicine; hoarhound.
marry |1. To unite in wedlock or matrimony; to perform the ceremony of joining, as a man and a woman, for life; to constitute (a man and a woman) husband and wife according to the laws or customs of the place. Tell him that he shall marry the couple himself. Gay. 2. To join according to law, (a man) to a woman as his wife, or (a woman) to a man as her husband. See the Note to def. 4. A woman who had been married to her twenty-fifth husband, and being now a widow, was prohibited to marry. Evelyn. 3. To dispose of in wedlock; to give away as wife. Mæcenas took the liberty to tell him [Augustus] that he must either marry his daughter [Julia] to Agrippa, or take away his life. Bacon. 4. To take for husband or wife. See the Note below. Note: We say, a man is married to or marries a woman; or, a woman is married to or marries a man. Both of these uses are equally well authorized; but given in marriage is said only of the woman. They got him [the Duke of Monmouth] . . . to declare in writing, that the last king [Charles II.] told him he was never married to his mother. Bp. Lloyd. 5. Figuratively, to unite in the closest and most endearing relation. Turn, O backsliding children, saith the Lord; for I am married unto you. Jer. iii. 14. To marry ropes. (Naut.) (a) To place two ropes along side of each other so that they may be grasped and hauled on at the same time. (b) To join two ropes end to end so that both will pass through a block. Ham. Nav. Encyc.\n\nTo enter into the conjugal or connubial state; to take a husband or a wife. I will, therefore, that the younger women marry. 1 Tim. v. 14. Marrrying man, a man disposed to marry. [Colloq.]\n\nIndeed ! in truth ! -- a term of asseveration said to have been derived from the practice of swearing by the Virgin Mary. [Obs.] Shak.
mars |1. (Rom. Myth.)  The god of war and husbandry. 2. (Astron.)  One of the planets of the solar system, the fourth in order from the sun, or the next beyond the earth, having a diameter of about 4,200 miles, a period of 687 days, and a mean distance of 141,000,000 miles. It is conspicuous for the redness of its light. 3. (Alchemy)  The metallic element iron, the symbol of which was the same as that of the planet Mars. [Archaic] Chaucer. Mars brown, a bright, somewhat yellowish, brown.
marsala |A kind of wine exported from Marsala in Sicily.
marsdenia |A genus of plants of the Milkweed family, mostly woody climbers with fragrant flowers, several species of which furnish valuable fiber, and one species (Marsdenia tinctoria) affords indigo.
marsebanker |The menhaden.
marseillais |Of or pertaining to Marseilles, in France, or to its inhabitants. Marseillaise hymn, or The Marseillaise, the national anthem of France, popularly so called. It was composed in 1792, by Rouget de l'Isle, an officer then stationed at Strasburg. In Paris it was sung for the first time by the band of men who came from Marseilles to aid in the revolution of August 10, 1792; whence the name.\n\nA native or inhabitant of Marseilles.
marseillaise |Of or pertaining to Marseilles, in France, or to its inhabitants. Marseillaise hymn, or The Marseillaise, the national anthem of France, popularly so called. It was composed in 1792, by Rouget de l'Isle, an officer then stationed at Strasburg. In Paris it was sung for the first time by the band of men who came from Marseilles to aid in the revolution of August 10, 1792; whence the name.\n\nA native or inhabitant of Marseilles.
marseilles |A general term for certain kinds of fabrics, which are formed of two series of threads interlacing each other, thus forming double cloth, quilted in the loom; -- so named because first made in Marseilles, France.
marsh |A tract of soft wet land, commonly covered partially or wholly with water; a fen; a swamp; a morass. [Written also marish.] Marsh asphodel (Bot.), a plant (Nartheeium ossifragum) with linear equitant leaves, and a raceme of small white flowers; -- called also bog asphodel. -- Marsh cinquefoil (Bot.), a plant (Potentilla palustris) having purple flowers, and found growing in marshy places; marsh five- finger. -- Marsh elder. (Bot.) (a) The guelder-rose or cranberry tree (Viburnum Opulus). (b) In the United States, a composite shrub growing in salt marshes (Iva frutescens). -- Marsh five-finger. (Bot.) See Marsh cinquefoil (above). -- Marsh gas. (Chem.) See under Gas. -- Marsh grass (Bot.), a genus (Spartina) of coarse grasses growing in marshes; -- called also cord grass. The tall S. cynosuroides is not good for hay unless cut very young. The low S. juncea is a common component of salt hay. -- Marsh harrier (Zoöl.), a European hawk or harrier (Circus æruginosus); -- called also marsh hawk, moor hawk, moor buzzard, puttock. -- Marsh hawk. (Zoöl.) (a) A hawk or harrier (Circus cyaneus), native of both America and Europe. The adults are bluish slate above, with a white rump. Called also hen harrier, and mouse hawk. (b) The marsh harrier. -- Marsh hen (Zoöl.), a rail; esp., Rallus elegans of fresh-water marshes, and R. longirostris of salt-water marshes. -- Marsh mallow (Bot.), a plant of the genus Althæa ( A. officinalis) common in marshes near the seashore, and whose root is much used in medicine as a demulcent. -- Marsh marigold. (Bot.) See in the Vocabulary. -- Marsh pennywort (Bot.), any plant of the umbelliferous genus Hydrocotyle; low herbs with roundish leaves, growing in wet places; - - called also water pennywort. -- Marsh quail (Zoöl.), the meadow lark. -- Marsh rosemary (Bot.), a plant of the genus Statice (S. Limonium), common in salt marshes. Its root is powerfully astringent, and is sometimes used in medicine. Called also sea lavender. -- Marsh samphire (Bot.), a plant (Salicornia herbacea) found along seacoasts. See Glasswort. -- Marsh St. John's-wort (Bot.), an American herb (Elodes Virginica) with small opposite leaves and flesh-colored flowers. -- Marsh tea. (Bot.). Same as Labrador tea. -- Marsh trefoil. (Bot.) Same as Buckbean. -- Marsh wren (Zoöl.), any species of small American wrens of the genus Cistothorus, and allied genera. They chiefly inhabit salt marshes.
marsh marigold |. (Bot.) A perennial plant of the genus Caltha (C. palustris), growing in wet places and bearing bright yellow flowers. In the United States it is used as a pot herb under the name of cowslip. See Cowslip.
marshal |1. Originally, an officer who had the care of horses; a groom. [Obs.] 2. An officer of high rank, charged with the arrangement of ceremonies, the conduct of operations, or the like; as, specifically: (a) One who goes before a prince to declare his coming and provide entertainment; a harbinger; a pursuivant. (b) One who regulates rank and order at a feast or any other assembly, directs the order of procession, and the like. (c) The chief officer of arms, whose duty it was, in ancient times, to regulate combats in the lists. Johnson. (d) (France) The highest military officer. In other countries of Europe a marshal is a military officer of high rank, and called field marshal. (e) (Am. Law) A ministerial officer, appointed for each judicial district of the United States, to execute the process of the courts of the United States, and perform various duties, similar to those of a sheriff. The name is also sometimes applied to certain police officers of a city. Earl marshal of England, the eighth officer of state; an honorary title, and personal, until made hereditary in the family of the Duke of Norfolk. During a vacancy in the office of high constable, the earl marshal has jurisdiction in the court of chivalry. Brande & C. -- Earl marshal of Scotland, an officer who had command of the cavalry under the constable. This office was held by the family of Keith, but forfeited by rebellion in 1715. -- Knight marshal, or Marshal of the King's house, formerly, in England, the marshal of the king's house, who was authorized to hear and determine all pleas of the Crown, to punish faults committed within the verge, etc. His court was called the Court of Marshalsea. -- Marshal of the Queen's Bench, formerly the title of the officer who had the custody of the Queen's bench prison in Southwark. Mozley & W.\n\n1. To dispose in order; to arrange in a suitable manner; as, to marshal troops or an army. And marshaling the heroes of his name As, in their order, next to light they came. Dryden. 2. To direct, guide, or lead. Thou marshalest me the way that I was going. Shak. 3. (Her.)  To dispose in due order, as the different quarterings on an escutcheon, or the different crests when several belong to an achievement.
marshaler |One who marshals.
marshaling |1. The act of arranging in due order. 2. (Her.)  The arrangement of an escutcheon to exhibit the alliances of the owner. Marshaling of assets (Law), the arranging or ranking of assets in due order of administration.
marshalsea |The court or seat of a marshal; hence, the prison in Southwark, belonging to the marshal of the king's household. [Eng.] Court of Marshalsea, a court formerly held before the steward and marshal of the king's house to administer justice between the king's domestic servants. Blackstone.
marshalship |The office of a marshal.
marshbanker |The menhaden.
marshiness |The state or condition of being marshy.
marshy |1. Resembling a marsh; wet; boggy; fenny. 2. Pertaining to, or produced in, marshes; as, a marshy weed. Dryden.
marsipobranch |One of the Marsipobranchia.
marsipobranchia |A class of Vertebrata, lower than fishes, characterized by their purselike gill cavities, cartilaginous skeletons, absence of limbs, and a suckerlike mouth destitute of jaws. It includes the lampreys and hagfishes. See Cyclostoma, and Lamprey. Called also Marsipobranchiata, and Marsipobranchii.
marsupial |1. (Zoöl.)  Having a pouch for carrying the immature young; of or pertaining to the Marsupialia. 2. (Anat. & Zoöl.)  Of or pertaining to a marsupium; as, the marsupial bones. Marsupial frog. (Zoöl.) See Nototrema.\n\nOne of the Marsupialia.
marsupialia |A subclass of Mammalia, including nearly all the mammals of Australia and the adjacent islands, together with the opossums of America. They differ from ordinary mammals in having the corpus callosum very small, in being implacental, and in having their young born while very immature. The female generally carries the young for some time after birth in an external pouch, or marsupium. Called also Marsupiata.
marsupialian |One of the Marsupialia.
marsupian |One of the Marsupialia.
marsupiate |Related to or resembling the marsupials; furnished with a pouch for the young, as the marsupials, and also some fishes and Crustacea.
marsupion |Same as Marsupium.
marsupite |A fossil crinoid of the genus Marsupites, resembling a purse in form.
marsupium |(a) The pouch, formed by a fold of the skin of the abdomen, in which marsupials carry their young; also, a pouch for similar use in other animals, as certain Crustacea. (b) The pecten in the eye of birds and reptiles. See Pecten.
mart |1. A market. Where has commerce such a mart . . . as London Cowper. 2. A bargain. [Obs.] Shak.\n\nTo buy or sell in, or as in, a mart. [Obs.] To sell and mart your officer for gold To undeservers. Shak.\n\nTo traffic. [Obs.] Shak.\n\n1. The god Mars. [Obs.] 2. Battle; contest. [Obs.] Fairfax.
martagon |A lily (Lilium Martagon) with purplish red flowers, found in Europe and Asia.
martel |To make a blow with, or as with, a hammer. [Obs.] Spenser.
martel de fer |A weapon resembling a hammer, often having one side of the head pointed; -- used by horsemen in the Middle Ages to break armor. Fairholt.
marteline |A small hammer used by marble workers and sculptors.
martello tower |A building of masonry, generally circular, usually erected on the seacoast, with a gun on the summit mounted on a traversing platform, so as to be fired in any direction. Note: The English borrowed the name of the tower from Corsica in 1794.
marten |A bird. See Martin.\n\n1. (Zoöl.)  Any one of several fur-bearing carnivores of the genus Mustela, closely allied to the sable. Among the more important species are the European beech, or stone, marten (Mustela foina); the pine marten (M. martes); and the American marten, or sable (M. Americana), which some zoölogists consider only a variety of the Russian sable. 2. The fur of the marten, used for hats, muffs, etc.
martern |Same as Marten. [Obs.]
martial |1. Of, pertaining to, or suited for, war; military; as, martial music; a martial appearance. \"Martial equipage.\" Milton. 2. Practiced in, or inclined to, war; warlike; brave. But peaceful kings, o'er martial people set, Each other's poise and counterbalance are. Dryden. 3. Belonging to war, or to an army and navy; -- opposed to civil; as, martial law; a court-martial. 4. Pertaining to, or resembling, the god, or the planet, Mars. Sir T. Browne. 5. (Old Chem. & Old Med.)  Pertaining to, or containing, iron; chalybeate; as, martial preparations. [Archaic] Martial flowers (Med.), a reddish crystalline salt of iron; the ammonio-chloride of iron. [Obs.] -- Martial law, the law administered by the military power of a government when it has superseded the civil authority in time of war, or when the civil authorities are unable to enforce the laws. It is distinguished from military law, the latter being the code of rules for the regulation of the army and navy alone, either in peace or in war. Syn. -- Martial, Warlike. Martial refers more to war in action, its array, its attendants, etc.; as, martial music, a martial appearance, a martial array, courts-martial, etc. Warlike describes the feeling or temper which leads to war, and the adjuncts of war; as, a warlike nation, warlike indication, etc. The two words are often used without discrimination.
martialism |The quality of being warlike; exercises suitable for war. [Obs.]
martialist |A warrior. [Obs.] Fuller.
martialize |To render warlike; as, to martialize a people.
martially |In a martial manner.
martialness |The quality of being martial.
martian |Of or pertaining to Mars, the Roman god of war, or to the planet bearing his name; martial.\n\nAn inhabitant of the planet Mars.  Du Maurier.
martin |A perforated stone-faced runner for grinding.\n\nOne of several species of swallows, usually having the tail less deeply forked than the tail of the common swallows. [Written also marten.] Note: The American purple martin, or bee martin (Progne subis, or purpurea), and the European house, or window, martin (Hirundo, or Chelidon, urbica), are the best known species. Bank martin. (a) The bank swallow. See under Bank. (b) The fairy martin. See under Fairy. -- Bee martin. (a) The purple martin. (b) The kingbird. -- Sand martin, the bank swallow.
martinet |In military language, a strict disciplinarian; in general, one who lays stress on a rigid adherence to the details of discipline, or to forms and fixed methods. [Hence, the word is commonly employed in a depreciatory sense.]\n\nThe martin.
martineta |A species of tinamou (Calopezus elegans), having a long slender crest.
martinetism |The principles or practices of a martinet; rigid adherence to discipline, etc.
martingal |1. A strap fastened to a horse's girth, passing between his fore legs, and fastened to the bit, or now more commonly ending in two rings, through which the reins pass. It is intended to hold down the head of the horse, and prevent him from rearing. 2. (Naut.)  A lower stay of rope or chain for the jib boom or flying jib boom, fastened to, or reeved through, the dolphin striker. Also, the dolphin striker itself. 3. (Gambling)  The act of doubling, at each stake, that which has been lost on the preceding stake; also, the sum so risked; -- metaphorically derived from the bifurcation of the martingale of a harness. [Cant] Thackeray.
martingale |1. A strap fastened to a horse's girth, passing between his fore legs, and fastened to the bit, or now more commonly ending in two rings, through which the reins pass. It is intended to hold down the head of the horse, and prevent him from rearing. 2. (Naut.)  A lower stay of rope or chain for the jib boom or flying jib boom, fastened to, or reeved through, the dolphin striker. Also, the dolphin striker itself. 3. (Gambling)  The act of doubling, at each stake, that which has been lost on the preceding stake; also, the sum so risked; -- metaphorically derived from the bifurcation of the martingale of a harness. [Cant] Thackeray.
martinmas |The feast of St. Martin, the eleventh of November; -- often called martlemans. Martinmas summer, a period of calm, warm weather often experienced about the time of Martinmas; Indian summer. Percy Smith.
martite |Iron sesquioxide in isometric form, probably a pseudomorph after magnetite.
martlemas |See Martinmas. [Obs.]
martlet |1. (Zoöl.)  The European house martin. 2. Etym: [Cf. F. merlette.] (Her.)  A bird without beak or feet; -- generally assumed to represent a martin. As a mark of cadency it denotes the fourth son.
martyr |1. One who, by his death, bears witness to the truth of the gospel; one who is put to death for his religion; as, Stephen was the first Christian martyr. Chaucer. To be a martyr, signifies only to witness the truth of Christ; but the witnessing of the truth was then so generally attended with persecution, that martyrdom now signifies not only to witness, but to witness by death South. 2. Hence, one who sacrifices his life, his station, or what is of great value to him, for the sake of principle, or to sustain a cause. Then if thou fall'st, O Cromwell, Thou fall'st a blessed martyr ! Shak.\n\n1. To put to death for adhering to some belief, esp. Christianity; to sacrifice on account of faith or profession. Bp. Pearson. 2. To persecute; to torment; to torture. Chaucer. The lovely Amoret, whose gentle heart Thou martyrest with sorrow and with smart. Spenser. Racked with sciatics, martyred with the stone. Pope.
martyrdom |1. The condition of a martyr; the death of a martyr; the suffering of death on account of adherence to the Christian faith, or to any cause. Bacon. I came from martyrdom unto this peace. Longfellow. 2. Affliction; torment; torture. Chaucer.
martyrization |Act of martyrizing, or state of being martyrized; torture. B. Jonson.
martyrize |To make a martyr of. Spenser.
martyrly |In the manner of a martyr.
martyrologe |A martyrology. [Obs.] Bp. Hall.
martyrologic |Pertaining to martyrology or martyrs; registering, or registered in, a catalogue of martyrs.
martyrological |Pertaining to martyrology or martyrs; registering, or registered in, a catalogue of martyrs.
martyrologist |A writer of martyrology; an historian of martyrs. T. Warton.
martyrology |A history or account of martyrs; a register of martyrs. Bp. Stillingfleet.
martyrship |Martyrdom. [R.] Fuller.
marvel |1. That which causes wonder; a prodigy; a miracle. I will do marvels such as have not been done. Ex. xxxiv. 10. Nature's sweet marvel undefiled. Emerson. 2. Wonder. [R.] \"Use lessens marvel.\" Sir W. Scott. Marvel of Peru. (Bot.) See Four-o'clock.\n\nTo be struck with surprise, astonishment, or wonder; to wonder. Marvel not, my brethren, if the world hate you. 1 john iii. 13.\n\n1. To marvel at. [Obs.] Wyclif. 2. To cause to marvel, or be surprised; -- used impersonally. [Obs.] But much now me marveleth. Rich. the Redeless.
marvelously |In a marvelous manner; wonderfully; strangely.
marvelousness |The quality or state of being marvelous; wonderfulness; strangeness.
marver |A stone, or cast-iron plate, or former, on which hot glass is rolled to give it shape.
mary |Marrow. [Obs.] Chaucer.\n\nSee Marry. [Obs.] Chaucer.
mary-bud |The marigold; a blossom of the marigold. Shak.
maryolatry |Mariolatry.
marysole |A large British fluke, or flounder (Rhombus megastoma); -- called also carter, and whiff. marchpane.
mascagnin |Native sulphate of ammonia, found in volcanic districts; -- so named from Mascagni, who discovered it.
mascagnite |Native sulphate of ammonia, found in volcanic districts; -- so named from Mascagni, who discovered it.
mascle |A lozenge voided.
mascled |Composed of, or covered with, lozenge-shaped scales; having lozenge-shaped divisions. Mascled armor, armor composed of small lozenge-shaped scales of metal fastened on a foundation of leather or quilted cloth.
mascot |A person who is supposed to bring good luck to the household to which he or she belongs; anything that brings good luck.
mascotte |A person who is supposed to bring good luck to the household to which he or she belongs; anything that brings good luck.
masculate |To make strong. [Obs.] Cockeram.
masculine |1. Of the male sex; not female. Thy masculine children, that is to say, thy sons. Chaucer. 2. Having the qualities of a man; suitable to, or characteristic of, a man; virile; not feminine or effeminate; strong; robust. That lady, after her husband's death, held the reins with a masculine energy. Hallam. 3. Belonging to males; appropriated to, or used by, males. [R.] \"A masculine church.\" Fuller. 4. (Gram.)  Having the inflections of, or construed with, words pertaining especially to male beings, as distinguished from feminine and neuter. See Gender. -- Mas\"cu*line*ly, adv. -- Mas\"cu*line*ness, n.
masculinity |The state or quality of being masculine; masculineness.
mase |See Maze. [Obs.] Chaucer.
maselyn |A drinking cup. See 1st Maslin, 2. [Obs.] Chaucer.
maser |Same as Mazer.
mash |A mesh. [Obs.]\n\n1. A mass of mixed ingredients reduced to a soft pulpy state by beating or pressure; a mass of anything in a soft pulpy state. Specifically (Brewing), ground or bruised malt, or meal of rye, wheat, corn, or other grain (or a mixture of malt and meal) steeped and stirred in hot water for making the wort. 2. A mixture of meal or bran and water fed to animals. 3. A mess; trouble. [Obs.] Beau. & Fl. Mash tun, a large tub used in making mash and wort.\n\nTo convert into a mash; to reduce to a soft pulpy state by beating or pressure; to bruise; to crush; as, to mash apples in a mill, or potatoes with a pestle. Specifically (Brewing), to convert, as malt, or malt and meal, into the mash which makes wort. Mashing tub, a tub for making the mash in breweries and distilleries; -- called also mash tun, and mash vat.
masher |1. One who, or that which, mashes; also (Brewing), a machine for making mash. 2. A charmer of women. [Slang] London Punch.
mashie |A golf club like the iron, but with a shorter head, slightly more lofted, used chiefly for short approaches.
mashlin |See Maslin.
mashy |A golf club like the iron, but with a shorter head, slightly more lofted, used chiefly for short approaches.\n\nProduced by crushing or bruising; resembling, or consisting of, a mash.
mask |1. A cover, or partial cover, for the face, used for disguise or protection; as, a dancer's mask; a fencer's mask; a ball player's mask. 2. That which disguises; a pretext or subterfuge. 3. A festive entertainment of dancing or other diversions, where all wear masks; a masquerade; hence, a revel; a frolic; a delusive show. Bacon. This thought might lead me through the world's vain mask. Milton. 4. A dramatic performance, formerly in vogue, in which the actors wore masks and represented mythical or allegorical characters. 5. (Arch.)  A grotesque head or face, used to adorn keystones and other prominent parts, to spout water in fountains, and the like; -- called also mascaron. 6. (Fort.) (a) In a permanent fortification, a redoubt which protects the caponiere. (b) A screen for a battery. 7. (Zoöl.)  The lower lip of the larva of a dragon fly, modified so as to form a prehensile organ. Mask house, a house for masquerades. [Obs.]\n\n1. To cover, as the face, by way of concealment or defense against injury; to conceal with a mask or visor. They must all be masked and vizarded. Shak. 2. To disguise; to cover; to hide. Masking the business from the common eye. Shak. 3. (Mil.) (a) To conceal; also, to intervene in the line of. (b) To cover or keep in check; as, to mask a body of troops or a fortess by a superior force, while some hostile evolution is being carried out.\n\n1. To take part as a masker in a masquerade. Cavendish. 2. To wear a mask; to be disguised in any way. Shak.
mask shell |Any spiral marine shell of the genus Persona, having a curiously twisted aperture.
masked |1. Wearing a mask or masks; characterized by masks; cincealed; hidden. 2. (Bot.)  Same as Personate. 3. (Zoöl.)  Having the anterior part of the head differing decidedly in color from the rest of the plumage; -- said of birds. Masked ball, a ball in which the dancers wear masks. -- Masked battery (Mil.), a battery so placed as not to be seen by an enemy until it opens fire. H. L. Scott. -- Masked crab (Zoöl.), a European crab (Corystes cassivelaunus) with markings on the carapace somewhat resembling a human face. -- Masked pig (Zoöl.), a Japanese domestic hog (Sus pliciceps). Its face is deeply furrowed.
masker |One who wears a mask; one who appears in disguise at a masquerade.\n\nTo confuse; to stupefy. [Obs.] Holland.
maskery |The dress or disguise of a maske [Obs.] Marston.
maskinonge |The muskellunge.
maslach |An excitant containing opium, much used by the Turks. Dunglison.
maslin |1. A mixture composed of different materials; especially: (a) A mixture of metals resembling brass. (b) A mixture of different sorts of grain, as wheat and rye. [Written also meslin, mislin, maselyn, mastlin.] 2. A vessel made of maslin, 1 (a). [Obs.] Mead eke in a maselyn. Chaucer.\n\nComposed of different sorts; as, maslin bread, which is made of rye mixed with a little wheat. [Written also meslin, mislin, etc.]
mason |1. One whose occupation is to build with stone or brick; also, one who prepares stone for building purposes. 2. A member of the fraternity of Freemasons. See Freemason. Mason bee (Zoöl.), any one of numerous species of solitary bees of the genus Osmia. They construct curious nests of hardened mud and sand. -- Mason moth (Zoöl.), any moth whose larva constructs an earthen cocoon under the soil. -- Mason shell (Zoöl.), a marine univalve shell of the genus Phorus; -- so called because it cements other shells and pebbles upon its own shell; a carrier shell. -- Mason wasp (Zoöl.), any wasp that constructs its nest, or brood cells, of hardened mud. The female fills the cells with insects or spiders, paralyzed by a sting, and thus provides food for its larvæ\n\nTo build stonework or brickwork about, under, in, over, etc.; to construct by masons; -- with a prepositional suffix; as, to mason up a well or terrace; to mason in a kettle or boiler.
masonic |Of or pertaining to Freemasons or to their craft or mysteries.
masonry |1. The art or occupation of a mason. 2. The work or performance of a mason; as, good or bad masonry; skillful masonry. 3. That which is built by a mason; anything constructed of the materials used by masons, such as stone, brick, tiles, or the like. Dry masonry is applied to structures made without mortar. 4. The craft, institution, or mysteries of Freemasons; freemasonry.
masoola boat |. A kind of boat used on the coast of Madras, India. The planks are sewed together with strands of coir which cross over a wadding of the same material, so that the shock on taking the beach through surf is much reduced. [Written also masula, masulah, etc.]
masora |A Jewish critical work on the text of the Hebrew Scriptures, composed by several learned rabbis of the school of Tiberias, in the eighth and ninth centuries. [Written also Masorah, Massora, and Massorah.]
masoret |A Masorite. [Written also Masorete, and Massorete.]
masoretic |Of or relating to the Masora, or to its authors. Masoretic points and accents, the vowel points and accents of the Hebrew text of the Bible, of which the first mention is in the Masora.
masoretical |Of or relating to the Masora, or to its authors. Masoretic points and accents, the vowel points and accents of the Hebrew text of the Bible, of which the first mention is in the Masora.
masorite |One of the writers of the Masora.
masque |A mask; a masquerade.
masquerade |1. An assembly of persons wearing masks, and amusing themselves with dancing, conversation, or other diversions. In courtly balls and midnight masquerades. Pope. 2. A dramatic performance by actors in masks; a mask. See 1st Mask, 4. [Obs.] 3. Acting or living under false pretenses; concealment of something by a false or unreal show; pretentious show; disguise. That masquerade of misrepresentation which invariably accompanied the political eloquence of Rome. De Quincey. 4. A Spanish diversion on horseback.\n\n1. To assemble in masks; to take part in a masquerade. 2. To frolic or disport in disquise; to make a pretentious show of being what one is not. A freak took an ass in the head, and he goes into the woods, masquerading up and down in a lion's skin. L'Estrange.\n\nTo conceal with masks; to disguise. \"To masquerade vice.\" Killingbeck.
masquerader |One who masquerades; a person wearing a mask; one disguised.
mass |1. (R. C. Ch.)  The sacrifice in the sacrament of the Eucharist, or the consecration and oblation of the host. 2. (Mus.)  The portions of the Mass usually set to music, considered as a musical composition; -- namely, the Kyrie, the Gloria, the Credo, the Sanctus, and the Agnus Dei, besides sometimes an Offertory and the Benedictus. Canon of the Mass. See Canon. -- High Mass, Mass with incense, music, the assistance of a deacon, subdeacon, etc. -- Low Mass, Mass which is said by the priest through-out, without music. -- Mass bell, the sanctus bell. See Sanctus. -- Mass book, the missal or Roman Catholic service book.\n\nTo celebrate Mass. [Obs.] Hooker.\n\n1. A quantity of matter cohering together so as to make one body, or an aggregation of particles or things which collectively make one body or quantity, usually of considerable size; as, a mass of ore, metal, sand, or water. If it were not for these principles, the bodies of the earth, planets, comets, sun, and all things in them, would grow cold and freeze, and become inactive masses. Sir I. Newton. A deep mass of continual sea is slower stirred To rage. Savile. 2. (Phar.)  A medicinal substance made into a cohesive, homogeneous lump, of consistency suitable for making pills; as, blue mass. 3. A large quantity; a sum. All the mass of gold that comes into Spain. Sir W. Raleigh. He had spent a huge mass of treasure. Sir J. Davies. 4. Bulk; magnitude; body; size. This army of such mass and charge. Shak. 5. The principal part; the main body. Night closed upon the pursuit, and aided the mass of the fugitives in their escape. Jowett (Thucyd.). 6. (Physics)  The quantity of matter which a body contains, irrespective of its bulk or volume. Note: Mass and weight are often used, in a general way, as interchangeable terms, since the weight of a body is proportional to its mass (under the same or equal gravitative forces), and the mass is usually ascertained from the weight. Yet the two ideas, mass and weight, are quite distinct. Mass is the quantity of matter in a body; weight is the comparative force with which it tends towards the center of the earth. A mass of sugar and a mass of lead are assumed to be equal when they show an equal weight by balancing each other in the scales. Blue mass. See under Blue. -- Mass center (Geom.), the center of gravity of a triangle. -- Mass copper, native copper in a large mass. -- Mass meeting, a large or general assembly of people, usually a meeting having some relation to politics. -- The masses, the great body of the people, as contrasted with the higher classes; the populace.\n\nTo form or collect into a mass; to form into a collective body; to bring together into masses; to assemble. But mass them together and they are terrible indeed. Coleridge.
massacre |1. The killing of a considerable number of human beings under circumstances of atrocity or cruelty, or contrary to the usages of civilized people; as, the massacre on St. Bartholomew's Day. 2. Murder. [Obs.] Shak. Syn. -- Massacre, Butchery, Carnage. Massacre denotes the promiscuous slaughter of many who can not make resistance, or much resistance. Butchery refers to cold-blooded cruelty in the killing of men as if they were brute beasts. Carnage points to slaughter as producing the heaped-up bodies of the slain. I'll find a day to massacre them all, And raze their faction and their family. Shak. If thou delight to view thy heinous deeds, Brhold this pattern of thy butcheries. Shak. Such a scent I draw Of carnage, prey innumerable ! Milton.\n\nTo kill in considerable numbers where much resistance can not be made; to kill with indiscriminate violence, without necessity, and contrary to the usages of nations; to butcher; to slaughter; -- limited to the killing of human beings. If James should be pleased to massacre them all, as Maximian had massacred the Theban legion. Macaulay.
massacrer |One who massacres. [R.]
massage |A rubbing or kneading of the body, especially when performed as a hygienic or remedial measure.
massagist |One who practices massage; a masseur or masseuse.
massasauga |The black rattlesnake (Crotalus, or Caudisona, tergemina), found in the Mississippi Valley.
masse |A stroke made with the cue held vertically.
masse shot |A stroke made with the cue held vertically.
masser |A priest who celebrates Mass. [R.] Bale.
masseter |The large muscle which raises the under jaw, and assists in mastication.
masseteric |Of or pertaining to the masseter.
masseterine |Masseteric.
masseur |One who performs massage.
masseuse |One who performs massage.
massicot |Lead protoxide, PbO, obtained as a yellow amorphous powder, the fused and crystalline form of which is called litharge; lead ocher. It is used as a pigment. Note: Massicot is sometimes used by painters, and also as a drier in the composition of ointments and plasters.
massiness |The state or quality of being massy; ponderousness.
massive |1. Forming, or consisting of, a large mass; compacted; weighty; heavy; massy. \"Massive armor.\" Dr. H. More. 2. (Min.)  In mass; not necessarily without a crystalline structure, but having no regular form; as, a mineral occurs massive. Massive rock (Geol.), a compact crystalline rock not distinctly schistone, as granite; also, with some authors, an eruptive rock.
massively |In a heavy mass.
massiveness |The state or quality of being massive; massiness.
massoola boat |See Masoola boat.
massora |Same as Masora.
massoret |Same as Masorite.
massy |Compacted into, or consisting of, a mass; having bulk and weight ot substance; ponderous; bulky and heavy; weight; heavy; as, a massy shield; a massy rock. Your swords are now too massy for your strengths, And will not be uplifted. Shak. Yawning rocks in massy fragments fly. Pope.
mast |The fruit of the oak and beech, or other forest trees; nuts; acorns. Oak mast, and beech, . . . they eat. Chapman. Swine under an oak filling themselves with the mast. South.\n\n1. (Naut.)  A pole, or long, strong, round piece of timber, or spar, set upright in a boat or vessel, to sustain the sails, yards, rigging, etc. A mast may also consist of several pieces of timber united by iron bands, or of a hollow pillar of iron or steel. The tallest pine Hewn on Norwegian hills, to be the mast Of some great ammiral. Milton. Note: The most common general names of masts are foremast, mainmast, and mizzenmast, each of which may be made of separate spars. 2. (Mach.)  The vertical post of a derrick or crane. Afore the mast, Before the mast. See under Afore, and Before. -- Mast coat. See under Coat. -- Mast hoop, one of a number of hoops attached to the fore edge of a boom sail, which slip on the mast as the sail is raised or lowered; also, one of the iron hoops used in making a made mast. See Made.\n\nTo furnish with a mast or masts; to put the masts of in position; as, to mast a ship.
mastaba |1. In Mohammedan countries, a fixed seat, common in dwellings and in public places. 2.  (Egyptology) A type of tomb, of the time of the Memphite dynasties, comprising an oblong structure with sloping sides (sometimes containing a decorated chamber, sometimes of solid masonry), and connected with a mummy chamber in the rock beneath.
mastabah |1. In Mohammedan countries, a fixed seat, common in dwellings and in public places. 2.  (Egyptology) A type of tomb, of the time of the Memphite dynasties, comprising an oblong structure with sloping sides (sometimes containing a decorated chamber, sometimes of solid masonry), and connected with a mummy chamber in the rock beneath.
mastax |(a) The pharynx of a rotifer. It usually contains four horny pieces. The two central ones form the incus, against which the mallei, or lateral ones, work so as to crush the food. (b) The lore of a bird.
masted |Furnished with a mast or masts; -- chiefly in composition; as, a three-masted schooner.
master |A vessel having (so many) masts; -- used only in compounds; as, a two-master.\n\n1. A male person having another living being so far subject to his will, that he can, in the main, control his or its actions; -- formerly used with much more extensive application than now. (a) The employer of a servant. (b) The owner of a slave. (c) The person to whom an apprentice is articled. (d) A sovereign, prince, or feudal noble; a chief, or one exercising similar authority. (e) The head of a household. (f) The male head of a school or college. (g) A male teacher. (h) The director of a number of persons performing a ceremony or sharing a feast. (i) The owner of a docile brute, -- especially a dog or horse. (j) The controller of a familiar spirit or other supernatural being. 2. One who uses, or controls at will, anything inanimate; as, to be master of one's time. Shak. Master of a hundred thousand drachms. Addison. We are masters of the sea. Jowett (Thucyd. ). 3. One who has attained great skill in the use or application of anything; as, a master of oratorical art. Great masters of ridicule. Maccaulay. No care is taken to improve young men in their own language, that they may thoroughly understand and be masters of it. Locke. 4. A title given by courtesy, now commonly pronounced mìster, except when given to boys; -- sometimes written Mister, but usually abbreviated to Mr. 5. A young gentleman; a lad, or small boy. Where there are little masters and misses in a house, they are impediments to the diversions of the servants. Swift. 6. (Naut.)  The commander of a merchant vessel; -- usually called captain. Also, a commissioned officer in the navy ranking next above ensign and below lieutenant; formerly, an officer on a man-of-war who had immediate charge, under the commander, of sailing the vessel. 7. A person holding an office of authority among the Freemasons, esp. the presiding officer; also, a person holding a similar office in other civic societies. Little masters, certain German engravers of the 16th century, so called from the extreme smallness of their prints. -- Master in chancery, an officer of courts of equity, who acts as an assistant to the chancellor or judge, by inquiring into various matters referred to him, and reporting thereon to the court. -- Master of arts, one who takes the second degree at a university; also, the degree or title itself, indicated by the abbreviation M. A., or A. M. -- Master of the horse, the third great officer in the British court, having the management of the royal stables, etc. In ceremonial cavalcades he rides next to the sovereign. -- Master of the rolls, in England, an officer who has charge of the rolls and patents that pass the great seal, and of the records of the chancery, and acts as assistant judge of the court. Bouvier. Wharton. -- Past master, one who has held the office of master in a lodge of Freemasons or in a society similarly organized. -- The old masters, distinguished painters who preceded modern painters; especially, the celebrated painters of the 16th and 17th centuries. -- To be master of one's self, to have entire self-control; not to be governed by passion. -- To be one's own master, to be at liberty to act as one chooses without dictation from anybody. Note: Master, signifying chief, principal, masterly, superior, thoroughly skilled, etc., is often used adjiectively or in compounds; as, master builder or master-builder, master chord or master-chord, master mason or master-mason, master workman or master-workman, master mechanic, master mind, master spirit, master passion, etc. Throughout the city by the master gate. Chaucer. Master joint (Geol.), a quarryman's term for the more prominent and extended joints traversing a rock mass. -- Master key, a key adapted to open several locks differing somewhat from each other; figuratively, a rule or principle of general application in solving difficulties. -- Master lode (Mining), the principal vein of ore. -- Master mariner, an experienced and skilled seaman who is certified to be competent to command a merchant vessel. -- Master sinew (Far.), a large sinew that surrounds the hough of a horse, and divides it from the bone by a hollow place, where the windgalls are usually seated. -- Master singer. See Mastersinger. -- Master stroke, a capital performance; a masterly achievement; a consummate action; as, a master stroke of policy. -- Master tap (Mech.), a tap for forming the thread in a screw cutting die. -- Master touch. (a) The touch or skill of a master. Pope. (b) Some part of a performance which exhibits very skillful work or treatment. \"Some master touches of this admirable piece.\" Tatler. -- Master work, the most important work accomplished by a skilled person, as in architecture, literature, etc.; also, a work which shows the skill of a master; a masterpiece. -- Master workman, a man specially skilled in any art, handicraft, or trade, or who is an overseer, foreman, or employer.\n\n1. To become the master of; to subject to one's will, control, or authority; to conquer; to overpower; to subdue. Obstinacy and willful neglects must be mastered, even though it cost blows. Locke. 2. To gain the command of, so as to understand or apply; to become an adept in; as, to master a science. 3. To own; to posses. [Obs.] The wealth That the world masters. Shak.\n\nTo be skillful; to excel. [Obs.]
master vibrator |In an internal-combustion engine with two or more cylinders, an induction coil and vibrator placed in the circuit between the battery or magneto and the coils for the different cylinders, which are used without vibrators of their own.
masterdom |Dominion; rule; command. [R.] Shak.
masterful |1. Inclined to play the master; domineering; imperious; arbitrary. Dryden. 2. Having the skill or power of a master; indicating or expressing power or mastery. His masterful, pale face. Mrs. Browning.
masterfully |In a masterful manner; imperiously. A lawless and rebellious man who held lands masterfully and in high contempt of the royal authority. Macaulay.
masterhood |The state of being a master; hence, disposition to command or hector. C. Bronté.
masterless |Destitute of a master or owner; ungoverned or ungovernable. -- Mas\"ter*less*ness, n.
masterliness |The quality or state of being masterly; ability to control wisely or skillfully.
masterly |1. Suitable to, or characteristic of, a master; indicating thorough knowledge or superior skill and power; showing a master's hand; as, a masterly design; a masterly performance; a masterly policy. \"A wise and masterly inactivity.\" Sir J. Mackintosh. 2. Imperious; domineering; arbitrary.\n\nWith the skill of a master. Thou dost speak masterly. Shak.
masterous |Masterly. [Obs.] Milton.
masterpiece |Anything done or made with extraordinary skill; a capital performance; a chef-d'oeuvre; a supreme achievement. The top and masterpiece of art. South. Dissimulation was his masterpiece. Claredon.
mastership |1. The state or office of a master. 2. Mastery; dominion; superior skill; superiority. Where noble youths for mastership should strive. Driden. 3. Chief work; masterpiece. [Obs.] Dryden. 4. An ironical title of respect. How now, seignior Launce ! what news with your mastership Shak.
mastersinger |One of a class of poets which flourished in Nuremberg and some other cities of Germany in the 15th and 16th centuries. They bound themselves to observe certain arbitrary laws of rhythm.
masterwort |(a) A tall and coarse European umbelliferous plant (Peucedanum Ostruthium, formerly Imperatoria). (b) The Astrantia major, a European umbelliferous plant with a showy colored involucre. (c) Improperly, the cow parsnip (Heracleum lanatum).
mastery |1. The position or authority of a master; dominion; command; supremacy; superiority. If divided by mountains, they will fight for the mastery of the passages of the tops. Sir W. Raleigh. 2. Superiority in war or competition; victory; triumph; preëminence. The voice of them that shout for mastery. Ex. xxxii. 18. Every man that striveth for the mastery is temperate in all things. 1 Cor. ix. 25. O, but to have gulled him Had been a mastery. B. Jonson. 3. Contest for superiority. [Obs.] Holland. 4. A masterly operation; a feat. [Obs.] I will do a maistrie ere I go. Chaucer. 5. Specifically, the philosopher's stone. [Obs.] 6. The act process of mastering; the state of having mastered. He could attain to a mastery in all languages. Tillotson. The learning and mastery of a tongue, being unpleasant in itself, should not be cumbered with other difficulties. Locke.
mastful |Abounding in mast; producing mast in abundance; as, the mastful forest; a mastful chestnut. Dryden.
masthead |The top or head of a mast; the part of a mast above the hounds.\n\nTo cause to go to the masthead as a punishment. Marryat.
masthouse |A building in which vessels' masts are shaped, fitted, etc.
mastic |1. (Bot.)  A low shrubby tree of the genus Pistacia (P. Lentiscus), growing upon the islands and coasts of the Mediterranean, and producing a valuable resin; -- called also, mastic tree. 2. A resin exuding from the mastic tree, and obtained by incision. The best is in yellowish white, semitransparent tears, of a faint smell, and is used as an astringent and an aromatic, also as an ingredient in varnishes. 3. A kind of cement composed of burnt clay, litharge, and linseed oil, used for plastering walls, etc. Barbary mastic (Bot.), the Pistachia Atlantica. -- Peruvian mastic tree (Bot.), a small tree (Schinus Molle) with peppery red berries; -- called also pepper tree. -- West Indian mastic (Bot.), a lofty tree (Bursera gummifera) full of gum resin in every part.
masticable |Capable of being masticated.
masticador |A part of a bridle, the slavering bit. [Written also mastigador.]
masticate |To grind or crush with, or as with, the teeth and prepare for swallowing and digestion; to chew; as, to masticate food.
masticater |One who masticates.
mastication |The act or operation of masticating; chewing, as of food. Mastication is a necessary preparation of solid aliment, without which there can be no good digestion. Arbuthnot.
masticator |1. One who masticates. 2. A machine for cutting meat into fine pieces for toothless people; also, a machine for cutting leather, India rubber, or similar tough substances, into fine pieces, in some processes of manufacture.
masticatory |Chewing; adapted to perform the office o\n\nA substance to be chewed to increase the saliva. Bacon.
mastich |See Mastic.
masticin |A white, amorphous, tenacious substance resembling caoutchouc, and obtained as an insoluble residue of mastic.
masticot |Massicot. [Obs.]
mastiff |A breed of large dogs noted for strength and courage. There are various strains, differing in form and color, and characteristic of different countries. Mastiff bat (Zoöl.) , any bat of the genus Molossus; so called because the face somewhat resembles that of a mastiff.
mastigopod |One of the Mastigopoda.
mastigopoda |The Infusoria.
mastigure |Any one of several large spiny-tailed lizards of the genus Uromastix. They inhabit Southern Asia and North Africa.
masting |The act or process of putting a mast or masts into a vessel; also, the scientific principles which determine the position of masts, and the mechanical methods of placing them. Masting house (Naut.), a large building, with suitable mechanism overhanging the water, used for stepping and unstepping the masts of vessels.
mastitis |Inflammation of the breast.
mastless |Bearing no mast; as, a mastless oak or beech. Dryden.\n\nHaving no mast; as, a mastless vessel.
mastlin |See Maslin.
mastodon |An extinct genus of mammals closely allied to the elephant, but having less complex molar teeth, and often a pair of lower, as well as upper, tusks, which are incisor teeth. The species were mostly larger than elephants, and their romains occur in nearly all parts of the world in deposits ranging from Miocene to late Quaternary time.
mastodonsaurus |A large extinct genus of labyrinthodonts, found in the European Triassic rocks.
mastodontic |Pertaining to, or resembling, a mastodon; as, mastodontic dimensions. Everett.
mastodynia |Pain occuring in the mamma or female breast, -- a form of neuralgia.
mastodyny |Pain occuring in the mamma or female breast, -- a form of neuralgia.
mastoid |(a) Resembling the nipple or the breast; -- applied specifically to a process of the temporal bone behind the ear. (b) Pertaining to, or in the region of, the mastoid process; mastoidal.
mastoidal |Same as Mastoid.
mastoiditis |Inflammation in the mastoid process of the temporal bone.
mastology |The natural history of Mammalia.
mastress |Mistress. [Obs.] Chaucer.
masturbation |Onanism; self-pollution.
masty |Full of mast; abounding in acorns, etc.
masula boat |Same as Masoola boat.
mat |A name given by coppersmiths to an alloy of copper, tin, iron, etc., usually called white metal. [Written also matt.]\n\nCast down; dejected; overthrown; slain. [Obs.] When he saw them so piteous and so maat. Chaucer.\n\n1. A fabric of sedge, rushes, flags, husks, straw, hemp, or similar material, used for wiping and cleaning shoes at the door, for covering the floor of a hall or room, and for other purposes. 2. Any similar fabric for various uses, as for covering plant houses, putting beneath dishes or lamps on a table, securing rigging from friction, and the like. 3. Anything growing thickly, or closely interwoven, so as to resemble a mat in form or texture; as, a mat of weeds; a mat of hair. 4. An ornamental border made of paper, pasterboard, metal, etc., put under the glass which covers a framed picture; as, the mat of a daguerreotype. Mat grass. (Bot.) (a) A low, tufted, European grass (Nardus stricta). (b) Same as Matweed. -- Mat rush (Bot.), a kind of rush (Scirpus lacustris) used in England for making mats.\n\n1. To cover or lay with mats. Evelyn. 2. To twist, twine, or felt together; to interweave into, or like, a mat; to entangle. And o'er his eyebrows hung his matted hair. Dryden.\n\nTo grow thick together; to become interwoven or felted together like a mat.
matabele |A warlike South African Kaffir tribe.
matabeles |A warlike South African Kaffir tribe.
matachin |An old dance with swords and bucklers; a sword dance.
mataco |The three-banded armadillo (Tolypeutis tricinctus). See Illust. under Loricata.
matador |1. The killer; the man appointed to kill the bull in bullfights. 2. (Card Playing)  In the game of quadrille or omber, the three principal trumps, the ace of spades being the first, the ace of clubs the third, and the second being the deuce of a black trump or the seven of a red one. When Lady Tricksey played a four, You took it with a matadore. Swift.
matadore |1. The killer; the man appointed to kill the bull in bullfights. 2. (Card Playing)  In the game of quadrille or omber, the three principal trumps, the ace of spades being the first, the ace of clubs the third, and the second being the deuce of a black trump or the seven of a red one. When Lady Tricksey played a four, You took it with a matadore. Swift.
matagasse |A shrike or butcher bird; -- called also mattages. [Prov. Eng.]
matajuelo |A large squirrel fish (Holocentrus ascensionis) of Florida and the West Indies.
matajuelo blanco |A West Indian food fish (Malacanthus plumieri) related to the tilefish.
matamata |The bearded tortoise (Chelys fimbriata) of South American rivers.
matanza |A place where animals are slaughtered for their hides and tallow. [Western U. S.]
match |Anything used for catching and retaining or communicating fire, made of some substance which takes fire readily, or remains burning some time; esp., a small strip or splint of wood dipped at one end in a substance which can be easily ignited by friction, as a preparation of phosphorus or chlorate of potassium. Match box, a box for holding matches. -- Match tub, a tub with a perforated cover for holding slow matches for firing cannon, esp. on board ship. The tub contains a little water in the bottom, for extinguishing sparks from the lighted matches. -- Quick match, threads of cotton or cotton wick soaked in a solution of gunpowder mixed with gum arabic and boiling water and afterwards strewed over with mealed powder. It burns at the rate of one yard in thirteen seconds, and is used as priming for heavy mortars, fireworks, etc. -- Slow match, slightly twisted hempen rope soaked in a solution of limewater and saltpeter or washed in a lye of water and wood ashes. It burns at the rate of four or five inches an hour, and is used for firing cannon, fireworks, etc.\n\n1. A person or thing equal or similar to another; one able to mate or cope with another; an equal; a mate. Government . . . makes an innocent man, though of the lowest rank, a match for the mightiest of his fellow subjects. Addison. 2. A bringing together of two parties suited to one another, as for a union, a trial of skill or force, a contest, or the like; as, specifically: (a) A contest to try strength or skill, or to determine superiority; an emulous struggle. \"Many a warlike match.\" Drayton. A solemn match was made; he lost the prize. Dryden. (b) A matrimonial union; a marriage. 3. An agreement, compact, etc. \"Thy hand upon that match.\" Shak. Love doth seldom suffer itself to be confined by other matches than those of its own making. Boyle. 4. A candidate for matrimony; one to be gained in marriage. \"She . . . was looked upon as the richest match of the West.\" Clarendon. 5. Equality of conditions in contest or competition. It were no match, your nail against his horn. Shak. 6. Suitable combination or bringing together; that which corresponds or harmonizes with something else; as, the carpet and curtains are a match. 7. (Founding)  A perforated board, block of plaster, hardened sand, etc., in which a pattern is partly imbedded when a mold is made, for giving shape to the surfaces of separation between the parts of the mold. Match boarding (Carp.), boards fitted together with tongue and groove, or prepared to be so fitted. -- Match game, a game arranged as a test of superiority. -- Match plane (Carp.), either of the two planes used to shape the edges of boards which are joined by grooving and tonguing. -- Match plate (Founding), a board or plate on the opposite sides of which the halves of a pattern are fastened, to facilitate molding. Knight. -- Match wheel (Mach.), a cogwheel of suitable pitch to work with another wheel; specifically, one of a pair of cogwheels of equal size.\n\n1. To be a mate or match for; to be able to complete with; to rival successfully; to equal. No settled senses of the world can match The pleasure of that madness. Shak. 2. To furnish with its match; to bring a match, or equal, against; to show an equal competitor to; to set something in competition with, or in opposition to, as equal. No history or antiquity can matchis policies and his conduct. South. 3. To oppose as equal; to contend successfully against. Eternal might To match with their inventions they presumed So easy, and of his thunder made a scorn. Milton. 4. To make or procure the equal of, or that which is exactly similar to, or corresponds with; as, to match a vase or a horse; to match cloth. \"Matching of patterns and colors.\" Swift. 5. To make equal, proportionate, or suitable; to adapt, fit, or suit (one thing to another). Let poets match their subject to their strength. Roscommon. 6. To marry; to give in marriage. A senator of Rome survived, Would not have matched his daughter with a king. Addison. 7. To fit together, or make suitable for fitting together; specifically, to furnish with a tongue and a groove, at the edges; as, to match boards. Matching machine, a planing machine for forming a tongue or a groove on the edge of a board.\n\n1. To be united in marriage; to mate. I hold it a sin to match in my kindred. Shak. Let tigers match with hinds, and wolves with sheep. Dryden. 2. To be of equal, or similar, size, figure, color, or quality; to tally; to suit; to correspond; as, these vases match.
match game |A game arranged as a test of superiority; also, one of a series of such games.
match play |Play in which the score is reckoned by counting the holes won or lost by each side; -- disting. from medal play.
match-cloth |A coarse cloth.
match-coat |A coat made of match-cloth.
matchable |Capable of being matched; comparable on equal conditions; adapted to being joined together; correspondent. -- Match\"a*ble*ness, n. Sir Walter Raleigh . . . is matchable with the best of the ancients. Hakewill.
matcher |One who, or that which, matches; a matching machine. See under 3d Match.
matchless |1. Having no equal; unequaled. \"A matchless queen.\" Waller. 2. Unlike each other; unequal; unsuited. [Obs.] \"Matchless ears.\" Spenser. -- Match\"less*ly, adv. -- Match\"less*ness, n.
matchlock |An old form of gunlock containing a match for firing the priming; hence, a musket fired by means of a match.
matchmaker |1. One who makes matches for burning or kinding. 2. One who tries to bring about marriages.
matchmaking |1. The act or process of making matches for kindling or burning. 2. The act or process of trying to bring about a marriage for others.\n\nBusy in making or contriving marriages; as, a matchmaking woman.
mate |The Paraguay tea, being the dried leaf of the Brazilian holly (Ilex Paraguensis). The infusion has a pleasant odor, with an agreeable bitter taste, and is much used for tea in South America.\n\nSame as Checkmate.\n\nSee 2d Mat. [Obs.] Chaucer.\n\n1. To confuse; to confound. [Obs.] Shak. 2. To checkmate.\n\n1. One who customarily associates with another; a companion; an associate; any object which is associated or combined with a similar object. 2. Hence, specifically, a husband or wife; and among the lower animals, one of a pair associated for propagation and the care of their young. 3. A suitable companion; a match; an equal. Ye knew me once no mate For you; there sitting where you durst not soar. Milton. 4. (Naut.)  An officer in a merchant vessel ranking next below the captain. If there are more than one bearing the title, they are called, respectively, first mate, second mate, third mate, etc. In the navy, a subordinate officer or assistant; as, master's mate; surgeon's mate.\n\n1. To match; to marry. If she be mated with an equal husband. Shak. 2. To match one's self against; to oppose as equal; to compete with. There is no passion in the mind of man so weak but it mates and masters the fear of death. Bacon. I, . . . in the way of loyalty and truth, . . . Dare mate a sounder man than Surrey can be. Shak.\n\nTo be or become a mate or mates, especially in sexual companionship; as, some birds mate for life; this bird will not mate with that one.
matelasse |Ornamented by means of an imitation or suggestion of quilting, the surface being marked by depressed lines which form squares or lozenges in relief; as, matelassé silks.\n\nA quilted ornamented dress fabric of silk or silk and wool.
mateless |Having no mate.
matelote |A dish of food composed of many kings of fish.\n\n1. A stew, commonly of fish, flavored with wine, and served with a wine sauce containing onions, mushrooms, etc. 2.  An old dance of sailors, in double time, and somewhat like a hornpipe.
matelotte |1. A stew, commonly of fish, flavored with wine, and served with a wine sauce containing onions, mushrooms, etc. 2.  An old dance of sailors, in double time, and somewhat like a hornpipe.
mateology |A vain, unprofitable discourse or inquiry. [R.]
mateotechny |Any unprofitable science. [Obs.]
mater |See Alma mater, Dura mater, and Pia mater.
materia medica |1. Material or substance used in the composition of remedies; -- a general term for all substances used as curative agents in medicine. 2. That branch of medical science which treats of the nature and properties of all the substances that are employed for the cure of diseases.
material |1. Consisting of matter; not spiritual; corporeal; physical; as, material substance or bodies. The material elements of the universe. Whewell. 2. Hence: Pertaining to, or affecting, the physical nature of man, as distinguished from the mental or moral nature; relating to the bodily wants, interests, and comforts. 3. Of solid or weighty character; not insubstantial; of cinsequence; not be dispensed with; important. Discourse, which was always material, never trifling. Evelyn. I shall, in the account of simple ideas, set down only such as are most material to our present purpose. Locke. 4. (Logic.)  Pertaining to the matter, as opposed to the form, of a thing. See Matter. Material cause. See under Cause. -- Material evidence (Law), evidence which conduces to the proof or disproof of a relevant hypothesis. Wharton. Syn. -- Corporeal; bodily; important; weighty; momentous; essential.\n\nThe substance or matter of which anything is made or may be made. Raw material, any crude, unfinished, or elementary materials that are adapted to use only by processes of skilled labor. Cotton, wool, ore, logs, etc., are raw material.\n\nTo form from matter; to materialize. [Obs.] Sir T. Browne.
materialism |1. The doctrine of materialists; materialistic views and tenets. The irregular fears of a future state had been supplanted by the materialism of Epicurus. Buckminster. 2. The tendency to give undue importance to material interests; devotion to the material nature and its wants. 3. Material substances in the aggregate; matter. [R. & Obs.] A. Chalmers.
materialist |1. One who denies the existence of spiritual substances or agents, and maintains that spiritual phenomena, so called, are the result of some peculiar organization of matter. 2. One who holds to the existence of matter, as distinguished from the idealist, who denies it. Berkeley.
materialistic |Of or pertaining to materialism or materialists; of the nature of materialism. But to me his very spiritualism seemed more materialistic than his physics. C. Kingsley.
materialistical |Of or pertaining to materialism or materialists; of the nature of materialism. But to me his very spiritualism seemed more materialistic than his physics. C. Kingsley.
materiality |1. The quality or state of being material; material existence; corporeity. 2. Importance; as, the materiality of facts.
materialization |The act of materializing, or the state of being materialized.
materialize |1. To invest wich material characteristics; to make perceptible to the senses; hence, to present to the mind through the medium of material objects. Having wich wonderful art and beauty materialized, if I may so call it, a scheme of abstracted notions, and clothed the most nice, refined conceptions of philosophy in sensible images. Tatler. 2. To regard as matter; to consider or explain by the laws or principles which are appropriate to matter. 3. To cause to assume a character appropriate to material things; to occupy with material interests; as, to materialize thought. 4. (Spiritualism)  To make visable in, or as in, a material form; -- said of spirits. A female spirit form temporarily materialized, and not distinguishable from a human being. Epes Sargent.\n\nTo appear as a material form; to take substantial shape. [Colloq.]
materially |1. In the state of matter. I do not mean that anything is separable from a body by fire that was not materially preëxistent in it. Boyle. 2. In its essence; substantially. An ill intention is certainly sufficient to spoil . . . an act in itself materially good. South. 3. In an important manner or degree; essentaily; as, it materially concern us to know the real motives of our actions.
materialness |The state of being material.
materiarian |See Materialist. [Obs.]
materiate |Consisting of matter. [Obs.] Bacon.
materiated |Consisting of matter. [Obs.] Bacon.
materiation |Act of forming matter. [Obs.] Sir T. Browne.
materiel |That in a complex system which constitutes the materials, or instruments employed, in distinction from the personnel, or men; as, the baggage, munitions, provisions, etc., of an army; or the buildings, libraries, and apparatus of a college, in distinction from its officers.
materious |See Material. [Obs.]
maternal |Of or pertaining to a mother; becoming to a mother; motherly; as, maternal love; maternal tenderness. Syn. -- See Motherly.
maternally |In a motherly manner.
maternity |The state of being a mother; the character or relation of a mother.
matfelon |The knapweed (Centaurea nigra).
math |A mowing, or that which is gathered by mowing; -- chiefly used in composition; as, an aftermath. [Obs.] The first mowing thereof, for the king's use, is wont to be sooner than the common math. Bp. Hall.
mathematic |See Mathematical.
mathematical |Of or pertaining to mathematics; according to mathematics; hence, theoretically precise; accurate; as, mathematical geography; mathematical instruments; mathematical exactness. -- Math`e*mat\"ic*al*ly, adv.
mathematician |One versed in mathematics.
mathematics |That science, or class of sciences, which treats of the exact relations existing between quantities or magnitudes, and of the methods by which, in accordance with these relations, quantities sought are deducible from other quantities known or supposed; the science of spatial and quantitative relations. Note: Mathematics embraces three departments, namely: 1. Arithmetic. 2. Geometry, including Trigonometry and Conic Sections. 3. Analysis, in which letters are used, including Algebra, Analytical Geometry, and Calculus. Each of these divisions is divided into pure or abstract, which considers magnitude or quantity abstractly, without relation to matter; and mixed or applied, which treats of magnitude as subsisting in material bodies, and is consequently interwoven with physical considerations.
mather |See Madder.
mathes |The mayweed. Cf. Maghet.
mathesis |Learning; especially, mathematics. [R.] Pope.
mathurin |See Trinitarian.
matico |A Peruvian plant (Piper, or Artanthe, elongatum), allied to the pepper, the leaves of which are used as a styptic and astringent.
matie |A fat herring with undeveloped roe. [Written also matty.] [Eng. & Scot.]
matin |A French mastiff.\n\n1. Morning. [Obs.] Shak. 2. pl. Etym: [F. matines. See Etymol. above.]  Morning worship or service; morning prayers or songs. The winged choristers began To chirp their matins. Cleveland. 3. Time of morning service; the first canonical hour in the Roman Catholic Church.\n\nOf or pertaining to the morning, or to matins; used in the morning; matutinal.
matinal |Relating to the morning, or to matins; matutinal.
matinee |A reception, or a musical or dramatic entertainment, held in the daytime. See SoirÉe.
matrass |A round-bottomed glass flask having a long neck; a bolthead.
matress |See Matress.
matriarch |The mother and ruler of a family or of her descendants; a ruler by maternal right.
matriarchal |Of or pertaining to a matriarch; governed by a matriarch.
matriarchate |The office or jurisdiction of a matriarch; a matriarchal form of government.
matrice |See Matrix.
matricidal |Of or pertaining to matricide.
matricide |1. The murder of a mother by her son or daughter. 2. Etym: [L. matricida: cf. F. matricide.]  One who murders one's own mother.
matriculate |To enroll; to enter in a register; specifically, to enter or admit to membership in a body or society, particularly in a college or university, by enrolling the name in a register. In discovering and matriculating the arms of commissaries from North America. Sir W. Scott.\n\nTo go though the process of admission to membership, as by examination and enrollment, in a society or college.\n\nMatriculated. Skelton. -- n.  One who is matriculated. Arbuthnot.
matriculation |The act or process of matriculating; the state of being matriculated.
matrimoine |Matrimony. [Obs.]
matrimonial |Of or pertaining to marriage; derived from marriage; connubial; nuptial; hymeneal; as, matrimonial rights or duties. If he relied upon that title, he could be but a king at courtesy, and have rather a matrimonial than a regal power. Bacon. Syn. -- Connubial; conjugal; sponsal; spousal; nuptial; hymeneal.
matrimonially |In a matrimonial manner.
matrimonious |Matrimonial. [R.] Milton.
matrimony |1. The union of man and woman as husband and wife; the nuptial state; marriage; wedlock. If either of you know any impediment, why ye may not be lawfully joined together in matrimony, ye do now confessit. Book of Com. Prayer (Eng. Ed. ) 2. A kind of game at cards played by several persons. Matrimony vine (Bot.), a climbing thorny vine (Lycium barbarum) of the Potato family. Gray. Syn. -- Marriage; wedlock. See Marriage.
matrix |1. (Anat.)  The womb. All that openeth the matrix is mine. Ex. xxxiv. 19. 2. Hence, that which gives form or origin to anything; as: (a) (Mech.) The cavity in which anything is formed, and which gives it shape; a die; a mold, as for the face of a type. (b) (Min.) The earthy or stony substance in which metallic ores or crystallized minerals are found; the gangue. (c) pl. (Dyeing)  The five simple colors, black, white, blue, red, and yellow, of which all the rest are composed. 3. (Biol.)  The lifeless portion of tissue, either animal or vegetable, situated between the cells; the intercellular substance. 4. (Math.)  A rectangular arrangement of symbols in rows and columns. The symbols may express quantities or operations.
matron |1. A wife or a widow, especially, one who has borne children; a woman of staid or motherly manners. Your wives, your daughters, Your matrons, and your maids. Shak. Grave from her cradle, insomuch that she was a matron before she was a mother. Fuller. 2. A housekeeper; esp., a woman who manages the domestic economy of a public instution; a head nurse in a hospital; as, the matron of a school or hospital. Jury of matrons (Law), a jury of experienced women called to determine the question of pregnancy when set up in bar of execution, and for other cognate purposes.
matronage |1. The state of a matron. 2. The collective body of matrons. Burke. Can a politician slight the feelings and convictions of the whole matronage of his country Hare.
matronal |Of or pertaining to a matron; suitable to an elderly lady or to a married woman; grave; motherly.
matronhood |The state of being a matron.
matronize |1. To make a matron of; to make matronlike. Childbed matronizes the giddiest spirits. Richardson. 2. To act the part of a marton toward; to superintend; to chaperone; as, to matronize an assembly.
matronlike |Like a matron; sedate; grave; matronly.
matronly |1. Advanced in years; elderly. 2. Like, or befitting, a matron; grave; sedate.
matronymic |See Metronymic.
matross |Formerly, in the British service, a gunner or a gunner's mate; one of the soldiers in a train of artillery, who assisted the gunners in loading, firing, and sponging the guns. [Obs.]
matt |See Matte. Knight.
mattages |A shrike or butcher bird; -- written also matagasse. [Prov. Eng.]
mattamore |A subterranean repository for wheat.
matte |1. (Metallurgy)  A partly reduced copper sulphide, obtained by alternately roasting and melting copper ore in separating the metal from associated iron ores, and called coarse metal, fine metal, etc., according to the grade of fineness. On the exterior it is dark brown or black, but on a fresh surface is yellow or bronzy in color. 2. A dead or dull finish, as in gilding where the gold leaf is not burnished, or in painting where the surface is purposely deprived of gloss.
matted |Having a dull surface; unburnished; as, matted gold leaf or gilding. Matted glass, glass ornamented with figures on a dull ground.\n\n1. Covered with a mat or mats; as, a matted floor. 2. Tangled closely together; having its parts adhering closely together; as, matted hair.
matter |1. That of which anything is composed; constituent substance; material; the material or substantial part of anything; the constituent elements of conception; that into which a notion may be analyzed; the essence; the pith; the embodiment. He is the matter of virtue. B. Jonson. 2. That of which the sensible universe and all existent bodies are composed; anything which has extension, occupies space, or is perceptible by the senses; body; substance. Note: Matter is usually divided by philosophical writers into three kinds or classes: solid, liquid, and aëriform. Solid substances are those whose parts firmly cohere and resist impression, as wood or stone. Liquids have free motion among their parts, and easily yield to impression, as water and wine. Aëriform substances are elastic fluids, called vapors and gases, as air and oxygen gas. 3. That with regard to, or about which, anything takes place or is done; the thing aimed at, treated of, or treated; subject of action, discussion, consideration, feeling, complaint, legal action, or the like; theme. \"If the matter should be tried by duel.\" Bacon. Son of God, Savior of men ! Thy name Shall be the copious matter of my song. Milton. Every great matter they shall bring unto thee, but every small matter they shall judge. Ex. xviii. 22. 4. That which one has to treat, or with which one has to do; concern; affair; business. To help the matter, the alchemists call in many vanities out of astrology. Bacon. Some young female seems to have carried matters so far, that she is ripe for asking advice. Spectator. 5. Affair worthy of account; thing of consequence; importance; significance; moment; -- chiefly in the phrases what matter no matter, and the like. A prophet some, and some a poet, cry; No matter which, so neither of them lie. Dryden. 6. Inducing cause or occasion, especially of anything disagreeable or distressing; difficulty; trouble. And this is the matter why interpreters upon that passage in Hosea will not consent it to be a true story, that the prophet took a harlot to wife. Milton. 7. Amount; quantity; portion; space; -- often indefinite. Away he goes, . . . a matter of seven miles. L' Estrange. I have thoughts to tarry a small matter. Congreve. No small matter of British forces were commanded over sea the year before. Mi lton. 8. Substance excreted from living animal bodies; that which is thrown out or discharged in a tumor, boil, or abscess; pus; purulent substance. 9. (Metaph.)  That which is permanent, or is supposed to be given, and in or upon which changes are effected by psychological or physical processes and relations; -- opposed to form. Mansel. 10. (Print.)  Written manuscript, or anything to be set in type; copy; also, type set up and ready to be used, or which has been used, in printing. Dead matter (Print.), type which has been used, or which is not to be used, in printing, and is ready for distribution. -- Live matter (Print.), type set up, but not yet printed from. -- Matter in bar, Matter of fact. See under Bar, and Fact. -- Matter of record, anything recorded. -- Upon the matter, or Upon the whole matter, considering the whole; taking all things into view. Waller, with Sir William Balfour, exceeded in horse, but were, upon the whole matter, equal in foot. Clarendon.\n\n1. To be of importance; to import; to signify. It matters not how they were called. Locke. 2. To form pus or matter, as an abscess; to maturate. [R.] \"Each slight sore mattereth.\" Sir P. Sidney.\n\nTo regard as important; to take account of; to care for. [Obs.] He did not matter cold nor hunger. H. Brooke.
matter-of-fact |Adhering to facts; not turning aside from absolute realities; not fanciful or imaginative; commonplace; dry.
matterless |1. Not being, or having, matter; as, matterless spirits. Davies (Wit's Pilgr. ). 2. Unimportant; immaterial. [Obs.]
mattery |1. Generating or containing pus; purulent. 2. Full of substance or matter; important. B. Jonson.
matting |1. The act of interweaving or tangling together so as to make a mat; the process of becoming matted. 2. Mats, in general, or collectively; mat work; a matlike fabric, for use in covering floors, packing articles, and the like; a kind of carpeting made of straw, etc. 3. Materials for mats. 4. An ornamental border. See 3d Mat, 4.\n\nA dull, lusterless surface in certain of the arts, as gilding, metal work, glassmaking, etc.
mattock |An implement for digging and grubbing. The head has two long steel blades, one like an adz and the other like a narrow ax or the point of a pickax. 'T is you must dig with mattock and with spade. Shak.
mattoid |A person of congenitally abnormal mind bordering on insanity or degeneracy.
mattoir |A kind of coarse punch with a rasplike face, used for making a rough surface on etching ground, or on the naked copper, the effect after biting being very similar to stippled lines.
mattowacca |An American clupeoid fish (Clupea mediocris), similar to the shad in habits and appearance, but smaller and less esteemed for food; -- called also hickory shad, tailor shad, fall herring, and shad herring.
mattress |1. A quilted bed; a bed stuffed with hair, moss, or other suitable material, and quilted or otherwise fastened. [Written also matress.] 2. (Hydraulic Engin.)  A mass of interwoven brush, poles, etc., to protect a bank from being worn away by currents or waves.
maturant |A medicine, or application, which promotes suppuration.
maturate |1. To bring to ripeness or maturity; to ripen. A tree may be maturated artificially. Fuller. 2. To promote the perfect suppuration of (an abscess).\n\nTo ripen; to become mature; specif
maturation |The process of bringing, or of coming, to maturity; hence, specifically, the process of suppurating perfectly; the formation of pus or matter.
maturative |Conducing to ripeness or maturity; hence, conducing to suppuration.\n\nA remedy promoting maturation; a maturant.
mature |1. Brought by natural process to completeness of growth and development; fitted by growth and development for any function, action, or state, appropriate to its kind; full-grown; ripe. Now is love mature in ear. Tennison. How shall I meet, or how accost, the sage, Unskilled in speech, nor yet mature of age Pope. 2. Completely worked out; fully digested or prepared; ready for action; made ready for destined application or use; perfected; as, a mature plan. This lies glowing, . . . and is almost mature for the violent breaking out. Shak. 3. Of or pertaining to a condition of full development; as, a man of mature years. 4. Come to, or in a state of, completed suppuration. Syn. -- Ripe; perfect; completed; prepared; digested; ready. -- Mature, Ripe. Both words describe fullness of growth. Mature brings to view the progressiveness of the process; ripe indicates the result. We speak of a thing as mature when thinking of the successive stayes through which it has passed; as ripe, when our attention is directed merely to its state. A mature judgment; mature consideration; ripe fruit; a ripe scholar.\n\nTo bring or hasten to maturity; to promote ripeness in; to ripen; to complete; as, to mature one's plans. Bacon.\n\n1. To advance toward maturity; to become ripe; as, wine matures by age; the judgment matures by age and experience. 2. Hence, to become due, as a note.
maturely |1. In a mature manner; with ripeness; completely. 2. With caution; deliberately. Dryden. 3. Early; soon. [A Latinism, little used] Bentley.
matureness |The state or quality of being mature; maturity.
maturer |One who brings to maturity.
maturescent |Approaching maturity.
maturing |Approaching maturity; as, maturing fruits; maturing notes of hand.
maturity |1. The state or quality of being mature; ripeness; full development; as, the maturity of corn or of grass; maturity of judgment; the maturity of a plan. 2. Arrival of the time fixed for payment; a becoming due; termination of the period a note, etc., has to run.
matutinal |Of or pertaining to the morning; early.
matutinary |Matutinal. [R.]
matutine |Matutinal. [R.]
matweed |A name of several maritime grasses, as the sea sand-reed (Ammophila arundinacea) which is used in Holland to bind the sand of the seacoast dikes (see Beach grass, under Beach); also, the Lygeum Spartum, a Mediterranean grass of similar habit.
maty |A native house servant in India. Balfour (Cyc. of India).
matzoth |A cake of unleavened bread eaten by the Jews at the feast of the Passover.
maucaco |A lemur; -- applied to several species, as the White-fronted, the ruffed, and the ring-tailed lemurs.
maud |A gray plaid; -- used by shepherds in Scotland.
maudeline |An aromatic composite herb, the costmary; also, the South European Achillea Ageratum, a kind of yarrow.
maudle |To throw onto confusion or disorder; to render maudlin. [Obs.]
maudlin |1. Tearful; easily moved to tears; exciting to tears; excessively sentimental; weak and silly. \"Maudlin eyes.\" Dryden. \"Maudlin eloquence.\" Roscommon. \"A maudlin poetess.\" Pope. \"Maudlin crowd.\" Southey. 2. Drunk, or somewhat drunk; fuddled; given to drunkenness. Maudlin Clarence in his malmsey butt. Byron.\n\nAn aromatic composite herb, the costmary; also, the South European Achillea Ageratum, a kind of yarrow.
maudlinism |A maudlin state. Dickens.
maudlinwort |The oxeye daisy.
mauger |In spite of; in opposition to; notwithstanding. A man must needs love maugre his heed. Chaucer. This mauger all the world will I keep safe. Shak.
maugre |In spite of; in opposition to; notwithstanding. A man must needs love maugre his heed. Chaucer. This mauger all the world will I keep safe. Shak.\n\nTo defy. [Obs.] J. Webster.
maukin |1. See Malkin. 2. (Zoöl.)  A hare. [Scot.]
maul |A heavy wooden hammer or beetle. [Written also mall.]\n\n1. To beat and bruise with a heavy stick or cudgel; to wound in a coarse manner. Meek modern faith to murder, hack, and maul. Pope. 2. To injure greatly; to do much harm to. It mauls not only the person misrepreseted, but him also to whom he is misrepresented. South.
maul-stick |A stick used by painters as a rest for the hand while working. [Written also mahl-stick.]
maule |The common mallow.
mauling |A severe beating with a stick, cudgel, or the fist.
maumet |See Mawmet. [Obs.] Chaucer.
maunch |To munch. [Obs.]\n\nSee Manche.
maund |A hand basket. [Obs.] Herrick.\n\nAn East Indian weight, varying in different localities from 25 to about 82 pounds avoirdupois.\n\n1. To beg. [Obs.] B. Jonson. Beau. & Fl. 2. To mutter; to mumble; to grumble; to speak indistinctly or disconnectedly; to talk incoherently. He was ever maundering by the how that he met a party of scarlet devils. Sir W. Scott.
maunder |1. To beg. [Obs.] B. Jonson. Beau. & Fl. 2. To mutter; to mumble; to grumble; to speak indistinctly or disconnectedly; to talk incoherently. He was ever maundering by the how that he met a party of scarlet devils. Sir W. Scott.\n\nTo utter in a grumbling manner; to mutter.\n\nA beggar. [Obs.]
maunderer |One who maunders.
maundril |A pick with two prongs, to pry with.
maundy coins |Silver coins or money of the nominal value of 1d., 2d., 3d., and 4d., struck annually for the Maundy alms.
maundy money |Silver coins or money of the nominal value of 1d., 2d., 3d., and 4d., struck annually for the Maundy alms.
maundy thursday |The Thursday in Passion week, or next before Good Friday.
maungy |Mangy. [Obs.] Skelton.
mauresque |See Moresque.
maurist |A member of the Congregation of Saint Maur, an offshoot of the Benedictines, originating in France in the early part of the seventeenth century. The Maurists have been distinguished for their interest in literature.
mausolean |Pertaining to a mausoleum; monumental.
mausoleum |A magnificent tomb, or stately sepulchral monument.
mauther |A girl; esp., a great, awkward girl; a wench. [Prov. Eng.]
mauvaniline |See Mauve aniline, under Mauve.
mauve |A color of a delicate purple, violet, or lilac. Mauve aniline (Chem.), a dyestuff produced artificially by the oxidation of commercial aniline, and the first discovered of the so-called coal- tar, or aniline, dyes. It consists of the sulphate of mauveïne, and is a dark brown or bronze amorphous powder, which dissolves to a beatiful purple color. Called also aniline purple, violine, etc.
mauveine |An artificial organic base, obtained by oxidizing a mixture of aniline and toluidine, and valuable for the dyestuffs it forms. [Written also mauvine.]
mauvine |Mauve-colored.
maverick |In the southwestern part of the united States, a bullock or heifer that has not been branded, and is unclaimed or wild; -- said to be from Maverick, the name of a cattle owner in Texas who naglected to brand his cattle.
maverick brand |A brand originated by a dishonest cattleman, who, without owning any stock, gradually accumulates a herd by finding mavericks. [Western U. S.]
mavis |The European throstle or song thrush (Turdus musicus).
mavourneen |My darling; -- an Irish term of endearment for a girl or woman. \"Erin mavournin.\"  Campbell.
mavournin |My darling; -- an Irish term of endearment for a girl or woman. \"Erin mavournin.\"  Campbell.
maw |A gull.\n\n1. A stomach; the receptacle into which food is taken by swallowing; in birds, the craw; -- now used only of the lower animals, exept humorously or in contempt. Chaucer. Bellies and maws of living creatures. Bacon. 2. Appetite; inclination. [Obs.] Unless you had more maw to do me good. Beau. & Fl. Fish maw. (Zoöl.) See under Fish.\n\nAn old game at cards. Sir A. Weldon.
mawk |1. A maggot. [Scot.] 2. A slattern; a mawks. [Prov. Eng.]
mawkin |See Malkin, and Maukin.
mawkingly |Slatternly. [Obs.]
mawkish |1. Apt to cause satiety or loathing; nauseous; disgusting. So sweetly mawkish', and so smoothly dull. Pope. 2. Easily disgusted; squeamish; sentimentally fastidious. J. H. Newman.
mawkishly |In a mawkish way.
mawkishness |The quality or state of being mawkish. J. H. Newman.
mawks |A slattern; a mawk. [Prov. Eng.]
mawky |Maggoty. [Prov. Eng.]
mawmet |A puppet; a doll; originally, an idol, because in the Middle Ages it was generally believed that the Mohammedans worshiped images representing Mohammed. [Obs.] Wyclif. Beau. & Fl.
mawmetry |The religion of Mohammed; also, idolatry. See Mawmet. [Obs.] Chaucer.
mawmish |Nauseous. [Obs.] L' Estrange.
mawseed |The seed of the opium poppy.
mawworm |(a) Any intestinal worm found in the stomach, esp. the common round worm (Ascaris lumbricoides), and allied species. (b) One of the larvæ of botflies of horses; a bot.
maxilla |1. (Anat.) (a) The bone of either the upper or the under jaw. (b) The bone, or principal bone, of the upper jaw, the bone of the lower jaw being the mandible. [Now commonly used in this restricted sense.] 2. (Zoöl.)  One of the lower or outer jaws of arthropods. Note: There are usually two pairs in Crustacea and one pair in insects. In certain insects they are not used as jaws, but may form suctorial organs. See Illust. under Lepidoptera, and Diptera.
maxillar |1. (Anat.)  Pertaining to either the upper or the lower jaw, but now usually applied to the upper jaw only. -- n.  The principal maxillary bone; the maxilla. 2. (Zoöl.)  Of or pertaining to a maxilla.
maxillary |1. (Anat.)  Pertaining to either the upper or the lower jaw, but now usually applied to the upper jaw only. -- n.  The principal maxillary bone; the maxilla. 2. (Zoöl.)  Of or pertaining to a maxilla.
maxilliform |Having the form, or structure, of a maxilla.
maxilliped |One of the mouth appendages of Crustacea, situated next behind the maxillæ. Crabs have three pairs, but many of the lower Crustacea have but one pair of them. Called also jawfoot, and foot jaw.
maxillo-mandibular |Pertaining to the maxilla and mandible; as, the maxillo- mandibular nerve.
maxillo-palatine |Pertaining to the maxillary and palatine regions of the skull; as, the maxillo-palatine process of the maxilla. Also used as n.
maxilloturbinal |Pertaining to the maxillary and turbinal regions of the skull. -- n.  The maxillo-turbinal, or inferior turbinate, bone.
maxim |1. An established principle or proposition; a condensed proposition of important practical truth; an axiom of practical wisdom; an adage; a proverb; an aphorism. 'T is their maxim, Love is love's reward. Dryden. 2. (Mus.)  The longest note formerly used, equal to two longs, or four breves; a large. Syn. -- Axiom; aphorism; apothegm; adage; proverb; saying. See Axiom.
maxim gun |A kind of machine gun; -- named after its inventor, Hiram S. Maxim.
maximilian |A gold coin of Bavaria, of the value of about 13s. 6d. sterling, or about three dollars and a quarter.
maximization |The act or process of increasing to the highest degree. Bentham.
maximize |To increase to the highest degree. Bentham.
maximum |The greatest quantity or value attainable in a given case; or, the greatest value attained by a quantity which first increases and then begins to decrease; the highest point or degree; -- opposed to Ant: minimum. Good legislation is the art of conducting a nation to the maximum of happiness, and the minimum of misery. P. Colquhoun. Maximum thermometer, a thermometer that registers the highest degree of temperature attained in a given time, or since its last adjustment.\n\nGreatest in quantity or highest in degree attainable or attained; as, a maximum consumption of fuel; maximum pressure; maximum heat.
may |An auxiliary verb qualifyng the meaning of another verb, by expressing: (a) Ability, competency, or possibility; -- now oftener expressed by can. How may a man, said he, with idle speech, Be won to spoil the castle of his health ! Spenser. For what he [the king] may do is of two kinds; what he may do as just, and what he may do as possible. Bacon. For of all sad words of tongue or pen The saddest are these: \"It might have been.\" Whittier. (b) Liberty; permission; allowance. Thou mayst be no longer steward. Luke xvi. 2. (c) Contingency or liability; possibility or probability. Though what he learns he speaks, and may advance Some general maxims, or be right by chance. Pope. (d) Modesty, courtesy, or concession, or a desire to soften a question or remark. How old may Phillis be, you ask. Prior. (e) Desire or wish, as in prayer, imprecation, benediction, and the like. \"May you live happily.\" Dryden. May be, and It may be, are used as equivalent to possibly, perhaps, by chance, peradventure. See 1st Maybe.\n\nA maiden. [Obs.] Chaucer.\n\n1. The fifth month of the year, containing thirty-one days. Chaucer. 2. The early part or springtime of life. His May of youth, and bloom of lustihood. Shak. 3. (Bot.)  The flowers of the hawthorn; -- so called from their time of blossoming; also, the hawthorn. The palm and may make country houses gay. Nash. Plumes that micked the may. Tennyson. 4. The merrymaking of May Day. Tennyson. Italian may (Bot.), a shrubby species of Spiræa (S. hypericifolia) with many clusters of small white flowers along the slender branches. -- May apple (Bot.), the fruit of an American plant (Podophyllum peltatum). Also, the plant itself (popularly called mandrake), which has two lobed leaves, and bears a single egg-shaped fruit at the forking. The root and leaves, used in medicine, are powerfully drastic. -- May beetle, May bug (Zoöl.), any one of numerous species of large lamellicorn beetles that appear in the winged state in May. They belong to Melolontha, and allied genera. Called also June beetle. -- May Day, the first day of May; -- celebrated in the rustic parts of England by the crowning of a May queen with a garland, and by dancing about a May pole. -- May dew, the morning dew of the first day of May, to which magical properties were attributed. -- May flower (Bot.), a plant that flowers in May; also, its blossom. See Mayflower, in the vocabulary. -- May fly (Zoöl.), any species of Ephemera, and allied genera; -- so called because the mature flies of many species appear in May. See Ephemeral fly, under Ephemeral. -- May game, any May-day sport. -- May lady, the queen or lady of May, in old May games. -- May lily (Bot.), the lily of the valley (Convallaria majalis). -- May pole. See Maypole in the Vocabulary. -- May queen, a girl or young woman crowned queen in the sports of May Day. -- May thorn, the hawthorn.
may laws |1. See Kulturkampf, above. 2.  In Russia, severe oppressive laws against Jews, which have given occasion for great persecution; -- so called because they received the assent of the czar in May, 1882, and because likened to the Prussian May laws (see Kulturkampf).
maya |The name for the doctrine of the unreality of matter, called, in English, idealism; hence, nothingness; vanity; illusion.
maya arch |A form of corbel arch employing regular small corbels.
mayan |1. Designating, or pertaining to, an American Indian linguistic stock occupying the Mexican States of Veracruz, Chiapas, Tabasco, Campeche, and Yucatan, together with a part of Guatemala and a part of Salvador. The Mayan peoples are dark, short, and brachycephallic, and at the time of the discovery had attained a higher grade of culture than any other American people. They cultivated a variety of crops, were expert in the manufacture and dyeing of cotton fabrics, used cacao as a medium of exchange, and were workers of gold, silver, and copper. Their architecture comprised elaborately carved temples and places, and they possessed a superior calendar, and a developed system of hieroglyphic writing, with records said to go back to about 700 a. d. 2.  Of or pertaining to the Mayas.
mayan arch |A form of corbel arch employing regular small corbels.
maybe |Perhaps; possibly; peradventure. Maybe the amorous count solicits her. Shak. In a liberal and, maybe, somewhat reckless way. Tylor.\n\nPossible; probable, but not sure. [R.] Then add those maybe years thou hast to live. Driden.\n\nPossibility; uncertainty. [R.] What they offer is mere maybe and shift. Creech.
maybird |(a) The whimbrel; -- called also May fowl, May curlew, and May whaap. (b) The knot. [Southern U. S.] (c) The bobolink.
maybloom |The hawthorn.
maybush |The hawthorn.
mayduke |A large dark-red cherry of excellent quality.
mayfish |A common American minnow (Fundulus majalis). See Minnow.
mayflower |In England, the hawthorn; in New England, the trailing arbutus (see Arbutus); also, the blossom of these plants.
mayhap |Perhaps; peradventure. [Prov. or Dialectic]
mayhem |The maiming of a person by depriving him of the use of any of his members which are necessary for defense or protection. See Maim.
maying |The celebrating of May Day. \"He met her once a-Maying.\" Milton.
mayonnaise |A sauce compounded of raw yolks of eggs beaten up with olive oil to the consistency of a sirup, and seasoned with vinegar, pepper, salt, etc.; -- used in dressing salads, fish, etc. Also, a dish dressed with this sauce.
mayor |The chief magistrate of a city or borough; the chief officer of a municipal corporation. In some American cities there is a city court of which the major is chief judge.
mayoral |The conductir of a mule team; also, a head shepherd.
mayoralty |The office, or the term of office, of a mayor.
mayoress |The wife of a mayor.
mayorship |The office of a mayor.
maypole |A tall pole erected in an open place and wreathed with flowers, about which the rustic May-day sports were had.
maypop |The edible fruit of a passion flower, especially that of the North American Passiflora incarnata, an oval yellowish berry as large as a small apple.
mayweed |(a) A composite plant (Anthemis Cotula), having a strong odor; dog's fennel. It is a native of Europe, now common by the roadsides in the United States. (b) The feverfew.
mazama |A goatlike antelope (Haplocerus montanus) which inhabits the Rocky Mountains, frequenting the highest parts; -- called also mountain goat.
mazame |A goatlike antelope (Haplocerus montanus) which inhabits the Rocky Mountains, frequenting the highest parts; -- called also mountain goat.
mazard |A kind of small black cherry.\n\nThe jaw; the head or skull. [Obs.] Shak.\n\nTo knock on the head. [Obs.]
mazarine |Of or pertaining to Cardinal Mazarin, prime minister of France, 1643-1661. Mazarine Bible, the first Bible, and perhaps the first complete book, printed with movable metal types; -- printed by Gutenberg at Mentz, 1450-55; -- so called because a copy was found in the Mazarine Library, at Paris, about 1760. -- Mazarine blue, a deep blue color, named in honor of Cardinal Mazarin.\n\nMazarine blue.
mazdean |Of or pertaining to Ahura-Mazda, or Ormuzd, the beneficent deity in the Zoroastrian dualistic system; hence, Zoroastrian.
mazdeism |The Zoroastrian religion.
maze |1. A wild fancy; a confused notion. [Obs.] Chaucer. 2. Confusion of thought; perplexity; uncertainty; state of bewilderment. 3. A confusing and baffling network, as of paths or passages; an intricacy; a labyrinth. \"Quaint mazes on the wanton green.\" Shak. Or down the tempting maze of Shawford brook. Wordaworth. The ways of Heaven are dark and intricate, Puzzled with mazes, and perplexed with error. Addison. Syn. -- Labyrinth; intricacy. See Labyrinth.\n\nTo perplex greatly; to bewilder; to astonish and confuse; to amaze. South.\n\nTo be bewildered. [Obs.] Chaucer.
mazedness |The condition of being mazed; confusion; astonishment. [Obs.] Chaucer.
mazeful |Mazy. [Obs.] Sir P. Sidney.
mazer |A large drinking bowl; -- originally made of maple. [Obs.] Their brimful mazers to the feasting bring. Drayton.
mazily |In a mazy manner.
maziness |The state or quality of being mazy.
mazological |Of or pertaining to mazology.
mazologist |One versed in mazology or mastology.
mazology |Same as Mastology.
mazourka |A Polish dance, or the music which accompanies it, usually in 3-4 or 3-8 measure, with a strong accent on the second beat.
mazurka |A Polish dance, or the music which accompanies it, usually in 3-4 or 3-8 measure, with a strong accent on the second beat.
mazy |Perplexed with turns and windings; winding; intricate; confusing; perplexing; embarrassing; as, mazy error. Milton. To range amid the mazy thicket. Spenser. To run the ring, and trace the mazy round. Dryden.
me |One. See Men, pron. [Obs.] Chaucer.\n\nThe person speaking, regarded as an object; myself; a pronoun of the first person used as the objective and dative case of the pronoum I; as, he struck me; he gave me the money, or he gave the money to me; he got me a hat, or he got a hat for me. Note: In methinks, me is properly in the dative case, and the verb is impersonal, the construction being, it appears to me. In early use me was often placed before forms of the verb to be with an adjective; as, me were lief. Me rather had my heart might frrl your love Than my unpleased eye see your courtesy. Shak.
meach |To skulk; to cower. See Mich.
meacock |An uxorious, effeminate, or spiritless man. [Obs.] Johnson.
mead |1. A fermented drink made of water and honey with malt, yeast, etc.; metheglin; hydromel. Chaucer. 2. A drink composed of sirup of sarsaparilla or other flavoring extract, and water. It is sometimes charged with carbonic acid gas. [U. S.]\n\nA meadow. A mede All full of freshe flowers, white and reede. Chaucer. To fertile vales and dewy meads My weary, wandering steps he leads. Addison.
meadow |1. A tract of low or level land producing grass which is mown for hay; any field on which grass is grown for hay. 2. Low land covered with coarse grass or rank herbage near rives and in marshy places by the sea; as, the salt meadows near Newark Bay.\n\nOf or pertaining to a meadow; of the nature of a meadow; produced, growing, or living in, a meadow. \"Fat meadow ground.\" Milton. Note: For many names of plants compounded with meadow, see the particular word in the Vocabulary. Meadow beauty. (Bot.) Same as Deergrass. -- Meadow foxtail (Bot.), a valuable pasture grass (Alopecurus pratensis) resembling timothy, but with softer spikes. -- Meadow grass (Bot.), a name given to several grasses of the genus Poa, common in meadows, and of great value for nay and for pasture. See Grass. -- Meadow hay, a coarse grass, or true sedge, growing in uncultivated swamp or river meadow; -- used as fodder or bedding for cattle, packing for ice, etc. [Local, U. S.] -- Meadow hen. (Zoöl.) (a) The American bittern. See Stake-driver. (b) The American coot (Fulica). (c) The clapper rail. -- Meadow lark (Zoöl.), any species of Sturnella, a genus of American birds allied to the starlings. The common species (S. magna) has a yellow breast with a black crescent. -- Meadow mouse (Zoöl.), any mouse of the genus Arvicola, as the common American species A. riparia; -- called also field mouse, and field vole. -- Meadow mussel (Zoöl.), an American ribbed mussel (Modiola plicatula), very abundant in salt marshes. -- Meadow ore (Min.), bog-iron ore , a kind of limonite. -- Meadow parsnip. (Bot.) See under Parsnip. -- Meadow pink. (Bot.) See under Pink. -- Meadow pipit (Zoöl.), a small singing bird of the genus Anthus, as A. pratensis, of Europe. -- Meadow rue (Bot.), a delicate early plant, of the genus Thalictrum, having compound leaves and numerous white flowers. There are many species. -- Meadow saffron. (Bot.) See under Saffron. -- Meadow sage. (Bot.) See under Sage. -- Meadow saxifrage (Bot.), an umbelliferous plant of Europe (Silaus pratensis), somewhat resembling fennel. -- Meadow snipe (Zoöl.), the common or jack snipe.
meadowsweet |The name of several plants of the genus Spiræa, especially the white- or pink-flowered S. salicifolia, a low European and American shrub, and the herbaceous S. Ulmaria, which has fragrant white flowers in compound cymes.
meadowwort |The name of several plants of the genus Spiræa, especially the white- or pink-flowered S. salicifolia, a low European and American shrub, and the herbaceous S. Ulmaria, which has fragrant white flowers in compound cymes.
meadowy |Of or pertaining to meadows; resembling, or consisting of, meadow.
meager |1. Destitue of, or having little, flesh; lean. Meager were his looks; Sharp misery had worn him to the bones. Shak. 2. Destitute of richness, fertility, strength, or the like; defective in quantity, or poor in quality; poor; barren; scanty in ideas; wanting strength of diction or affluence of imagery. \"Meager soil.\" Dryden. Of secular habits and meager religious belief. I. Taylor. His education had been but meager. Motley. 3. (Min.)  Dry and harsh to the touch, as chalk. Syn. -- Thin; lean; lank; gaunt; starved; hungry; poor; emaciated; scanty; barren.\n\nTo make lean. [Obs.]
meagerly |Poorly; thinly.
meagerness |The state or quality of being meager; leanness; scantiness; barrenness.
meagre |1. Destitue of, or having little, flesh; lean. Meager were his looks; Sharp misery had worn him to the bones. Shak. 2. Destitute of richness, fertility, strength, or the like; defective in quantity, or poor in quality; poor; barren; scanty in ideas; wanting strength of diction or affluence of imagery. \"Meager soil.\" Dryden. Of secular habits and meager religious belief. I. Taylor. His education had been but meager. Motley. 3. (Min.)  Dry and harsh to the touch, as chalk. Syn. -- Thin; lean; lank; gaunt; starved; hungry; poor; emaciated; scanty; barren.\n\nTo make lean. [Obs.]\n\nA large European sciænoid fish (Sciæna umbra or S. aquila), having white bloodless flesh. It is valued as a food fish. [Written also maigre.]
meagrely |Poorly; thinly.
meagreness |The state or quality of being meager; leanness; scantiness; barrenness.
meak |A hook with a long handle. [Obs.] Tusser.
meaking |The process of picking out the oakum from the seams of a vessel which is to be recalked. Meaking iron (Naut.), the tool with which old oakum is picked out of a vessel's seams.
meal |A part; a fragment; a portion. [Obs.]\n\nThe portion of food taken at a particular time for the satisfaction of appetite; the quantity usually taken at one time with the purpose of satisfying hunger; a repast; the acas, the traveler has not eaten a good meal for a week; there was silence during the meal. What strange fish Hath made his meal on thee Shak.\n\n1. Grain (esp. maize, rye, or oats) that is coarsely ground and unbolted; also, a kind of flour made from beans, pease, etc.; sometimes, any flour, esp. if coarse. 2. Any substance that is coarsely pulverized like meal, but not granulated. Meal beetle (Zoöl.), the adult of the meal worm. See Meal worm, below. -- Meal moth (Zoöl.), a lepidopterous insect (Asopia farinalis), the larvæ of which feed upon meal, flour, etc. -- Meal worm (Zoöl.), the larva of a beetle (Tenebrio molitor) which infests granaries, bakehouses, etc., and is very injurious to flour and meal.\n\n1. To sprinkle with, or as with, meal. Shak. 2. To pulverize; as, mealed powder.
meal-mouthed |See Mealy-mouthed.
mealies |Maize or Indian corn; -- the common name in South Africa.
mealiness |The quality or state of being mealy.
mealtime |The usual time of eating a meal.
mealy |1. Having the qualities of meal; resembling meal; soft, dry, and friable; easily reduced to a condition resembling meal; as, a mealy potato. 2. Overspread with something that resembles meal; as, the mealy wings of an insect. Shak. Mealy bug (Zoöl.), a scale insect (Coccus adonidum, and related species), covered with a white powderlike substance. It is a common pest in hothouses.
mealy-mouthed |Using soft words; plausible; affectedly or timidly delicate of speech; unwilling to tell the truth in plain language. \"Mealy-mouthed philanthropies.\" Tennyson. She was a fool to be mealy-mouthed where nature speaks so plain. L'Estrange. -- Meal\"y-mouth`ness, n.
mean |1. To have in the mind, as a purpose, intention, etc.; to intend; to purpose; to design; as, what do you mean to do What mean ye by this service Ex. xii. 26. Ye thought evil against me; but God meant it unto good. Gen. 1. 20. I am not a Spaniard To say that it is yours and not to mean it. Longfellow. 2. To signify; to indicate; to import; to denote. What mean these seven ewe lambs Gen. xxi. 29. Go ye, and learn what that me. Matt. ix. 13.\n\nTo have a purpose or intention. [Rare, except in the phrase to mean well, or ill.] Shak.\n\n1. Destitute of distinction or eminence; common; low; vulgar; humble. \"Of mean parentage.\" Sir P. Sidney. The mean man boweth down, and the great man humbleth himself. Is. ii. 9. 2. Wanting dignity of mind; low-minded; base; destitute of honor; spiritless; as, a mean motive. Can you imagine I so mean could prove, To save my life by changing of my love Dryden. 3. Of little value or account; worthy of little or no regard; contemptible; despicable. The Roman legions and great Cæsar found Our fathers no mean foes. J. Philips. 4. Of poor quality; as, mean fare. 5. Penurious; stingy; close-fisted; illiberal; as, mean hospitality. Note: Mean is sometimes used in the formation of compounds, the sense of which is obvious without explanation; as, meanborn, mean-looking, etc. Syn. -- Base; ignoble; abject; beggarly; wretched; degraded; degenerate; vulgar; vile; servile; menial; spiritless; groveling; slavish; dishonorable; disgraceful; shameful; despicable; contemptible; paltry; sordid. See Base.\n\n1. Occupying a middle position; middle; being about midway between extremes. Being of middle age and a mean stature. Sir. P. Sidney. 2. Intermediate in excellence of any kind. According to the fittest style of lofty, mean, or lowly. Milton. 3. (Math.)  Average; having an intermediate value between two extremes, or between the several successive values of a variable quantity during one cycle of variation; as, mean distance; mean motion; mean solar day. Mean distance (of a planet from the sun) (Astron.), the average of the distances throughout one revolution of the planet, equivalent to the semi-major axis of the orbit. -- Mean error (Math. Phys.), the average error of a number of observations found by taking the mean value of the positive and negative errors without regard to sign. -- Mean-square error, or Error of the mean square (Math. Phys.), the error the square of which is the mean of the squares of all the errors; -- called also, especially by European writers, mean error. -- Mean line. (Crystallog.) Same as Bisectrix. -- Mean noon, noon as determined by mean time. -- Mean proportional (between two numbers) (Math.), the square root of their product. -- Mean sun, a fictitious sun supposed to move uniformly in the equator so as to be on the meridian each day at mean noon. -- Mean time, time as measured by an equable motion, as of a perfect clock, or as reckoned on the supposition that all the days of the year are of a mean or uniform length, in contradistinction from apparent time, or that actually indicated by the sun, and from sidereal time, or that measured by the stars.\n\n1. That which is mean, or intermediate, between two extremes of place, time, or number; the middle point or place; middle rate or degree; mediocrity; medium; absence of extremes or excess; moderation; measure. But to speak in a mean, the virtue of prosperity is temperance; the virtue of adversity is fortitude. Bacon. There is a mean in all things. Dryden. The extremes we have mentioned, between which the wellinstracted Christian holds the mean, are correlatives. I. Taylor. 2. (Math.)  A quantity having an intermediate value between several others, from which it is derived, and of which it expresses the resultant value; usually, unless otherwise specified, it is the simple average, formed by adding the quantities together and dividing by their number, which is called an arithmetical mean. A geometrical mean is the square root of the product of the quantities. 3. That through which, or by the help of which, an end is attained; something tending to an object desired; intermediate agency or measure; necessary condition or coagent; instrument. Their virtuous conversation was a mean to work the conversion of the heathen to Christ. Hooker. You may be able, by this mean, to review your own scientific acquirements. Coleridge. Philosophical doubt is not an end, but a mean. Sir W. Hamilton. Note: In this sense the word is usually employed in the plural form means, and often with a singular attribute or predicate, as if a singular noun. By this means he had them more at vantage. Bacon. What other means is left unto us. Shak. 4. pl.  Hence: Resources; property, revenue, or the like, considered as the condition of easy livelihood, or an instrumentality at command for effecting any purpose; disposable force or substance. Your means are very slender, and your waste is great. Shak. 5. (Mus.)  A part, whether alto or tenor, intermediate between the soprano and base; a middle part. [Obs.] The mean is drowned with your unruly base. Shak. 6. Meantime; meanwhile. [Obs.] Spenser. 7. A mediator; a go-between. [Obs.] Piers Plowman. He wooeth her by means and by brokage. Chaucer. By all means, certainly; without fail; as, go, by all means. -- By any means, in any way; possibly; at all. If by any means I might attain to the resurrection of the dead. Phil. iii. ll. -- By no means, or By no manner of means, not at all; certainly not; not in any degree. The wine on this side of the lake is by no means so good as that on the other. Addison.
mean-spirited |Of a mean spirit; base; groveling. -- Mean\"-spir`it*ed*ness, n.
meander |1. A winding, crooked, or involved course; as, the meanders of the veins and arteries. Sir M. Hale. While lingering rivers in meanders glide. Sir R. Blackmore. 2. A tortuous or intricate movement. 3. (Arch.)  Fretwork. See Fret.\n\nTo wind, turn, or twist; to make flexuous. Dryton.\n\nTo wind or turn in a course or passage; to be intricate. Five miles meandering with a mazy motion Through wood and dale the sacred river ran. Coleridge.
meandrian |Winding; having many turns.
meandrina |A genus of corals with meandering grooves and ridges, including the brain corals.
meandrous |Winding; flexuous.
meandry |Winding; flexuous.
meaning |1. That which is meant or intended; intent; purpose; aim; object; as, a mischievous meaning was apparent. If there be any good meaning towards you. Shak. 2. That which is signified, whether by act lanquage; signification; sence; import; as, the meaning of a hint. 3. Sense; power of thinking. [R.] -- Mean\"ing*less, a. -- Mean\"ing*ly, adv.
meanly |Moderately. [Obs.] A man meanly learned himself, but not meanly affectioned to set forward learning in others. Ascham.\n\nIn a mean manner; unworthily; basely; poorly; ungenerously. While the heaven-born child All meanly wrapt in the rude manger lies. Milton. Would you meanly thus rely On power you know I must obey Prior. We can not bear to have others think meanly of them [our kindred]. I. Watts.
meanness |1. The condition, or quality, of being mean; want of excellence; poorness; lowness; baseness; sordidness; stinginess. This figure is of a later date, by the meanness of the workmanship. Addison. 2. A mean act; as, to be guilty of meanness. Goldsmith.
meant |of Mean.
meantime |The intervening time; as, in the meantime (or mean time).\n\nIn the intervening time; during the interval.
meanwhile |The intervening time; as, in the meantime (or mean time).\n\nIn the intervening time; during the interval.
mear |A boundary. See Mere. [Obs.]
mease |Five hundred; as, a mease of herrings. [Prov. Eng.]
measelry |Leprosy. [Obs.] R. of Brunne.
measle |A leper. [Obs.] [Written also meazel, and mesel.] Wyclif (Matt. x. 8. ).\n\nA tapeworm larva. See 2d Measles, 4.
measled |Infected or spotted with measles, as pork. -- Mea\"sled*ness, n.
measles |Leprosy; also, a leper. [Obs.]\n\n1. (Med.)  A contagious febrile disorder commencing with catarrhal symptoms, and marked by the appearance on the third day of an eruption of distinct red circular spots, which coalesce in a crescentic form, are slightly raised above the surface, and after the fourth day of the eruption gradually decline; rubeola. Measles commences with the ordinary symptoms of fever. Am. Cyc. 2. (Veter. Med.)  A disease of cattle and swine in which the flesh is filled with the embryos of different varieties of the tapeworm. 3. A disease of trees. [Obs.] 4. pl. (Zoöl.)  The larvæ of any tapeworm (Tænia) in the cysticerus stage, when contained in meat. Called also bladder worms.
measly |1. Infected with measles. 2. (Zoöl.)  Containing larval tapeworms; -- said of pork and beef.
measurable |1. Capable of being measured; susceptible of mensuration or computation. 2. Moderate; temperate; not excessive. Of his diet measurable was he. Chaucer. -- Meas\"ur*a*ble*ness, n. -- Meas\"ur*a*bly, adv. Yet do it measurably, as it becometh Christians. Latimer.
measure |1. A standard of dimension; a fixed unit of quantity or extent; an extent or quantity in the fractions or multiples of which anything is estimated and stated; hence, a rule by which anything is adjusted or judged. 2. An instrument by means of which size or quantity is measured, as a graduated line, rod, vessel, or the like. False ells and measures be brought all clean adown. R. of Gloucester. 3. The dimensions or capacity of anything, reckoned according to some standard; size or extent, determined and stated; estimated extent; as, to take one's measure for a coat. The measure thereof is longer than the earth, and broader than the sea. Job xi. 9. 4. The contents of a vessel by which quantity is measured; a quantity determined by a standard; a stated or limited quantity or amount. It is like leaven which a woman took and hid in three measures of meal. Luke xiii. 21. 5. Extent or degree not excessive or beyong bounds; moderation; due restraint; esp. in the phrases, in measure; with measure; without or beyond measure. Hell hath enlarged herself, and opened her mouth without measure. Is. v. 14. 6. Determined extent, not to be exceeded; limit; allotted share, as of action, influence, ability, or the like; due proportion. Lord, make me to know mine end, and the measure of my days. Ps. xxxix. 4. 7. The quantity determined by measuring, especially in buying and selling; as, to give good or full measure. 8. Undefined quantity; extent; degree. There is a great measure of discretion to be used in the performance of confession. Jer. Taylor. 9. Regulated division of movement: (a) (Dancing) A regulated movement corresponding to the time in which the accompanying music is performed; but, especially, a slow and stately dane, like the minuet. (b) (Mus.) (1) The group or grouping of beats, caused by the regular recurrence of accented beats. (2)  The space between two bars. See Beat, Triple, Quadruple, Sextuple, Compound time, under Compound, a., and Figure. (c) (Poetry) The manner of ordering and combining the quantities, or long and short syllables; meter; rhythm; hence, a foot; as, a poem in iambic measure. 10. (Arith.)  A number which is contained in a given number a number of times without a remainder; as in the phrases, the common measure, the greatest common measure, etc., of two or more numbers. 11. A step or definite part of a progressive course or policy; a means to an end; an act designed for the accomplishment of an object; as, political measures; prudent measures; an inefficient measure. His majesty found what wrong measures he had taken in the conferring that trust, and lamented his error. Clarendon. 12. The act of measuring; measurement. Shak. 13. pl. (Geol.)  Beds or strata; as, coal measures; lead measures. Lineal, or Long, measure, measure of length; the measure of lines or distances. -- Liquid measure, the measure of liquids. -- Square measure, the measure of superficial area of surfaces in square units, as inches, feet, miles, etc. -- To have hard measure, to have harsh treatment meted out to one; to be harshly or oppressively dealt with. -- To take measures, to make preparations; to provide means. -- To take one's measure, to measure one, as for a garment; hence, to form an opinion of one's disposition, character, ability, etc. -- To tread a measure, to dance in the style so called. See 9 (a). Say to her, we have measured many miles To tread a measure with her on this grass. Shak.\n\n1. To ascertain by use of a measuring instrument; to compute or ascertain the extent, quantity, dimensions, or capacity of, by a certain rule or standard; to take the dimensions of; hence, to estimate; to judge of; to value; to appraise. Great are thy works, Jehovah, infinite Thy power! what thought can measure thee Milton. 2. To serve as the measure of; as, the thermometer measures changes of temperature. 3. To pass throught or over in journeying, as if laying off and determining the distance. A true devoted pilgrim is not weary To measure kingdoms with his feeble steps. Shak. 4. To adjust by a rule or standard. To secure a contented spirit, measure your desires by your fortunes, not your fortunes by your desires. Jer. Taylor. 5. To allot or distribute by measure; to set off or apart by measure; -- often with out or off. With what measure ye mete, it shall be measured to you again. Matt. vii. 2. That portion of eternity which is called time, measured out by the sun. Addison. To measure swords with one, to try another's skill in the use of the sword; hence, figuratively, to match one's abilities against an antagonist's.\n\n1. To make a measurement or measurements. 2. To result, or turn out, on measuring; as, the grain measures well; the pieces measure unequally. 3. To be of a certain size or quantity, or to have a certain length, breadth, or thickness, or a certain capacity according to a standard measure; as, cloth measures three fourths of a yard; a tree measures three feet in diameter.
measured |Regulated or determined by a standard; hence, equal; uniform; graduated; limited; moderated; as, he walked with measured steps; he expressed himself in no measured terms. -- Meas\"ured*ly, adv.
measureless |Without measure; unlimited; immeasurable. -- Meas\"ure*less*ness, n. Syn. -- Boundless; limitless; endless; unbounded; unlimited; vast; immense; infinite; immeasurable. Where Alf, the sacred river ran, Through canyons measureless to man, Down to a hidden sea. Coleridge
measurement |1. The act or result of measuring; mensuration; as, measurement is required. 2. The extent, size, capacity, amount. or quantity ascertained by measuring; as, its measurement is five acres.
measurer |One who measures; one whose occupation or duty is to measure commondities in market.
measuring |Used in, or adapted for, ascertaining measurements, or dividing by measure. Measuring faucet, a faucet which permits only a given quantity of liquid to pass each time it is opened, or one by means of which the liquid which passes can be measured. -- Measuring worm (Zoöl.), the larva of any geometrid moth. See Geometrid.
meat |1. Food, in general; anything eaten for nourishment, either by man or beast. Hence, the edible part of anything; as, the meat of a lobster, a nut, or an egg. Chaucer. And God said, Behold, I have given you every herb bearing seed, . . . to you it shall be for meat. Gen. i. 29. Every moving thing that liveth shall be meat for you. Gen. ix. 3. 2. The flesh of animals used as food; esp., animal muscle; as, a breakfast of bread and fruit without meat. 3. Specifically, dinner; the chief meal. [Obs.] Chaucer. Meat biscuit. See under Biscuit. -- Meat earth (Mining), vegetable mold. Raymond. -- Meat fly. (Zoöl.) See Flesh fly, under Flesh. -- Meat offering (Script.), an offering of food, esp. of a cake made of flour with salt and oil. -- To go to meat, to go to a meal. [Obs.] -- To sit at meat, to sit at the table in taking food.\n\nTo supply with food. [Obs.] Tusser. His shield well lined, his horses meated well. Chapman.
meatal |Of or pertaining to a meatus; resembling a meatus. Owen.
meated |1. Fed; fattened. [Obs.] Tusser. 2. Having (such) meat; -- used chiefly in composition; as, thick- meated.
meath |A sweet liquor; mead. [Obs.] Chaucer. Milton.
meathe |A sweet liquor; mead. [Obs.] Chaucer. Milton.
meatiness |Quality of being meaty.
meatless |Having no meat; without food. \"Leave these beggars meatless.\" Sir T. More.
meatoscope |A speculum for examining a natural passage, as the urethra.
meatotome |An instrument for cutting into the urethra so as to enlarge its orifice.
meatus |A natural passage or canal; as, the external auditory meatus. See Illust. of Ear.
meaty |Abounding in meat.
meaw |The sea mew. [Obs.] Spenser.\n\nSee Mew, to cry as a cat.
meawl |See Mewl, and Miaul.
meazel |See 1st Measle. [Obs.]
meazling |Falling in small drops; mistling; mizzing. [Obs.] Arbuthnot.
