artsman |A man skilled in an art or in arts. [Obs.] Bacon.
arum |A genus of plants found in central Europe and about the Mediterranean, having flowers on a spadix inclosed in a spathe. The cuckoopint of the English is an example. Our common arums the lords and ladies of village children. Lubbock. Note: The American \"Jack in the pulpit\" is now separated from the genus Arum.
arundelian |Pertaining to an Earl of Arundel; as, Arundel or Arundelian marbles, marbles from ancient Greece, bought by the Earl of Arundel in 1624.
arundiferous |Producing reeds or canes.
arundinaceous |Of or pertaining to a reed; resembling the reed or cane.
arundineous |Abounding with reeds; reedy.
aruspex |One of the class of diviners among the Etruscans and Romans, who foretold events by the inspection of the entrails of victims offered on the altars of the gods.
aruspice |A soothsayer of ancient Rome. Same as Aruspex. [Written also haruspice.]
aruspicy |Prognostication by inspection of the entrails of victims slain sacrifice.
arval |A funeral feast. [North of Eng.] Grose.
arvicole |A mouse of the genus Arvicola; the meadow mouse. There are many species.
aryan |1. One of a primitive people supposed to have lived in prehistoric times, in Central Asia, east of the Caspian Sea, and north of the Hindoo 2. The language of the original Aryans. [Written also Arian.]\n\nOf or pertaining to the people called Aryans; Indo-European; Indo-Germanic; as, the Aryan stock, the Aryan languages.
aryanize |To make Aryan (a language, or in language). K. Johnston.
arytenoid |Ladle-shaped; -- applied to two small cartilages of the larynx, and also to the glands, muscles, etc., connected with them. The cartilages are attached to the cricoid cartilage and connected with the vocal cords.
as |1. Denoting equality or likeness in kind, degree, or manner; like; similar to; in the same manner with or in which; in accordance with; in proportion to; to the extent or degree in which or to which; equally; no less than; as, ye shall be as gods, knowing good and evil; you will reap as you sow; do as you are bidden. His spiritual attendants adjured him, as he loved his soul, to emancipate his brethren. Macaulay. Note: As is often preceded by one of the antecedent or correlative words such, same, so, or as, in expressing an equality or comparison; as, give us such things as you please, and so long as you please, or as long as you please; he is not so brave as Cato; she is as amiable as she is handsome; come as quickly as possible. \"Bees appear fortunately to prefer the same colors as we do.\" Lubbock. As, in a preceding part of a sentence, has such or so to answer correlatively to it; as with the people, so with the priest. 2. In the idea, character, or condition of, -- limiting the view to certain attributes or relations; as, virtue considered as virtue; this actor will appear as Hamlet. The beggar is greater as a man, than is the man merely as a king. Dewey. 3. While; during or at the same time that; when; as, he trembled as he spoke. As I return I will fetch off these justices. Shak. 4. Because; since; it being the case that. As the population of Scotland had been generally trained to arms . . . they were not indifferently prepared. Sir W. Scott. [See Synonym under Because.] 5. Expressing concession. (Often approaching though in meaning). We wish, however, to avail ourselves of the interest, transient as it may be, which this work has excited. Macaulay. 6. That, introducing or expressing a result or consequence, after the correlatives so and such. [Obs.] I can place thee in such abject state, as help shall never find thee. Rowe. So as, so that. [Obs.] The relations are so uncertain as they require a great deal of examination. Bacon. 7. As if; as though. [Obs. or Poetic] He lies, as he his bliss did know. Waller. 8. For instance; by way of example; thus; -- used to introduce illustrative phrases, sentences, or citations. 9. Than. [Obs. & R.] The king was not more forward to bestow favors on them as they free to deal affronts to others their superiors. Fuller. 10. Expressing a wish. [Obs.] \"As have,\" i. e., may he have. Chaucer. As . . . as. See So . . . as, under So. -- As far as, to the extent or degree. \"As far as can be ascertained.\" Macaulay. -- As far forth as, as far as. [Obs.] Chaucer. -- As for, or As to, in regard to; with respect to. -- As good as, not less than; not falling short of. -- As good as one's word, faithful to a promise. -- As if, or As though, of the same kind, or in the same condition or manner, that it would be if. -- As it were (as if it were), a qualifying phrase used to apologize for or to relieve some expression which might be regarded as inappropriate or incongruous; in a manner. -- As now, just now. [Obs.] Chaucer. -- As swythe, as quickly as possible. [Obs.] Chaucer. -- As well, also; too; besides. Addison. -- As well as, equally with, no less than. \"I have understanding as well as you.\" Job xii. 3. -- As yet, until now; up to or at the present time; still; now.\n\nAn ace. [Obs.] Chaucer. Ambes-as, double aces.\n\n1. A Roman weight, answering to the libra or pound, equal to nearly eleven ounces Troy weight. It was divided into twelve ounces. 2. A Roman copper coin, originally of a pound weight (12 oz.); but reduced, after the first Punic war, to two ounces; in the second Punic war, to one ounce; and afterwards to half an ounce.
asa |An ancient name of a gum.
asafetida |The fetid gum resin or inspissated juice of a large umbelliferous plant (Ferula asafoetida) of Persia and the East India. It is used in medicine as an antispasmodic. [Written also assafoetida.]
asafoetida |The fetid gum resin or inspissated juice of a large umbelliferous plant (Ferula asafoetida) of Persia and the East India. It is used in medicine as an antispasmodic. [Written also assafoetida.]
asaphus |A genus of trilobites found in the Lower Silurian formation. See Illust. in Append.
asarabacca |An acrid herbaceous plant (Asarum Europæum), the leaves and roots of which are emetic and cathartic. It is principally used in cephalic snuffs.
asarone |A crystallized substance, resembling camphor, obtained from the Asarum Europæum; -- called also camphor of asarum.
asbestic |Of, pertaining to, or resembling asbestus; inconsumable; asbestine.
asbestiform |Having the form or structure of asbestus.
asbestine |Of or pertaining to asbestus, or partaking of its nature; incombustible; asbestic.
asbestos |A variety of amphibole or of pyroxene, occurring in long and delicate fibers, or in fibrous masses or seams, usually of a white, gray, or green-gray color. The name is also given to a similar variety of serpentine. Note: The finer varieties have been wrought into gloves and cloth which are incombustible. The cloth was formerly used as a shroud for dead bodies, and has been recommended for firemen's clothes. Asbestus in also employed in the manufacture of iron safes, for fireproof roofing, and for lampwicks. Some varieties are called amianthus. Dana.
asbestous |Asbestic.
asbestus |A variety of amphibole or of pyroxene, occurring in long and delicate fibers, or in fibrous masses or seams, usually of a white, gray, or green-gray color. The name is also given to a similar variety of serpentine. Note: The finer varieties have been wrought into gloves and cloth which are incombustible. The cloth was formerly used as a shroud for dead bodies, and has been recommended for firemen's clothes. Asbestus in also employed in the manufacture of iron safes, for fireproof roofing, and for lampwicks. Some varieties are called amianthus. Dana.
asbolin |A peculiar acrid and bitter oil, obtained from wood soot.
ascariasis |A disease, usually accompanied by colicky pains and diarrhea, caused by the presence of ascarids in the gastrointestinal canal.
ascarid |A parasitic nematoid worm, espec. the roundworm, Ascaris lumbricoides, often occurring in the human intestine and allied species found in domestic animals; also commonly applied to the pinworm (Oxyuris), often troublesome to children and aged persons.
ascend |1. To move upward; to mount; to go up; to rise; -- opposed to Ant: descend. Higher yet that star ascends. Bowring. I ascend unto my father and your father. John xx. 17. Note: Formerly used with up. The smoke of it ascended up to heaven. Addison. 2. To rise, in a figurative sense; to proceed from an inferior to a superior degree, from mean to noble objects, from particulars to generals, from modern to ancient times, from one note to another more acute, etc.; as, our inquiries ascend to the remotest antiquity; to ascend to our first progenitor. Syn. -- To rise; mount; climb; scale; soar; tower.\n\nTo go or move upward upon or along; to climb; to mount; to go up the top of; as, to ascend a hill, a ladder, a tree, a river, a throne.
ascendable |Capable of being ascended.
ascendance |Same as Ascendency.
ascendancy |Same as Ascendency.
ascendant |1. Ascent; height; elevation. [R.] Sciences that were then in their highest ascendant. Temple. 2. (Astrol.)  The horoscope, or that degree of the ecliptic which rises above the horizon at the moment of one's birth; supposed to have a commanding influence on a person's life and fortune. Note: Hence the phrases To be in the ascendant, to have commanding power or influence, and Lord of the ascendant, one who has possession of such power or influence; as, to rule, for a while, lord of the ascendant. Burke. 3. Superiority, or commanding influence; ascendency; as, one man has the ascendant over another. Chievres had acquired over the mind of the young monarch the ascendant not only of a tutor, but of a parent. Robertson. 4. An ancestor, or one who precedes in genealogy or degrees of kindred; a relative in the ascending line; a progenitor; -- opposed to descendant. Ayliffe.\n\n1. Rising toward the zenith; above the horizon. The constellation . . . about that time ascendant. Browne. 2. Rising; ascending. Ruskin. 3. Superior; surpassing; ruling. An ascendant spirit over him. South. The ascendant community obtained a surplus of wealth. J. S. Mill. Without some power of persuading or confuting, of defending himself against accusations, . . . no man could possibly hold an ascendent position. Grote.
ascendency |Governing or controlling influence; domination; power. An undisputed ascendency. Macaulay. Custom has an ascendency over the understanding. Watts. Syn. -- Control; authority; influence; sway; dominion; prevalence; domination.
ascendent |1. Rising toward the zenith; above the horizon. The constellation . . . about that time ascendant. Browne. 2. Rising; ascending. Ruskin. 3. Superior; surpassing; ruling. An ascendant spirit over him. South. The ascendant community obtained a surplus of wealth. J. S. Mill. Without some power of persuading or confuting, of defending himself against accusations, . . . no man could possibly hold an ascendent position. Grote.
ascendible |Capable of being ascended; climbable.
ascending |Rising; moving upward; as, an ascending kite. -- As*cend\"ing*ly, adv. Ascending latitude (Astron.), the increasing latitude of a planet. Ferguson. -- Ascending line (Geneol.), the line of relationship traced backward or through one's ancestors. One's father and mother, grandfather and grandmother, etc., are in the line direct ascending. -- Ascending node having, that node of the moon or a planet wherein it passes the ecliptic to proceed northward. It is also called the northern node. Herschel. -- Ascending series. (Math.) (a) A series arranged according to the ascending powers of a quantity. (b) A series in which each term is greater than the preceding. -- Ascending signs, signs east of the meridian.
ascension |1. The act of ascending; a rising; ascent. 2. Specifically: The visible ascent of our Savior on the fortieth day after his resurrection. (Acts i. 9.) Also, Ascension Day. 3. An ascending or arising, as in distillation; also that which arises, as from distillation. Vaporous ascensions from the stomach. Sir T. Browne. Ascension Day, the Thursday but one before Whitsuntide, the day on which commemorated our Savior's ascension into heaven after his resurrection; -- called also Holy Thursday. -- Right ascension (Astron.), that degree of the equinoctial, counted from the beginning of Aries, which rises with a star, or other celestial body, in a right sphere; or the arc of the equator intercepted between the first point of Aries and that point of the equator that comes to the meridian with the star; -- expressed either in degrees or in time. -- Oblique ascension (Astron.), an arc of the equator, intercepted between the first point of Aries and that point of the equator which rises together with a star, in an oblique sphere; or the arc of the equator intercepted between the first point of Aries and that point of the equator that comes to the horizon with a star. It is little used in modern astronomy.
ascensional |Relating to ascension; connected with ascent; ascensive; tending upward; as, the ascensional power of a balloon. Ascensional difference (Astron.), the difference between oblique and right ascension; -- used chiefly as expressing the difference between the time of the rising or setting of a body and six o'clock, or six hours from its meridian passage.
ascensive |1. Rising; tending to rise, or causing to rise. Owen. 2. (Gram.)  Augmentative; intensive. Ellicott.
ascent |1. The act of rising; motion upward; rise; a mounting upward; as, he made a tedious ascent; the ascent of vapors from the earth. To him with swift ascent he up returned. Milton. 2. The way or means by which one ascends. 3. An eminence, hill, or high place. Addison. 4. The degree of elevation of an object, or the angle it makes with a horizontal line; inclination; rising grade; as, a road has an ascent of five degrees.
ascertain |1. To render (a person) certain; to cause to feel certain; to make confident; to assure; to apprise. [Obs.] When the blessed Virgin was so ascertained. Jer. Taylor. Muncer assured them that the design was approved of by Heaven, and that the Almighty had in a dream ascertained him of its effects. Robertson. 2. To make (a thing) certain to the mind; to free from obscurity, doubt, or change; to make sure of; to fix; to determine. [Archaic] The divine law . . . ascertaineth the truth. Hooker. The very deferring [of his execution] shall increase and ascertain the condemnation. Jer. Taylor. The ministry, in order to ascertain a majority . . . persuaded the queen to create twelve new peers. Smollett. The mildness and precision of their laws ascertained the rule and measure of taxation. Gibbon. 3. To find out or learn for a certainty, by trial, examination, or experiment; to get to know; as, to ascertain the weight of a commodity, or the purity of a metal. He was there only for the purpose of ascertaining whether a descent on England was practicable. Macaulay.
ascertainable |That may be ascertained. -- As`cer*tain\"a*ble*ness, n. -- As`cer*tain\"a*bly, adv.
ascertainer |One who ascertains.
ascertainment |The act of ascertaining; a reducing to certainty; a finding out by investigation; discovery. The positive ascertainment of its limits. Burke.
ascessancy |See Acescency, Acescent. [Obs.]
ascessant |See Acescency, Acescent. [Obs.]
ascetic |Extremely rigid in self-denial and devotions; austere; severe. The stern ascetic rigor of the Temple discipline. Sir W. Scott.\n\nIn the early church, one who devoted himself to a solitary and contemplative life, characterized by devotion, extreme self-denial, and self-mortification; a hermit; a recluse; hence, one who practices extreme rigor and self-denial in religious things. I am far from commending those ascetics that take up their quarters in deserts. Norris. Ascetic theology, the science which treats of the practice of the theological and moral virtues, and the counsels of perfection. Am. Cyc.
asceticism |The condition, practice, or mode of life, of ascetics.
ascham |A sort of cupboard, or case, to contain bows and other implements of archery.
asci |See Ascus.
ascian |One of the Ascii.
ascians |Persons who, at certain times of the year, have no shadow at noon; -- applied to the inhabitants of the torrid zone, who have, twice a year, a vertical sun.
ascidian |One of the Ascidioidea, or in a more general sense, one of the Tunicata. Also as an adj.
ascidiarium |The structure which unites together the ascidiozooids in a compound ascidian.
ascidiform |Shaped like an ascidian.
ascidioidea |A group of Tunicata, often shaped like a two-necked bottle. The group includes, social, and compound species. The gill is a netlike structure within the oral aperture. The integument is usually leathery in texture. See Illustration in Appendix.
ascidiozooid |One of the individual members of a compound ascidian. See Ascidioidea.
ascidium |1. (Bot.)  A pitcher-shaped, or flask-shaped, organ or appendage of a plant, as the leaves of the pitcher plant, or the little bladderlike traps of the bladderwort (Utricularia). 2. pl. (Zoöl.)  A genus of simple ascidians, which formerly included most of the known species. It is sometimes used as a name for the Ascidioidea, or for all the Tunicata.
ascigerous |Having asci. Loudon.
ascii |Persons who, at certain times of the year, have no shadow at noon; -- applied to the inhabitants of the torrid zone, who have, twice a year, a vertical sun.
ascites |A collection of serous fluid in the cavity of the abdomen; dropsy of the peritoneum. Dunglison.
ascitic |Of, pertaining to, or affected by, ascites; dropsical.
ascitical |Of, pertaining to, or affected by, ascites; dropsical.
ascititious |Supplemental; not inherent or original; adscititious; additional; assumed. Homer has been reckoned an ascititious name. Pope.
asclepiad |A choriambic verse, first used by the Greek poet Asclepias, consisting of four feet, viz., a spondee, two choriambi, and an iambus.
asclepiadaceous |Of, pertaining to, or resembling, plants of the Milkweed family.
asclepias |A genus of plants including the milkweed, swallowwort, and some other species having medicinal properties. Asclepias butterfly (Zoöl.), a large, handsome, red and black butterfly (Danais Archippus), found in both hemispheres. It feeds on plants of the genus Asclepias.
ascocarp |In ascomycetous fungi, the spherical, discoid, or cup-shaped body within which the asci are collected, and which constitutes the mature fructification. The different forms are known in mycology under distinct names. Called also spore fruit.
ascococcus |A form of micrococcus, found in putrid meat infusions, occurring in peculiar masses, each of which is inclosed in a hyaline capsule and contains a large number of spherical micrococci.
ascomycetes |A large class of higher fungi distinguished by septate hyphæ, and by having their spores formed in asci, or spore sacs. It comprises many orders, among which are the yeasts, molds, mildews, truffles, morels, etc. -- As`co*my*ce\"tous (#), a.
ascospore |One of the spores contained in the asci of lichens and fungi. [See Illust. of Ascus.]
ascribable |Capable of being ascribed; attributable.
ascribe |1. To attribute, impute, or refer, as to a cause; as, his death was ascribed to a poison; to ascribe an effect to the right cause; to ascribe such a book to such an author. The finest [speech] that is ascribed to Satan in the whole poem. Addison. 2. To attribute, as a quality, or an appurtenance; to consider or allege to belong. Syn. -- To Ascribe, Attribute, Impute. Attribute denotes, 1. To refer some quality or attribute to a being; as, to attribute power to God. 2. To refer something to its cause or source; as, to attribute a backward spring to icebergs off the coast. Ascribe is used equally in both these senses, but involves a different image. To impute usually denotes to ascribe something doubtful or wrong, and hence, in general literature, has commonly a bad sense; as, to impute unworthy motives. The theological sense of impute is not here taken into view. More than good-will to me attribute naught. Spenser. Ascribes his gettings to his parts and merit. Pope. And fairly quit him of the imputed blame. Spenser.
ascript |See Adscript. [Obs.]
ascription |The act of ascribing, imputing, or affirming to belong; also, that which is ascribed.
ascriptitious |1. Ascribed. 2. Added; additional. [Obs.] An ascriptitious and supernumerary God. Farindon.
ascus |A small membranous bladder or tube in which are inclosed the seedlike reproductive particles or sporules of lichens and certain fungi.
asemia |Loss of power to express, or to understand, symbols or signs of thought.
asepsis |State of being aseptic; the methods or processes of asepticizing.
aseptic |Not liable to putrefaction; nonputrescent. -- n.  An aseptic substance.
asexual |Having no distinct; without sexual action; as, asexual reproduction. See Fission and Gemmation.
asexualization |The act or process of sterilizing an animal or human being, as by vasectomy.
asexually |In an asexual manner; without sexual agency.
ash |1. (Bot.)  A genus of trees of the Olive family, having opposite pinnate leaves, many of the species furnishing valuable timber, as the European ash (Fraxinus excelsior) and the white ash (F. Americana). Prickly ash (Zanthoxylum Americanum) and Poison ash (Rhus venenata) are shrubs of different families, somewhat resembling the true ashes in their foliage. -- Mountain ash. See Roman tree, and under Mountain. 2. The tough, elastic wood of the ash tree. Note: Ash is used adjectively, or as the first part of a compound term; as, ash bud, ash wood, ash tree, etc.\n\nsing. of Ashes. Note: Ash is rarely used in the singular except in connection with chemical or geological products; as, soda ash, coal which yields a red ash, etc., or as a qualifying or combining word; as, ash bin, ash heap, ash hole, ash pan, ash pit, ash-grey, ash-colored, pearlash, potash. Bone ash, burnt powered; bone earth. -- Volcanic ash. See under Ashes.\n\nTo strew or sprinkle with ashes. Howell.
ash wednesday |The first day of Lent; -- so called from a custom in the Roman Catholic church of putting ashes, on that day, upon the foreheads of penitents.
ash-colored |Of the color of ashes; a whitish gray or brownish gray.
ash-fire |A low fire used in chemical operations.
ash-furnace |A furnace or oven for fritting materials for glass making.
ash-oven |A furnace or oven for fritting materials for glass making.
ashame |To shame. [R.] Barrow.
ashamed |Affected by shame; abashed or confused by guilt, or a conviction or consciousness of some wrong action or impropriety. \"I am ashamed to beg.\" Wyclif. All that forsake thee shall be ashamed. Jer. xvii. 13. I began to be ashamed of sitting idle. Johnson. Enough to make us ashamed of our species. Macaulay. An ashamed person can hardly endure to meet the gaze of those present. Darwin. Note: Ashamed seldom precedes the noun or pronoun it qualifies. By a Hebraism, it is sometimes used in the Bible to mean disappointed, or defeated.
ashamedly |Bashfully. [R.]
ashantee |A native or an inhabitant of Ashantee in Western Africa.\n\nOf or pertaining to Ashantee.
ashen |Of or pertaining to the ash tree. \"Ashen poles.\" Dryden.\n\nConsisting of, or resembling, ashes; of a color between brown and gray, or white and gray. The ashen hue of age. Sir W. Scott.\n\nobs. pl. for Ashes. Chaucer.
ashery |1. A depository for ashes. 2. A place where potash is made.
ashes |1. The earthy or mineral particles of combustible substances remaining after combustion, as of wood or coal. 2. Specifically: The remains of the human body when burnt, or when \"returned to dust\" by natural decay. Their martyred blood and ashes sow. Milton. The coffins were broken open. The ashes were scattered to the winds. Macaulay. 3. The color of ashes; deathlike paleness. The lip of ashes, and the cheek of flame. Byron. In dust and ashes, In sackcloth and ashes, with humble expression of grief or repentance; -- from the method of mourning in Eastern lands. -- Volcanic ashes, or Volcanic ash, the loose, earthy matter, or small fragments of stone or lava, ejected by volcanoes.
ashine |Shining; radiant.
ashlar |1. (Masonry) (a) Hewn or squared stone; also, masonry made of squared or hewn stone. Rough ashlar, a block of freestone as brought from the quarry. When hammer-dressed it is known as common ashlar. Knight. (b) In the United States especially, a thin facing of squared and dressed stone upon a wall of rubble or brick. Knight.
ashlaring |1. The act of bedding ashlar in mortar. 2. Ashlar when in thin slabs and made to serve merely as a case to the body of the wall. Brande & C. 3. (Carp.)  The short upright pieces between the floor beams and rafters in garrets. See Ashlar, 2.
ashler |1. (Masonry) (a) Hewn or squared stone; also, masonry made of squared or hewn stone. Rough ashlar, a block of freestone as brought from the quarry. When hammer-dressed it is known as common ashlar. Knight. (b) In the United States especially, a thin facing of squared and dressed stone upon a wall of rubble or brick. Knight.
ashlering |1. The act of bedding ashlar in mortar. 2. Ashlar when in thin slabs and made to serve merely as a case to the body of the wall. Brande & C. 3. (Carp.)  The short upright pieces between the floor beams and rafters in garrets. See Ashlar, 2.
ashore |On shore or on land; on the land adjacent to water; to the shore; to the land; aground (when applied to a ship); -- sometimes opposed to aboard or afloat. Here shall I die ashore. Shak. I must fetch his necessaries ashore. Shak.
ashtoreth |The principal female divinity of the Phoenicians, as Baal was the principal male divinity. W. Smith.
ashweed |Goutweed.
ashy |1. Pertaining to, or composed of, ashes; filled, or strewed with, ashes. 2. Ash-colored; whitish gray; deadly pale. Shak. Ashy pale, pale as ashes. Shak.
asian |Of or pertaining to Asia; Asiatic. \"Asian princes.\" Jer. Taylor. -- n.  An Asiatic.
asiarch |One of the chiefs or pontiffs of the Roman province of Asia, who had the superintendence of the public games and religious rites. Milner.
asiatic |Of or pertaining to Asia or to its inhabitants. -- n.  A native, or one of the people, of Asia.
asiaticism |Something peculiar to Asia or the Asiatics.
aside |1. On, or to, one side; out of a straight line, course, or direction; at a little distance from the rest; out of the way; apart. Thou shalt set aside that which is full. 2 Kings iv. 4. But soft! but soft! aside: here comes the king. Shak. The flames were blown aside. Dryden. 2. Out of one's thoughts; off; away; as, to put aside gloomy thoughts. \"Lay aside every weight.\" Heb. xii. 1. 3. So as to be heard by others; privately. Then lords and ladies spake aside. Sir W. Scott. To set aside (Law), to annul or defeat the effect or operation of, by a subsequent decision of the same or of a superior tribunal; to declare of no authority; as, to set aside a verdict or a judgment.\n\nSomething spoken aside; as, a remark made by a stageplayer which the other players are not supposed to hear.
asilus |A genus of large and voracious two-winged flies, including the bee killer and robber fly.
asinego |A stupid fellow. [Obs.] Shak.
asinine |Of or belonging to, or having the qualities of, the ass, as stupidity and obstinacy. \"Asinine nature.\" B. Jonson. \"Asinine feast.\" Milton.
asininity |The quality of being asinine; stupidity combined with obstinacy.
asiphonata |A group of bivalve mollusks destitute of siphons, as the oyster; the asiphonate mollusks.
asiphonate |Destitute of a siphon or breathing tube; -- said of many bivalve shells. -- n.  An asiphonate mollusk.
asiphonea |A group of bivalve mollusks destitute of siphons, as the oyster; the asiphonate mollusks.
asiphonida |A group of bivalve mollusks destitute of siphons, as the oyster; the asiphonate mollusks.
asitia |Want of appetite; loathing of food.
ask |1. To request; to seek to obtain by words; to petition; to solicit; - - often with of, in the sense of from, before the person addressed. Ask counsel, we pray thee, of God. Judg. xviii. 5. If ye abide in me, and my words abide in you, ye shall ask what ye will, and it shall be done unto you. John xv. 7. 2. To require, demand, claim, or expect, whether by way of remuneration or return, or as a matter of necessity; as, what price do you ask Ask me never so much dowry. Gen. xxxiv. 12. To whom men have committed much, of him they will ask the more. Luke xii. 48. An exigence of state asks a much longer time to conduct a design to maturity. Addison. 3. To interrogate or inquire of or concerning; to put a question to or about; to question. He is of age; ask him: he shall speak for himself. John ix. 21. He asked the way to Chester. Shak. 4. To invite; as, to ask one to an entertainment. 5. To publish in church for marriage; -- said of both the banns and the persons. Fuller. Syn. -- To beg; request; seek; petition; solicit; entreat; beseech; implore; crave; require; demand; claim; exhibit; inquire; interrogate. See Beg.\n\n1. To request or petition; -- usually folllowed by for; as, to ask for bread. Ask, and it shall be given you. Matt. vii. 7. 2. To make inquiry, or seek by request; -- sometimes followed by after. Wherefore . . . dost ask after my name Gen. xxxii. 29.\n\nA water newt. [Scot. & North of Eng.]
askance |Sideways; obliquely; with a side glance; with disdain, envy, or suspicion. They dart away; they wheel askance. Beattie. My palfrey eyed them askance. Landor. Both . . . were viewed askance by authority. Gladstone.\n\nTo turn aside. [Poet.] O, how are they wrapped in with infamies That from their own misdeeds askance their eyes! Shak.
askant |Sideways; obliquely; with a side glance; with disdain, envy, or suspicion. They dart away; they wheel askance. Beattie. My palfrey eyed them askance. Landor. Both . . . were viewed askance by authority. Gladstone.
asker |One who asks; a petitioner; an inquirer. Shak.\n\nAn ask; a water newt. [Local Eng.]
askew |Awry; askance; asquint; oblique or obliquely; -- sometimes indicating scorn, or contempt, or entry. Spenser.
asking |1. The act of inquiring or requesting; a petition; solicitation. Longfellow. 2. The publishing of banns.
aslake |To mitigate; to moderate; to appease; to abate; to diminish. [Archaic] Chaucer.
aslant |Toward one side; in a slanting direction; obliquely. [The shaft] drove through his neck aslant. Dryden.\n\nIn a slanting direction over; athwart. There is a willow grows aslant a brook. Shak.
asleep |1. In a state of sleep; in sleep; dormant. Fast asleep the giant lay supine. Dryden. By whispering winds soon lulled asleep. Milton. 2. In the sleep of the grave; dead. Concerning them which are asleep . . . sorrow not, even as others which have no hope. 1 Thess. iv. 13. 3. Numbed, and, usually, tingling. Udall. Leaning long upon any part maketh it numb, and, as we call it, asleep. Bacon.
aslope |Slopingly; aslant; declining from an upright direction; sloping. \"Set them not upright, but aslope.\" Bacon.
aslug |Sluggishly. [Obs.] Fotherby.
asmear |Smeared over. Dickens.
asmonean |Of or pertaining to the patriotic Jewish family to which the Maccabees belonged; Maccabean; as, the Asmonean dynasty. [Written also Asmonæan.]\n\nOne of the Asmonean family. The Asmoneans were leaders and rulers of the Jews from 168 to 35 b. c.
asoak |Soaking.
asomatous |Without a material body; incorporeal. Todd.
asonant |Not sounding or sounded. [R.] C. C. Felton.
asp |Same as Aspen. \"Trembling poplar or asp.\" Martyn.\n\nA small, hooded, poisonous serpent of Egypt and adjacent countries, whose bite is often fatal. It is the Naja haje. The name is also applied to other poisonous serpents, esp. to Vipera aspis of southern Europe. See Haje.\n\nOne of several species of poplar bearing this name, especially the Populus tremula, so called from the trembling of its leaves, which move with the slightest impulse of the air.
aspalathus |(a) A thorny shrub yielding a fragrant oil. Ecclus. xxiv. 15. (b) A genus of plants of the natural order Leguminosæ. The species are chiefly natives of the Cape of Good Hope.
asparagine |A white, nitrogenous, crystallizable substance, C4H8N2O3+H2O, found in many plants, and first obtained from asparagus. It is believed to aid in the disposition of nitrogenous matter throughout the plant; -- called also altheine.
asparaginous |Pertaining or allied to, or resembling, asparagus; having shoots which are eaten like asparagus; as, asparaginous vegetables.
asparagus |1. (Bot.)  A genus of perennial plants belonging to the natural order Liliaceæ, and having erect much branched stems, and very slender branchlets which are sometimes mistaken for leaves. Asparagus racemosus is a shrubby climbing plant with fragrant flowers. Specifically: The Asparagus officinalis, a species cultivated in gardens. 2. The young and tender shoots of A. officinalis, which form a valuable and well-known article of food. Note: This word was formerly pronounced sparrowgrass; but this pronunciation is now confined exclusively to uneducated people. Asparagus beetle (Zoöl.), a small beetle (Crioceris asparagi) injurious to asparagus.
aspartic |Pertaining to, or derived, asparagine; as, aspartic acid.
aspect |1. The act of looking; vision; gaze; glance. [R.] \"The basilisk killeth by aspect.\" Bacon. His aspect was bent on the ground. Sir W. Scott. 2. Look, or particular appearance of the face; countenance; mien; air. \"Serious in aspect.\" Dryden. [Craggs] with aspect open shall erect his head. Pope. 3. Appearance to the eye or the mind; look; view. \"The aspect of affairs.\" Macaulay. The true aspect of a world lying in its rubbish. T. Burnet. 4. Position or situation with regard to seeing; that position which enables one to look in a particular direction; position in relation to the points of the compass; as, a house has a southern aspect, that is, a position which faces the south. 5. Prospect; outlook. [Obs.] This town affords a good aspect toward the hill from whence we descended. Evelyn. 6. (Astrol.)  The situation of planets or stars with respect to one another, or the angle formed by the rays of light proceeding from them and meeting at the eye; the joint look of planets or stars upon each other or upon the earth. Milton. Note: The aspects which two planets can assume are five; sextile, 7. (Astrol.)  The influence of the stars for good or evil; as, an ill aspect. Shak. The astrologers call the evil influences of the stars evil aspects. Bacon. Aspect of a plane (Geom.), the direction of the plane.\n\nTo behold; to look at. [Obs.]
aspect ratio |The ratio of the long to the short side of an aëroplane, aërocurve, or wing.
aspectable |Capable of being; visible. \"The aspectable world.\" Ray. \"Aspectable stars.\" Mrs. Browning.
aspectant |Facing each other.
aspected |Having an aspect. [Obs.] B. Jonson.
aspection |The act of viewing; a look. [Obs.]
aspen |One of several species of poplar bearing this name, especially the Populus tremula, so called from the trembling of its leaves, which move with the slightest impulse of the air.\n\nOf or pertaining to the aspen, or resembling it; made of aspen wood. Nor aspen leaves confess the gentlest breeze. Gay.
asper |Rough; rugged; harsh; bitter; stern; fierce. [Archaic] \"An asper sound.\" Bacon.\n\nThe rough breathing; a mark placed over an initial vowel sound or over h before it; thus hws, pronounced h, hrj'twr, pronounced hra\\'b6t.\n\nA Turkish money of account (formerly a coin), of little value; the 120th part of a piaster.
asperate |To make rough or uneven. The asperated part of its surface. Boyle.
asperation |The act of asperating; a making or becoming rough. Bailey.
asperges |(a) The service or ceremony of sprinkling with holy water. (b) The brush or instrument used in sprinkling holy water; an aspergill.
aspergill |1. The brush used in the Roman Catholic church for sprinkling holy water on the people. [Also written aspergillus.] 2. (Zoöl.)  See Wateringpot shell.
aspergilliform |Resembling the aspergillum in form; as, an aspergilliform stigma. Gray.
aspergillum |1. The brush used in the Roman Catholic church for sprinkling holy water on the people. [Also written aspergillus.] 2. (Zoöl.)  See Wateringpot shell.
asperifoliate |Having rough leaves. Note: By some applied to the natural order now called Boraginaceæ or borageworts.
asperifolious |Having rough leaves. Note: By some applied to the natural order now called Boraginaceæ or borageworts.
asperity |1. Roughness of surface; unevenness; -- opposed to smoothness. \"The asperities of dry bodies.\" Boyle. 2. Roughness or harshness of sound; that quality which grates upon the ear; raucity. 3. Roughness to the taste; sourness; tartness. 4. Moral roughness; roughness of manner; severity; crabbedness; harshness; -- opposed to mildness. \"Asperity of character.\" Landor. It is no very cynical asperity not to confess obligations where no benefit has been received. Johnson. 5. Sharpness; disagreeableness; difficulty. The acclivities and asperities of duty. Barrow. Syn. -- Acrimony; moroseness; crabbedness; harshness; sourness; tartness. See Acrimony.
aspermatous |Aspermous.
aspermous |Destitute of seeds; aspermatous.
asperne |To spurn; to despise. [Obs.] Sir T. More.
asperous |Rough; uneven. Boyle.
asperse |1. To sprinkle, as water or dust, upon anybody or anything, or to besprinkle any one with a liquid or with dust. Heywood. 2. To bespatter with foul reports or false and injurious charges; to tarnish in point of reputation or good name; to slander or calumniate; as, to asperse a poet or his writings; to asperse a man's character. With blackest crimes aspersed. Cowper. Syn. -- To slander; defame; detract from; calumniate; vilify. -- To Asperse, Defame, Slander, Calumniate. These words have in common the idea of falsely assailing the character of another. To asperse is figuratively to cast upon a character hitherto unsullied the imputation of blemishes or faults which render it offensive or loathsome. To defame is to detract from a man's honor and reputation by charges calculated to load him with infamy. Slander (etymologically the same as scandal) and calumniate, from the Latin, have in common the sense of circulating reports to a man's injury from unworthy or malicious motives. Men asperse their neighbors by malignant insinuations; they defame by advancing charges to blacken or sully their fair fame; they slander or calumniate by spreading injurious reports which are false, or by magnifying slight faults into serious errors or crimes.
aspersed |1. (Her.)  Having an indefinite number of small charges scattered or strewed over the surface. Cussans. 2. Bespattered; slandered; calumniated. Motley.
asperser |One who asperses; especially, one who vilifies another.
aspersion |1. A sprinkling, as with water or dust, in a literal sense. Behold an immersion, not and aspersion. Jer. Taylor. 2. The spreading of calumniations reports or charges which tarnish reputation, like the bespattering of a body with foul water; calumny. Every candid critic would be ashamed to cast wholesale aspersions on the entire body of professional teachers. Grote. Who would by base aspersions blot thy virtue. Dryden.
aspersive |Tending to asperse; defamatory; slanderous. -- As*pers\"ive*ly, adv.
aspersoir |An aspergill.
aspersorium |1. The stoup, basin, or other vessel for holy water in Roman Catholic churches. 2. A brush for sprinkling holy water; an aspergill.
asphalt |1. Mineral pitch, Jews' pitch, or compact native bitumen. It is brittle, of a black or brown color and high luster on a surface of fracture; it melts and burns when heated, leaving no residue. It occurs on the surface and shores of the Dead Sea, which is therefore called Asphaltites, or the Asphaltic Lake. It is found also in many parts of Asia, Europe, and America. See Bitumen. 2. A composition of bitumen, pitch, lime, and gravel, used for forming pavements, and as a water-proof cement for bridges, roofs, etc.; asphaltic cement. Artificial asphalt is prepared from coal tar, lime, sand, etc. Asphalt stone, Asphalt rock, a limestone found impregnated with asphalt.\n\nTo cover with asphalt; as, to asphalt a roof; asphalted streets.
asphalte |Asphaltic mastic or cement. See Asphalt, 2.
asphaltic |Pertaining to, of the nature of, or containing, asphalt; bituminous. \"Asphaltic pool.\" \"Asphaltic slime.\" Milton.
asphaltite |Asphaltic.\n\nAsphaltic. Bryant.
asphaltum |1. Mineral pitch, Jews' pitch, or compact native bitumen. It is brittle, of a black or brown color and high luster on a surface of fracture; it melts and burns when heated, leaving no residue. It occurs on the surface and shores of the Dead Sea, which is therefore called Asphaltites, or the Asphaltic Lake. It is found also in many parts of Asia, Europe, and America. See Bitumen. 2. A composition of bitumen, pitch, lime, and gravel, used for forming pavements, and as a water-proof cement for bridges, roofs, etc.; asphaltic cement. Artificial asphalt is prepared from coal tar, lime, sand, etc. Asphalt stone, Asphalt rock, a limestone found impregnated with asphalt.
asphaltus |See Asphalt.
asphodel |A general name for a plant of the genus Asphodelus. The asphodels are hardy perennial plants, several species of which are cultivated for the beauty of their flowers. Note: The name is also popularly given to species of other genera. The asphodel of the early English and French poets was the daffodil. The asphodel of the Greek poets is supposed to be the Narcissus poeticus. Dr. Prior. Pansies, and violets, and asphodel. Milton.
asphyctic |Pertaining to asphyxia.
asphyxia |Apparent death, or suspended animation; the condition which results from interruption of respiration, as in suffocation or drowning, or the inhalation of irrespirable gases.
asphyxial |Of or relating to asphyxia; as, asphyxial phenomena.
asphyxiate |To bring to a state of asphyxia; to suffocate. Note: [Used commonly in the past pple.]
asphyxiated |In a state of asphyxia; suffocated.
asphyxiation |The act of causing asphyxia; a state of asphyxia.
asphyxied |In a state of asphyxia; suffocated.
asphyxy |Apparent death, or suspended animation; the condition which results from interruption of respiration, as in suffocation or drowning, or the inhalation of irrespirable gases.
aspic |1. The venomous asp. [Chiefly poetic] Shak. Tennyson. 2. A piece of ordnance carrying a 12 pound shot. [Obs.]\n\nA European species of lavender (Lavandula spica), which produces a volatile oil. See Spike.\n\nA savory meat jelly containing portions of fowl, game, fish, hard boiled eggs, etc. Thackeray.
aspidobranchia |A group of Gastropoda, with limpetlike shells, including the abalone shells and keyhole limpets.
aspirant |Aspiring.\n\nOne who aspires; one who eagerly seeks some high position or object of attainment. In consequence of the resignations . . . the way to greatness was left clear to a new set of aspirants. Macaulay.
aspirate |To pronounce with a breathing, an aspirate, or an h sound; as, we aspirate the words horse and house; to aspirate a vowel or a liquid consonant.\n\n1. A sound consisting of, or characterized by, a breath like the sound of h; the breathing h or a character representing such a sound; an aspirated sound. 2. A mark of aspiration used in Greek; the asper, or rough breathing. Bentley. 3. An elementary sound produced by the breath alone; a surd, or nonvocal consonant; as, f, th in thin, etc.\n\nPronounced with the h sound or with audible breath. But yet they are not aspirate, i. e., with such an aspiration as h. Holder.
aspirated |Pronounced with the h sound or with audible breath. But yet they are not aspirate, i. e., with such an aspiration as h. Holder.
aspiration |1. The act of aspirating; the pronunciation of a letter with a full or strong emission of breath; an aspirated sound. If aspiration be defined to be an impetus of breathing. Wilkins. 2. The act of breathing; a breath; an inspiration. 3. The act of aspiring of a ardently desiring; strong wish; high desire. \"Aspirations after virtue.\" Johnson. Vague aspiration after military renown. Prescott.
aspirator |1. (Chem.)  An apparatus for passing air or gases through or over certain liquids or solids, or for exhausting a closed vessel, by means of suction. 2. (Med.)  An instrument for the evacuation of the fluid contents of tumors or collections of blood.
aspiratory |Of or pertaining to breathing; suited to the inhaling of air
aspire |1. To desire with eagerness; to seek to attain something high or great; to pant; to long; -- followed by to or after, and rarely by at; as, to aspire to a crown; to aspire after immorality. Aspiring to be gods, if angels fell; Aspiring to be angels, men rebel. Pope. 2. To rise; to ascend; to tower; to soar. My own breath still foments the fire, Which flames as high as fancy can aspire. Waller.\n\nTo aspire to; to long for; to try to reach; to mount to. [Obs.] That gallant spirit hath aspired the clouds. Shak.\n\nAspiration. [Obs.] Chapman.
aspirement |Aspiration. [Obs.]
aspirer |One who aspires.
aspirin |A white crystalline compound of acetyl and salicylic acid used as a drug for the salicylic acid liberated from it in the intestines.
aspiring |That aspires; as, an Aspiring mind. -- As*pir\"ing*ly, adv. -- As*pir\"ing*ness, n.
aspish |Pertaining to, or like, an asp.
asportation |The felonious removal of goods from the place where they were deposited. Note: It is adjudged to be larceny, though the goods are not carried from the house or apartment. Blackstone.
asprawl |Sprawling.
asquat |Squatting.
asquint |With the eye directed to one side; not in the straight line of vision; obliquely; awry, so as to see distortedly; as, to look asquint.
ass |1. (Zoöl.)  A quadruped of the genus Equus (E. asinus), smaller than the horse, and having a peculiarly harsh bray and long ears. The tame or domestic ass is patient, slow, and sure-footed, and has become the type of obstinacy and stupidity. There are several species of wild asses which are swift-footed. 2. A dull, heavy, stupid fellow; a dolt. Shak. Asses' Bridge. Etym: [L. pons asinorum.] The fifth proposition of the first book of Euclid, \"The angles at the base of an isosceles triangle are equal to one another.\" [Sportive] \"A schoolboy, stammering out his Asses' Bridge.\" F. Harrison. -- To make an ass of one's self, to do or say something very foolish or absurd.
assafoetida |Same as Asafetida.
assagai |A spear used by tribes in South Africa as a missile and for stabbing, a kind of light javelin.
assai |A direction equivalent to very; as, adagio assai, very slow.
assail |1. To attack with violence, or in a vehement and hostile manner; to assault; to molest; as, to assail a man with blows; to assail a city with artillery. No rude noise mine ears assailing. Cowper. No storm can now assail The charm he wears within. Keble. 2. To encounter or meet purposely with the view of mastering, as an obstacle, difficulty, or the like. The thorny wilds the woodmen fierce assail. Pope. 3. To attack morally, or with a view to produce changes in the feelings, character, conduct, existing usages, institutions; to attack by words, hostile influence, etc.; as, to assail one with appeals, arguments, abuse, ridicule, and the like. The papal authority . . . assailed. Hallam. They assailed him with keen invective; they assailed him with still keener irony. Macaulay. Syn. -- To attack; assault; invade; encounter; fall upon. See Attack.
assailable |Capable of being assailed.
assailant |Assailing; attacking. Milton.\n\nOne who, or that which, assails, attacks, or assaults; an assailer. An assailant of the church. Macaulay.
assailer |One who assails.
assailment |The act or power of assailing; attack; assault. [R.] His most frequent assailment was the headache. Johnson.
assamar |The peculiar bitter substance, soft or liquid, and of a yellow color, produced when meat, bread, gum, sugar, starch, and the like, are roasted till they turn brown.
assamese |Of or pertaining to Assam, a province of British India, or to its inhabitants. -- n. sing. & pl.  A native or natives of Assam.
assapan |The American flying squirrel (Pteromys volucella).
assapanic |The American flying squirrel (Pteromys volucella).
assart |1. (Old Law)  The act or offense of grubbing up trees and bushes, and thus destroying the tickets or coverts of a forest. Spelman. Cowell. 2. A piece of land cleared of trees and bushes, and fitted for cultivation; a clearing. Ash. Assart land, forest land cleared of woods and brush.\n\nTo grub up, as trees; to commit an assart upon; as, to assart land or trees. Ashmole.
assassin |One who kills, or attempts to kill, by surprise or secret assault; one who treacherously murders any one unprepared for defense.\n\nTo assassinate. [Obs.] Stillingfleet.
assassinate |1. To kill by surprise or secret assault; to murder by treacherous violence. Help, neighbors, my house is broken open by force, and I am ravished, and like to be assassinated. Dryden. 2. To assail with murderous intent; hence, by extended meaning, to maltreat exceedingly. [Archaic] Your rhymes assassinate our fame. Dryden. Such usage as your honorable lords Afford me, assassinated and betrayed. Milton. Syn. -- To kill; murder; slay. See Kill.\n\n1. An assassination, murder, or murderous assault. [Obs.] If I had made an assassinate upon your father. B. Jonson. 2. An assassin. [Obs.] Dryden.
assassination |The act of assassinating; a killing by treacherous violence.
assassinator |An assassin.
assassinous |Murderous. Milton.
assastion |Roasting. [Obs.] Sir T. Browne.
assault |1. A violent onset or attack with physical means, as blows, weapons, etc.; an onslaught; the rush or charge of an attacking force; onset; as, to make assault upon a man, a house, or a town. The Spanish general prepared to renew the assault. Prescott. Unshaken bears the assault Of their most dreaded foe, the strong southwest. Wordsworth. 2. A violent onset or attack with moral weapons, as words, arguments, appeals, and the like; as, to make an assault on the prerogatives of a prince, or on the constitution of a government. Clarendon. 3. (Law)  An apparently violent attempt, or willful offer with force or violence, to do hurt to another; an attempt or offer to beat another, accompanied by a degree of violence, but without touching his person, as by lifting the fist, or a cane, in a threatening manner, or by striking at him, and missing him. If the blow aimed takes effect, it is a battery. Blackstone. Wharton. Practically, however, the word assault is used to include the battery. Mozley & W. Syn. -- Attack; invasion; incursion; descent; onset; onslaught; charge; storm.\n\n1. To make an assault upon, as by a sudden rush of armed men; to attack with unlawful or insulting physical violence or menaces. Insnared, assaulted, overcome, led bound. Milton. 2. To attack with moral means, or with a view of producing moral effects; to attack by words, arguments, or unfriendly measures; to assail; as, to assault a reputation or an administration. Before the gates, the cries of babes newborn, . . . Assault his ears. Dryden. Note: In the latter sense, assail is more common. Syn. -- To attack; assail; invade; encounter; storm; charge. See Attack.
assaultable |Capable of being assaulted.
assaulter |One who assaults, or violently attacks; an assailant. E. Hall.
assay |1. Trial; attempt; essay. [Obs.] Chaucer. I am withal persuaded that it may prove much more easy in the assay than it now seems at distance. Milton. 2. Examination and determination; test; as, an assay of bread or wine. [Obs.] This can not be, by no assay of reason. Shak. 3. Trial by danger or by affliction; adventure; risk; hardship; state of being tried. [Obs.] Through many hard assays which did betide. Spenser. 4. Tested purity or value. [Obs.] With gold and pearl of rich assay. Spenser. 5. (Metallurgy)  The act or process of ascertaining the proportion of a particular metal in an ore or alloy; especially, the determination of the proportion of gold or silver in bullion or coin. 6. The alloy or metal to be assayed. Ure. Assay and essay are radically the same word; but modern usage has appropriated assay chiefly to experiments in metallurgy, and essay to intellectual and bodily efforts. See Essay.] Note: Assay is used adjectively or as the first part of a compound; as, assay balance, assay furnace. Assay master, an officer who assays or tests gold or silver coin or bullion. -- Assay ton, a weight of 29.1662\/3 grams.\n\n1. To try; to attempt; to apply. [Obs. or Archaic] To-night let us assay our plot. Shak. Soft words to his fierce passion she assayed. Milton. 2. To affect. [Obs.] When the heart is ill assayed. Spenser. 3. To try tasting, as food or drink. [Obs.] 4. To subject, as an ore, alloy, or other metallic compound, to chemical or metallurgical examination, in order to determine the amount of a particular metal contained in it, or to ascertain its composition.\n\nTo attempt, try, or endeavor. [Archaic. In this sense essay is now commonly used.] She thrice assayed to speak. Dryden.
assay pound |A small standard weight used in assaying bullion, etc., sometimes equaling 0.5 gram, but varying with the assayer.
assay ton |A weight of 29.166 + grams used in assaying, for convenience. Since it bears the same relation to the milligram that a ton of 2000 avoirdupois pounds does to the troy ounce, the weight in milligrams of precious metal obtained from an assay ton of ore gives directly the number of ounces to the ton.
assayable |That may be assayed.
assayer |One who assays. Specifically: One who examines metallic ores or compounds, for the purpose of determining the amount of any particular metal in the same, especially of gold or silver.
assaying |The act or process of testing, esp. of analyzing or examining metals and ores, to determine the proportion of pure metal.
asse |A small foxlike animal (Vulpes cama) of South Africa, valued for its fur.
assecuration |Assurance; certainty. [Obs.]
assecure |To make sure or safe; to assure. [Obs.] Hooker.
assecution |An obtaining or acquiring. [Obs.] Ayliffe.
assegai |A spear used by tribes in South Africa as a missile and for stabbing, a kind of light javelin.\n\nSame as Assagai.
assemblage |1. The act of assembling, or the state o In sweet assemblage every blooming grace. Fenton. 2. A collection of individuals, or of individuals, or of particular things; as, a political assemblage; an assemblage of ideas. Syn. -- Company; group; collection; concourse; gathering; meeting; convention. Assemblage, Assembly. An assembly consists only of persons; an assemblage may be composed of things as well as persons, as, an assemblage of incoherent objects. Nor is every assemblage of persons an assembly; since the latter term denotes a body who have met, and are acting, in concert for some common end, such as to hear, to deliberate, to unite in music, dancing, etc. An assemblage of skaters on a lake, or of horse jockeys at a race course, is not an assembly, but might be turned into one by collecting into a body with a view to discuss and decide as to some object of common interest.
assemblance |1. Resemblance; likeness; appearance. [Obs.] Care I for the . . . stature, bulk, and big assemblance of a man Shak. 2. An assembling; assemblage. [Obs.] To weete [know] the cause of their assemblance. Spenser.
assemble |To collect into one place or body; to bring or call together; to convene; to congregate. Thither he assembled all his train. Milton. All the men of Israel assembled themselves. 1 Kings viii. 2.\n\nTo meet or come together, as a number of individuals; to convene; to congregate. Dryden. The Parliament assembled in November. W. Massey.\n\nTo liken; to compare. [Obs.] Bribes may be assembled to pitch. Latimer.
assembler |One who assembles a number of individuals; also, one of a number assembled.
assembly |1. A company of persons collected together in one place, and usually for some common purpose, esp. for deliberation and legislation, for worship, or for social entertainment. 2. A collection of inanimate objects. [Obs.] Howell. 3. (Mil.)  A beat of the drum or sound of the bugle as a signal to troops to assemble. Note: In some of the United States, the legislature, or the popular branch of it, is called the Assembly, or the General Assembly. In the Presbyterian Church, the General Assembly is the highest ecclesiastical tribunal, composed of ministers and ruling elders delegated from each presbytery; as, the General Assembly of the Presbyterian Church in the United States, or of Scotland. Assembly room, a room in which persons assemble, especially for dancing. -- Unlawful assembly (Law), a meeting of three or more persons on a common plan, in such a way as to cause a reasonable apprehension that they will disturb the peace tumultuously. -- Westminster Assembly, a convocation, consisting chiefly of divines, which, by act of Parliament, assembled July 1, 1643, and remained in session some years. It framed the \"Confession of Faith,\" the \"Larger Catechism,\" and the \"Shorter Catechism,\" which are still received as authority by Presbyterians, and are substantially accepted by Congregationalists. Syn. -- See Assemblage.
assemblyman |A member of an assembly, especially of the lower branch of a state legislature.
assent |To admit a thing as true; to express one's agreement, acquiescence, concurrence, or concession. Who informed the governor . . . And the Jews also assented, saying that these things were so. Acts xxiv. 9. The princess assented to all that was suggested. Macaulay. Syn. -- To yield; agree; acquiesce; concede; concur.\n\nThe act of assenting; the act of the mind in admitting or agreeing to anything; concurrence with approval; consent; agreement; acquiescence. Faith is the assent to any proposition, on the credit of the proposer. Locke. The assent, if not the approbation, of the prince. Prescott. Too many people read this ribaldry with assent and admiration. Macaulay. Royal assent, in England, the assent of the sovereign to a bill which has passed both houses of Parliament, after which it becomes law. Syn. -- Concurrence; acquiescence; approval; accord. -- Assent, Consent. Assent is an act of the understanding, consent of the will or feelings. We assent to the views of others when our minds come to the same conclusion with theirs as to what is true, right, or admissible. We consent when there is such a concurrence of our will with their desires and wishes that we decide to comply with their requests. The king of England gives his assent, not his consent, to acts of Parliament, because, in theory at least, he is not governed by personal feelings or choice, but by a deliberate, judgment as to the common good. We also use assent in cases where a proposal is made which involves but little interest or feeling. A lady may assent to a gentleman's opening the window; but if he offers himself in marriage, he must wait for her consent.
assentation |Insincere, flattering, or obsequious assent; hypocritical or pretended concurrence. Abject flattery and indiscriminate assentation degrade as much as indiscriminate contradiction and noisy debate disgust. Ld. Chesterfield.
assentator |An obsequious; a flatterer. [R.]
assentatory |Flattering; obsequious. [Obs.] -- As*sent\"a*to*ri*ly, adv. [Obs.]
assenter |One who assents.
assentient |Assenting.
assenting |Giving or implying assent. -- As*sent\"ing*ly, adv.
assentive |Giving assent; of the nature of assent; complying. -- As*sent\"ive*ness, n.
assentment |Assent; agreement. [Obs.]
assert |1. To affirm; to declare with assurance, or plainly and strongly; to state positively; to aver; to asseverate. Nothing is more shameful . . . than to assert anything to be done without a cause. Ray. 2. To maintain; to defend. [Obs. or Archaic] That . . . I may assert Eternal Providence, And justify the ways of God to men. Milton. I will assert it from the scandal. Jer. Taylor. 3. To maintain or defend, as a cause or a claim, by words or measures; to vindicate a claim or title to; as, to assert our rights and liberties. To assert one's self, to claim or vindicate one's rights or position; to demand recognition. Syn. -- To affirm; aver; asseverate; maintain; protest; pronounce; declare; vindicate. -- To Assert, Affirm, Maintain, Vindicate. To assert is to fasten to one's self, and hence to claim. It is, therefore, adversative in its nature. We assert our rights and privileges, or the cause of tree institutions, as against opposition or denial. To affirm is to declare as true. We assert boldly; we affirm positively. To maintain is to uphold, and insist upon with earnestness, whatever we have once asserted; as, to maintain one's cause, to maintain an argument, to maintain the ground we have taken. To vindicate is to use language and measures of the strongest kind, in defense of ourselves and those for whom we act. We maintain our assertions by adducing proofs, facts, or arguments; we are ready to vindicate our rights or interests by the utmost exertion of our powers.
asserter |One who asserts; one who avers pr maintains; an assertor. The inflexible asserter of the rights of the church. Milman.
assertion |1. The act of asserting, or that which is asserted; positive declaration or averment; affirmation; statement asserted; position advanced. There is a difference between assertion and demonstration. Macaulay. 2. Maintenance; vindication; as, the assertion of one's rights or prerogatives.
assertive |Positive; affirming confidently; affirmative; peremptory. In a confident and assertive form. Glanvill. As*sert\"ive*ly, adv. -- As*sert\"ive*ness, n.
assertor |One who asserts or avers; one who maintains or vindicates a claim or a right; an affirmer, supporter, or vindicator; a defender; an asserter. The assertors of liberty said not a word. Macaulay. Faithful assertor of thy country's cause. Prior.
assertorial |Asserting that a thing is; -- opposed to problematical and apodeictical.
assertory |Affirming; maintaining. Arguments . . . assertory, not probatory. Jer. Taylor. An assertory, not a promissory, declaration. Bentham. A proposition is assertory, when it enounces what is known as actual. Sir W. Hamilton.
assess |1. To value; to make a valuation or official estimate of for the purpose of taxation. 2. To apportion a sum to be paid by (a person, a community, or an estate), in the nature of a tax, fine, etc.; to impose a tax upon (a person, an estate, or an income) according to a rate or apportionment. 3. To determine and impose a tax or fine upon (a person, community, estate, or income); to tax; as, the club assessed each member twenty- five cents. 4. To fix or determine the rate or amount of. This sum is assessed and raised upon individuals by commissioners in the act. Blackstone.
assessable |Liable to be assessed or taxed; as, assessable property.
assessee |One who is assessed.
assession |A sitting beside or near.
assessment |1. The act of assessing; the act of determining an amount to be paid; as, an assessment of damages, or of taxes; an assessment of the members of a club. 2. A valuation of property or profits of business, for the purpose of taxation; such valuation and an adjudging of the proper sum to be levied on the property; as, an assessment of property or an assessment on property. Note: An assessment is a valuation made by authorized persons according to their discretion, as opposed to a sum certain or determined by law. It is a valuation of the property of those who are to pay the tax, for the purpose of fixing the proportion which each man shall pay. Blackstone. Burrill. 3. The specific sum levied or assessed. 4. An apportionment of a subscription for stock into successive installments; also, one of these installments (in England termed a \"call\"). [U. S.]
assessor |1. One appointed or elected to assist a judge or magistrate with his special knowledge of the subject to be decided; as legal assessors, nautical assessors. Mozley & W. 2. One who sits by another, as next in dignity, or as an assistant and adviser; an associate in office. Whence to his Son, The assessor of his throne, he thus began. Milton. With his ignorance, his inclinations, and his fancy, as his assessors in judgment. I. Taylor. 3. One appointed to assess persons or property for the purpose of taxation. Bouvier.
assessorial |Of or pertaining to an assessor, or to a court of assessors. Coxe.
assessorship |The office or function of an assessor.
asset |Any article or separable part of one's assets.
assets |1. (Law) (a) Property of a deceased person, subject by law to the payment of his debts and legacies; -- called assets because sufficient to render the executor or administrator liable to the creditors and legatees, so far as such goods or estate may extend. Story. Blackstone. (b) Effects of an insolvent debtor or bankrupt, applicable to the payment of debts. 2. The entire property of all sorts, belonging to a person, a corporation, or an estate; as, the assets of a merchant or a trading association; -- opposed to liabilities. Note: In balancing accounts the assets are put on the Cr. side and the debts on the Dr. side.
assever |See Asseverate. [Archaic]
asseverate |To affirm or aver positively, or with solemnity. Syn. -- To affirm; aver; protest; declare. See Affirm.
asseveration |The act of asseverating, or that which is asseverated; positive affirmation or assertion; solemn declaration. Another abuse of the tongue I might add, -- vehement asseverations upon slight and trivial occasions. Ray.
asseverative |Characterized by asseveration; asserting positively.
asseveratory |Asseverative.
assibilate |To make sibilant; to change to a sibilant. J. Peile.
assibilation |Change of a non-sibilant letter to a sibilant, as of -tion to - shun, duke to ditch.
assidean |One of a body of devoted Jews who opposed the Hellenistic Jews, and supported the Asmoneans.
assident |Usually attending a disease, but not always; as, assident signs, or symptoms.
assiduate |Unremitting; assiduous. [Obs.] \"Assiduate labor.\" Fabyan.
assiduity |1. Constant or close application or attention, particularly to some business or enterprise; diligence. I have, with much pains and assiduity, qualified myself for a nomenclator. Addison. 2. Studied and persevering attention to a person; -- usually in the plural.
assiduous |1. Constant in application or attention; devoted; attentive; unremitting. She grows more assiduous in her attendance. Addison. 2. Performed with constant diligence or attention; unremitting; persistent; as, assiduous labor. To weary him with my assiduous cries. Milton. Syn. -- Diligent; attentive; sedulous; unwearied; unintermitted; persevering; laborious; indefatigable. As*sid\"u*ous*ly, adv. -- As*sid\"u*ous*ness, n.
assiege |To besiege. [Obs.] \"Assieged castles.\" Spenser.\n\nA siege. [Obs.] Chaucer.
assientist |A shareholder of the Assiento company; one of the parties to the Assiento contract. Bancroft.
assiento |A contract or convention between Spain and other powers for furnishing negro slaves for the Spanish dominions in America, esp. the contract made with Great Britain in 1713.
assign |1. To appoint; to allot; to apportion; to make over. In the order I assign to them. Loudon. The man who could feel thus was worthy of a better station than that in which his lot had been assigned. Southey. He assigned to his men their several posts. Prescott. 2. To fix, specify, select, or designate; to point out authoritatively or exactly; as, to assign a limit; to assign counsel for a prisoner; to assign a day for trial. All as the dwarf the way to her assigned. Spenser. It is not easy to assign a period more eventful. De Quincey. 3. (Law)  To transfer, or make over to another, esp. to transfer to, and vest in, certain persons, called assignees, for the benefit of creditors. To assign dower, to set out by metes and bounds the widow's share or portion in an estate. Kent.\n\nA thing pertaining or belonging to something else; an appurtenance. [Obs.] Six French rapiers and poniards, with their assigns, as girdles, hangers, and so. Shak.\n\nA person to whom property or an interest is transferred; as, a deed to a man and his heirs and assigns.
assignability |The quality of being assignable.
assignable |Capable of being assigned, allotted, specified, or designated; as, an assignable note or bill; an assignable reason; an assignable quantity.
assignat |One of the notes, bills, or bonds, issued as currency by the revolutionary government of France (1790-1796), and based on the security of the lands of the church and of nobles which had been appropriated by the state.
assignation |1. The act of assigning or allotting; apportionment. This order being taken in the senate, as touching the appointment and assignation of those provinces. Holland. 2. An appointment of time and place for meeting or interview; -- used chiefly of love interviews, and now commonly in a bad sense. While nymphs take treats, or assignations give. Pope. 3. A making over by transfer of title; assignment. House of assignation, a house in which appointments for sexual intercourse are fulfilled.
assignee |(a) A person to whom an assignment is made; a person appointed or deputed by another to do some act, perform some business, or enjoy some right, privilege, or property; as, an assignee of a bankrupt. See Assignment (c). An assignee may be by special appointment or deed, or be created by jaw; as an executor. Cowell. Blount. (b) pl.  In England, the persons appointed, under a commission of bankruptcy, to manage the estate of a bankrupt for the benefit of his creditors.
assigner |One who assigns, appoints, allots, or apportions.
assignment |1. An allotting or an appointment to a particular person or use; or for a particular time, as of a cause or causes in court. 2. (Law) (a) A transfer of title or interest by writing, as of lease, bond, note, or bill of exchange; a transfer of the whole of some particular estate or interest in lands. (b) The writing by which an interest is transferred. (c) The transfer of the property of a bankrupt to certain persons called assignees, in whom it is vested for the benefit of creditors. Assignment of dower, the setting out by metes and bounds of the widow's thirds or portion in the deceased husband's estate, and allotting it to her. Note: Assignment is also used in law as convertible with specification; assignment of error in proceedings for review being specification of error; and assignment of perjury or fraud in indictment being specifications of perjury or fraud.
assignor |An assigner; a person who assigns or transfers an interest; as, the assignor of a debt or other chose in action.
assimilability |The quality of being assimilable. [R.] Coleridge.
assimilable |That may be assimilated; that may be likened, or appropriated and incorporated.
assimilate |1. To bring to a likeness or to conformity; to cause a resemblance between. Sir M. Hale. To assimilate our law to the law of Scotland. John Bright. Fast falls a fleecy; the downy flakes Assimilate all objects. Cowper. 2. To liken; to compa [R.] 3. To appropriate and transform or incorporate into the substance of the assimilating body; to absorb or appropriate, as nourishment; as, food is assimilated and converted into organic tissue. Hence also animals and vegetables may assimilate their nourishment. Sir I. Newton. His mind had no power to assimilate the lessons. Merivale.\n\n1. To become similar or like something else. [R.] 2. To change and appropriate nourishment so as to make it a part of the substance of the assimilating body. Aliment easily assimilated or turned into blood. Arbuthnot. 3. To be converted into the substance of the assimilating body; to become incorporated; as, some kinds of food assimilate more readily than others. I am a foreign material, and cannot assimilate with the church of England. J. H. Newman.
assimilation |1. The act or process of assimilating or bringing to a resemblance, likeness, or identity; also, the state of being so assimilated; as, the assimilation of one sound to another. To aspire to an assimilation with God. Dr. H. More. The assimilation of gases and vapors. Sir J. Herschel. 2. (Physiol.)  The conversion of nutriment into the fluid or solid substance of the body, by the processes of digestion and absorption, whether in plants or animals. Not conversing the body, not repairing it by assimilation, but preserving it by ventilation. Sir T. Browne. Note: The term assimilation has been limited by some to the final process by which the nutritive matter of the blood is converted into the substance of the tissues and organs.
assimilative |Tending to, or characterized by, assimilation; that assimilates or causes assimilation; as, an assimilative process or substance.
assimilatory |Tending to assimilate, or produce assimilation; as, assimilatory organs.
assimulate |1. To feign; to counterfeit; to simulate; to resemble. [Obs.] Blount. 2. To assimilate. [Obs.] Sir M. Hale.
assimulation |Assimilation. [Obs.] Bacon.
assinego |A stupid fellow. [Obs.] Shak.\n\nSee Asinego.
assish |Resembling an ass; asinine; stupid or obstinate. Such . . . appear to be of the assich kind . . . Udall.
assist |To give support to in some undertaking or effort, or in time of distress; to help; to aid; to succor. Assist me, knight. I am undone! Shak. Syn. -- To help; aid; second; back; support; relieve; succor; befriend; sustain; favor. See Help.\n\n1. To lend aid; to help. With God not parted from him, as was feared, But favoring and assisting to the end. Milton. 2. To be present as a spectator; as, to assist at a public meeting. [A Gallicism] Gibbon. Prescott.
assistance |1. The act of assisting; help; aid; furtherance; succor; support. Without the assistance of a mortal hand. Shak. 2. An assistant or helper; a body of helpers. [Obs.] Wat Tyler [was] killed by valiant Walworth, the lord mayor of London, and his assistance, . . . John Cavendish. Fuller. 3. Persons present. [Obs. or a Gallicism]
assistant |1. Helping; lending aid or support; auxiliary. Genius and learning . . . are mutually and greatly assistant to each other. Beattie. 2. (Mil.)  Of the second grade in the staff of the army; as, an assistant surgeon. [U.S.] Note: In the English army it designates the third grade in any particular branch of the staff. Farrow.\n\n1. One who, or that which, assists; a helper; an auxiliary; a means of help. Four assistants who his labor share. Pope. Rhymes merely as assistants to memory. Mrs. Chapone. 2. An attendant; one who is present. Dryden.
assistantly |In a manner to give aid. [R.]
assister |An assistant; a helper.
assistful |Helpful.
assistive |Lending aid, helping.
assistless |Without aid or help. [R.] Pope.
assistor |A assister.
assithment |See Assythment. [Obs.]
assize |1. An assembly of knights and other substantial men, with a bailiff or justice, in a certain place and at a certain time, for public business. [Obs.] 2. (Law) (a) A special kind of jury or inquest. (b) A kind of writ or real action. (c) A verdict or finding of a jury upon such writ. (d) A statute or ordinance in general. Specifically: (1) A statute regulating the weight, measure, and proportions of ingredients and the price of articles sold in the market; as, the assize of bread and other provisions; (2) A statute fixing the standard of weights and measures. (e) Anything fixed or reduced to a certainty in point of time, number, quantity, quality, weight, measure, etc.; as, rent of assize. Glanvill. Spelman. Cowell. Blackstone. Tomlins. Burrill. Note: [This term is not now used in England in the sense of a writ or real action, and seldom of a jury of any kind, but in Scotch practice it is still technically applied to the jury in criminal cases. Stephen. Burrill. Erskine.] (f) A court, the sitting or session of a court, for the trial of processes, whether civil or criminal, by a judge and jury. Blackstone. Wharton. Encyc. Brit. (g) The periodical sessions of the judges of the superior courts in every county of England for the purpose of administering justice in the trial and determination of civil and criminal cases; -- usually in the plural. Brande. Wharton. Craig. Burrill. (h) The time or place of holding the court of assize; -- generally in the plural, assizes. 3. Measure; dimension; size. [In this sense now corrupted into size.] An hundred cubits high by just assize. Spenser. [Formerly written, as in French, assise.]\n\n1. To assess; to value; to rate. [Obs.] Gower. 2. To fix the weight, measure, or price of, by an ordinance or regulation of authority. [Obs.]
assizer |An officer who has the care or inspection of weights and measures, etc.
assizor |A juror.
assober |To make or keep sober. [Obs.] Gower.
associability |The quality of being associable, or capable of association; associableness. \"The associability of feelings.\" H. Spencer.
associable |1. Capable of being associated or joined. We know feelings to be associable only by the proved ability of one to revive another. H. Spencer. 2. Sociable; companionable. [Obs.] 3. (Med.)  Liable to be affected by sympathy with other parts; -- said of organs, nerves, muscles, etc. The stomach, the most associable of all the organs of the animal body. Med. Rep.
associableness |Associability.
associate |1. To join with one, as a friend, companion, partner, or confederate; as, to associate others with . 2. To join or connect; to combine in acting; as, particles of gold associated with other substances. 3. To connect or place together in thought. He succeeded in associating his name inseparably with some names which will last an long as our language. Macaulay. 4. To accompany; to keep company with. [Obs.] Friends should associate friends in grief and woe. Shak.\n\n1. To unite in company; to keep company, implying intimacy; as, congenial minds are disposed to associate. 2. To unite in action, or to be affected by the action of a different part of the body. E. Darwin.\n\n1. Closely connected or joined with some other, as in interest, purpose, employment, or office; sharing responsibility or authority; as, an associate judge. While I descend . . . to my associate powers. Milton. 2. Admitted to some, but not to all, rights and privileges; as, an associate member. 3. (Physiol.)  Connected by habit or sympathy; as, associate motions, such as occur sympathetically, in consequence of preceding motions. E. Darwin.\n\n1. A companion; one frequently in company with another, implying intimacy or equality; a mate; a fellow. 2. A partner in interest, as in business; or a confederate in a league. 3. One connected with an association or institution without the full rights or privileges of a regular member; as, an associate of the Royal Academy. 4. Anything closely or usually connected with another; an concomitant. The one [idea] no sooner comes into the understanding, than its associate appears with it. Locke. Syn. -- Companion; mate; fellow; friend; ally; partner; coadjutor; comrade; accomplice.
associated |Joined as a companion; brought into association; accompanying; combined. Associated movements (Physiol.), consensual movements which accompany voluntary efforts without our consciousness. Dunglison.
associateship |The state of an associate, as in Academy or an office.
association |1. The act of associating, or state of being associated; union; connection, whether of persons of things. \"Some . . . bond of association.\" Hooker. Self-denial is a kind of holy association with God. Boyle. 2. Mental connection, or that which is mentally linked or associated with a thing. Words . . . must owe their powers association. Johnson. Why should . . . the holiest words, with all their venerable associations, be profaned Coleridge. 3. Union of persons in a company or society for some particular purpose; as, the American Association for the Advancement of Science; a benevolent association. Specifically, as among the Congregationalists, a society, consisting of a number of ministers, generally the pastors of neighboring churches, united for promoting the interests of religion and the harmony of the churches. Association of ideas (Physiol.), the combination or connection of states of mind or their objects with one another, as the result of which one is said to be revived or represented by means of the other. The relations according to which they are thus connected or revived are called the law of association. Prominent among them are reckoned the relations of time and place, and of cause and effect. Porter.
associational |1. Of or pertaining to association, or to an association. 2. Pertaining to the theory held by the associationists.
associationism |The doctrine or theory held by associationists.
associationist |One who explains the higher functions and relations of the soul by the association of ideas; e. g., Hartley, J. C. Mill.
associative |Having the quality of associating; tending or leading to association; as, the associative faculty. Hugh Miller.
associator |An associate; a confederate or partner in any scheme. How Pennsylvania's air agrees with Quakers, And Carolina's with associators. Dryden.
assoil |1. To set free; to release. [Archaic] Till from her hands the spright assoiled is. Spenser. 2. To solve; to clear up. [Obs.] Any child might soon be able to assoil this riddle. Bp. Jewel. 3. To set free from guilt; to absolve. [Archaic] Acquitted and assoiled from the guilt. Dr. H. More. Many persons think themselves fairly assoiled, because they are . . . not of scandalous lives. Jer. Taylor. 4. To expiate; to atone for. [Archaic] Spenser. Let each act assoil a fault. E. Arnold. 5. To remove; to put off. [Obs.] She soundly slept, and careful thoughts did quite assoil. Spenser.\n\nTo soil; to stain. [Obs. or Poet.] Beau. & Fl. Ne'er assoil my cobwebbed shield. Wordsworth.
assoilment |Act of assoiling, or state of being assoiled; absolution; acquittal.\n\nA soiling; defilement.
assoilyie |To absolve; to acquit by sentence of court. God assoilzie him for the sin of bloodshed. Sir W. Scott.
assoilzie |To absolve; to acquit by sentence of court. God assoilzie him for the sin of bloodshed. Sir W. Scott.
assonance |1. Resemblance of sound. \"The disagreeable assonance of Steevens. 2. (Pros.)  A peculiar species of rhyme, in which the last accented vowel and those which follow it in one word correspond in sound with the vowels of another word, while the consonants of the two words are unlike in sound; as, calamo and platano, baby and chary. The assonance is peculiar to the Spaniard. Hallam. 3. Incomplete correspondence. Assonance between facts seemingly remote. Lowell.
assonant |1. Having a resemblance of sounds. 2. (Pros.)  Pertaining to the peculiar species of rhyme called assonance; not consonant.
assonantal |Assonant.
assonate |To correspond in sound.
assort |1. To separate and distribute into classes, as things of a like kind, nature, or quality, or which are suited to a like purpose; to classify; as, to assort goods. Note: [Rarely applied to persons.] They appear . . . no ways assorted to those with whom they must associate. Burke. 2. To furnish with, or make up of, various sorts or a variety of goods; as, to assort a cargo.\n\nTo agree; to be in accordance; to be adapted; to suit; to fall into a class or place. Mitford.
assorted |Selected; culled.
assortment |1. Act of assorting, or distributing into sorts, kinds, or classes. 2. A collection or quantity of things distributed into kinds or sorts; a number of things assorted. 3. A collection containing a variety of sorts or kinds adapted to various wants, demands, or purposes; as, an assortment of goods.
assot |To besot; to befool; to beguile; to infatuate. [Obs.] Some ecstasy assotted had his sense. Spenser.\n\nDazed; foolish; infatuated. [Obs.] Willie, I ween thou be assot. Spenser.
assuage |To soften, in a figurative sense; to allay, mitigate, ease, or lessen, as heat, pain, or grief; to appease or pacify, as passion or tumult; to satisfy, as appetite or desire. Refreshing winds the summer's heat assuage. Addison. To assuage the sorrows of a desolate old man Burke. The fount at which the panting mind assuages Her thirst of knowledge. Byron. Syn. -- To alleviate; mitigate; appease; soothe; calm; tranquilize; relieve. See Alleviate.\n\nTo abate or subside. [Archaic] \"The waters assuaged.\" Gen. vii. 1. The plague being come to a crisis, its fury began to assuage. De Foe.
assuagement |Mitigation; abatement.
assuager |One who, or that which, assuages.
assuasive |Mitigating; tranquilizing; soothing. [R.] Music her soft assuasive voice applies. Pope.
assubjugate |To bring into subjection. [Obs.] Shak.
assuefaction |The act of accustoming, or the state of being accustomed; habituation. [Obs.] Custom and studies efform the soul like wax, and by assuefaction introduce a nature. Jer. Taylor.
assuetude |Accustomedness; habit; habitual use. Assuetude of things hurtful doth make them lose their force to hurt. Bacon.
assumable |That may be assumed.
assumably |By way of assumption.
assume |1. To take to or upon one's self; to take formally and demonstratively; sometimes, to appropriate or take unjustly. Trembling they stand while Jove assumes the throne. Pope. The god assumed his native form again. Pope. 2. To take for granted, or without proof; to suppose as a fact; to suppose or take arbitrarily or tentatively. The consequences of assumed principles. Whewell. 3. To pretend to possess; to take in appearance. Ambition assuming the mask of religion. Porteus. Assume a virtue, if you have it not. Shak. 4. To receive or adopt. The sixth was a young knight of lesser renown and lower rank, assumed into that honorable company. Sir W. Scott. Syn. -- To arrogate; usurp; appropriate.\n\n1. To be arrogant or pretentious; to claim more than is due. Bp. Burnet. 2. (Law)  To undertake, as by a promise. Burrill.
assumed |1. Supposed. 2. Pretended; hypocritical; make-believe; as, an assumed character.
assumedly |By assumption.
assument |A patch; an addition; a piece put on. [Obs.] John Lewis (1731).
assumer |One who assumes, arrogates, pretends, or supposes. W. D. Whitney.
assuming |Pretentious; taking much upon one's self; presumptuous. Burke.
assumpsit |(a) A promise or undertaking, founded on a consideration. This promise may be oral or in writing not under seal. It may be express or implied. (b) An action to recover damages for a breach or nonperformance of a contract or promise, express or implied, oral or in writing not under seal. Common or indebitatus assumpsit is brought for the most part on an implied promise. Special assumpsit is founded on an express promise or undertaking. Wharton.
assumpt |To take up; to elevate; to assume. [Obs.] Sheldon.\n\nThat which is assumed; an assumption. [Obs.] The sun of all your assumpts is this. Chillingworth.
assumption |1. The act of assuming, or taking to or upon one's self; the act of taking up or adopting. The assumption of authority. Whewell. 2. The act of taking for granted, or supposing a thing without proof; supposition; unwarrantable claim. This gives no sanction to the unwarrantable assumption that the soul sleeps from the period of death to the resurrection of the body. Thodey. That calm assumption of the virtues. W. Black. 3. The thing supposed; a postulate, or proposition assumed; a supposition. Hold! says the Stoic; your assumption's wrong. Dryden. 4. (Logic)  The minor or second proposition in a categorical syllogism. 5. The taking of a person up into heaven. Hence: (Rom. Cath. & Greek Churches)  A festival in honor of the ascent of the Virgin Mary into heaven.
assumptive |Assumed, or capable of being assumed; characterized by assumption; making unwarranted claims. -- As*sump\"tive*ly, adv. Assumptive arms (Her.), originally, arms which a person had a right to assume, in consequence of an exploit; now, those assumed without sanction of the Heralds' College. Percy Smith.
assurance |1. The act of assuring; a declaration tending to inspire full confidence; that which is designed to give confidence. Whereof he hath given assurance unto all men, in that he hath raised him from the dead. Acts xvii. 31. Assurances of support came pouring in daily. Macaulay. 2. The state of being assured; firm persuasion; full confidence or trust; freedom from doubt; certainty. Let us draw with a true heart in full assurance of faith, having our hearts sprinkled from an evil conscience. Heb. x. 22. 3. Firmness of mind; undoubting, steadiness; intrepidity; courage; confidence; self-reliance. Brave men meet danger with assurance. Knolles. Conversation with the world will give them knowledge and assurance. Locke. 4. Excess of boldness; impudence; audacity; as, his assurance is intolerable. 5. Betrothal; affiance. [Obs.] Sir P. Sidney. 6. Insurance; a contract for the payment of a sum on occasion of a certain event, as loss or death. Note: Recently, assurance has been used, in England, in relation to life contingencies, and insurance in relation to other contingencies. It is called temporary assurance, in the time within which the contingent event must happen is limited. See Insurance. 7. (Law)  Any written or other legal evidence of the conveyance of property; a conveyance; a deed. Note: In England, the legal evidences of the conveyance of property are called the common assurances of the kingdom. Blackstone.
assure |1. To make sure or certain; to render confident by a promise, declaration, or other evidence. His promise that thy seed shall bruise our foe . . . Assures me that the bitterness of death Is past, and we shall live. Milton. 2. To declare to, solemnly; to assert to (any one) with the design of inspiring belief or confidence. I dare assure thee that no enemy Shall ever take alive the noble Brutus. Shak. 3. To confirm; to make certain or secure. And it shall be assured to him. Lev. xxvii. 19. And hereby we know that we are of the truth, and shall assure our hearts before him. 1 John iii. 19. 4. To affiance; to betroth. [Obs.] Shak. 5. (Law)  To insure; to covenant to indemnify for loss, or to pay a specified sum at death. See Insure. Syn. -- To declare; aver; avouch; vouch; assert; asseverate; protest; persuade; convince.
assured |Made sure; safe; insured; certain; indubitable; not doubting; bold to excess.\n\nOne whose life or property is insured.
assuredly |Certainly; indubitably. \"The siege assuredly I'll raise.\" Shak.
assuredness |The state of being assured; certainty; full confidence.
assurer |1. One who assures. Specifically: One who insures against loss; an insurer or underwriter. 2. One who takes out a life assurance policy.
assurgency |Act of rising. The . . . assurgency of the spirit through the body. Coleridge.
assurgent |Ascending; (Bot.)  rising obliquely; curving upward. Gray.
assuring |That assures; tending to assure; giving confidence. -- As*sur\"ing*ly, adv.
asswage |See Assuage.
assyrian |Of or pertaining to Assyria, or to its inhabitants. -- n. A native or an inhabitant of Assyria; the language of Assyria.
assyriological |Of or pertaining to Assyriology; as, Assyriological studies.
assyriologist |One versed in Assyriology; a student of Assyrian archæology.
assyriology |The science or study of the antiquities, language, etc., of ancient Assyria.
assythment |Indemnification for injury; satisfaction. [Chiefly in Scots law]
astacus |A genus of crustaceans, containing the crawfish of fresh-water lobster of Europe, and allied species of western North America. See Crawfish.
astarboard |Over to the starboard side; -- said of the tiller.
astart |Same as Astert. [Obs.]
astarte |A genus of bivalve mollusks, common on the coasts of America and Europe.
astate |Estate; state. [Obs.] Chaucer.
astatic |Having little or no tendency to take a fixed or definite position or direction: thus, a suspended magnetic needle, when rendered astatic, loses its polarity, or tendency to point in a given direction. Astatic pair (Magnetism), a pair of magnetic needles so mounted as to be nearly or quite astatic, as in some galvanometers.
astatically |In an astatic manner.
astaticism |The state of being astatic.
astatize |To render astatic.
astatki |A thick liquid residuum obtained in the distillation of Russian petroleum, much used as fuel.
astay |An anchor is said to be astay, in heaving it, an acute angle is formed between the cable and the surface of the water.
asteism |Genteel irony; a polite and ingenious manner of deriding another.
astel |An arch, or ceiling, of boards, placed over the men's heads in a mine.
aster |1. (Bot.)  A genus of herbs with compound white or bluish flowers; starwort; Michaelmas daisy. 2. (Floriculture)  A plant of the genus Callistephus. Many varieties (called China asters, German asters, etc.) are cultivated for their handsome compound flowers.
asterias |A genus of echinoderms. Note: Formerly the group of this name included nearly all starfishes and ophiurans. Now it is restricted to a genus including the commonest shore starfishes.
asteriated |Radiated, with diverging rays; as, asteriated sapphire.
asteridea |A class of Echinodermata including the true starfishes. The rays vary in number and always have ambulacral grooves below. The body is starshaped or pentagonal.
asteridian |Of or pertaining to the Asterioidea. -- n.  A starfish; one of the Asterioidea.
asterioidea |A class of Echinodermata including the true starfishes. The rays vary in number and always have ambulacral grooves below. The body is starshaped or pentagonal.
asterion |The point on the side of the skull where the lambdoid, parieto- mastoid and occipito-mastoid sutures.
asteriscus |The smaller of the two otoliths found in the inner ear of many fishes.
asterisk |The figure of a star, thus,
asterism |1. (Astron.) (a) A constellation. [Obs.] (b) A small cluster of stars. 2. (Printing) (a) An asterisk, or mark of reference. [R.] (b) Three asterisks placed in this manner, *, to direct attention to a particular passage. 3. (Crystallog.)  An optical property of some crystals which exhibit a star- shaped by reflected light, as star sapphire, or by transmitted light, as some mica.
astern |1. In or at the hinder part of a ship; toward the hinder part, or stern; backward; as, to go astern. 2. Behind a ship; in the rear. \"A gale of wind right astern.\" De Foe. \"Left this strait astern.\" Drake. To bake astern, to go stern foremost. -- To be astern of the reckoning, to be behind the position given by the reckoning. -- To drop astern, to fall or be left behind. -- To go astern, to go backward, as from the action of currents or winds.
asternal |Not sternal; -- said of ribs which do not join the sternum.
asteroid |A starlike body; esp. one of the numerous small planets whose orbits lie between those of Mars and Jupiter; -- called also planetoids and minor planets.
asteroidal |Of or pertaining to an asteroid, or to the asteroids.
asterolepis |A genus of fishes, some of which were eighteen or twenty feet long, found in a fossil state in the Old Red Sandstone. Hugh Miller.
asterope |1.  (Myth.)  One of the Pleiades; -- called also Sterope. 2.  (Astron.) A double star in the Pleiades (21 k and 22 l Pleiadum, of the 5.8 and 6.4 magnitude respectively), appearing as a single star of the 5.3 magnitude to the naked eye.
asterophyllite |A fossil plant from the coal formations of Europe and America, now regarded as the branchlets and foliage of calamites.
astert |To start up; to befall; to escape; to shun. [Obs.] Spenser.\n\nTo escape. [Obs.] Chaucer.
asthenia |Want or loss of strength; debility; diminution of the vital forces.
asthenic |Characterized by, or pertaining to, debility; weak; debilitating.
asthenopia |Weakness of sight. Quain. -- As`the*nop\"ic, a.
astheny |Want or loss of strength; debility; diminution of the vital forces.
asthma |A disease, characterized by difficulty of breathing (due to a spasmodic contraction of the bronchi), recurring at intervals, accompanied with a wheezing sound, a sense of constriction in the chest, a cough, and expectoration.
asthma paper |Paper impregnated with saltpeter. The fumes from the burning paper are often inhaled as an alleviative by asthmatics.
asthmatic |Of or pertaining to asthma; as, an asthmatic cough; liable to, or suffering from, asthma; as, an asthmatic patient. -- Asth*mat\"ic*al*ly, adv.\n\nA person affected with asthma.
asthmatical |Of or pertaining to asthma; as, an asthmatic cough; liable to, or suffering from, asthma; as, an asthmatic patient. -- Asth*mat\"ic*al*ly, adv.
astigmatic |Affected with, or pertaining to, astigmatism; as, astigmatic eyes; also, remedying astigmatism; as, astigmatic lenses.
astigmatism |A defect of the eye or of a lens, in consequence of which the rays derived from one point are not brought to a single focal point, thus causing imperfect images or indistictness of vision. Note: The term is applied especially to the defect causing images of lines having a certain direction to be indistinct, or imperfectly seen, while those of lines transverse to the former are distinct, or clearly seen.
astipulate |To assent. [Obs.] Bp. Hall.
astipulation |Stipulation; agreement. [Obs.] Bp. Hall.
astir |Stirring; in a state of activity or motion; out of bed.
astomatous |Not possessing a mouth.
astomous |Not possessing a mouth.
aston |To stun; to astonish; to stupefy. [Obs.] Chaucer.
astone |To stun; to astonish; to stupefy. [Obs.] Chaucer.
astonied |Stunned; astonished. See Astony. [Archaic] And I astonied fell and could not pray. Mrs. Browning.
astonish |1. To stun; to render senseless, as by a blow. [Obs.] Enough, captain; you have astonished him. [Fluellen had struck Pistol]. Shak. The very cramp-fish [i. e., torpedo] . . . being herself not benumbed, is able to astonish others. Holland. 2. To strike with sudden fear, terror, or wonder; to amaze; to surprise greatly, as with something unaccountable; to confound with some sudden emotion or passion. Musidorus . . . had his wits astonished with sorrow. Sidney. I, Daniel . . . was astonished at the vision. Dan. viii. 27. Syn. -- To amaze; astound; overwhelm; surprise. -- Astonished, Surprised. We are surprised at what is unexpected. We are astonished at what is above or beyond our comprehension. We are taken by surprise. We are struck with astonishment. C. J. Smith. See Amaze.
astonishedly |In an astonished manner. [R.] Bp. Hall.
astonishing |Very wonderful; of a nature to excite astonishment; as, an astonishing event. Syn. -- Amazing; surprising; wonderful; marvelous. As*ton\"ish*ing*ly, adv. -- As*ton\"ish*ing*ness, n.
astonishment |1. The condition of one who is stunned. Hence: Numbness; loss of sensation; stupor; loss of sense. [Obs.] A coldness and astonishment in his loins, as folk say. Holland. 2. Dismay; consternation. [Archaic] Spenser. 3. The overpowering emotion excited when something unaccountable, wonderful, or dreadful is presented to the mind; an intense degree of surprise; amazement. Lest the place And my quaint habits breed astonishment. Milton. 4. The object causing such an emotion. Thou shalt become an astonishment. Deut. xxviii. 37. Syn. -- Amazement; wonder; surprise.
astony |To stun; to bewilder; to astonish; to dismay. [Archaic] The captain of the Helots . . . strake Palladius upon the side of his head, that he reeled astonied. Sir P. Sidney. This sodeyn cas this man astonied so, That reed he wex, abayst, and al quaking. Chaucer.
astoop |In a stooping or inclined position. Gay.
astound |Stunned; astounded; astonished. [Archaic] Spenser. Thus Ellen, dizzy and astound. As sudden ruin yawned around. Sir W. Scott.\n\n1. To stun; to stupefy. No puissant stroke his senses once astound. Fairfax. 2. To astonish; to strike with amazement; to confound with wonder, surprise, or fear. These thoughts may startle well, but not astound The virtuous mind. Milton.
astounding |Of a nature to astound; astonishing; amazing; as, an astounding force, statement, or fact. -- As*tound\"ing*ly, adv.
astoundment |Amazement. Coleridge.
astrachan |See Astrakhan.
astraddle |In a straddling position; astride; bestriding; as, to sit astraddle a horse.
astraean |Pertaining to the genus Astræa or the family Astræidæ. -- n.  A coral of the family Astræidæ; a star coral.
astragal |1. (Arch.)  A convex molding of rounded surface, generally from half to three quarters of a circle. 2. (Gun.)  A round molding encircling a cannon near the mouth.
astragalar |Of or pertaining to the astragalus.
astragaloid |Resembling the astragalus in form.
astragalomancy |Divination by means of small bones or dice.
astragalus |1. (Anat.)  The ankle bone, or hock bone; the bone of the tarsus which articulates with the tibia at the ankle. 2. (Bot.)  A genus of papilionaceous plants, of the tribe Galegeæ, containing numerous species, two of which are called, in English, milk vetch and licorice vetch. Gum tragacanth is obtained from different oriental species, particularly the A. gummifer and A. verus. 3. (Arch.)  See Astragal, 1.
astrakhan |Of or pertaining to Astrakhan in Russia or its products; made of an Astrakhan skin. -- n.  The skin of stillborn or young lambs of that region, the curled wool of which resembles fur.
astral |Pertaining to, coming from, or resembling, the stars; starry; starlike. Shines only with an astral luster. I. Taylor. Some astral forms I must invoke by prayer. Dryden. Astral lamp, an Argand lamp so constructed that no shadow is cast upon the table by the flattened ring-shaped reservoir in which the oil is contained. -- Astral spirits, spirits formerly supposed to live in the heavenly bodies or the aërial regions, and represented in the Middle Ages as fallen angels, spirits of the dead, or spirits originating in fire.
astrand |Stranded. Sir W. Scott.
astray |Out of the right, either in a literal or in a figurative sense; wandering; as, to lead one astray. Ye were as sheep going astray. 1 Pet. ii. 25.
astrict |1. To bind up; to confine; to constrict; to contract. The solid parts were to be relaxed or astricted. Arbuthnot. 2. To bind; to constrain; to restrict; to limit. [R.] The mind is astricted to certain necessary modes or forms of thought. Sir W. Hamilton. 3. (Scots Law)  To restrict the tenure of; as, to astrict lands. See Astriction, 4. Burrill.\n\nConcise; contracted. [Obs.] Weever.
astriction |1. The act of binding; restriction; also, obligation. Milton. 2. (Med.) (a) A contraction of parts by applications; the action of an astringent substance on the animal economy. Dunglison. (b) Constipation. Arbuthnot. 3. Astringency. [Obs.] Bacon. 4. (Scots Law)  An obligation to have the grain growing on certain lands ground at a certain mill, the owner paying a toll. Bell. Note: The lands were said to be astricted to the mill.
astrictive |Binding; astringent. -- n.  An astringent. -- As*tric\"tive*ly, adv.
astrictory |Astrictive. [R.]
astride |With one leg on each side, as a man when on horseback; with the legs stretched wide apart; astraddle. Placed astride upon the bars of the palisade. Sir W. Scott. Glasses with horn bows sat astride on his nose. Longfellow.
astriferous |Bearing stars. [R.] Blount.
astringe |1. To bind fast; to constrict; to contract; to cause parts to draw together; to compress. Which contraction . . . astringeth the moistuBacon. 2. To bind by moral or legal obligation. Wolsey.
astringency |The quality of being astringent; the power of contracting the parts of the body; that quality in medicines or other substances which causes contraction of the organic textures; as, the astringency of tannin.
astringent |1. Drawing together the tissues; binding; contracting; -- opposed to laxative; as, astringent medicines; a butter and astringent taste; astringent fruit. 2. Stern; austere; as, an astringent type of virtue.\n\nA medicine or other substance that produces contraction in the soft organic textures, and checks discharges of blood, mucus, etc. External astringents are called styptics. Dunglison.
astringently |In an astringent manner.
astringer |A falconer who keeps a goschawk. [Obs.] Shak. Cowell. [Written also austringer.]
astro- |The combining form of the Greek word 'a`stron, meaning star.
astrofel |A bitter herb, probably the same as aster, or starwort. Spenser.
astrofell |A bitter herb, probably the same as aster, or starwort. Spenser.
astrogeny |The creation or evolution of the stars or the heavens. H. Spencer.
astrognosy |The science or knowledge of the stars, esp. the fixed stars. Bouvier.
astrogony |Same as Astrogeny. -- As`*tro*gon\"ic, a.
astrography |The art of describing or delineating the stars; a description or mapping of the heavens.
astroite |A radiated stone or fossil; star-stone. [Obs.] [Written also astrite and astrion.]
astrolabe |1. (Astron.)  An instrument for observing or showing the positions of the stars. It is now disused. Note: Among the ancients, it was essentially the armillary sphere. A graduated circle with sights, for taking altitudes at sea, was called an astrolabe in the 18th century. It is now superseded by the quadrant and sextant. 2. A stereographic projection of the sphere on the plane of a great circle, as the equator, or a meridian; a planisphere. Whewell.
astrolater |A worshiper of the stars. Morley.
astrolatry |The worship of the stars.
astrolithology |The science of aërolites.
astrologer |1. One who studies the stars; an astronomer. [Obs.] 2. One who practices astrology; one who professes to foretell events by the aspects and situation of the stars.
astrologian |An astrologer. [Obs.]
astrologic |Of or pertaining to astrology; professing or practicing astrology. \"Astrologi learning.\" Hudibras. \"Astrological prognostication.\" Cudworth. -- As`tro*log\"ic*al*ly, adv.
astrological |Of or pertaining to astrology; professing or practicing astrology. \"Astrologi learning.\" Hudibras. \"Astrological prognostication.\" Cudworth. -- As`tro*log\"ic*al*ly, adv.
astrologize |To apply astrology to; to study or practice astrology.
astrology |In its etymological signification, the science of the stars; among the ancients, synonymous with astronomy; subsequently, the art of judging of the influences of the stars upon human affairs, and of foretelling events by their position and aspects. Note: Astrology was much in vogue during the Middle Ages, and became the parent of modern astronomy, as alchemy did of chemistry. It was divided into two kinds: judicial astrology, which assumed to foretell the fate and acts of nations and individuals, and natural astrology, which undertook to predict events of inanimate nature, such as changes of the weather, etc.
astromantic |Of or pertaining to divination by means of the stars; astrologic. [R.] Dr. H. More.
astrometeorology |The investigation of the relation between the sun, moon, and stars, and the weather. -- As`*tro*me`te*or`o*log\"ic*al, a. -- As`tro*me`te*or*ol\"o*gist, n.
astrometer |An instrument for comparing the relative amount of the light of stars.
astrometry |The art of making measurements among the stars, or of determining their relative magnitudes.
astronomer |1. An astrologer. [Obs.] Shak. 2. One who is versed in astronomy; one who has a knowledge of the laws of the heavenly orbs, or the principles by which their motions are regulated, with their various phenomena. An undevout astronomer is mad. Young.
astronomian |An astrologer. [Obs.]
astronomic |Astronomical.
astronomical |Of or pertaining to astronomy; in accordance with the methods or principles of astronomy. -- As`tro*nom\"ic*al*ly, adv. Astronomical clock. See under Clock. -- Astronomical day. See under Day. -- Astronomical fractions, Astronomical numbers. See under Sexagesimal.
astronomize |To study or to talk astronomy. [R.] They astronomized in caves. Sir T. Browne.
astronomy |1. Astrology. [Obs.] Not from the stars do I my judgment pluck; And yet methinks I have astronomy. Shak. 2. The science which treats of the celestial bodies, of their magnitudes, motions, distances, periods of revolution, eclipses, constitution, physical condition, and of the causes of their various phenomena. 3. A treatise on, or text-book of, the science. Physical astronomy. See under Physical.
astrophel |See Astrofel. [Obs.]
astrophotography |The application of photography to the delineation of the sun, moon, and stars.
astrophotometer |A photometer for measuring the brightness of stars.
astrophotometry |The determination of the brightness of stars, and also of the sun, moon, and planets. --As`tro*pho`to*met\"ric*al (#), a.
astrophysical |Pertaining to the physics of astronomical science.
astrophysics |The science treating of the physical characteristics of the stars and other heavenly bodies, their chemical constitution, light, heat, atmospheres, etc. Its observations are made with the spectroscope, bolometer, etc., usually in connection with the telescope.
astrophyton |A genus of ophiurans having the arms much branched.
astroscope |An old astronomical instrument, formed of two cones, on whose surface the constellations were delineated.
astroscopy |Observation of the stars. [Obs.]
astrotheology |Theology founded on observation or knowledge of the celestial bodies. Derham.
astructive |Building up; constructive; -- opposed to destructive. [Obs.]
astrut |1. Sticking out, or puffed out; swelling; in a swelling manner. [Archaic] Inflated and astrut with self-conceit. Cowper. 2. In a strutting manner; with a strutting gait.
astucious |Subtle; cunning; astute. [R.] Sir W. Scott. -- As*tu\"cious*ly, adv. [R.]
astucity |Craftiness; astuteness. [R.] Carlyle.
astun |To stun. [Obs.] \"Breathless and astunned.\" Somerville.
asturian |Of or pertaining to Asturias in Spain. -- n.  A native of Asturias.
astute |Critically discerning; sagacious; shrewd; subtle; crafty. Syn. -- Keen; eagle-eyed; penetrating; skilled; discriminating; cunning; sagacious; subtle; wily; crafty. As*tute\"ly, adv. -- As*tute\"ness, n.
astylar |Without columns or pilasters. Weale.
astyllen |A small dam to prevent free passage of water in an adit or level.
asunder |Apart; separate from each other; into parts; in two; separately; into or in different pieces or places. I took my staff, even Beauty, and cut it asunder. Zech. xi. 10. As wide asunder as pole and pole. Froude.
asura |An enemy of the gods, esp. one of a race of demons and giants.
aswail |The sloth bear (Melursus labiatus) of India.
asweve |To stupefy. [Obs.] Chaucer.
aswing |In a state of swinging.
aswoon |In a swoon. Chaucer.
aswooned |In a swoon.
