oviposit |To lay or deposit eggs; -- said esp. of insects.\n\nTo deposit or lay (an egg).
ovipositing |The depositing of eggs, esp. by insects.
oviposition |The depositing of eggs, esp. by insects.
ovipositor |The organ with which many insects and some other animals deposit their eggs. Some ichneumon files have a long ovipositor fitted to pierce the eggs or larvæ of other insects, in order to lay their own eggs within the same.
ovisac |(a) A Graafian follicle; any sac containing an ovum or ova. (b) The inner layer of the fibrous wall of a Graafian follicle.
ovism |The old theory that the egg contains the whole embryo of the future organism and the germs of all subsequent offsprings and is merely awakened to activity by the spermatozoön; -- opposed to spermism or animalculism.
ovist |Same as Ovulist.
ovococcus |A germinal vesicle.
ovoid |Resembling an egg in shape; egg-shaped; ovate; as, an ovoidal apple.\n\nA solid resembling an egg in shape.
ovoidal |Resembling an egg in shape; egg-shaped; ovate; as, an ovoidal apple.
ovolo |A round, convex molding. See Illust. of Column. Note: In Roman work it is usually a quarter circle in section; in Greek work it is flatter, and is equivalent to the echinus; that is, it has in section the elastic curve of the shell of the sea urchin. In mediæval architecture it is not distinguishable from the multitude of convex moldings, of all sections, which are used.
ovology |That branch of natural history which treats of the origin and functions of eggs.
ovoplasma |Yolk; egg yolk. Haeckel.
ovotesttis |An organ which produces both ova and spermatozoids; an hermaphrodite gland.
ovoviviparous |Oviparous, but hatching the egg while it is within the body, as some fishes and reptiles.
ovular |Relating or belonging to an ovule; as, an ovular growth.
ovulary |Pertaining to ovules.
ovulate |Containing an ovule or ovules.
ovulation |The formation of ova or eggs in the ovary, and the discharge of the same. In the mammalian female the discharge occurs during menstruation.
ovule |(a) The rudiment of a seed. It grows from a placenta, and consists of a soft nucleus within two delicate coatings. The attached base of the ovule is the hilum, the coatings are united with the nucleus at the chalaza, and their minute orifice is the foramen. (b) An ovum.
ovuliferous |Producing ovules.
ovulist |A believer in the theory (called encasement theory), current during the last century, that the egg was the real animal germ, and that at the time of fecundation the spermatozoa simply gave the impetus which caused the unfolding of the egg, in which all generations were inclosed one within the other. Also called ovist.
ovulite |A fossil egg.
ovulum |An ovule.
ovum |1. (Biol.)  A more or less spherical and transparent mass of granular protoplasm, which by a process of multiplication and growth develops into a mass of cells, constituting a new individual like the parent; an egg, spore, germ, or germ cell. See Illust. of Mycropyle. Note: The ovum is a typical cell, with a cell wall, cell substance, nucleus, and nucleolus. In man and the higher animals the cell wall, a vertically striated membrane, is called the zona pellucida; the cell contents, the vitellus; the nucleus, the germinal vesicle; and the nucleolus, the germinal spot. The diameter of the ripe ovum in man and the domestic animals varies between 1-200 and 1-120 of an inch. 2. (Arch.)  One of the series of egg-shaped ornaments into which the ovolo is often carved. Gwilt.
owch |See Ouch. [Obs.] Speser.
owe |1. To possess; to have, as the rightful owner; to own. [Obs.] Thou dost here usurp The name thou ow'st not. Shak. 2. To have or possess, as something derived or bestowed; to be obliged to ascribe (something to some source); to be indebted or obliged for; as, he owed his wealth to his father; he owed his victoty to his lieutenants. Milton. O deem thy fall not owed to man's decree. Pope. 3. Hence: To have or be under an obigation to restore, pay, or render (something) in return or compensation for something received; to be indebted in the sum of; as, the subject owes allegiance; the fortunate owe assistance to the unfortunate. The one ought five hundred pence, and the other fifty. Bible (1551). A son owes help and honor to his father. Holyday. Note: Owe was sometimes followed by an objective clause introduced by the infinitive. \"Ye owen to incline and bow your heart.\" Chaucer. 4. To have an obligation to (some one) on account of something done or received; to be indebted to; as, to iwe the grocer for supplies, or a laborer for services.
owel |Equal. [Obs.] Burrill.
owelty |Equality; -- sometimes written ovelty and ovealty. Burrill.
owen |Own. [Obs.] Chaucer.
owenite |A follower of Robert Owen, who tried to reorganize society on a socialistic basis, and established an industrial community on the Clyde, Scotland, and, later, a similar one in Indiana.
owher |Anywhere. [Obs.] \"If he found owher a good fellow.\" Chaucer.
owing |1. Had or held under obligation of paying; due. There is more owing her than is paid. Shak. 2. Had or experienced as a consequence, result, issue, etc.; ascribable; -- with to; as, misfortunes are often owing to vices; his failure was owing to speculations.
owl |1. (Zoöl.)  Any cpecies of raptorial birds of the family Strigidæ. They have large eyes and ears, and a conspicuous circle of feathers around each eye. They are mostly nocturnal in their habits. Note: Some species have erectile tufts of feathers on the head. The feathers are soft and somewhat downy. The species are numerous. See Barn owl, Burrowing owl, Eared owl, Hawk owl, Horned owl, Screech owl, Snowy owl, under BarnBurrowing, etc. Note: In the Scriptures the owl is commonly associated with desolation; poets and story-tellers introduce it as a bird of ill omen. . . . The Greeks and Romans made it the emblem of wisdom, and sacred to Minerva, -- and indeed its large head and solemn eyes give it an air of wisdom. Am. Cyc. 2. (Zoöl.)  A variety of the domestic pigeon. Owl monkey (Zoöl.), any one of several species of South American nocturnal monkeys of the genus Nyctipithecus. They have very large eyes. Called also durukuli. -- Owl moth ( (Zoöl.), a very large moth (Erebus strix). The expanse of its wings is over ten inches. -- Owl parrot (Zoöl.), the kakapo. -- Sea owl (Zoöl.), the lumpfish. -- Owl train, a cant name for certain railway trains whose run is in the nighttime.\n\n1. To pry about; to prowl. [Prov. Eng.] 2. To carry wool or sheep out of England. [Obs.] Note: This was formerly illegal, and was done chiefly by night. 3. Hence, to carry on any contraband trade. [Eng.]
owl-eyed |Having eyes like an owl's.
owler |One who owls; esp., one who conveys contraband goods. See Owling, n. [Obs. or Prov. Eng.] T. Brown.
owlery |An abode or a haunt of owls.
owlet |A small owl; especially, the European species (Athene noctua), and the California flammulated owlet (Megascops flammeolus). Owlet moth (Zoöl.), any noctuid moth.
owling |The offense of transporting wool or sheep out of England contrary to the statute formerly existing. Blackstone.
owlish |Resembling, or characteristic of, an owl.
owlism |Affected wisdom; pompous dellness. [R.]
owllight |Glimmering or imperfect [R.] Bp. Warburton.
own |To grant; to acknowledge; to admit to be true; to confess; to recognize in a particular character; as, we own that we have forfeited your love. The wakeful bloodhound rose, and shook his hide owns. Keats.\n\nBelonging to; belonging exclusively or especially to; peculiar; -- most frequently following a possessive pronoun, as my, our, thy, your, his, her, its, their, in order to emphasize or intensify the idea of property, peculiar interest, or exclusive ownership; as, my own father; my own composition; my own idea; at my own price. \"No man was his own [i. e., no man was master of himself, or in possession of his senses].\" Shak. To hold one's own, to keep or maintain one's possessions; to yield nothing; esp., to suffer no loss or disadvantage in a contest. Shak.\n\nTo hold as property; to have a legal or rightful title to; to be the proprietor or possessor of; to possess; as, to own a house.
owner |One who owns; a rightful proprietor; one who has the legal or rightful title, whether he is the possessor or not. Shak.
ownerless |Without an owner.
ownership |The state of being an owner; the right to own; exclusive right of possession; legal or just claim or title; proprietorship.
owre |The aurohs. [Obs.]
owse |Tanner's ooze. See Ooze, 3.
owser |Tanner's ooze. See Ooze, 3.
ox |The male of bovine quadrupeds, especially the domestic animal when castrated and grown to its full size, or nearly so. The word is also applied, as a general name, to any species of bovine animals, male and female. All sheep and oxen, yea, and the beasts of the field. Ps. viii. 7. Note: The castrated male is called a steer until it attains its full growth, and then, an ox; but if castrated somewhat late in life, it is called a stag. The male, not castrated, is called a bull. These distinctions are well established in regard to domestic animals of this genus. When wild animals of this kind are spoken of, ox is often applied both to the male and the female. The name ox is never applied to the individual cow, or female, of the domestic kind. Oxen may comprehend both the male and the female. Grunting ox (Zoöl.), the yak. -- Indian ox (Zoöl.), the zebu. -- Javan ox (Zoöl.), the banteng. -- Musk ox. (Zoöl.) See under Musk. -- Ox bile. See Ox gall, below. -- Ox gall, the fresh gall of the domestic ox; -- used in the arts and in medicine. -- Ox pith, ox marrow. [Obs.] Marston. -- Ox ray (Zoöl.), a very large ray (Dicerobatis Giornæ) of Southern Europe. It has a hornlike organ projecting forward from each pectoral fin. It sometimes becomes twenty feet long and twenty-eight feet broad, and weighs over a ton. Called also sea devil. -- To have the black ox tread on one's foot, to be unfortunate; to know what sorrow is (because black oxen were sacrificed to Pluto). Leigh Hunt.
oxacid |See Oxyacid.
oxalan |A complex nitrogenous substance C3N3H5O3 obtained from alloxan (or when urea is fused with ethyl oxamate), as a stable white crystalline powder; -- called also oxaluramide.
oxalantin |A white crystalline nitrogenous substance (C6H4N4O5) obtained by the reduction of parabanic acid; -- called also leucoturic acid.
oxalate |A salt of oxalic acid.
oxaldehyde |Same as Glyoxal.
oxalethyline |A poisonous nitrogenous base (C6H10N2) obtained indirectly from oxamide as a thick transparent oil which has a strong narcotic odor, and a physiological action resembling that of atropine. It is probably related to pyridine.
oxalic |Pertaining to, derived from, or contained in, sorrel, or oxalis; specifically, designating an acid found in, and characteristic of, oxalis, and also certain plant of the Buckwheat family. Oxalic acid (Chem.), a dibasic acid, existing combined in oxalis as an acid potassium oxalate, and in many plant tissues as the calcium oxalate. It is prepared on a large scale, by the action of fused caustic soda or potash on sawdust, as a white crystalline substance, which has a strong acid taste, and is poisonous in large doses. It is used in dyeing, calico printing, bleaching flax and straw, the preparation of formic acid, and in salts of lemon for removing ink stains, mold, etc.
oxaline |See Glyoxaline.
oxalis |A genus of plants,mostly herbs, with acid-tasting trifoliolate or multifoliolate leaves; -- called also wood sorrel.
oxalite |A yellow mineral consisting of oxalate of iron.
oxaluramide |Same as Oxalan.
oxalurate |A salt of oxaluric acid.
oxaluric |Pertaining to, or designating, a complex nitrogenous acid related to the ureids, and obtained from parabanic acid as a white silky crystalline substance.
oxalyl |(a) A hydrocarbon radical (C2O2) regarded as a residue of oxalic acid and occurring in derivatives of it. (b) An old name for carbonyl. (c) An old name for carboxyl.
oxamate |A salt of oxamic acid.
oxamethane |Ethyl oxamate, obtained as a white scaly crystalline powder.
oxamethylane |Methyl oxamate, obtained as a pearly white crystalline substance.
oxamic |Pertaining to, or designating, an acid NH2.C2O2.HO obtained as a fine crystalline powder, intermediate between oxalic acid and oxamide. Its ammonium salt is obtained by boiling oxamide with ammonia.
oxamide |A white crystalline neutral substance (C2O2(NH2)2) obtained by treating ethyl oxalate with ammonia. It is the acid amide of oxalic acid. Formerly called also oxalamide.
oxamidine |One of a series of bases containing the amido and the isonitroso groups united to the same carbon atom.
oxanilamide |A white crystalline nitrogenous substance, obtained indirectly by the action of cyanogen on aniline, and regarded as an anilide of oxamic acid; -- called also phenyl oxamide.
oxanilate |A salt of oxanilic acid.
oxanilic |Pertaining to, or derived from, oxalic acid and aniline; -- used to designate an acid obtained in white crystalline scales by heating these substances together.
oxanilide |a white crystalline substance, resembling oxanilamide, obtained by heating aniline oxalate, and regarded as a double anilide of oxalic acid; -- called also diphenyl oxamide.
oxanillamide |A white crystalline nitrogenous substance, obtained indirectly by the action of cyanogen on aniline, and regarded as an anilide of oxamic acid; -- called also phenyl oxamide.
oxbane |A poisonous bulbous plant (Buphane toxicaria) of the Cape of Good Hope.
oxbird |(a) The dunlin. (b) The sanderling. (c) An African weaver bird (Textor alector).
oxbiter |The cow blackbird. [Local, U. S.]
oxbow |A frame of wood, bent into the shape of the letter U, and embracing an ox's neck as a kind of collar, the upper ends passing through the bar of the yoke; also, anything so shaped, as a bend in a river.
oxeye |1. (Bot.) (a) The oxeye daisy. See under Daisy. (b) The corn camomile (Anthemis arvensis). (c) A genus of composite plants (Buphthalmum) with large yellow flowers. 2. (Zoöl.) (a) A titmouse, especially the great titmouse (Parus major) and the blue titmouse (P. coeruleus). [Prov. Eng.] (b) The dunlin. (c) A fish; the bogue, or box. Creeping oxeye (Bot.) a West Indian composite plant (Wedelia carnosa). -- Seaside oxeye (Bot.), a West Indian composite shrub (Borrichia arborescens).
oxeyed |Having large, full eyes, like those of an ox. Burton.
oxfly |The gadfly of cattle.
oxford |Of or pertaining to the city or university of Oxford, England. Oxford movement. See Tractarianism. -- Oxford School, a name given to those members of the Church of England who adopted the theology of the so-called Oxford \"Tracts for the Times,\" issued the period 1833 -- 1841. Shipley. -- Oxford tie, a kind of shoe, laced on the instep, and usually covering the foot nearly to the ankle.
oxgang |See Bovate.
oxgoad |A goad for driving oxen.
oxhead |Literally, the head of an ox (emblem of cuckoldom); hence, a dolt; a blockhead. Dost make a mummer of me, oxhead Marston.
oxheal |Same as Bear's-foot.
oxheart |A large heart-shaped cherry, either black, red, or white.
oxhide |1. The skin of an ox, or leather made from it. 2. (O. Eng. Law)  A measure of land. See 3d Hide.
oxid |See Oxide.
oxidability |Capability of being converted into an oxide.
oxidable |Capable of being converted into an oxide.
oxidate |To oxidize. [Obs.]
oxidation |The act or process of oxidizing, or the state or result of being oxidized.
oxidator |1. An oxidizer. [Obs.] 2. A contrivance for causing a current of air to impinge on the flame of the Argand lamp; -- called also oxygenator.
oxide |A binary compound of oxygen with an atom or radical, or a compound which is regarded as binary; as, iron oxide, ethyl oxide, nitrogen oxide, etc. Note: In the chemical nomenclature adopted by Guyton de Morveau, Lavoisier,and their associates, the term oxides was made to include all compounds of oxygen which had no acid (F. acide) properties, as contrasted with the acid, all of which were at that time supposed to contain oxygen. The orthography oxyde, oxyd, etc., was afterwards introduced in ignorance or disregard of the true etymology, but these forms are now obsolete in English. The spelling oxid is not common.
oxidizable |Capable of being oxidized.
oxidize |To combine with oxygen, or subject to the action of oxygen, or of an oxidizing agent. Specifically: (a) To combine with oxygen or with more oxygen; to add oxygen to; as, to oxidize nitrous acid so as to form nitric acid. (b) To remove hydrogen from (anything), as by the action of oxygen; as, to oxidize alcohol so as to form aldehyde. (c) To subject to the action of oxygen or of an oxidizing agent, so as to bring to a higher grade, as an -ous compound to an -ic compound; as, to oxidize mercurous chloride to mercuric chloride. Note: In certain cases to oxidize is identical with to acidify; for, in nearly all cases, the more oxygen a substance contains the more nearly does it approximate to acid qualities; thus, by oxidation many elements, as sulphur, nitrogen, carbon, chromium, manganese, etc., pass into compounds which are acid anhydrides, and thus practically in the acid state.
oxidizement |Oxidation. [R.]
oxidizer |An agent employed in oxidation, or which facilitates or brings about combination with oxygen; as, nitric acid, chlorine, bromine, etc., are strong oxidizers.
oxidulated |Existing in the state of a protoxide; -- said of an oxide. [R.]
oxime |One of a series of isonitroso derivatives obtained by the action of hydroxylamine on aldehydes or ketones.
oxindol |A white crystalline nitrogenous substance (C8H7NO) of the indol group, obtained by the reduction of dioxindol. It is a so-called lactam compound.
oxiodic |Pertaining to, or designating, certain compounds of iodine and oxygen.
oxlike |Characteristic of, or like, an ox.
oxlip |The great cowslip (Primula veris, var. elatior).
oxonate |A salt of oxonic acid.
oxonian |Of or relating to the city or the university of Oxford, England. Macaulay.\n\nA student or graduate of Oxford University, in England.
oxonic |Pertaining to, or designating, a complex nitrogenous acid (C4H5N3O4) not known in the free state, but obtained, in combination with its salts, by a slow oxidation of uric acid, to which it is related.
oxpecker |An African bird of the genus Buphaga; the beefeater.
oxshoe |A shoe for oxen, consisting of a flat piece of iron nailed to the hoof.
oxter |The armpit; also, the arm. [Prov. Eng. & Scot.]
oxtongue |A name given to several plants, from the shape and roughness of their leaves; as, Anchusa officinalis, a kind of bugloss, and Helminthia echioides, both European herbs.
oxy- |A prefix, also used adjectively, designating: (a) A compound containing oxygen. (b) A compound containing the hydroxyl group, more properly designated by hydroxy-. See Hydroxy-. Oxy acid. See Oxyacid (below).
oxyacetic |Hydroxyacetic; designating an acid called also glycolic acid.
oxyacid |An acid containing oxygen, as chloric acid or sulphuric acid; - - contrasted with the hydracids, which contain no oxygen, as hydrochloric acid. See Acid, and Hydroxy-.
oxyammonia |Same as Hydroxylamine.
oxybenzene |Hydroxy benzene. Same as Phenol.
oxybenzoic |Hydroxybenzoic; pertaining to, or designating, any one of several hydroxyl derivatives of benzonic acid, of which the commonest is salicylic acid.
oxybromic |Pertaining to, or designating, certain compounds of oxygen and bromine.
oxybutyric |Hydroxybutyric; designating any one of a group of metameric acids (C3H6.OH.CO2H).
oxycalcium |Of or pertaining to oxygen and calcium; as, the oxycalcium light. See Drummond light.
oxycaproic |See Leucic.
oxychloric |(a) Of, pertaining to, or designating in general, certain compounds containing oxygen and chlorine. (b) Formerly designating an acid now called perchloric acid. See Perchloric.
oxychloride |A ternary compound of oxygen and chlorine; as, plumbic oxychloride.
oxycrate |A Mixture of water and vinegar. Wiseman.
oxycymene |Hydroxy cymene. Same as Carvacrol.
oxygenate |To unite, or cause to combine, with oxygen; to treat with oxygen; to oxidize; as, oxygenated water (hydrogen dioxide).
oxygenation |The act or process of combining or of treating with oxygen; oxidation.
oxygenator |An oxidizer.
oxygenic |Pertaining to, containing, or resembling, oxygen; producing oxygen.
oxygenium |The technical name of oxygen. [R.]
oxygenizable |Oxidizable.
oxygenize |To oxidize.
oxygenizement |Oxidation.
oxygenous |Oxygenic.
oxygon |A triangle having three acute angles.
oxygonal |Having acute angles. Barlow.
oxygonial |Having acute angles. Barlow.
oxyhaemacyanin |See Hæmacyanin.
oxyhaemocyanin |See Hæmacyanin.
oxyhaemoglobin |See Hemoglobin.
oxyhemoglobin |See Hemoglobin.
oxyhydrogen |Of or pertaining to a mixture of oxygen and hydrogen; as, oxyhydrogen gas. Oxyhydrogen blowpipe. (Chem.) See Blowpipe. -- Oxyhydrogen microscope, a form of microscope arranged so as to use the light produced by burning lime or limestone under a current of oxyhydrogen gas.
oxyhydrogen light |A light produced by the incandescence of some substances, esp. lime, in the oxyhydrogen flame. Coal gas (producing the oxygas light), or the vapor of ether (oxyether light) or methylated spirit (oxyspirit light), may be substituted for hydrogen.
oxymel |A mixture of honey, water, vinegar, and spice, boiled to a sirup. Sir T. Elyot.
oxymethylene |Formic aldehyde, regarded as a methylene derivative.
oxymoron |A figure in which an epithet of a contrary signification is added to a word; e. g., cruel kindness; laborious idleness.
oxymuriate |A salt of the supposed oxymuriatic acid; a chloride. Oxymuriate of lime, chloride of lime.
oxymuriatic |Pertaining to, or consisting of, oxygen and muriatic acid, that is, hydrochloric acid. [Archaic.] Oxymuriatic acid, chlorine, formerly so called on the supposition that it was a compound of oxygen and muriatic acid. [Obs.]
oxyneurine |See Betaine.
oxyntic |Acid; producing acid; -applied especially to certain glands and cells in the stomach.
oxyopia |Excessive acuteness of sight.
oxyopy |Excessive acuteness of sight.
oxyphenic |Pertaining to, or designating, the phenol formerly called oxyphenic acid, and now oxyphenol and pyrocatechin. See Pyrocatechin.
oxyphenol |A phenol, oxyphenic acid, and now pyrocatechin.
oxyphony |Acuteness or shrillness of voice.
oxyquinoline |Hydroxy quinoline; a phenol derivative of quinoline, -- called also carbostyril.
oxyrhyncha |The maioid crabs.
oxyrrhodine |A mixture of two parts of the oil of roses with one of the vinegar of roses. Floyer.
oxysalt |A salt of an oxyacid, as a sulphate.
oxysulphide |A ternary compound of oxygen and sulphur.
oxysulphuret |An oxysulphide. [Obsolescent]
oxytocic |Promoting uterine contractions, or parturition. -- n.  An oxytocic medicine or agent.
oxytoluene |One of three hydroxy derivatives of toluene, called the cresols. See Cresol.
oxytone |Having an acute sound; (Gr. Gram.), having an acute accent on the last syllable.\n\n1. An acute sound. 2. (Gr. Gram.)  A word having the acute accent on the last syllable.
oxytonical |Oxytone.
oyer |A hearing or an inspection, as of a deed, bond, etc., as when a defendant in court prays oyer of a writing. Blackstone. Oyer and terminer (Law), a term used in England in commissions directed to judges of assize about to hold court, directing them to hear and determine cases brought before them. In the U.S. the phrase is used to designate certain criminal courts.
oyez |Hear; attend; -- a term used by criers of courts to secure silence before making a proclamation. It is repeated three times. [Written also oyes.]
oylet |1. See Eyelet. 2. (Arch.)  Same as Oillet.
oynoun |Onion. [Obs.] Chaucer.
oyster |1. (Zoöl.)  Any marine bivalve mollusk of the genus Ostrea. They are usually found adhering to rocks or other fixed objects in shallow water along the seacoasts, or in brackish water in the mouth of rivers. The common European oyster (Ostrea edulis), and the American oyster (Ostrea Virginiana), are the most important species. 2. A name popularly given to the delicate morsel contained in a small cavity of the bone on each side of the lower part of the back of a fowl. Fresh-water oyster (Zoöl.), any species of the genus Etheria, and allied genera, found in rivers of Africa and South America. They are irregular in form, and attach themselves to rocks like oysters, but they have a pearly interior, and are allied to the fresh-water mussels. -- Oyster bed, a breeding place for oysters; a place in a tidal river or other water on or near the seashore, where oysters are deposited to grow and fatten for market. See lst Scalp, n. -- Oyster catcher (Zoöl.), any one of several species of wading birds of the genus Hæmatopus, which frequent seashores and feed upon shellfish. The European species (H. ostralegus), the common American species (H. palliatus), and the California, or black, oyster catcher (H. Bachmani) are the best known. -- Oyster crab (Zoöl.) a small crab (Pinnotheres ostreum) which lives as a commensal in the gill cavity of the oyster. -- Oyster dredge, a rake or small dragnet of bringing up oyster from the bottom of the sea. -- Oyster fish. (Zoöl.) (a) The tautog. (b) The toadfish. -- Oyster plant. (Bot.) (a) A plant of the genus Tragopogon (T. porrifolius), the root of which, when cooked, somewhat resembles the oyster in taste; salsify; -- called also vegetable oyster. (b) A plant found on the seacoast of Northern Europe, America and Asia (Mertensia maritima), the fresh leaves of which have a strong flavor of oysters. -- Oyster plover. (Zoöl.) Same as Oyster catcher, above. -- Oyster shell (Zoöl.), the shell of an oyster. -- Oyster wench, Oyster wife, Oyster women, a women who deals in oysters. -- Pearl oyster. (Zoöl.) See under Pearl. -- Thorny oyster (Zoöl.), any spiny marine shell of the genus Spondylus.
oyster-green |A green membranous seaweed (Ulva) often found growing on oysters but common on stones, piles, etc.
oystering |Gathering, or dredging for, oysters.
oysterling |A young oyster.
ozena |A discharge of fetid matter from the nostril, particularly if associated with ulceration of the soft parts and disease of the bones of the nose.
ozocerite |A waxlike mineral resin; -- sometimes called native paraffin, and mineral wax.
ozonation |The act of treating with ozone; also, the act of converting into, or producing, ozone; ozonization.
ozone |A colorless gaseous substance (O
ozone paper |Paper coated with starch and potassium iodine. It turns blue when exposed to ozone.>-- also called starch-iodide paper --> P.
ozonic |Pertaining to, resembling, or containing, ozone.
ozonification |The act or process of producing, or of subjecting to the action of, ozone.
ozonization |Ozonation.
ozonize |(a) To convert into ozone, as oxygen. (b) To treat with ozone.
ozonizer |An apparatus or agent for the production or application of ozone.
ozonometer |An instrument for ascertaining the amount of ozone in the atmosphere, or in any gaseous mixture. Faraday.
ozonometric |Pertaining to, or used for, the determination of the amount of ozone; of or relating to ozonometry.
ozonometry |The measurement or determination of the quantity of ozone.
ozonoscope |An apparatus employed to indicate the presence, or the amount, of ozone.
ozonoscopic |Serving to indicate the presence or the amount of ozone.
ozonous |Pertaining to or containing, ozone.
p |the sixteenth letter of the English alphabet, is a nonvocal consonant whose form and value come from the Latin, into which language the letter was brought, through the ancient Greek, from the Phonician, its probable origin being Egyptian. Etymologically P is most closely related to b, f, and v; as hobble, hopple; father, paternal; recipient, receive. See B, F, and M. See Guide to Pronunciation, §§ 247, 248, and 184-195.
pa |A shortened form of Papa.
paage |A toll for passage over another person's grounds. [Written also peage and pedage.]  Burke.
paard |The zebra. [S. Africa]
paas |The Easter festival. [Local, U. S.] Bartlett. Paas egg. See Easter egg, under Easter.\n\nPace [Obs.]  Chaucer
pabular |Of, pertaining to, or fit for, pabulum or food; affording food.
pabulation |1. The act of feeding, or providing food. [Obs.]  Cockeram. 2. Food; fodder; pabulum. [Obs.]
pabulous |Affording pabulum, or food; alimental. [R.]  Sir T. Browne.
pabulum |The means of nutriment to animals or plants; food; nourishment; hence, that which feeds or sustains, as fuel for a fire; that upon which the mind or soul is nourished; as, intellectual pabulum.
pac |A kind of moccasin, having the edges of the sole turned up and sewed to the upper. Knight.
paca |A small South American rodent (Cologenys paca), having blackish brown fur, with four parallel rows of white spots along its sides; the spotted cavy. It is nearly allied to the agouti and the Guinea pig.
pacable |Placable. [R.]  Coleridge.
pacane |A species of hickory. See Pecan.
pacate |Appeased; pacified; tranquil. [R.]
pacated |Pacified; pacate.
pacation |The act of pacifying; a peacemaking.  Coleridge.
pacer |One who, or that which, paces; especially, a horse that paces.
pachacamac |A divinity worshiped by the ancient Peruvians as the creator of the universe.
pachak |The fragrant roots of the Saussurea Costus, exported from India to China, and used for burning as incense. It is supposed to be the costus of the ancients. [Written also putchuck.]
pachalic |See Pashalic.
pachisi |A game adopted from the Indian game, using disks, as of pasteboard, and dice. [U. S. & Eng.]\n\nA game, somewhat resembling backgammon, originating in India.
pachometer |An instrument for measuring thickness, as of the glass of a mirror, or of paper; a pachymeter.
pachonta |A substance resembling gutta-percha, and used to adulterate it, obtained from the East Indian tree Isonandra acuminata.
pachuca tank |A high and narrow tank, with a central cylinder for the introduction of compressed air, used in the agitation and settling of pulp (pulverized ore and water) during treatment by the cyanide process; -- so named because, though originally devised in New Zealand, it was first practically introduced in Pachuca, Mexico.
pachy- |A combining form meaning thick; as, pachyderm, pachydactyl.
pachycarpous |Having the pericarp thick.
pachydactyl |A bird or other animal having thick toes.
pachydactylous |Having thick toes.
pachyderm |One of the Pachydermata.
pachydermal |Of or relating to the pachyderms; as, pachydermal dentition.
pachydermata |A group of hoofed mammals distinguished for the thickness of their skins, including the elephant, hippopotamus, rhinoceros, tapir, horse, and hog. It is now considered an artificial group.
pachydermatous |1. (Zoöl.) Of or pertaining to the pachyderms. 2. Thick-skinned; not sensitive to ridicule.
pachydermoid |Related to the pachyderms.
pachyglossal |Having a thick tongue; --applied to a group of lizards (Pachyglossæ), including the iguanas and agamas.
pachymeningitis |Inflammation of the dura mater or outer membrane of the brain.
pachymeter |Same as Pachometer.
pachyote |One of a family of bats, including those which have thick external ears.
pacifiable |Capable of being pacified or appeased; placable.
pacific |Of or pertaining to peace; suited to make or restore peace; of a peaceful character; not warlike; not quarrelsome; conciliatory; as, pacific words or acts; a pacific nature or condition. Pacific Ocean, the ocean between America and Asia, so called by Magellan, its first European navigator, on account of the exemption from violent tempests which he enjoyed while sailing over it; -- called also, simply, the Pacific, and, formerly, the South sea. Syn. -- Peacemaking; appeasing; conciliatory; tranquil; calm; quiet; peaceful; reconciling; mild; gentle.
pacificable |Placable. [R.]  Bp. Hall.
pacifical |Of or pertaining to peace; pacific. [R.] Sir H. Wotton. -- Pa*cif\"ic*al*ly, adv. [R.]
pacification |The act or process of pacifying, or of making peace between parties at variance; reconciliation. \"An embassy of pacification.\" Bacon.
pacificator |One who, or that which, pacifies; a peacemaker.  Bacon.
pacificatory |Tending to make peace; conciliatory.  Barrow.
pacifico |A peaceful person; -- applied specif. by the Spaniards to the natives in Cuba and the Philippine Islands who did not oppose the Spanish arms. While we were going through the woods one of the pacificos pointed to a new grave. Harper's Weekly.
pacifier |One who pacifies.
pacify |To make to be at peace; to appease; to calm; to still; to quiet; to allay the agitation, excitement, or resentment of; to tranquillize; as, to pacify a man when angry; to pacify pride, appetite, or importunity. \"Pray ye, pacify yourself.\" Shak. To pacify and settle those countries. Bacon.
pacinian |Of, pertaining to, or discovered by, Filippo Pacini, an Italian physician of the 19th century. Pacinian corpuscles, small oval bodies terminating some of the minute branches of the sensory nerves in the integument and other parts of the body. They are supposed to be tactile organs.
pack |1. To make a pack of; to arrange closely and securely in a pack; hence, to place and arrange compactly as in a pack; to press into close order or narrow compass; as to pack goods in a box; to pack fish. Strange materials packed up with wonderful art. Addison. Where . . . the bones Of all my buried ancestors are packed. Shak. 2. To fill in the manner of a pack, that is, compactly and securely, as for transportation; hence, to fill closely or to repletion; to stow away within; to cause to be full; to crowd into; as, to pack a trunk; the play, or the audience, packs the theater. 3. To sort and arrange (the cards) in a pack so as to secure the game unfairly. And mighty dukes pack cards for half a crown. Pope. 4. Hence: To bring together or make up unfairly and fraudulently, in order to secure a certain result; as, to pack a jury or a causes. The expected council was dwindling into . . . a packed assembly of Italian bishops. Atterbury. 5. To contrive unfairly or fraudulently; to plot. [Obs.] He lost life . . . upon a nice point subtilely devised and packed by his enemies. Fuller. 6. To load with a pack; hence, to load; to encumber; as, to pack a horse. Our thighs packed with wax, our mouths with honey. Shack. 7. To cause to go; to send away with baggage or belongings; esp., to send away peremptorily or suddenly; -- sometimes with off; as, to pack a boy off to school. He . . . must not die Till George be packed with post horse up to heaven. Shak. 8. To transport in a pack, or in the manner of a pack (i. e., on the backs of men or beasts). [Western U.S.] 9. (Hydropathy)  To envelop in a wet or dry sheet, within numerous coverings. See Pack, n., 5. 10. (Mech.)  To render impervious, as by filling or surrounding with suitable material, or to fit or adjust so as to move without giving passage to air, water, or steam; as, to pack a joint; to pack the piston of a steam engine.\n\n1. To make up packs, bales, or bundles; to stow articles securely for transportation. 2. To admit of stowage, or of making up for transportation or storage; to become compressed or to settle together, so as to form a compact mass; as, the goods pack conveniently; wet snow packs well. 3. To gather in flocks or schools; as, the grouse or the perch begin to pack. [Eng.] 4. To depart in haste; -- generally with off or away. Poor Stella must pack off to town Swift. You shall pack, And never more darken my doors again. Tennyson. 5. To unite in bad measures; to confederate for ill purposes; to join in collusion. [Obs.] \"Go pack with him.\" Shak. To send packing, to drive away; to send off roughly or in disgrace; to dismiss unceremoniously. \"The parliament . . . presently sent him packing. South.
pack herse |See under 2d Pack.
pack saddle |See under 2d Pack.
pack thread |See under 2d Pack.
package |1. Act or process of packing. 2. A bundle made up for transportation; a packet; a bale; a parcel; as, a package of goods. 3. A charge made for packing goods. 4. A duty formerly charged in the port of London on goods imported or exported by aliens, or by denizens who were the sons of aliens.
packer |A person whose business is to pack things; especially, one who packs food for preservation; as, a pork packer.
packet |1. A small pack or package; a little bundle or parcel; as, a packet of letters. Shak. 2. Originally, a vessel employed by government to convey dispatches or mails; hence, a vessel employed in conveying dispatches, mails, passengers, and goods, and having fixed days of sailing; a mail boat. Packet boat, ship, or vessel. See Packet, n., 2. -- Packet day, the day for mailing letters to go by packet; or the sailing day. -- Packet note or post. See under Paper.\n\n1. To make up into a packet or bundle. 2. To send in a packet or dispatch vessel. Her husband Was packeted to France. Ford.\n\nTo ply with a packet or dispatch boat.
packfong |A Chinese alloy of nickel, zinc, and copper, resembling German silver.
packhouse |Warehouse for storing goods.
packing |1. The act or process of one who packs. 2. Any material used to pack, fill up, or make close. Specifically (Mach.):  A substance or piece used to make a joint impervious; as: (a) A thin layer, or sheet, of yielding or elastic material inserted between the surfaces of a flange joint. (b) The substance in a stuffing box, through which a piston rod slides. (c) A yielding ring, as of metal, which surrounds a piston and maintains a tight fit, as inside a cylinder, etc. 3. (Masonry)  Same as Filling. [Rare in the U. S.] 4. A trick; collusion. [Obs.] Bale. Cherd packing (Bridge Building), the arrangement, side by side, of several parts, as bars, diagonals, a post, etc., on a pin at the bottom of a chord. Waddell. -- Packing box, a stuffing box. See under Stuffing. -- Packing press, a powerful press for baling cotton, wool, hay, etc. -- Packing ring. See Packing, 2 (c), and Illust. of Piston. -- Packing sheet. (a) A large cloth for packing goods. (b) A sheet prepared for packing hydropathic patients.
packman |One who bears a pack; a peddler.
packwax |Same as Paxwax.
packway |A path, as over mountains, followed by pack animals.
paco |1. (Zoöl.)  Same as Alpaca. 2. Etym: [Peruv. paco, pacu, red, reddish, reddish ore containing silver; perh. a different word.] (Min.)  An earthy-looking ore, consisting of brown oxide of iron with minute particles of native silver. Ure.
pacos |1. (Zoöl.)  Same as Alpaca. 2. Etym: [Peruv. paco, pacu, red, reddish, reddish ore containing silver; perh. a different word.] (Min.)  An earthy-looking ore, consisting of brown oxide of iron with minute particles of native silver. Ure.
pact |An agreement; a league; a compact; a covenant. Bacon. The engagement and pact of society whish goes by the name of the constitution. Burke.
paction |An agreement; a compact; a bargain. [R.] Sir W. Scott.
pactional |Of the nature of, or by means of, a paction. Bp. Sanderson.
pactitious |Setted by a pact, or agreement. [R.] Johnson.
pactolian |Pertaining to the Pactolus, a river in ancient Lydia famous for its golden sands.
pacu |A South American freah-water fish (Myleies pacu), of the family Characinidæ. It is highly esteemed as food.
pad |1. A footpath; a road. [Obs. or Prov. Eng.] 2. An easy-paced horse; a padnag. Addison An abbot on an ambling pad. Tennyson. 3. A robber that infests the road on foot; a highwayman; -- usually called a footpad. Gay. Byron. 4. The act of robbing on the highway. [Obs.]\n\nTo travel upon foot; to tread. [Obs.] Padding the streets for half a crown. Somerville.\n\n1. To travel heavily or slowly. Bunyan. 2. To rob on foot. [Obs.] Cotton Mather. 3. To wear a path by walking. [Prov. Eng.]\n\n1. A soft, or small, cushion; a mass of anything soft; stuffing. 2. A kind of cushion for writing upon, or for blotting; esp., one formed of many flat sheets of writing paper, or layers of blotting paper; a block of paper. 3. A cushion used as a saddle without a tree or frame. 4. A stuffed guard or protection; esp., one worn on the legs of horses to prevent bruising. 5. (Zoöl.)  A cushionlike thickening of the skin one the under side of the toes of animals. 6. A floating leaf of a water lily or similar plant. 7. (Med.)  A soft bag or cushion to relieve pressure, support a part, etc. 8. (Naut.)  A piece of timber fixed on a beam to fit the curve of the deck. W. C. Russel. 9. A measure for fish; as, sixty mackerel go to a pad; a basket of soles. [Eng.] Simmonds. Pad cloth, a saddlecloth; a housing. -- Pad saddle. See def. 3, above. -- Pad tree (Harness Making), a piece of wood or metal which gives rigidity and shape to a harness pad. Knight.\n\n1. To stuff; to furnish with a pad or padding. 2. (Calico Printing)  To imbue uniformly with a mordant; as, to pad cloth. Ure.
pad elephant |An elephant that is furnished with a pad for carrying burdens instead of with a howdah for carrying passengers.
padar |Groats; coarse flour or meal. [Obs.] Sir. H. Wotton.
padder |1. One who, or that which, pads. 2. A highwayman; a footpad. [Obs.]
padding |1. The act or process of making a pad or of inserting stuffing. 2. The material with which anything is padded. 3. Material of inferior value, serving to extend a book, essay, etc. London Sat. Rev. 4. (Calico Printing)  The uniform impregnation of cloth with a mordant.
paddle |1. To use the hands or fingers in toying; to make caressing strokes. [Obs.] Shak. 2. To dabble in water with hands or feet; to use a paddle, or something which serves as a paddle, in swimming, in paddling a boat, etc. As the men were paddling for their lives. L'Estrange. While paddling ducks the standing lake desire. Gay.\n\n1. To pat or stroke amorously, or gently. To be paddling palms and pinching fingers. Shak. 2. To propel with, or as with, a paddle or paddles. 3. To pad; to tread upon; to trample. [Prov. Eng.]\n\n1. An implement with a broad blade, which is used without a fixed fulcrum in propelling and steering canoes and boats. 2. The broad part of a paddle, with which the stroke is made; hence, any short, broad blade, resembling that of a paddle. Thou shalt have a paddle upon thy weapon. Deut. xxiii. 13. 3. One of the broad boards, or floats, at the circumference of a water wheel, or paddle wheel. 4. A small gate in sluices or lock gates to admit or let off water; - - also called clough. 5. (Zoöl.)  A paddle-shaped foot, as of the sea turtle. 6. A paddle-shaped implement for string or mixing. 7. Etym: [In this sense prob. for older spaddle, a dim. of spade.]  See Paddle staff (b), below. [Prov. Eng.] Paddle beam (Shipbuilding), one of two large timbers supporting the spring beam and paddle box of a steam vessel. -- Paddle board. See Paddle, n., 3. -- Paddle box, the structure inclosing the upper part of the paddle wheel of a steam vessel. -- Paddle shaft, the revolving shaft which carries the paddle wheel of a steam vessel. -- Paddle staff. (a) A staff tipped with a broad blade, used by mole catchers. [Prov. Eng.] (b) A long-handled spade used to clean a plowshare; -- called also plow staff. [Prov. Eng.] -- Paddle steamer, a steam vessel propelled by paddle wheels, in distinction from a screw propeller. -- Paddle wheel, the propelling wheel of a steam vessel, having paddles (or floats) on its circumference, and revolving in a vertical plane parallel to the vessel's length.
paddlecock |The lumpfish. [Prov. Eng.]
paddlefish |A large ganoid fish (Polyodon spathula) found in the rivers of the Mississippi Valley. It has a long spatula-shaped snout. Called also duck-billed cat, and spoonbill sturgeon.
paddler |One who, or that which, paddles.\n\nOne who, or that which, paddles.
paddlewood |The light elastic wood of the Aspidosperma excelsum, a tree of Guiana having a fluted trunk readily split into planks.
paddock |A toad or frog. Wyclif. \"Loathed paddocks.\" Spenser Paddock pipe (Bot.), a hollow-stemmed plant of the genus Equisetum, especially E. limosum and the fruiting stems of E. arvense; -- called also padow pipe and toad pipe. See Equisetum. -- Paddock stone. See Toadstone. -- Paddock stool (Bot.),a toadstool.\n\n1. A small inclosure or park for sporting. [Obs.] 2. A small inclosure for pasture; esp., one adjoining a stable. Evelyn. Cowper.
paddy |Low; mean; boorish; vagabond. \"Such pady persons.\" Digges (1585). \"The paddy persons.\" Motley.\n\nA jocose or contemptuous name for an Irishman.\n\nUnhusked rice; -- commonly so called in the East Indies. Paddy bird. (Zoöl.) See Java sparrow, under Java.
padelion |A plant with pedately lobed leaves; the lady's mantle.
padella |A large cup or deep saucer, containing fatty matter in which a wick is placed, -- used for public illuminations, as at St. Peter's, in Rome. Called also padelle.
pademelon |See Wallaby.
padesoy |See Paduasoy.
padge |The barn owl; -- called also pudge, and pudge owl. [Prov. Eng.]
padishah |Chief ruler; monarch; sovereign; -- a title of the Sultan of Turkey, and of the Shah of Persia.
padlock |1. A portable lock with a bow which is usually jointed or pivoted at one end so that it can be opened, the other end being fastened by the bolt, -- used for fastening by passing the bow through a staple over a hasp or through the links of a chain, etc. 2. Fig.: A curb; a restraint.\n\nTo fasten with, or as with, a padlock; to stop; to shut; to confine as by a padlock. Milton. Tennyson.
padnag |An ambling nag. \"An easy padnag.\" Macaulay.
padow |A paddock, or toad. Padow pipe. (Bot.) See Paddock pipe, under Paddock.
padre |1. A Christian priest or monk; -- used in Italy, Spain, Portugal, and Spanish America. 2.  In India (from the Portuguese), any Christian minister; also, a priest of the native region. Kipling.
padrone |1. A patron; a protector. 2. The master of a small coaster in the Mediterranean. 3. A man who imports, and controls the earnings of, Italian laborers, street musicians, etc.
paduasoy |A rich and heavy silk stuff. [Written also padesoy.]
paducahs |See Comanches.
paean |1. An ancient Greek hymn in honor of Apollo as a healing deity, and, later, a song addressed to other deities. 2. Any loud and joyous song; a song of triumph. Dryden. \"Public pæans of congratulation.\" De Quincey. 3. See Pæon.
paedobaptism |Pedobaptism.
paedogenesis |Reproduction by young or larval animals.
paedogenetic |Producing young while in the immature or larval state; -- said of certain insects, etc.
paeon |A foot of four syllables, one long and three short, admitting of four combinations, according to the place of the long syllable. [Written also, less correctly, pæan.]
paeonine |An artifical red nitrogenous dyestuff, called also red coralline.
paeony |See Peony.
pagan |One who worships false goods; an idolater; a heathen; one who is neither a Christian, a Mohammedan, nor a Jew. Neither having the accent of Christians, nor the gait of Christian, pagan, nor man. Shak. Syn. -- Gentile; heathen; idolater. -- Pagan, Gentile, Heathen. Gentile was applied to the other nations of the earth as distinguished from the Jews. Pagan was the name given to idolaters in the early Christian church, because the villagers, being most remote from the centers of instruction, remained for a long time unconverted. Heathen has the same origin. Pagan is now more properly applied to rude and uncivilized idolaters, while heathen embraces all who practice idolatry.\n\nOf or pertaining to pagans; relating to the worship or the worshipers of false goods; heathen; idolatrous, as, pagan tribes or superstitions. And all the rites of pagan honor paid. Dryden.
pagandom |The pagan lands; pagans, collectively; paganism. [R.]
paganic |Of or pertaining to pagans or paganism; heathenish; paganish. [R.] \"The paganic fables of the goods.\" Cudworth. -- Pa*gan\"ic*al*ly, adv. [R.]
paganical |Of or pertaining to pagans or paganism; heathenish; paganish. [R.] \"The paganic fables of the goods.\" Cudworth. -- Pa*gan\"ic*al*ly, adv. [R.]
paganish |Of or pertaining to pagans; heathenish. \"The old paganish idolatry.\" Sharp
paganism |The state of being pagan; pagan characteristics; esp., the worship of idols or false gods, or the system of religious opinions and worship maintained by pagans; heathenism.
paganity |The state of being a pagan; paganism. [R.] Cudworth.
paganize |To render pagan or heathenish; to convert to paganism. Hallywell.\n\nTo behave like pagans. Milton.
paganly |In a pagan manner. Dr. H. More.
page |1. A serving boy; formerly, a youth attending a person of high degree, especially at courts, as a position of honor and education; now commonly, in England, a youth employed for doin errands, waiting on the door, and similar service in households; in the United States, a boy emploed to wait upon the members of a legislative body. He had two pages of honor -- on either hand one. Bacon. 2. A boy child. [Obs.] Chaucer. 3. A contrivance, as a band, pin, snap, or the like, to hold the skirt of a woman's dress from the ground. 4. (Brickmaking.)  A track along which pallets carrying newly molded bricks are conveyed to the hack. 5. (Zoöl.)  Any one of several species of beautiful South American moths of the genus Urania.\n\nTo attend (one) as a page. [Obs.] Shak.\n\n1. One side of a leaf of a book or manuscript. Such was the book from whose pages she sang. Longfellow. 2. Fig.: A record; a writing; as, the page of history. 3. (Print.)  The type set up for printing a page.\n\nTo mark or number the pages of, as a book or manuskript; to furnish with folios.
pageant |1. A theatrical exhibition; a spectacle. \"A pageant truly played.\" Shak. To see sad pageants of men's miseries. Spenser. 2. An elaborate exhibition devised for the entertainmeut of a distinguished personage, or of the public; a show, spectacle, or display. The gaze of fools, and pageant of a day ! Pope. We love the man, the paltry pageant you. Cowper.\n\nOf the nature of a pageant; spectacular. \"Pageant pomp.\" Dryden.\n\nTo exhibit in show; to represent; to mimic. [R.] \"He pageants us.\" Shak.
pageantry |Scenic shows or spectacles, taken collectivelly; spectacular guality; splendor. Such pageantry be to the people shown. Dryden. The pageantry of festival. J. A. Symonds. Syn. -- Pomp; parade; show; display; spectacle.
pagehood |The state of being a page.
pagina |The surface of a leaf or of a flattened thallus.
paginal |Consisting of pages. \"Paginal books.\" Sir T. Browne.
pagination |The act or process of paging a book; also, the characters used in numbering the pages; page number. Lowndes.
paging |The marking or numbering of the pages of a book.
pagod |1. A pagoda. [R.] \"Or some queer pagod.\" Pope. 2. An idol. [Obs.] Bp. Stillingfleet.
pagoda |1. A term by which Europeans designate religious temples and tower- like buildings of the Hindoos and Buddhists of India, Farther India, China, and Japan, -- usually but not always, devoted to idol worship. 2. An idol. [R.] Brande & C. 3. Etym: [Prob. so named from the image of a pagoda or a deity (cf. Skr. bhagavat holy, divine) stamped on it.]  A gold or silver coin, of various kinds and values, formerly current in India. The Madras gold pagoda was worth about three and a half rupees.
pagoda sleeve |A funnel-shaped sleeve arranged to show the sleeve lining and an inner sleeve.
pagodite |Agalmatolite; -- so called because sometimes carved by the Chinese into the form of pagodas. See Agalmatolite.
paguma |Any one of several species of East Indian viverrine mammals of the genus Paguma. They resemble a weasel in form.
pagurian |Any one of a tribe of anomuran crustaceans, of which Pagurus is a type; the hermit crab. See Hermit crab, under Hermit.
pah |An exclamation expressing disgust or contempt. See Bah. Fie! fie! fie! pah! pah! Give me an ounce of civet, good apothecary, to sweeten my imagination. Shak.\n\nA kind of stockaded intrenchment. [New Zealand.] Farrow.
pahi |A large war canoe of the Society Islands.
pahlevi |Same as Pehlevi.
pahoehoe |A name given in the Sandwich Islands to lava having a relatively smooth surface, in distinction from the rough-surfaced lava, called a-a.
pahutes |See Utes.
paid |1. Receiving pay; compensated; hired; as, a paid attorney. 2. Satisfied; contented. [Obs.] \"Paid of his poverty.\" Chaucer.
paideutics |The science or art of teaching.
paien |Pagan. [Obs.] Chaucer.
paigle |A species of Primula, either the cowslip or the primrose. [Written also pagle, pagil, peagle, and pygil.]
paijama |Pyjama.
pail |A vessel of wood or tin, etc., usually cylindrical and having a bail, -- used esp. for carrying liquids, as water or milk, etc.; a bucket. It may, or may not, have a cover. Shak.
pailful |The quantity that a pail will hold. \"By pailfuls.\" Shak.
paillasse |An under bed or mattress of straw. [Written also palliasse.]
paillon |A thin leaf of metal, as for use in gilding or enameling, or to show through a translucent medium.
pailmall |See Pall-mall. [Obs.]
pain |1. Punishment suffered or denounced; suffering or evil inflicted as a punishment for crime, or connected with the commission of a crime; penalty. Chaucer. We will, by way of mulct or pain, lay it upon him. Bacon. Interpose, on pain of my displeasure. Dryden. None shall presume to fly, under pain of death. Addison. 2. Any uneasy sensation in animal bodies, from slight uneasiness to extreme distress or torture, proceeding from a derangement of functions, disease, or injury by violence; bodily distress; bodily suffering; an ache; a smart. \"The pain of Jesus Christ.\" Chaucer. Note: Pain may occur in any part of the body where sensory nerves are distributed, and it is always due to some kind of stimulation of them. The sensation is generally referred to the peripheral end of the nerve. 3. pl.  Specifically, the throes or travail of childbirth. She bowed herself and travailed, for her pains came upon her. 1 Sam. iv. 19. 4. Uneasiness of mind; mental distress; disquietude; anxiety; grief; solicitude; anguish. Chaucer. In rapture as in pain. Keble. 5. See Pains, labor, effort. Bill of pains and penalties. See under Bill. -- To die in the pain, to be tortured to death. [Obs.] Chaucer.\n\n1. To inflict suffering upon as a penalty; to punish. [Obs.] Wyclif (Acts xxii. 5). 2. To put to bodily uneasiness or anguish; to afflict with uneasy sensations of any degree of intensity; to torment; to torture; as, his dinner or his wound pained him; his stomach pained him. Excess of cold, as well as heat, pains us. Lock 3. To render uneasy in mind; to disquiet; to distress; to grieve; as a child's faults pain his parents. I am pained at mJer. iv. 19. To pain one's self, to exert or trouble one's self; to take pains; to be solicitous. [Obs.] \"She pained her to do all that she might.\" Chaucer. Syn. -- To disquiet; trouble; afflict; grieve; aggrieve; distress; agonize; torment; torture.
painable |Causing pain; painful. [Obs.] The manacles of Astyages were not . . . the less weighty and painable for being composed of gold or silver. Evelyn.
painful |1. Full of pain; causing uneasiness or distress, either physical or mental; afflictive; disquieting; distressing Addison. 2. Requiring labor or toil; difficult; executed with laborious effort; as a painful service; a painful march. 3. Painstaking; careful; industrious. [Obs.] Fuller. A very painful person, and a great clerk. Jer. Taylor. Nor must the painful husbandman be tired. Dryden. Syn. -- Disquieting; troublesome; afflictive; distressing; grievous; laborious; toilsome; difficult; arduous. -- Pain\"ful*ly, adv. -- Pain\"ful*ness, n.
painim |A pagan; an infidel; -- used also adjectively. [Written also panim and paynim.] Peacham.
painless |Free from pain; without pain. -- Pain\"less*ly, adv. -- Pain\"less*ness, n.
pains |Labor; toilsome effort; care or trouble taken; -- plural in form, but used with a singular or plural verb, commonly the former. And all my pains is sorted to no proof. Shak. The pains they had taken was very great. Clarendon. The labored earth your pains have sowed and tilled. Dryden.
painstaker |One who takes pains; one careful and faithful in all work. Gay.
painstaking |Careful in doing; diligent; faithful; attentive. \"Painstaking men.\" Harris.\n\nThe act of taking pains; carefulness and fidelity in performance. Beau. & Fl.
painsworthy |Worth the pains o
paint |1. To cover with coloring matter; to apply paint to; as, to paint a house, a signboard, etc. Jezebel painted her face and tired her head. 2 Kings ix. 30. 2. Fig.: To color, stain, or tinge; to adorn or beautify with colors; to diversify with colors. Not painted with the crimson spots of blood. Shak. Cuckoo buds of yellow hue Do paint the meadows with delight. Shak. 3. To form in colors a figure or likeness of on a flat surface, as upon canvas; to represent by means of colors or hues; to exhibit in a tinted image; to portray with paints; as, to paint a portrait or a landscape. 4. Fig.: To represent or exhibit to the mind; to describe vividly; to delineate; to image; to depict. Disloyal The word is too good to paint out her wickedness. Shak. If folly grow romantic, I must paint it. Pope. Syn. -- To color; picture; depict; portray; delineate; sketch; draw; describe.\n\n1. To practice the art of painting; as, the artist paints well. 2. To color one's face by way of beautifying it. Let her paint an inch thick. Shak.\n\n1. (a) A pigment or coloring substance. (b) The same prepared with a vehicle, as oil, water with gum, or the like, for application to a surface. 2. A cosmetic; rouge. Praed.
painted |1. Covered or adorned with paint; portrayed in colors. As idle as a painted ship Upon a painted ocean. Coleridge. 2. (Nat. Hist.)  Marked with bright colors; as, the painted turtle; painted bunting. Painted beauty (Zoöl.), a handsome American butterfly (Vanessa Huntera), having a variety of bright colors, -- Painted cup (Bot.), any plant of an American genus of herbs (Castilleia) in which the bracts are usually bright-colored and more showy than the flowers. Castilleia coccinea has brilliantly scarlet bracts, and is common in meadows. -- Painted finch. See Nonpareil. -- Painted lady (Zoöl.), a bright-colored butterfly. See Thistle butterfly. -- Painted turtle (Zoöl.), a common American freshwater tortoise (Chrysemys picta), having bright red and yellow markings beneath.
painter |A rope at the bow of a boat, used to fasten it to anything. Totten.\n\nThe panther, or puma. [A form representing an illiterate pronunciation, U. S.] J. F. Cooper.\n\nOne whose occupation is to paint; esp.: (a) One who covers buildings, ships, ironwork, and the like, with paint. (b) An artist who represents objects or scenes in color on a flat surface, as canvas, plaster, or the like. Painter's colic. (Med.) See Lead colic, under Colic. -- Painter stainer. (a) A painter of coats of arms. Crabb. (b) A member of a livery company or guild in London, bearing this name.
painterly |Like a painter's work. [Obs.] \"A painterly glose of a visage.\" Sir P. Sidney.
paintership |The state or position of being a painter. [R.] Br. Gardiner.
painting |1. The act or employment of laying on, or adorning with, paints or colors. 2. (Fine Arts)  The work of the painter; also, any work of art in which objects are represented in color on a flat surface; a colored representation of any object or scene; a picture. 3. Color laid on; paint. [R.] Shak. 4. A depicting by words; vivid representation in words. Syn. -- See Picture.
paintless |Not capable of being painted or described. \"In paintless patience.\" Savage.
painture |The art of painting. [Obs.] Chaucer. Dryden.
painty |Unskillfully painted, so that the painter's method of work is too obvious; also, having too much pigment applied to the surface. [Cant]
pair |1. A number of things resembling one another, or belonging together; a set; as, a pair or flight of stairs. \"A pair of beads.\" Chaucer. Beau. & Fl. \"Four pair of stairs.\" Macaulay. Note: [Now mostly or quite disused, except as to stairs.] Two crowns in my pocket, two pair of cards. Beau. & Fl. 2. Two things of a kind, similar in form, suited to each other, and intended to be used together; as, a pair of gloves or stockings; a pair of shoes. 3. Two of a sort; a span; a yoke; a couple; a brace; as, a pair of horses; a pair of oxen. 4. A married couple; a man and wife. \"A happy pair.\" Dryden. \"The hapless pair.\" Milton. 5. A single thing, composed of two pieces fitted to each other and used together; as, a pair of scissors; a pair of tongs; a pair of bellows. 6. Two members of opposite parties or opinion, as in a parliamentary body, who mutually agree not to vote on a given question, or on issues of a party nature during a specified time; as, there were two pairs on the final vote. [Parliamentary Cant] 7. (Kinematics)  In a mechanism, two elements, or bodies, which are so applied to each other as to mutually constrain relative motion. Note: Pairs are named in accordance with the kind of motion they permit; thus, a journal and its bearing form a turning pair, a cylinder and its piston a sliding pair, a screw and its nut a twisting pair, etc. Any pair in which the constraining contact is along lines or at points only (as a cam and roller acting together), is designated a higher pair; any pair having constraining surfaces which fit each other (as a cylindrical pin and eye, a screw and its nut, etc.), is called a lower pair. Pair royal (pl. Pairs Royal) three things of a sort; -- used especially of playing cards in some games, as cribbage; as three kings, three \"eight spots\" etc. Four of a kind are called a double pair royal. \"Something in his face gave me as much pleasure as a pair royal of naturals in my own hand.\" Goldsmith. \"That great pair royal of adamantine sisters [the Fates].\" Quarles. [Written corruptly parial and prial.] Syn. -- Pair, Flight, Set. Originally, pair was not confined to two things, but was applied to any number of equal things (pares), that go together. Ben Jonson speaks of a pair (set) of chessmen; also, he and Lord Bacon speak of a pair (pack) of cards. A \"pair of stairs\" is still in popular use, as well as the later expression, \"flight of stairs.\"\n\n1. To be joined in paris; to couple; to mate, as for breeding. 2. To suit; to fit, as a counterpart. My heart was made to fit and pair with thine. Rowe. 3. Same as To pair off. See phrase below. To pair off, to separate from a company in pairs or couples; specif. (Parliamentary Cant), to agree with one of the opposite party or opinion to abstain from voting on specified questions or issues. See Pair, n., 6.\n\n1. To unite in couples; to form a pair of; to bring together, as things which belong together, or which complement, or are adapted to one another. Glossy jet is paired with shining white. Pope. 2. To engage (one's self) with another of opposite opinions not to vote on a particular question or class of questions. [Parliamentary Cant] Paired fins. (Zoöl.) See under Fin.\n\nTo impair. [Obs.] Spenser.
pairer |One who impairs. [Obs.] Wyclif.
pairing |1. The act or process of uniting or arranging in pairs or couples. 2. See To pair off, under Pair, v. i. Pairyng time, the time when birds or other animals pair.
pairment |Impairment. [Obs.] Wyclif.
pais |The country; the people of the neighborhood. Note: A trial per pais is a trial by the country, that is, by a jury; and matter in pais is matter triable by the country, or jury.
paisano |The chaparral cock.
paise |See Poise. Chapman.
pajamas |Originally, in India, loose drawers or trousers, such as those worn, tied about the waist, by Mohammedan men and women; by extension, a similar garment adopted among Europeans, Americans, etc., for wear in the dressing room and during sleep; also, a suit consisting of drawers and a loose upper garment for such wear.\n\nA garment, similar to the Oriental pyjama (which see), adopted among Europeans, Americans, and other Occidentals, for wear in the dressing room and during sleep; also, a suit of drawers and blouse for such wear.
pajock |A peacock. [Obs.] Shak.
pakfong |See Packfong.
pal |A mate; a partner; esp., an accomplice or confederate. [Slang]
palace |1. The residence of a sovereign, including the lodgings of high officers of state, and rooms for business, as well as halls for ceremony and reception. Chaucer. 2. The official residence of a bishop or other distinguished personage. 3. Loosely, any unusually magnificent or stately house. Palace car. See under Car. -- Palace court, a court having jurisdiction of personal actions arising within twelve miles of the palace at Whitehall. The court was abolished in 1849. [Eng.] Mozley & W.
palacious |Palatial. [Obs.] Graunt.
paladin |A knight-errant; a distinguished champion; as, the paladins of Charlemagne. Sir W. Scott.
palaeo- |See Paleo-.
palaeographer |See Paleographer, Paleographic, etc.
palaeographic |See Paleographer, Paleographic, etc.
palaeotype |A system of representing all spoken sounds by means of the printing types in common use. Ellis. -- Pa`læ*o*typ\"ic*al, a. -- Pa`læ*o*typ\"ic*al*ly, adv.
palaestra |See Palestra.
palaestric |See Palestric.
palaetiologist |One versed in palætiology.
palaetiology |The science which explains, by the law of causation, the past condition and changes of the earth. -- Pa*læ`ti*o*log\"ic*al, a.
palama |A membrane extending between the toes of a bird, and uniting them more or less closely together.
palamate |Web-footed.
palamedeae |An order, or suborder, including the kamichi, and allied South American birds; -- called also screamers. In many anatomical characters they are allied to the Anseres, but they externally resemble the wading birds.
palampore |See Palempore.
palanka |A camp permanently intrenched, attached to Turkish frontier fortresses.
palanquin |An inclosed carriage or litter, commonly about eight feet long, four feet wide, and four feet high, borne on the shoulders of men by means of two projecting poles, -- used in India, China, etc., for the conveyance of a single person from place to place. [Written also palankeen.]
palapteryx |A large extinct ostrichlike bird of New Zealand.
palatability |Palatableness.
palatable |Agreeable to the palate or taste; savory; hence, acceptable; pleasing; as, palatable food; palatable advice.
palatableness |The quality or state of being agreeable to the taste; relish; acceptableness.
palatably |In a palatable manner.
palatal |1. Of or pertaining to the palate; palatine; as, the palatal bones. 2. (Phonetics)  Uttered by the aid of the palate; -- said of certain sounds, as the sound of k in kirk.\n\nA sound uttered, or a letter pronounced, by the aid of the palate, as the letters k and y.
palatalize |To palatize.
palate |1. (Anat.)  The roof of the mouth. Note: The fixed portion, or palate proper, supported by the maxillary and palatine bones, is called the hard palate to distinguish it from the membranous and muscular curtain which separates the cavity of the mouth from the pharynx and is called the soft palate, or velum. 2. Relish; taste; liking; -- a sense originating in the mistaken notion that the palate is the organ of taste. Hard task! to hit the palate of such guests. Pope. 3. Fig.: Mental relish; intellectual taste. T. Baker. 4. (Bot.)  A projection in the throat of such flowers as the snapdragon.\n\nTo perceive by the taste. [Obs.] Shak.
palatial |Of or pertaining to a palace; suitable for a palace; resembling a palace; royal; magnificent; as, palatial structures. \"Palatial style.\" A. Drummond.\n\nPalatal; palatine. [Obs.] Barrow.\n\nA palatal letter. [Obs.] Sir W. Jones.
palatic |Palatal; palatine.\n\nA palatal. [R.]
palatinate |The province or seigniory of a palatine; the dignity of a palatine. Howell.\n\nTo make a palatinate of. [Obs.] Fuller.
palatine |Of or pertaining to a palace, or to a high officer of a palace; hence, possessing royal privileges. Count palatine, County palatine. See under Count, and County. -- Palatine hill, or The palatine, one of the seven hills of Rome, once occupied by the palace of the Cæsars. See Palace.\n\n1. One invested with royal privileges and rights within his domains; a count palatine. See Count palatine, under 4th Count. 2. The Palatine hill in Rome.\n\nOf or pertaining to the palate. Palatine bones (Anat.), a pair of bones (often united in the adult) in the root of the mouth, back of and between the maxillaries.\n\n, (Anat.) A palatine bone.
palative |Pleasing to the taste; palatable. [Obs.] \"Palative delights.\" Sir T. Browne.
palatize |To modify, as the tones of the voice, by means of the palate; as, to palatize a letter or sound. -- Pal`a*ti*za\"tion, n. J. Peile.
palato- |A combining form used in anatomy to indicate relation to, or connection with, the palate; as in palatolingual.
palatonares |The posterior nares. See Nares.
palatopterygoid |Pertaining to the palatine and pterygoid region of the skull; as, the palatopterygoid cartilage, or rod, from which the palatine and pterygoid bones are developed.
palaver |1. Talk; conversation; esp., idle or beguiling talk; talk intended to deceive; flattery. 2. In Africa, a parley with the natives; a talk; hence, a public conference and deliberation; a debate. This epoch of parliaments and eloquent palavers. Carlyle.\n\nTo make palaver with, or to; to used palaver;to talk idly or deceitfully; to employ flattery; to cajole; as, to palaver artfully. Palavering the little language for her benefit. C. Bront
palaverer |One who palavers; a flatterer.
pale |1. Wanting in color; not ruddy; dusky white; pallid; wan; as, a pale face; a pale red; a pale blue. \"Pale as a forpined ghost.\" Chaucer. Speechless he stood and pale. Milton. They are not of complexion red or pale. T. Randolph. 2. Not bright or brilliant; of a faint luster or hue; dim; as, the pale light of the moon. The night, methinks, is but the daylight sick; It looks a little paler. Shak. Note: Pale is often used in the formation of self-explaining compounds; as, pale-colored, pale-eyed, pale-faced, pale-looking, etc.\n\nPaleness; pallor. [R.] Shak.\n\nTo turn pale; to lose color or luster. Whittier. Apt to pale at a trodden worm. Mrs. Browning.\n\nTo make pale; to diminish the brightness of. The glowpale his uneffectual fire. Shak.\n\n1. A pointed stake or slat, either driven into the ground, or fastened to a rail at the top and bottom, for fencing or inclosing; a picket. Deer creep through when a pale tumbles down. Mortimer. 2. That which incloses or fences in; a boundary; a limit; a fence; a palisade. \"Within one pale or hedge.\" Robynson (More's Utopia). 3. A space or field having bounds or limits; a limited region or place; an inclosure; -- often used figuratively. \"To walk the studious cloister's pale.\" Milton. \"Out of the pale of civilization.\" Macaulay. 4. A stripe or band, as on a garment. Chaucer. 5. (Her.)  One of the greater ordinaries, being a broad perpendicular stripe in an escutcheon, equally distant from the two edges, and occupying one third of it. 6. A cheese scoop. Simmonds. 7. (Shipbuilding)  A shore for bracing a timber before it is fastened. English pale (Hist.), the limits or territory within which alone the English conquerors of Ireland held dominion for a long period after their invasion of the country in 1172. Spencer.\n\nTo inclose with pales, or as with pales; to encircle; to encompass; to fence off. [Your isle, which stands] ribbed and paled in With rocks unscalable and roaring waters. Shak.
palea |1. (Bot.) (a) The interior chaff or husk of grasses. (b) One of the chaffy scales or bractlets growing on the receptacle of many compound flowers, as the Coreopsis, the sunflower, etc. 2. (Zoöl.)  A pendulous process of the skin on the throat of a bird, as in the turkey; a dewlap.
paleaceous |Chaffy; resembling or consisting of paleæ, or chaff; furnished with chaff; as, a paleaceous receptacle.
palearctic |Belonging to a region of the earth's surface which includes all Europe to the Azores, Iceland, and all temperate Asia.
paled |1. Striped. [Obs.] \"[Buskins] . . . paled part per part.\" Spenser. 2. Inclosed with a paling. \"A paled green.\" Spenser.
paleechinoidea |An extinct order of sea urchins found in the Paleozoic rocks. They had more than twenty vertical rows of plates. Called also Palæechini. [Written also Palæechinoidea.]
paleface |A white person; -- an appellation supposed to have been applied to the whites by the American Indians. J. F. Cooper.
paleichthyes |A comprehensive division of fishes which includes the elasmobranchs and ganoids. [Written also Palæichthyes.]
palely |In a pale manner; dimly; wanly; not freshly or ruddily. Thackeray.
palempore |A superior kind of dimity made in India, -- used for bed coverings. [Written also palampore, palampoor, etc.] De Colange.
paleness |The quality or condition of being pale; want of freshness or ruddiness; a sickly whiteness; lack of color or luster; wanness. The blood the virgin's cheek forsook; A livid paleness spreads o'er all her look. Pope.
palenque |A collective name for the Indians of Nicaragua and Honduras.
paleo- |A combining form meaning old, ancient; as, palearctic, paleontology, paleothere, paleography. [Written also palæo-.]
paleobotanist |One versed in paleobotany.
paleobotany |That branch of paleontology which treats of fossil plants.
paleocarida |Same as Merostomata. [Written also Palæocarida.]
paleocrinoidea |A suborder of Crinoidea found chiefly in the Paleozoic rocks.
paleocrystic |Of, pertaining to, or derived from, a former glacial formation.
paleogaean |Of or pertaining to the Eastern hemisphere. [Written also palæogæan.]
paleograph |An ancient manuscript.
paleographer |One skilled in paleography; a paleographist.
paleographic |Of or pertaining to paleography.
paleographical |Of or pertaining to paleography.
paleographist |One versed in paleography; a paleographer.
paleography |1. An ancient manner of writing; ancient writings, collectively; as, Punic paleography. 2. The study of ancient inscriptions and modes of writing; the art or science of deciphering ancient writings, and determining their origin, period, etc., from external characters; diplomatics.
paleola |A diminutive or secondary palea; a lodicule.
paleolith |A relic of the Paleolithic era.
paleolithic |Of or pertaining to an era marked by early stone implements. The Paleolithic era (as proposed by Lubbock) includes the earlier half of the \"Stone Age;\" the remains belonging to it are for the most part of extinct animals, with relics of human beings.
paleologist |One versed in paleology; a student of antiquity.
paleology |The study or knowledge of antiquities, esp. of prehistoric antiquities; a discourse or treatise on antiquities; archæology .
paleontographical |Of or pertaining to the description of fossil remains.
paleontography |The description of fossil remains.
paleontological |Of or pertaining to paleontology. -- Pa`le*on`to*log\"ic*al*ly, adv.
paleontologist |One versed in paleontology.
paleontology |The science which treats of the ancient life of the earth, or of fossils which are the remains of such life.
paleophytologist |A paleobotanist.
paleophytology |Paleobotany.
paleornithology |The branch of paleontology which treats of fossil birds.
paleosaurus |A genus of fossil saurians found in the Permian formation.
paleotechnic |Belonging to, or connected with, ancient art. \"The paleotechnic men of central France.\" D. Wilson.
paleothere |Any species of Paleotherium.
paleotherian |Of or pertaining to Paleotherium.
paleotherium |An extinct genus of herbivorous Tertiary mammals, once supposed to have resembled the tapir in form, but now known to have had a more slender form, with a long neck like that of a llama. [Written also Palæotherium.]
paleotheroid |Resembling Paleotherium. -- n.  An animal resembling, or allied to, the paleothere.
paleotype |See Palæotype.
paleous |Chaffy; like chaff; paleaceous. [R.] Sir T. Browne.
paleozoic |Of or pertaining to, or designating, the older division of geological time during which life is known to have existed, including the Silurian, Devonian, and Carboniferous ages, and also to the life or rocks of those ages. See Chart of Geology.
paleozoic era |The Paleozoic time or strata.
paleozooelogy |The science of extinct animals, a branch of paleontology.
paleozoology |The science of extinct animals, a branch of paleontology.
palesie |Palsy. [Obs.] Wyclif.
palestinean |Of or pertaining to Palestine.
palestinian |Of or pertaining to Palestine.
palestra |(a) A wrestling school; hence, a gymnasium, or place for athletic exercise in general. (b) A wrestling; the exercise of wrestling.
palestrian |Of or pertaining to the palestra, or to wrestling.
palestric |Of or pertaining to the palestra, or to wrestling.
palestrical |Of or pertaining to the palestra, or to wrestling.
palesy |Palsy. [Obs.] Wyclif.
palet |Same as Palea.\n\nA perpendicular band upon an escutcheon, one half the breadth of the pale.
paletot |(a) An overcoat. Dickens. (b) A lady's outer garment, -- of varying fashion.
palette |1. (Paint.)  A thin, oval or square board, or tablet, with a thumb hole at one end for holding it, on which a painter lays and mixes his pigments. [Written also pallet.] 2. (Anc. Armor)  One of the plates covering the points of junction at the bend of the shoulders and elbows. Fairholt. 3. (Mech.)  A breastplate for a breast drill. Palette knife, a knife with a very flexible steel blade and no cutting edge, rounded at the end, used by painters to mix colors on the grinding slab or palette. -- To set the palette (Paint.), to lay upon it the required pigments in a certain order, according to the intended use of them in a picture. Fairholt.
palewise |In the manner of a pale or pales; by perpendicular lines or divisions; as, to divide an escutcheon palewise.
palfrey |1. A saddle horse for the road, or for state occasions, as distinguished from a war horse. Chaucer. 2. A small saddle horse for ladies. Spenser. Call the host and bid him bring Charger and palfrey. Tennyson.
palfreyed |Mounted on a palfrey. Tickell.
palgrave |See Palsgrave.
pali |pl. of Palus.\n\nA dialect descended from Sanskrit, and like that, a dead language, except when used as the sacred language of the Buddhist religion in Farther India, etc.
palification |The act or practice of driving piles or posts into the ground to make it firm. [R.] Sir H. Wotton.
paliform |Resembling a palus; as, the paliform lobes of the septa in corals.
palilogy |The repetition of a word, or part of a sentence, for the sake of greater emphasis; as, \"The living, the living, he shall praise thee.\" Is. xxxviii. 19.
palimpsest |A parchment which has been written upon twice, the first writing having been erased to make place for the second. Longfellow.
palindrome |A word, verse, or sentence, that is the same when read backward or forward; as, madam; Hannah; or Lewd did I live, & evil I did dwel.
palindromic |Of, pertaining to, or like, a palindrome.
palindromical |Of, pertaining to, or like, a palindrome.
palindromist |A writer of palindromes.
paling |1. Pales, in general; a fence formed with pales or pickets; a limit; an inclosure. They moved within the paling of order and decorum. De Quincey. 2. The act of placing pales or stripes on cloth; also, the stripes themselves. [Obs.] Chaucer. Paling board, one of the slabs sawed from the sides of a log to fit it to be sawed into boards. [Eng.]
palingenesia |See Palingenesis.
palingenesis |1. A new birth; a re-creation; a regeneration; a continued existence in different manner or form. 2. (Biol.)  That form of evolution in which the truly ancestral characters conserved by heredity are reproduced in development; original simple descent; -- distinguished from kenogenesis. Sometimes, in zoölogy, the abrupt metamorphosis of insects, crustaceans, etc.
palingenesy |1. A new birth; a re-creation; a regeneration; a continued existence in different manner or form. 2. (Biol.)  That form of evolution in which the truly ancestral characters conserved by heredity are reproduced in development; original simple descent; -- distinguished from kenogenesis. Sometimes, in zoölogy, the abrupt metamorphosis of insects, crustaceans, etc.
palingenetic |Of or pertaining to palingenesis: as, a palingenetic process. -- Pal`in*ge*net\"ic*al*ly, adv.
palinode |1. An ode recanting, or retracting, a former one; also, a repetition of an ode. 2. A retraction; esp., a formal retraction. Sandys.
palinodial |Of or pertaining to a palinode, or retraction. J. Q. Adams.
palinody |See Palinode. [Obs.] Wood.
palinurus |An instrument for obtaining directly, without calculation, the true bearing of the sun, and thence the variation of the compass
palisade |1. (Fort.)  A strong, long stake, one end of which is set firmly in the ground, and the other is sharpened; also, a fence formed of such stakes set in the ground as a means of defense. 2. Any fence made of pales or sharp stakes. Palisade cells (Bot.), vertically elongated parenchyma cells, such as are seen beneath the epidermis of the upper surface of many leaves. -- Palisade worm (Zoöl.), a nematoid worm (Strongylus armatus), parasitic in the blood vessels of the horse, in which it produces aneurisms, often fatal.\n\nTo surround, inclose, or fortify, with palisades.
palisading |) A row of palisades set in the ground.
palisado |A palisade. [Obs.] Shak.\n\nTo palisade. [Obs.] Sterne.
palish |Somewhat pale or wan.
palissander |(a) Violet wood. (b) Rosewood.
palissy |Designating, or of the nature of, a kind of pottery made by Bernard Palissy, in France, in the 16th centry. Palissy ware, glazed pottery like that made by Bernard Palissy; especially, that having figures of fishes, reptiles, etc., in high relief.
palkee |A palanquin. Malcom.
pall |Same as Pawl.\n\n1. An outer garment; a cloak mantle. His lion's skin changed to a pall of gold. Spenser. 2. A kind of rich stuff used for garments in the Middle Ages. [Obs.] Wyclif (Esther viii. 15). 3. (R. C. Ch.)  Same as Pallium. About this time Pope Gregory sent two archbishop's palls into England, -- the one for London, the other for York. Fuller. 4. (Her.)  A figure resembling the Roman Catholic pallium, or pall, and having the form of the letter Y. 5. A large cloth, esp., a heavy black cloth, thrown over a coffin at a funeral; sometimes, also, over a tomb. Warriors carry the warrior's pall. Tennyson. 6. (Eccl.)  A piece of cardboard, covered with linen and embroidered on one side; -- used to put over the chalice.\n\nTo cloak. [R.] Shak\n\nTo become vapid, tasteless, dull, or insipid; to lose strength, life, spirit, or taste; as, the liquor palls. Beauty soon grows familiar to the lover, Fades in the eye, and palls upon the sense. Addisin.\n\n1. To make vapid or insipid; to make lifeless or spiritless; to dull; to weaken. Chaucer. Reason and reflection . . . pall all his enjoyments. Atterbury. 2. To satiate; to cloy; as, to pall the appetite.\n\nNausea. [Obs.] Shaftesbury.
pall-mall |A game formerly common in England, in which a wooden ball was driven with a mallet through an elevated hoop or ring of iron. The name was also given to the mallet used, to the place where the game was played, and to the street, in London, still called Pall Mall. [Written also pail-mail and pell-mell.] Sir K. Digby. Evelyn.
palla |An oblong rectangular piece of cloth, worn by Roman ladies, and fastened with brooches.
palladian |Of, pertaining to, or designating, a variety of the revived classic style of architecture, founded on the works of Andrea Palladio, an Italian architect of the 16th century.
palladic |Of, pertaining to, or derived from, palladium; -- used specifically to designate those compounds in which the element has a higher valence as contrasted with palladious compounds.
palladious |Of, pertaining to, or containing, palladium; -- used specifically to designate those compounds in which palladium has a lower valence as compared with palladic compounds.
palladium |1. (Gr. Antiq.)  Any statue of the goddess Pallas; esp., the famous statue on the preservation of which depended the safety of ancient Troy. 2. Hence: That which affords effectual protection or security; a sateguard; as, the trial by jury is the palladium of our civil rights. Blackstone.\n\nA rare metallic element of the light platinum group, found native, and also alloyed with platinum and gold. It is a silver-white metal resembling platinum, and like it permanent and untarnished in the air, but is more easily fusible. It is unique in its power of occluding hydrogen, which it does to the extent of nearly a thousand volumes, forming the alloy Pd2H. It is used for graduated circles and verniers, for plating certain silver goods, and somewhat in dentistry. It was so named in 1804 by Wollaston from the asteroid Pallas, which was discovered in 1802. Symbol Pd. Atomic weight, 106.2.
palladiumize |To cover or coat with palladium. [R.]
pallah |A large South African antelope (Æpyceros melampus). The male has long lyrate and annulated horns. The general color is bay, with a black crescent on the croup. Called also roodebok.
pallas |Pallas Athene, the Grecian goddess of wisdom, called also Athene, and identified, at a later period, with the Roman Minerva.
pallbearer |One of those who attend the coffin at a funeral; -- so called from the pall being formerly carried by them.
pallet |A small and mean bed; a bed of straw. Milton.\n\n1. (Paint.)  Same as Palette. 2. (Pettery) (a) A wooden implement used by potters, crucible makers, etc., for forming, beating, and rounding their works. It is oval, round, and of other forms. (b) A potter's wheel. 3. (Gilding) (a) An instrument used to take up gold leaf from the pillow, and to apply it. (b) A tool for gilding the backs of books over the bands. 4. (Brickmaking)  A board on which a newly molded brick is conveyed to the hack. Knight. 5. (Mach.) (a) A click or pawl for driving a ratchet wheel. (b) One of the series of disks or pistons in the chain pump. Knight. 6. (Horology)  One of the pieces or levers connected with the pendulum of a clock, or the balance of a watch, which receive the immediate impulse of the scape-wheel, or balance wheel. Brande & C. 7. (Mus.)  In the organ, a valve between the wind chest and the mouth of a pipe or row of pipes. 8. (Zoöl.)  One of a pair of shelly plates that protect the siphon tubes of certain bivalves, as the Teredo. See Illust. of Teredo. 9. A cup containing three ounces, --
pallial |Of or pretaining to a mantle, especially to the mantle of mollusks; produced by the mantle; as, the pallial line, or impression, which marks the attachment of the mantle on the inner surface of a bivalve shell. See Illust. of Bivalve. Pallial chamber (Zoöl.), the cavity inclosed by the mantle. -- Pallial sinus (Zoöl.), an inward bending of the pallial line, near the posterior end of certain bivalve shells, to receive the siphon. See Illust. of Bivalve.
palliament |A dress; a robe. [Obs.] Shak.
palliard |1. A born beggar; a vagabond. [Obs.] Halliwell. 2. A lecher; a lewd person. [Obs.] Dryden.
palliasse |See Paillasse.
palliate |1. Covered with a mant [Obs.] Bp. Hall. 2. Eased; mitigated; alleviated. [Obs.] Bp. Fell.\n\n1. To cover with a mantle or cloak; to cover up; to hide. [Obs.] Being palliated with a pilgrim's coat. Sir T. Herbert. 2. To cover with excuses; to conceal the enormity of, by excuses and apologies; to extenuate; as, to palliate faults. They never hide or palliate their vices. Swift. 3. To reduce in violence; to lessen or abate; to mitigate; to ease withhout curing; as, to palliate a disease. To palliate dullness, and give time a shove. Cowper. Syn. -- To cover; cloak; hide; extenuate; conceal. -- To Palliate, Extenuate, Cloak. These words, as here compared, are used in a figurative sense in reference to our treatment of wrong action. We cloak in order to conceal completely. We extenuate a crime when we endeavor to show that it is less than has been supposed; we palliate a crime when we endeavor to cover or conceal its enormity, at least in part. This naturally leads us to soften some of its features, and thus palliate approaches extenuate till they have become nearly or quite identical. \"To palliate is not now used, though it once was, in the sense of wholly cloaking or covering over, as it might be, our sins, but in that of extenuating; to palliate our faults is not to hide them altogether, but to seek to diminish their guilt in part.\" Trench.
palliation |1. The act of palliating, or state of being palliated; extenuation; excuse; as, the palliation of faults, offenses, vices. 2. Mitigation; alleviation, as of a disease. Bacon. 3. That which cloaks or covers; disguise; also, the state of being covered or disguised. [Obs.]
palliative |Serving to palliate; serving to extenuate or mitigate.\n\nThat which palliates; a palliative agent. Sir W. Scott.
palliatory |Palliative; extenuating.
pallid |Deficient in color; pale; wan; as, a pallid countenance; pallid blue. Spenser.
pallidity |Pallidness; paleness.
pallidly |In a pallid manner.
pallidness |The quality or state of being pallid; paleness; pallor; wanness.
palliobranchiata |Same as Brachiopoda.
palliobranchiate |Having the pallium, or mantle, acting as a gill, as in brachiopods.
pallium |1. (Anc. Costume)  A large, square, woolen cloak which enveloped the whole person, worn by the Greeks and by certain Romans. It is the Roman name of a Greek garment. 2. (R.C.Ch.)  A band of white wool, worn on the shoulders, with four purple crosses worked on it; a pall. Note: The wool is obtained from two lambs brought to the basilica of St. Agnes, Rome, and blessed. It is worn by the pope, and sent to patriarchs, primates, and archbishops, as a sign that they share in the plenitude of the episcopal office. Befoer it is sent, the pallium is laid on the tomb of St. Peter, where it remains all night. 3. (Zoöl.) (a) The mantle of a bivalve. See Mantle. (b) The mantle of a bird.
