polyacid |Capable of neutralizing, or of combining with, several molecules of a monobasic acid; having more than one hydrogen atom capable of being replaced by acid radicals; -- said of certain bases; as, calcium hydrate and glycerin are polyacid bases.
polyacoustic |Multiplying or magnifying sound. -- n.  A polyacoustic instrument.
polyacoustics |The art of multiplying or magnifying sounds.
polyacron |A solid having many summits or angular points; a polyhedron.
polyactinia |An old name for those Anthozoa which, like the actinias, have numerous simple tentacles.
polyadelphia |A Linnæan class of plants having stamens united in three or more bodies or bundles by the filaments.
polyadelphian |Belonging to the class Polyadelphia; having stamens united in three or more bundles.
polyadelphous |Belonging to the class Polyadelphia; having stamens united in three or more bundles.
polyandria |A Linnæan class of monoclinous or hermaphrodite plants, having many stamens, or any number above twenty, inserted in the receptacle.
polyandrian |Polyandrous.
polyandrous |Belonging to the class Polyandria; having many stamens, or any number above twenty, inserted in the receptacle.
polyandry |The possession by a woman of more than one husband at the same time; -- contrasted with Ant: monandry. Note: In law, this falls under the head of polygamy.
polyanthus |(a) The oxlip. So called because the peduncle bears a many-flowered umbel. See Oxlip. (b) A bulbous flowering plant of the genus Narcissus (N. Tazetta, or N. polyanthus of some authors). See Illust. of Narcissus.
polyarchist |One who advocates polyarchy; -- opposed to monarchist. Cudworth.
polyarchy |A government by many persons, of whatever order or class. Cudworth.
polyatomic |(a) Having more than one atom in the molecule; consisting of several atoms. (b) Having a valence greater than one. [Obs.]
polyautography |The act or practice of multiplying copies of one's own handwriting, or of manuscripts, by printing from stone, -- a species of lithography.
polybasic |Capable of neutralizing, or of combining with, several molecules of a monacid base; having several hydrogen atoms capable of being replaced by basic radicals; -- said of certain acids; as, sulphuric acid is polybasic.
polybasite |An iron-black ore of silver, consisting of silver, sulphur, and antimony, with some copper and arsenic.
polybranchia |A division of Nudibranchiata including those which have numerous branchiæ on the back.
polybromide |A bromide containing more than one atom of bromine in the molecule.
polycarpellary |Composed of several or numerous carpels; -- said of such fruits as the orange.
polycarpic |(a) Bearing fruit repeatedly, or year after year. (b) Having several pistils in one flower.
polycarpous |(a) Bearing fruit repeatedly, or year after year. (b) Having several pistils in one flower.
polychaeta |One of the two principal groups of Chætopoda. It includes those that have prominent parapodia and fascicles of setæ. See Illust. under Parapodia.
polychloride |A chloride containing more than one atom of chlorine in the molecule.
polychoerany |A government by many chiefs, princes, or rules. [Obs.] Cudworth.
polychord |Having many strings.\n\n(a) A musical instrument of ten strings. (b) An apparatus for coupling two octave notes, capable of being attached to a keyed instrument.
polychrest |A medicine that serves for many uses, or that cures many diseases. [Obs.] Polychrest salt (Old Med. Chem.), potassium sulphate, specifically obtained by fusing niter with sulphur.
polychroism |Same as Pleochroism.
polychroite |The coloring matter of saffron; -- formerly so called because of the change of color on treatment with certain acids; -- called also crocin, and safranin.
polychromate |A salt of a polychromic acid.\n\nA compound which exhibits, or from which may be prepared, a variety of colors, as certain solutions derived from vegetables, which display colors by fluorescence.
polychromatic |Showing a variety, or a change, of colors. Polychromatic acid (Old Chem.), a substance obtained by the action of nitric acid on aloes.
polychrome |Esculin; -- so called in allusion to its fluorescent solutions. [R.]\n\nExecuted in the manner of polychromy; as, polychrome printing.
polychromic |1. Polychromatic. 2. (Chem.)  Pertaining to, or designating, any one of several acids (known only in their salts) which contain more than one atom of chromium.
polychromous |Of or pertaining to polychromy; many-colored; polychromatic.
polychromy |The art or practice of combining different colors, especially brilliant ones, in an artistic way.
polychronious |Enduring through a long time; chronic.
polyclinic |A clinic in which diseases of many sorts are treated; especially, an institution in which clinical instruction is given in all kinds of disease.
polyconic |Pertaining to, or based upon, many cones. Polyconic projection (Map Making), a projection of the earth's surface, or any portion thereof, by which each narrow zone is projected upon a conical surface that touches the sphere along this zone, the conical surface being then unrolled. This projection differs from conic projection in that latter assumes but one cone for the whole map. Polyconic projection is that in use in the United States coast and geodetic survey.
polycotyledon |A plant that has many, or more than two, cotyledons in the seed. -- Pol`y*cot`y*led\"on*ous, a.
polycotyledonary |Having the villi of the placenta collected into definite patches, or cotyledons.
polycracy |Government by many rulers; polyarchy.
polycrotic |Of or pertaining to polycrotism; manifesting polycrotism; as, a polycrotic pulse; a polycrotic pulse curve.
polycrotism |That state or condition of the pulse in which the pulse curve, or sphygmogram, shows several secondary crests or elevations; -- contrasted with monocrotism and dicrotism.
polycystid |(a) One of the Polycystidea. (b) One of the Polycystina. -- a.  Pertaining to the Polycystidea, or the Polycystina.
polycystidea |A division of Gregarinæ including those that have two or more internal divisions of the body.
polycystina |A division of Radiolaria including numerous minute marine species. The skeleton is composed of silica, and is often very elegant in form and sculpture. Many have been found in the fossil state.
polycystine |Pertaining to the Polycystina. -- n.  One of the Polycystina.
polycyttaria |A division of Radiolaria. It includes those having one more central capsules.
polydactylism |The possession of more that the normal number of digits.
polydipsia |Excessive and constant thirst occasioned by disease.
polyedron |See Polyhedron.
polyedrous |See Polyhedral.
polyeidic |Passing through several distinct larval forms; -- having several distinct kinds of young.
polyeidism |The quality or state of being polyeidic.
polyembryonate |Consisting of, or having, several embryos; polyembryonic.
polyembryonic |Polyembryonate.
polyembryony |The production of two or more embryos in one seed, due either to the existence and fertilization of more than one embryonic sac or to the origination of embryos outside of the embryonic sac.
polyfoil |Same as Multifoil.
polygala |A genus of bitter herbs or shrubs having eight stamens and a two-celled ovary (as the Seneca snakeroot, the flowering wintergreen, etc.); milkwort.
polygalaceous |Of or pertaining to a natural order of plants (Polygalaceæ) of which Polygala is the type.
polygalic |Of, pertaining to, or obtained from, Polygala; specifically, designating an acrid glucoside (called polygalic acid, senegin, etc.), resembling, or possibly identical with, saponin.
polygamia |(a) A Linnæan class of plants, characterized by having both hermaphrodite and unisexual flowers on the same plant. (b) A name given by Linnæus to file orders of plants having syngenesious flowers.
polygamian |Polygamous.
polygamist |One who practices polygamy, or maintains its lawfulness.
polygamize |To practice polygamy; to marry several wives. Sylvester. Coleridge.
polygamous |1. Of or pertaining to polygamy; characterized by, or involving, polygamy; having a plurality of wives; as, polygamous marriages; -- opposed to monogamous. 2. (Zoöl.)  Pairing with more than one female. Most deer, cattle, and sheep are polygamous. Darwin. 3. (Bot.)  Belonging to the Polygamia; bearing both hermaphrodite and unisexual flowers on the same plant.
polygamy |1. The having of a plurality of wives or husbands at the same time; usually, the marriage of a man to more than one woman, or the practice of having several wives, at the same time; -- opposed to monogamy; as, the nations of the East practiced polygamy. See the Note under Bigamy, and cf. Polyandry. 2. (Zoöl.)  The state or habit of having more than one mate. 3. (Bot.)  The condition or state of a plant which bears both perfect and unisexual flowers.
polygastrian |One of the Polygastrica. [Obs.]
polygastric |1. (Anat.)  Having several bellies; -- applied to muscles which are made up of several bellies separated by short tendons. 2. (Zoöl.)  Pertaining to the Polygastrica. [Obs.]\n\nOne of the Polygastrica.
polygastrica |The Infusoria. [Obs.]
polygenesis |The theory that living organisms originate in cells or embryos of different kinds, instead of coming from a single cell; -- opposed to monogenesis.
polygenetic |1. Having many distinct sources; originating at various places or times. 2. (Biol.) Of or pertaining to polygenesis; polyphyletic. Polygenetic mountain range (Geol.), one which is composite, or consists of two or more monogenetic ranges, each having had its own history of development. Dana.
polygenic |Of or relating to polygeny; polygenetic.
polygenism |The doctrine that animals of the same species have sprung from more than one original pair.
polygenist |One who maintains that animals of the same species have sprung from more than one original pair; -- opposed to monogenist.
polygenous |Consisting of, or containing, many kinds; as, a polygenous mountain. Kirwan.
polygeny |The theory that living organisms originate in cells or embryos of different kinds, instead of coming from a single cell; -- opposed to monogenesis.
polyglot |1. Containing, or made up, of, several languages; as, a polyglot lexicon, Bible. 2. Versed in, or speaking, many languages.\n\n1. One who speaks several languages. [R.] \"A polyglot, or good linguist.\" Howell. 2. A book containing several versions of the same text, or containing the same subject matter in several languages; esp., the Scriptures in several languages. Enriched by the publication of polyglots. Abp. Newcome.
polyglottous |Speaking many languages; polyglot. [R.] \"The polyglottous tribes of America.\" Max Müller.
polygon |A plane figure having many angles, and consequently many sides; esp., one whose perimeter consists of more than four sides; any figure having many angles. Polygon of forces (Mech.), a polygonal figure, the sides of which, taken successively, represent, in length and direction, several forces acting simultaneously upon one point, so that the side necessary to complete the figure represents the resultant of those forces. Cf. Parallelogram of forces, under Parallelogram.
polygonaceous |Of or pertaining to a natural order of apetalous plants (Polygonaceæ), of which the knotweeds (species of Polygonum) are the type, and which includes also the docks (Rumex), the buckwheat, rhubarb, sea grape (Coccoloba), and several other genera.
polygonal |Having many angles. Polygonal numbers, certain figurate numbers. See under Figurate.
polygoneutic |Having two or more broods in a season.
polygonometry |The doctrine of polygons; an extension of some of the principles of trigonometry to the case of polygons.
polygonous |Polygonal.
polygonum |A genus of plants embracing a large number of species, including bistort, knotweed, smartweed, etc.
polygony |Any plant of the genus Polygonum.
polygordius |A genus of marine annelids, believed to be an ancient or ancestral type. It is remarkable for its simplicity of structure and want of parapodia. It is the type of the order Archiannelida, or Gymnotoma. See Loeven's larva.
polygram |A figure consisting of many lines. [R.] Barlow.
polygraph |1. An instrument for multiplying copies of a writing; a manifold writer; a copying machine. 2. In bibliography, a collection of different works, either by one or several authors. Brande & C.
polygraphic |Pertaining to, or employed in, polygraphy; as, a polygraphic instrument. 2. Done with a polygraph; as, a polygraphic copy.
polygraphical |Pertaining to, or employed in, polygraphy; as, a polygraphic instrument. 2. Done with a polygraph; as, a polygraphic copy.
polygraphy |1. Much writing; writing of many books. [Obs.] Fuller. 2. The art of writing in various ciphers, and of deciphering the same. [R.] 3. The art or practice of using a polygraph.
polygrooved |Having many grooves; as, a polygrooved rifle or gun (referring to the rifling).
polygyn |A plant of the order Polygynia.
polygynia |A Linnæan order of plants having many styles.
polygynian |Having many styles; belonging to the order Polygynia.
polygynist |One who practices or advocates polygyny. H. Spenser.
polygynous |Having many styles; belonging to the order Polygynia.
polygyny |The state or practice of having several wives at the same time; marriage to several wives. H. Spenser.
polyhalite |A mineral usually occurring in fibrous masses, of a brick-red color, being tinged with iron, and consisting chiefly of the sulphates of lime, magnesia, and soda.
polyhedral |Having many sides, as a solid body. Polyhedral angle, an angle bounded by three or more plane angles having a common vertex.
polyhedrical |Having many sides, as a solid body. Polyhedral angle, an angle bounded by three or more plane angles having a common vertex.
polyhedron |1. (Geom.)  A body or solid contained by many sides or planes. 2. (Opt.)  A polyscope, or multiplying glass.
polyhedrous |Polyhedral.
polyhistor |One versed in various learning. [R.]
polyhymnia |The Muse of lyric poetry.
polyiodide |A iodide having more than one atom of iodine in the molecule.
polylogy |Talkativeness. [R.]
polyloquent |Garrulous; loquacious. [R.]
polymastism |The condition of having more than two mammæ, or breasts.
polymathic |Pertaining to polymathy; acquainted with many branches of learning.
polymathist |One versed in many sciences; a person of various learning.
polymathy |The knowledge of many arts and sciences; variety of learning. Johnson.
polymeniscous |Having numerous facets; -- said of the compound eyes of insects and crustaceans.
polymer |Any one of two or more substances related to each other by polymerism; specifically, a substance produced from another substance by chemical polymerization. [Formerly also written polymere.]
polymeric |Having the same percentage composition (that is, having the same elements united in the same proportion by weight), but different molecular weights; -- often used with with; thus, cyanic acid (CNOH), fulminic acid (C2N2O2H2), and cyanuric acid (C3N3O3H3), are polymeric with each other. Note: The figures expressing the number of atoms of each element in a number of polymeric substances are respectively multiples and factors of each other, or have some simple common divisor. The relation may be merely a numerical one, as in the example given above, or a chemical one, as in the case of aldehyde, paraldehyde, and metaldehyde.
polymerism |(a) The state, quality, or relation of two or more polymeric substances. (b) The act or process of forming polymers.
polymerization |The act or process of changing to a polymeric form; the condition resulting from such change.
polymerize |To cause polymerization of; to produce polymers from; to increase the molecular weight of, without changing the atomic proportions; thus, certain acids polymerize aldehyde.\n\nTo change into another substance having the same atomic proportions, but a higher molecular weight; to undergo polymerization; thus, aldehyde polymerizes in forming paraldehyde.
polymerous |1. (Bot.)  Having many parts or members in each set. Gray. 2. (Chem.)  Polymeric. [Obs.]
polymnia |See Polyhymnia.
polymnite |A stone marked with dendrites and black lines, and so disposed as to represent rivers, marshes, etc.
polymorph |A substance capable of crystallizing in several distinct forms; also, any one of these forms. Cf. Allomorph.
polymorphic |Polymorphous.
polymorphism |1. (Crystallog.)  Same as Pleomorphism. 2. (Biol.) (a) The capability of assuming different forms; the capability of widely varying in form. (b) Existence in many forms; the coexistence, in the same locality, of two or more distinct forms independent of sex, not connected by intermediate gradations, but produced from common parents.
polymorphosis |The assumption of several structural forms without a corresponding difference in function; -- said of sponges, etc.
polymorphous |1. Having, or assuming, a variety of forms, characters, or styles; as, a polymorphous author. De Quincey. 2. (Biol.)  Having, or occurring in, several distinct forms; -- opposed to monomorphic.
polymorphy |Existence in many forms; polymorphism.
polymyodae |Same as Oscines.
polymyodous |Polymyoid.
polymyoid |Having numerous vocal muscles; of or pertaining to the Polymyodæ.
polyneme |Any one of numerous species of tropical food fishes of the family Polynemidæ. They have several slender filaments, often very long, below the pectoral fin. Some of them yield isinglass of good quality. Called also threadfish.
polynemoid |Of or pertaining to the polynemes, or the family Polynemidæ.
polynesian |Of or pertaining to Polynesia (the islands of the eastern and central Pacific), or to the Polynesians.
polynesians |The race of men native in Polynesia.
polynia |The open sea supposed to surround the north pole. Kane.
polynomial |An expression composed of two or more terms, connected by the signs plus or minus; as, a2 - 2ab + b2.\n\n1. Containing many names or terms; multinominal; as, the polynomial theorem. 2. Consisting of two or more words; having names consisting of two or more words; as, a polynomial name; polynomial nomenclature.
polynuclear |Containing many nuclei.
polynucleolar |Having more than one nucleolus.
polyommatous |Having many eyes.
polyonomous |Having many names or titles; polyonymous. Sir W. Jones.
polyonomy |The use of a variety of names for the same object. G. S. Faber.
polyonym |1. An object which has a variety of names. 2. A polynomial name or term.
polyonymous |Polyonomous.
polyoptron |A glass through which objects appear multiplied, but diminished in size. [R.]
polyoptrum |A glass through which objects appear multiplied, but diminished in size. [R.]
polyorama |A view of many objects; also, a sort of panorama with dissolving views.
polyp |(a) One of the feeding or nutritive zooids of a hydroid or coral. (b) One of the Anthozoa. (c) pl.  Same as Anthozoa. See Anthozoa, Madreporaria, Hydroid. [Written also polype.] Fresh-water polyp, the hydra. -- Polyp stem (Zoöl.), that portion of the stem of a siphonophore which bears the polypites, or feeding zooids.
polyparous |Producing or bearing a great number; bringing forth many.
polypary |Same as Polypidom.
polype |See Polyp.
polypean |Of or pertaining to a polyp, or polyps.
polyperythrin |A coloring matter found in many simple Anthozoa and some hydroids.
polypetalous |Consisting of, or having, several or many separate petals; as, a polypetalous corolla, flower, or plant. Martyn.
polyphagous |Eating, or subsisting on, many kinds of food; as, polyphagous animals.
polyphagy |The practice or faculty of subsisting on many kinds of food.
polypharmacy |(a) The act or practice of prescribing too many medicines. (b) A prescription made up of many medicines or ingredients. Dunglison.
polyphase |Having or producing two or more phases; multiphase; as, a polyphase machine, a machine producing two or more pressure waves of electro-motive force, differing in phase; a polyphase current.
polyphaser |A machine generating more than one pressure wave; a multiphaser.
polyphemus |A very large American moth (Telea polyphemus) belonging to the Silkworm family (Bombycidæ). Its larva, which is very large, bright green, with silvery tubercles, and with oblique white stripes on the sides, feeds on the oak, chestnut, willow, cherry, apple, and other trees. It produces a large amount of strong silk. Called also American silkworm.
polyphone |A character or vocal sign representing more than one sound, as read, which is pronounced red or rèd.
polyphonic |1. Having a multiplicity of sounds. 2. Characterized by polyphony; as, Assyrian polyphonic characters. 3. (Mus.)  Consisting of several tone series, or melodic parts, progressing simultaneously according to the laws of counterpoint; contrapuntal; as, a polyphonic composition; -- opposed to homophonic, or monodic.
polyphonism |Polyphony.
polyphonist |1. A proficient in the art of multiplying sounds; a ventriloquist. 2. (Mus.)  A master of polyphony; a contrapuntist.
polyphonous |Same as Polyphonic.
polyphony |1. Multiplicity of sounds, as in the reverberations of an echo. 2. Plurality of sounds and articulations expressed by the same vocal sign. 3. (Mus.)  Composition in mutually related, equally important parts which share the melody among them; contrapuntal composition; -- opposed to homophony, in which the melody is given to one part only, the others filling out the harmony. See Counterpoint.
polyphore |A receptacle which bears many ovaries.
polyphotal |Pertaining to or designating arc lamps so constructed that more than one can be used on a single circuit.
polyphote |Pertaining to or designating arc lamps so constructed that more than one can be used on a single circuit.
polyphyletic |Pertaining to, or characterized by, descent from more than one root form, or from many different root forms; polygenetic; -- opposed to Ant: monophyletic.
polyphyllous |Many-leaved; as, a polyphyllous calyx or perianth.
polypi |The Anthozoa.
polypide |One of the ordinary zooids of the Bryozoa. [Spellt also polypid.]
polypidom |A coral, or corallum; also, one of the coral-like structure made by bryozoans and hydroids.
polypier |A polypidom.
polypifera |The Anthozoa.
polypiferous |Bearing polyps, or polypites.
polypiparous |Producing polyps.
polypite |1. (Zoöl.) (a) One of the feeding zooids, or polyps, of a coral, hydroid, or siphonophore; a hydranth. See Illust. of Campanularian. (b) Sometimes, the manubrium of a hydroid medusa. 2. (Paleon.)  A fossil coral.
polyplacophora |See Placophora.
polyplastic |Assuming, or having the power of assuming, many forms; as, a polyplastic element which does not preserve its original shape.
polypode |A plant of the genus Polypodium; polypody. [Written also polypod.]\n\nAn animal having many feet; a myriapod.
polypodium |A genus of plants of the order Filices or ferns. The fructifications are in uncovered roundish points, called sori, scattered over the inferior surface of the frond or leaf. There are numerous species.
polypody |Any plant of the genus Polypodium.
polypoid |1. (Zoöl.)  Like a polyp; having the nature of a polyp, but lacking the tentacles or other parts. 2. (Med.)  Resembling a polypus in appearance; having a character like that of a polypus.
polypomedusae |Same as Hydrozoa.
polyporous |Having many pores. Wright.
polyporus |A genus of fungi having the under surface full of minute pores; also, any fungus of this genus. Note: Polyporus fomentarius was formerly dried and cut in slices for tinder, called amadou. P. betulinus is common in America, and forms very large thick white semicircular excrescences on birch trees. Several species of Polyporous are considered edible.
polypous |Of the nature of a polypus; having many feet or roots, like the polypus; affected with polypus.
polypragmatic |Overbusy; officious. [R.] Heywood.
polypragmatical |Overbusy; officious. [R.] Heywood.
polypragmaty |The state of being overbusy. [R.]
polyprotodonta |A division of marsupials in which there are more fore incisor teeth in each jaw.
polypteroidei |A suborder of existing ganoid fishes having numerous fins along the back. The bichir, or Polypterus, is the type. See Illust. under Crossopterygian.
polypterus |An African genus of ganoid fishes including the bichir.
polyptoton |A figure by which a word is repeated in different forms, cases, numbers, genders, etc., as in Tennyson's line, -- \"My own heart's heart, and ownest own, farewell.\",
  "projection |1. The act of throwing or shooting forward. 2. A jutting out; also, a part jutting out, as of a building; an extension beyond something else. 3. The act of scheming or planning; also, that which is planned; contrivance; design; plan. Davenant. 4. (Persp.)  The representation of something; delineation; plan; especially, the representation of any object on a perspective plane, or such a delineation as would result were the chief points of the object thrown forward upon the plane, each in the direction of a line drawn through it from a given point of sight, or central point; as, the projection of a sphere. The several kinds of projection differ according to the assumed point of sight and plane of projection in each. 5. (Geog.)  Any method of representing the surface of the earth upon a plane. Conical projection, a mode of representing the sphere, the spherical surface being projected upon the surface of a cone tangent to the sphere, the point of sight being at the center of the sphere. -- Cylindric projection, a mode of representing the sphere, the spherical surface being projected upon the surface of a cylinder touching the sphere, the point of sight being at the center of the sphere. -- Globular, Gnomonic, Orthographic, projection,etc. See under Globular, Gnomonic, etc. -- Mercator's projection, a mode of representing the sphere in which the meridians are drawn parallel to each other, and the parallels of latitude are straight lines whose distance from each other increases with their distance from the equator, so that at all places the degrees of latitude and longitude have to each other the same ratio as on the sphere itself. -- Oblique projection, a projection made by parallel lines drawn from every point of a figure and meeting the plane of projection obliquely. -- Polar projection, a projection of the sphere in which the point of sight is at the center, and the plane of projection passes through one of the polar circles. -- Powder of projection (Alchemy.), a certain powder cast into a crucible or other vessel containing prepared metal or other matter which is to be thereby transmuted into gold. -- Projection of a point on a plane (Descriptive Geom.), the foot of a perpendicular to the plane drawn through the point. -- Projection of a straight line of a plane, the straight line of the plane connecting the feet of the perpendiculars let fall from the extremities of the given line. Syn. -- See Protuberance.
polypus |1. (Zoöl.)  Same as Polyp. 2. (Med.)  A tumor, usually with a narrow base, somewhat resembling a pear, -- found in the nose, uterus, etc., and produced by hypertrophy of some portion of the mucous membrane.
polyrhizous |Having numerous roots, or rootlets.
polyschematist |Having, or existing in, many different forms or fashions; multiform.
polyscope |1. (Opt.)  A glass which makes a single object appear as many; a multiplying glass. Hutton. 2. (Med.)  An apparatus for affording a view of the different cavities of the body.
polysepalous |Having the sepals separate from each other.
polysilicic |Of or pertaining to compounds formed by the condensation of two or more molecules of silicic acid. Polysilicic acid (Chem.), any one of a series of acids formed by the condensation of two or more molecules of silicic acid, with elimination of water.
polyspast |A machine consisting of many pulleys; specifically, an apparatus formerly used for reducing luxations.
polyspermous |Containing many seeds; as, a polyspermous capsule or berry. Martyn.
polyspermy |Fullness of sperm, or seed; the passage of more than one spermatozoön into the vitellus in the impregnation of the ovum.
polysporous |Containing many spores.
polystomata |A division of trematode worms having more two suckers. Called also Polystomea and Polystoma.
polystome |Having many mouths.\n\nAn animal having many mouths; -- applied to Protozoa.
polystyle |Having many columns; -- said of a building, especially of an interior part or court; as, a polystyle hall. -- n.  A polystyle hall or edifice.
polysulphide |A sulphide having more than one atom of sulphur in the molecule; -- contrasted with monosulphide.
polysulphuret |A polysulphide. [Obsoles.]
polysyllabic |Pertaining to a polysyllable; containing, or characterized by, polysyllables; consisting of more than three syllables.
polysyllabical |Pertaining to a polysyllable; containing, or characterized by, polysyllables; consisting of more than three syllables.
polysyllabicism |Polysyllabism.
polysyllabicity |Polysyllabism.
polysyllabism |The quality or state of being polysyllabic.
polysyllable |A word of many syllables, or consisting of more syllables than three; -- words of less than four syllables being called monosyllables, dissyllables, and trisyllables.
polysyndetic |Characterized by polysyndeton, or the multiplication of conjunctions. -- Pol`y*syn*det\"ic*al*ly, adv.
polysyndeton |A figure by which the conjunction is often repeated, as in the sentence, \"We have ships and men and money and stores.\" Opposed to asyndeton.
polysynthesis |1. The act or process of combining many separate elements into a whole. 2. (Philol.)  The formation of a word by the combination of several simple words, as in the aboriginal languages of America; agglutination. Latham.
polysynthetic |Characterized by polysynthesis; agglutinative. Polysynthetic twinning (Min.), repeated twinning, like that of the triclinic feldspar, producing fine parallel bands in alternately reversed positions.
polysyntheticism |Polysynthesis.
polytechnic |Comprehending, or relating to, many arts and sciences; -- applied particularly to schools in which many branches of art and science are taught with especial reference to their practical application; also to exhibitions of machinery and industrial products.
polytechnical |Polytechnic.
polytechnics |The science of the mechanic arts.
polythalamia |A division of Foraminifera including those having a manychambered shell.
polythalamous |Many-chambered; -- applied to shells of Foraminifera and cephalopods. See Illust. of Nautilus.
polytheism |The doctrine of, or belief in, a plurality of gods. In the Old Testament, the gradual development of polytheism from the primitive monotheism may be learned. Shaff-Herzog.
polytheist |One who believes in, or maintains the doctrine of, a plurality of gods.
polytheistic |Of or pertaining to polytheism; characterized by polytheism; professing or advocating polytheism; as, polytheistic worship; a polytheistic author, or nation. -- Pol`y*the*is\"tic*al*ly, adv.
polytheistical |Of or pertaining to polytheism; characterized by polytheism; professing or advocating polytheism; as, polytheistic worship; a polytheistic author, or nation. -- Pol`y*the*is\"tic*al*ly, adv.
polytheize |To adhere to, advocate, or inculcate, the doctrine of polytheism. Milman.
polythelism |The condition of having more than two teats, or nipples.
polytocous |1. (Bot.)  Bearing fruit repeatedly, as most perennial plants; polycarpic. 2. (Zoöl.)  Producing many or young.
polytomous |Subdivided into many distinct subordinate parts, which, however, not being jointed to the petiole, are not true leaflets; -- said of leaves. Henslow.
polytomy |A division into many members. F. Bowen.
polytungstate |A salt of polytungstic acid.
polytungstic |Containing several tungsten atoms or radicals; as, polytungstic acid. Polytungstic acid (Chem.), any one of several complex acids of tungsten containing more than one atom of tungsten.
polytype |A cast, or facsimile copy, of an engraved block, matter in type, etc. (see citation); as, a polytype in relief. By pressing the wood cut into semifluid metal, an intaglio matrix is produced: and from this matrix, in a similar way, a polytype in relief is obtained. Hansard.\n\nOf or pertaining to polytypes; obtained by polytyping; as, a polytype plate.\n\nTo produce a polytype of; as, to polytype an engraving.
polyuria |A persistently excessive flow of watery urine, with low specific gravity and without the presence of either albumin or sugar. It is generally accompanied with more or less thirst.
polyvalent |Multivalent.
polyve |A pulley. [Obs.]
polyzoa |Same as Bryozoa. See Illust. under Bryozoa, and Phylactolæmata.
polyzoan |(a) Any species of Polyzoa; one of the Polyzoa. (b) A polyzoön.
polyzoarium |Same as Polyzoary.
polyzoary |The compound organism of a polyzoan.
polyzonal |Consisting of many zones or rings. Polyzonal lens (Opt.), a lens made up of pieces arranged zones or rings, -- used in the lanterns of lighthouses.
polyzooen |One of the individual zooids forming the compound organism of a polyzoan.
polyzoon |One of the individual zooids forming the compound organism of a polyzoan.
pom-pom |A Vickers-Maxim one-pounder automatic machine cannon using metallic ammunition fed from a lopped belt attached to the gun; -- popularly so called from its peculiar drumming sound in action. Sometimes, any of other similar automatic cannons.
pomace |The substance of apples, or of similar fruit, crushed by grinding.
pomacentroid |Pertaining to the Pomacentridæ, a family of bright-colored tropical fishes having spiny opercula; -- often called coral fishes.
pomaceous |1. (Bot.) (a) Like an apple or pear; producing pomes. (b) Of or pertaining to a suborder (Pomeæ) of rosaceous plants, which includes the true thorn trees, the quinces, service berries, medlars, and loquats, as well as the apples, pears, crabs, etc. 2. Like pomace.
pomade |1. Cider. [Obs.] Piers Plowman. 2. Perfumed ointment; esp., a fragrant unguent for the hair; pomatum; -- originally made from apples.
pomander |(a) A perfume to be carried with one, often in the form of a ball. (b) A box to contain such perfume, formerly carried by ladies, as at the end of a chain; -- more properly pomander box. [Obs.] Bacon.
pomarine |Having the nostril covered with a scale. Pomarine jager (Zoöl.), a North Atlantic jager (Stercorarius pomarinus) having the elongated middle tail feathers obtuse. The adult is black.
pomatum |A perfumed unguent or composition, chiefly used in dressing the hair; pomade. Wiseman.\n\nTo dress with pomatum.
pome |1. (Bot.)  A fruit composed of several cartilaginous or bony carpels inclosed in an adherent fleshy mass, which is partly receptacle and partly calyx, as an apple, quince, or pear. 2. (R. C. Ch.)  A ball of silver or other metal, which is filled with hot water, and used by the priest in cold weather to warm his hands during the service.\n\nTo grow to a head, or form a head in growing. [Obs.]
pomegranate |1. (Bot.)  The fruit of the tree Punica Granatum; also, the tree itself (see Balaustine), which is native in the Orient, but is successfully cultivated in many warm countries, and as a house plant in colder climates. The fruit is as large as an orange, and has a hard rind containing many rather large seeds, each one separately covered with crimson, acid pulp. 2. A carved or embroidered ornament resembling a pomegranate. Ex. xxviii. 33.
pomel |A pommel. [Obs.] Chaucer.
pomelo |A variety of shaddock, called also grape fruit.
pomely |Dappled. [Obs.] \"Pomely gray.\" Chaucer.
pomeranian |Of or pertaining to Pomerania, a province of Prussia on the Baltic Sea. -- n.  A native or inhabitant of Pomerania. Pomeranian dog (Zoöl.), the loup-loup, or Spitz dog.
pomewater |A kind of sweet, juicy apple. [Written also pomwater.] Shak.
pomey |A figure supposed to resemble an apple; a roundel, -- always of a green color.
pomfret |(a) One of two or more species of marine food fishes of the genus Stromateus (S. niger, S. argenteus) native of Southern Europe and Asia. (b) A marine food fish of Bermuda (Brama Raji).
pomiculture |The culture of fruit; pomology as an art.
pomiferous |(a) Bearing pomes, or applelike fruits. (b) Bearing fruits, or excrescences, more or less resembling an apple.
pommage |See Pomage.
pomme |Having the ends terminating in rounded protuberances or single balls; -- said of a cross.
pomme blanche |The prairie turnip. See under Prairie.
pommel |A knob or ball; an object resembling a ball in form; as: (a) The knob on the hilt of a sword. Macaulay. (b) The knob or protuberant part of a saddlebow. (c) The top (of the head). Chaucer. (d) A knob forming the finial of a turret or pavilion.\n\nTo beat soundly, as with the pommel of a sword, or with something knoblike; hence, to beat with the fists. [Written also pummel.]
pommelion |The cascabel, or hindmost knob, of a cannon. [R.]
pommette |Having two balls or protuberances at each end; -- said of a cross.
pomological |Of or pertaining to pomology.
pomologist |One versed in pomology; one who culticvates fruit trees.
pomology |The science of fruits; a treatise on fruits; the cultivation of fruits and fruit trees.
pomona |The goddess of fruits and fruit trees.
pomp |1. A procession distinguished by ostentation and splendor; a pageant. \"All the pomps of a Roman triumph.\" Addison. 2. Show of magnificence; parade; display; power. Syn. -- Display; parade; pageant; pageantry; splendor; state; magnificence; ostentation; grandeur; pride.\n\nTo make a pompons display; to conduct. [Obs.] B. Jonson.
pompadour |A crimson or pink color; also, a style of dress cut low and square in the neck; also, a mode of dressing the hair by drawing it straight back from the forehead over a roll; -- so called after the Marchioness de Pompadour of France. Also much used adjectively.
pompano |1. Any one of several species of marine fishes of the genus Trachynotus, of which four species are found on the Atlantic coast of the United States; -- called also palometa. Note: They have a brilliant silvery or golden luster, and are highly esteemed as food fishes. The round pompano (T. thomboides) and the Carolina pompano (T. Carolinus) are the most common. Other species occur on the Pacific coast. 2. A California harvest fish (Stromateus simillimus), highly valued as a food fish. Pompano shell (Zoöl.), a small bivalve shell of the genus Donax; -- so called because eaten by the pompano. [Florida]
pompatic |Pompous. [Obs.] Barrow.
pompeian |Of, pertaining to, or characteristic of, Pompeii, an ancient city of Italy, buried by an eruption of Vesuvius in 79 a. d., and partly uncovered by modern excavations.
pompeian red |A brownish red approaching maroon, supposed to be imitated from the color of the wall panels of houses in Pompeii, which were decorated during the last age of the Republic.
pompelmous |A shaddock, esp. one of large size.
pompet |The ball formerly used to ink the type.
pompholyx |1. (Old Chem.)  Impure zinc oxide. 2. (Med.)  A skin disease in which there is an eruption of bullæ, without inflammation or fever.
pompillion |An ointment or pomatum made of black poplar buds. [Obs.] Cotgrave.
pompion |See Pumpion.
pompire |A pearmain. [Obs.]
pompoleon |See Pompelmous.
pompon |1. Any trifling ornament for a woman's dress or bonnet. 2. (Mil.)  A tuft or ball of wool, or the like, sometimes worn by soldiers on the front of the hat, instead of a feather.
pomposity |The quality or state of being pompous; pompousness. Thackeray.
pomposo |Grand and dignified; in grand style.
pompous |1. Displaying pomp; stately; showy with grandeur; magnificent; as, a pompous procession. 2. Ostentatious; pretentious; boastful; vainlorious; as, pompous manners; a pompous style. \"Pompous in high presumption.\" Chaucer. he pompous vanity of the old schoolmistress. Thackeray. -- Pom\"ous*ly, adv. -- Pomp\"ous*ness, n.
pomptine |See Pontine.
pomwater |Same as Pomewater.
poncelet |A unit of power, being the power obtained from an expenditure of one hundred kilogram-meters of energy per second. One poncelet equals g watts, when g is the value of the acceleration of gravity in centimeters.
poncho |1. A kind of cloak worn by the Spanish Americans, having the form of a blanket, with a slit in the middle for the head to pass through. A kind of poncho made of rubber or painted cloth is used by the mounted troops in the United States service. 2. A trade name for camlets, or stout worsteds.
pond |A body of water, naturally or artificially confined, and usually of less extent than a lake. \"Through pond or pool.\" Milton. Pond hen (Zoöl.), the American coot. See Coot (a). -- Pond lily (Bot.), the water lily. See under Water, and Illust. under Nymphæa. -- Pond snail (Zoöl.), any gastropod living in fresh-water ponds or lakes. The most common kinds are air-breathing snails (Pulmonifera) belonging to Limnæa, Physa, Planorbis, and allied genera. The operculated species are pectinibranchs, belonging to Melantho, Valvata, and various other genera. -- Pond spice (Bot.), an American shrub (Tetranthera geniculata) of the Laurel family, with small oval leaves, and axillary clusters of little yellow flowers. The whole plant is spicy. It grows in ponds and swamps from Virginia to Florida. -- Pond tortoise, Pond turtle (Zoöl.), any freshwater tortoise of the family Emydidæ. Numerous species are found in North America.\n\nTo make into a pond; to collect, as water, in a pond by damming.\n\nTo ponder. [Obs.] Pleaseth you, pond your suppliant's plaint. Spenser.
ponder |1. To weigh. [Obs.] 2. To weigh in the mind; to view with deliberation; to examine carefully; to consider attentively. Ponder the path of thy feet. Prov. iv. 26. Syn. -- To Ponder, Consider, Muse. To consider means to view or contemplate with fixed thought. To ponder is to dwell upon with long and anxious attention, with a view to some practical result or decision. To muse is simply to think upon continuously with no definite object, or for the pleasure it gives. We consider any subject which is fairly brought before us; we ponder a concern involving great interests; we muse on the events of childhood.\n\nTo think; to deliberate; to muse; -- usually followed by on or over. Longfellow.
ponderability |The quality or state of being ponderable.
ponderable |Capable of being weighed; having appreciable weight. -- Pon\"der*a*ble*ness, n.
ponderal |Estimated or ascertained by weight; -- distinguished from numeral; as, a ponderal drachma. [R.] Arbuthnot.
ponderance |Weight; gravity. [R.] Gregory.
ponderary |Of or pertaining to weight; as, a ponderary system. [R.] M'Culloch.
ponderate |To consider; to ponder. [R.]\n\nTo have weight or influence. [R.]
ponderation |The act of weighing. [R.] Arbuthnot.
ponderer |One who ponders.
pondering |Deliberating. -- Pon\"der*ing*ly, adv.
ponderosity |The quality or state of being ponderous; weight; gravity; heaviness, ponderousness; as, the ponderosity of gold. Ray.
ponderous |1. Very heavy; weighty; as, a ponderous shield; a ponderous load; the ponderous elephant. The sepulcher . . . Hath oped his ponderous and marble jaws. Shak. 2. Important; momentous; forcible. \"Your more ponderous and settled project.\" Shak. 3. Heavy; dull; wanting; lightless or spirit; as, a ponderous style; a ponderous joke. Ponderous spar (Min.), heavy spar, or barytes. See Barite.
ponderously |In a ponderous manner.
ponderousness |The quality or state of being ponderous; ponderosity.
pondfish |Any one of numerous species of American fresh-water fishes belonging to the family Centrarchidæ; -- called also pond perch, and sunfish. Note: The common pondfish of New England (Lepomis gibbosus) is called also bream, pumpkin seed, and sunny. See Sunfish. The long-eared pondfish (Lepomis auritus) of the Eastern United States is distinguished by its very long opercular flap.
pondweed |Any aquatic plant of the genus Potamogeton, of which many species are found in ponds or slow-moving rivers. Choke pondweed, an American water weed (Anarcharis, or Elodea, Canadensis.) See Anacharis. -- Horned pondweed, the Zannichellia palustris, a slender, branching aquatic plant, having pointed nutlets.
pone |A kind of johnnycake. [Written also paune.] [Southern U. S.]
ponent |Western; occidental. [R.] Forth rush the levant and the ponent winds. Milton.
pongee |A fabric of undyed silk from India and China.
ponghee |A Buddhist priest of the higher orders in Burmah. Malcom.
pongo |Any large ape; especially, the chimpanzee and the orang-outang.
poniard |A kind of dagger, -- usually a slender one with a triangular or square blade. She speaks poniards, and every word stabs. Shak.\n\nTo pierce with a poniard; to stab. Cowper.
ponibility |The capability of being placed or located. [Obs.] Barrow.
pons |A bridge; -- applied to several parts which connect others, but especially to the pons Varolii, a prominent band of nervous tissue situated on the ventral side of the medulla oblongata and connected at each side with the hemispheres of the cerebellum; the mesocephalon. See Brain. Pons asinorum. Etym: [L., literally, bridge of asses.] See Asses' bridge, under Ass.
pontage |A duty or tax paid for repairing bridges. Ayliffe.
pontee |An iron rod used by glass makers for manipulating the hot glass; -- called also, puntil, puntel, punty, and ponty. See Fascet.
pontic |Of or pertaining to the Pontus, Euxine, or Black Sea.
pontifex |A high priest; a pontiff.
pontiff |A high priest. Especially: (a) One of the sacred college, in ancient Rome, which had the supreme jurisdiction over all matters of religion, at the head of which was the Pontifex Maximus. Dr. W. Smith. (b) (Jewish Antiq.) The chief priest. (c) (R. C. Ch.) The pope.
pontific |1. Relating to, or consisting of, pontiffs or priests. \"The pontific college with their augurs and flamens.\" Milton. 2. Of or pertaining to the pope; papal. Shenstone.
pontifical |1. Of or pertaining to a pontiff, or high priest; as, pontifical authority; hence, belonging to the pope; papal. 2. Of or pertaining to the building of bridges. [R.] Now had they brought the work by wondrous art Pontifical, a ridge of pendent rock Over the vexed abyss. Milton.\n\n1. A book containing the offices, or formulas, used by a pontiff. South. 2. pl.  The dress and ornaments of a pontiff. \"Dressed in full pontificals.\" Sir W. Scott.
pontificality |The state and government of the pope; the papacy. [R.] Bacon.
pontifically |In a pontifical manner.
pontificate |1. The state or dignity of a high priest; specifically, the office of the pope. Addison. 2. The term of office of a pontiff. Milman.\n\nTo perform the duty of a pontiff.
pontifice |Bridgework; structure or edifice of a bridge. [R.] Milton.
pontificial |Papal; pontifical. [Obs.] \"Pontificial writers.\" Burton.
pontifician |Of or pertaining to the pontiff or pope. [Obs.] Bp. Hall.\n\nOne who adheres to the pope or papacy; a papist. [Obs.] Bp. Montagu.
pontil |Same as Pontee.
pontile |Of or pertaining to the pons Varolii. See Pons.
pontine |Of or pertaining to an extensive marshy district between Rome and Naples. [Written also Pomptine.]
pontlevis |The action of a horse in rearing repeatedly and dangerously.
ponton |See Pontoon.
pontoon |1. (Mil.)  A wooden flat-bottomed boat, a metallic cylinder, or a frame covered with canvas, India rubber, etc., forming a portable float, used in building bridges quickly for the passage of troops. 2. (Naut.)  A low, flat vessel, resembling a barge, furnished with cranes, capstans, and other machinery, used in careening ships, raising weights, drawing piles, etc., chiefly in the Mediterranean; a lighter. Pontoon bridge, a bridge formed with pontoons. -- Pontoon train, the carriages of the pontoons, and the materials they carry for making a pontoon bridge. Note: The French spelling ponton often appears in scientific works, but pontoon is more common form.
pontooning |The act, art, or process of constructing pontoon bridges. \"Army instruction in pontooning.\" Gen. W. T. Shermah.
pontvolant |A kind of light bridge, used in sieges, for surprising a post or outwork which has but a narrow moat; a flying bridge.
ponty |See Pontee.
pony |1. A small horse. 2. Twenty-five pounds sterling. [Slang, Eng.] 3. A translation or a key used to avoid study in getting lessons; a crib. [College Cant] 4. A small glass of beer. [Slang] Pony chaise, a light, low chaise, drawn by a pony or a pair of ponies. -- Pony engine, a small locomotive for switching cars from one track to another. [U.S.] -- Pony truck (Locomotive Engine), a truck which has only two wheels. -- Pony truss (Bridge Building), a truss which has so little height that overhead bracing can not be used.
pood |A Russian weight, equal to forty Russian pounds or about thirty-six English pounds avoirdupois.
poodle |A breed of dogs having curly hair, and often showing remarkable intelligence in the performance of tricks.
pooh |Pshaw! pish! nonsense! -- an expression of scorn, dislike, or contempt.
pooh-pooh |To make light of; to treat with derision or contempt, as if by saying pooh! pooh! [Colloq.] Thackeray.
pookoo |A red African antelope (Kobus Vardoni) allied to the water buck.
pool |1. A small and rather deep collection of (usually) fresh water, as one supplied by a spring, or occurring in the course of a stream; a reservoir for water; as, the pools of Solomon. Wyclif. Charity will hardly water the ground where it must first fill a pool. Bacon. The sleepy pool above the dam. Tennyson. 2. A small body of standing or stagnant water; a puddle. \"The filthy mantled pool beyond your cell.\" Shak.\n\n1. The stake played for in certain games of cards, billiards, etc.; an aggregated stake to which each player has contributed a snare; also, the receptacle for the stakes. 2. A game at billiards, in which each of the players stakes a certain sum, the winner taking the whole; also, in public billiard rooms, a game in which the loser pays the entrance fee for all who engage in the game; a game of skill in pocketing the balls on a pool table. Note: This game is played variously, but commonly with fifteen balls, besides one cue ball, the contest being to drive the most balls into the pockets. He plays pool at the billiard houses. Thackeray. 3. In rifle shooting, a contest in which each competitor pays a certain sum for every shot he makes, the net proceeds being divided among the winners. 4. Any gambling or commercial venture in which several persons join. 5. A combination of persons contributing money to be used for the purpose of increasing or depressing the market price of stocks, grain, or other commodities; also, the aggregate of the sums so contributed; as, the pool took all the wheat offered below the limit; he put $10,000 into the pool. 6. (Railroads)  A mutual arrangement between competing lines, by which the receipts of all are aggregated, and then distributed pro rata according to agreement. 7. (Law)  An aggregation of properties or rights, belonging to different people in a community, in a common fund, to be charged with common liabilities. Pin pool, a variety of the game of billiards in which small wooden pins are set up to be knocked down by the balls. -- Pool ball, one of the colored ivory balls used in playing the game at billiards called pool. -- Pool snipe (Zoöl.), the European redshank. [Prov. Eng.] -- Pool table, a billiard table with pockets.\n\nTo put together; to contribute to a common fund, on the basis of a mutual division of profits or losses; to make a common interest of; as, the companies pooled their traffic. Finally, it favors the poolingof all issues. U. S. Grant.\n\nTo combine or contribute with others, as for a commercial, speculative, or gambling transaction.
pooler |A stick for stirring a tan vat.
pooling |The act of uniting, or an agreement to unite, an aggregation of properties belonging to different persons, with a view to common liabilities or profits.
poon |A name for several East Indian, or their wood, used for the masts and spars of vessels, as Calophyllum angustifolium, C. inophullum, and Sterculia foetida; -- called also peon.
poonac |A kind of oil cake prepared from the cocoanut. See Oil cake, under Cake.
poonah painting |A style of painting, popular in England in the 19th century, in which a thick opaque color is applied without background and with scarcely any shading, to thin paper, producing flowers, birds, etc., in imitation of Oriental work. Hence: Poonah brush, paper, painter, etc.
poonga oil |A kind of oil used in India for lamps, and for boiling with dammar for pitching vessels. It is pressed from the seeds of a leguminous tree (Pongamia glabra).
poop |See 2d Poppy.\n\nTo make a noise; to pop; also, to break wind.\n\nA deck raised above the after part of a vessel; the hindmost or after part of a vessel's hull; also, a cabin covered by such a deck. See Poop deck, under Deck. See also Roundhouse. With wind in poop, the vessel plows the sea. Dryden. The poop was beaten gold. Shak.\n\n(a) To break over the poop or stern, as a wave. \"A sea which he thought was going to poop her.\" Lord Dufferin. (b) To strike in the stern, as by collision.
pooped |(a) Having a poop; furnished with a poop. (b) Struck on the poop.
pooping |The act or shock of striking a vessel's stern by a following wave or vessel.
poor |1. Destitute of property; wanting in material riches or goods; needy; indigent. Note: It is often synonymous with indigent and with necessitous denoting extreme want. It is also applied to persons who are not entirely destitute of property, but who are not rich; as, a poor man or woman; poor people. 2. (Law)  So completely destitute of property as to be entitled to maintenance from the public. 3. Hence, in very various applications:  Destitute of such qualities as are desirable, or might naturally be expected; as: (a) Wanting in fat, plumpness, or fleshiness; lean; emaciated; meager; as, a poor horse, ox, dog, etc. \"Seven other kine came up after them, poor and very ill-favored and lean-fleshed.\" Gen. xli. 19. (b) Wanting in strength or vigor; feeble; dejected; as, poor health; poor spirits. \"His genius . . . poor and cowardly.\" Bacon. (c) Of little value or worth; not good; inferior; shabby; mean; as, poor clothes; poor lodgings. \"A poor vessel.\" Clarendon. (d) Destitute of fertility; exhausted; barren; sterile; -- said of land; as, poor soil. (e) Destitute of beauty, fitness, or merit; as, a poor discourse; a poor picture. (f) Without prosperous conditions or good results; unfavorable; unfortunate; unconformable; as, a poor business; the sick man had a poor night. (g) Inadequate; insufficient; insignificant; as, a poor excuse. That I have wronged no man will be a poor plea or apology at the last day. Calamy. 4. Worthy of pity or sympathy; -- used also sometimes as a term of endearment, or as an expression of modesty, and sometimes as a word of contempt. And for mine own poor part, Look you, I'll go pray. Shak. Poor, little, pretty, fluttering thing. Prior. 5. Free from self-assertion; not proud or arrogant; meek. \"Blessed are the poor in spirit.\" Matt. v. 3. Poor law, a law providing for, or regulating, the relief or support of the poor. -- Poor man's treacle (Bot.), garlic; -- so called because it was thought to be an antidote to animal poison. [Eng] Dr. Prior. -- Poor man's weatherglass (Bot.), the red-flowered pimpernel (Anagallis arvensis), which opens its blossoms only in fair weather. -- Poor rate, an assessment or tax, as in an English parish, for the relief or support of the poor. -- Poor soldier (Zoöl.), the friar bird. -- The poor, those who are destitute of property; the indigent; the needy. In a legal sense, those who depend on charity or maintenance by the public. \"I have observed the more public provisions are made for the poor, the less they provide for themselves.\" Franklin.\n\nA small European codfish (Gadus minutus); -- called also power cod.
poor-john |A small European fish, similar to the cod, but of inferior quality. Poor-john and apple pies are all our fare. Sir J. Harrington.
poor-spirited |Of a mean spirit; cowardly; base. -- Poor\"-spir`it*ed*ness, n.
poor-will |A bird of the Western United States (Phalænoptilus Nutalli) allied to the whip-poor-will.
poor-willie |The bar-tailed godwit. [Prov. Eng.]
poorbox |A receptacle in which money given for the poor is placed.
poorhouse |A dwelling for a number of paupers maintained at public expense; an almshouse; a workhouse.
poorliness |The quality or state of being poorly; ill health.
poorly |1. In a poor manner or condition; without plenty, or sufficiency, or suitable provision for comfort; as, to live poorly. 2. With little or no success; indifferently; with little profit or advantage; as, to do poorly in business. 3. Meanly; without spirit. Nor is their courage or their wealth so low, That from his wars they poorly would retire. Dryden. 4. Without skill or merit; as, he performs poorly. Poorly off, not well off; not rich.\n\nSomewhat ill; indisposed; not in health. \"Having been poorly in health.\" T. Scott.
poorness |The quality or state of being poor (in any of the senses of the adjective). Bacon.
pop |1. A small, sharp, quick explosive sound or report; as, to go off with a pop. Addison. 2. An unintoxicating beverage which expels the cork with a pop from the bottle containing it; as, ginger pop; lemon pop, etc. Hood. 3. (Zoöl.)  The European redwing. [Prov. Eng.] Pop corn. (a) Corn, or maize, of peculiar excellence for popping; especially, a kind the grains of which are small and compact. (b) Popped corn; which has been popped.\n\n1. To make a pop, or sharp, quick sound; as, the muskets popped away on all sides. 2. To enter, or issue forth, with a quick, sudden movement; to move from place to place suddenly; to dart; -- with in, out, upon, off, etc. He that killed my king . . . Popp'd in between the election and my hopes. Shak. A trick of popping up and down every moment. Swift. 3. To burst open with a pop, when heated over a fire; as, this corn pops well.\n\n1. To thrust or push suddenly; to offer suddenly; to bring suddenly and unexpectedly to notice; as, to pop one's head in at the door. He popped a paper into his hand. Milton. 2. To cause to pop; to cause to burst open by heat, as grains of Indian corn; as, to pop corn or chestnuts. To pop off, to thrust away, or put off promptly; as, to pop one off with a denial. Locke. -- To pop the question, to make an offer of marriage to a lady. [Colloq.] Dickens.\n\nLike a pop; suddenly; unexpectedly. \"Pop goes his plate.\" Beau. & Fl.
pope |1. Any ecclesiastic, esp. a bishop. [Obs.] Foxe. 2. The bishop of Rome, the head of the Roman Catholic Church. See Note under Cardinal. 3. A parish priest, or a chaplain, of the Greek Church. 4. (Zoöl.)  A fish; the ruff. Pope Joan, a game at cards played on a round board with compartments. -- Pope's eye, the gland surrounded with fat in the middle of the thigh of an ox or sheep. R. D. Blackmore. -- Pope's nose, the rump, or uropygium, of a bird. See Uropygium.
popedom |1. The place, office, or dignity of the pope; papal dignity. Shak. 2. The jurisdiction of the pope.
popeling |1. A petty or deputy pope. 2. An adherent of the pope. [R.] Marlowe.
popelote |A word variously explained as \"a little puppet,\" \"a little doll,\" or \"a young butterfly.\" Cf. Popet. [Obs.] So gay a popelote, so sweet a wench. Chaucer.
popery |The religion of the Roman Catholic Church, comprehending doctrines and practices; -- generally used in an opprobrious sense. POPE'S HEAD Pope's head.  A long-handled brush for dusting ceilings, etc., also for washing windows. [Cant]
popet |A puppet. [Obs.] Chaucer.
popgun |A child's gun; a tube and rammer for shooting pellets, with a popping noise, by compression of air.
popinjay |1. (Zoöl.) (a) The green woodpecker. (b) A parrot. The pye and popyngay speak they know not what. Tyndale. 2. A target in the form of a parrot. [Scot.] 3. A trifling, chattering, fop or coxcomb. \"To be so pestered with a popinjay.\" Shak.
popish |Of or pertaining to the pope; taught or ordained by the pope; hence, of or pertaining to the Roman Catholic Church; -- often used opprobriously. -- Pop\"ish*ly, adv. -- Pop\"ish*ness, n.
poplar |1. Any tree of the genus Populus; also, the timber, which is soft, and capable of many uses. Note: The aspen poplar is Populus tremula and P. tremuloides; Balsam poplar is P. balsamifera; Lombardy poplar (P. dilatata) is a tall, spiry tree; white poplar is Populus alba. 2. The timber of the tulip tree; -- called also white poplar. [U.S.]
poplexy |Apoplexy. [Obs.] Chaucer.
poplin |A fabric of many varieties, usually made of silk and worsted, - - used especially for women's dresses. Irish poplin, a fabric with silk warp and worsted weft, made in Ireland.
popliteal |Of or pertaining to the ham; in the region of the ham, or behind the knee joint; as, the popliteal space.
poplitic |Popliteal.
popovtsy |See Raskolnik.
popper |A utensil for popping corn, usually a wire basket with a long handle.\n\nA dagger. [Obs.] Chaucer.
poppet |1. See Puppet. 2. (Naut.)  One of certain upright timbers on the bilge ways, used to support a vessel in launching. Totten. 3. (Mach.)  An upright support or guide fastened at the bottom only. Poppet head, Puppet head. See Headstock (a).
poppied |1. Mingled or interspersed with poppies. \"Poppied corn.\" Keats. 2. Affected with poppy juice; hence, figuratively, drugged; drowsy; listless; inactive. [R.] The poppied sails doze on the yard. Lowell.
popping |a. & n. from Pop. Popping crease. (Cricket) See under Crease.
popple |To move quickly up and down; to bob up and down, as a cork on rough water; also, to bubble. Cotton.\n\n1. The poplar. [Prov. Eng. & Local, U. S.] 2. Tares. [Obs.] \"To sow popple among wheat.\" Bale.
poppy |Any plant or species of the genus Papaver, herbs with showy polypetalous flowers and a milky juice. From one species (Papaver somniferum) opium is obtained, though all the species contain it to some extent; also, a flower of the plant. See Illust. of Capsule. California poppy (Bot.), any yellow-flowered plant of the genus Eschscholtzia. -- Corn poppy. See under Corn. -- Horn, or Horned, poppy. See under Horn. -- Poppy bee (Zoöl.), a leaf-cutting bee (Anthocopa papaveris) which uses pieces cut from poppy petals for the lining of its cells; -- called also upholsterer bee. -- Prickly poppy (Bot.), Argemone Mexicana, a yellow-flowered plant of the Poppy family, but as prickly as a thistle. -- Poppy seed, the seed the opium poppy (P. somniferum). -- Spatling poppy (Bot.), a species of Silene (S. inflata). See Catchfly.\n\nA raised ornament frequently having the form of a final. It is generally used on the tops of the upright ends or elbows which terminate seats, etc., in Gothic churches.
poppyhead |A raised ornament frequently having the form of a final. It is generally used on the tops of the upright ends or elbows which terminate seats, etc., in Gothic churches.
populace |The common people; the vulgar; the multitude, -- comprehending all persons not distinguished by rank, office, education, or profession. Pope. To . . . calm the peers and please the populace. Daniel. They . . . call us Britain's barbarous populaces. Tennyson. Syn. -- Mob; people; commonalty.
populacy |Populace. [Obs.] Feltham.
popular |1. Of or pertaining to the common people, or to the whole body of the people, as distinguished from a select portion; as, the popular voice; popular elections. \"Popular states.\" Bacon. \"So the popular vote inclines.\" Milton. The commonly held in popular estimation are greatest at a distance. J. H. Newman. 2. Suitable to common people; easy to be comprehended; not abstruse; familiar; plain. Homilies are plain popular instructions. Hooker. 3. Adapted to the means of the common people; possessed or obtainable by the many; hence, cheap; common; ordinary; inferior; as, popular prices; popular amusements. The smallest figs, called popular figs, . . . are, of all others, the basest and of least account. Holland. 4. Beloved or approved by the people; pleasing to people in general, or to many people; as, a popular preacher; a popular law; a popular administration. 5. Devoted to the common people; studious of the favor of the populace. [R.] Such popular humanity is treason. Addison. 6. Prevailing among the people; epidemic; as, a popular disease. [Obs.] Johnson. Popular action (Law), an action in which any person may sue for penalty imposed by statute. Blackstone.
populares |The people or the people's party, in ancient Rome, as opposed to the optimates.
popularity |1. The quality or state of being popular; especially, the state of being esteemed by, or of being in favor with, the people at large; good will or favor proceeding from the people; as, the popularity of a law, statesman, or a book. A popularity which has lasted down to our time. Macaulay. 2. The quality or state of being adapted or pleasing to common, poor, or vulgar people; hence, cheapness; inferiority; vulgarity. This gallant laboring to avoid popularity falls into a habit of affectation. B. Jonson. 3. Something which obtains, or is intended to obtain, the favor of the vulgar; claptrap. Popularities, and circumstances which . . . sway the ordinary judgment. Bacon. 4. The act of courting the favor of the people. [Obs.] \"Indicted . . . for popularity and ambition.\" Holland. 5. Public sentiment; general passion. [R.] A little time be allowed for the madness of popularity to cease. Bancroft.
popularization |The act of making popular, or of introducing among the people.
popularize |To make popular; to make suitable or acceptable to the common people; to make generally known; as, to popularize philosophy. \"The popularizing of religious teaching.\" Milman.
popularizer |One who popularizes.
popularly |In a popular manner; so as to be generally favored or accepted by the people; commonly; currently; as, the story was popularity reported. The victor knight, Bareheaded, popularly low had bowed. Dryden.
popularness |The quality or state of being popular; popularity. Coleridge.
populate |Populous. [Obs.] Bacon.\n\nTo furnish with inhabitants, either by natural increase or by immigration or colonization; to cause to be inhabited; to people.\n\nTo propagate. [Obs.] Great shoals of people which go on to populate. Bacon.
population |1. The act or process of populating; multiplication of inhabitants. 2. The whole number of people, or inhabitants, in a country, or portion of a country; as, a population of ten millions.
populator |One who populates.
populicide |Slaughter of the people. [R.]
populin |A glycoside, related to salicin, found in the bark of certain species of the poplar (Populus), and extracted as a sweet white crystalline substance.
populism |The political doctrines advocated by the People's party.
populist |A member of the People's party. -- Pop`u*lis\"tic (#), a.
populosity |Populousness.[Obs.]
populous |1. Abounding in people; full of inhabitants; containing many inhabitants in proportion to the extent of the country. Heaven, yet populous, retains Number sufficient to possess her realms. Milton. 2. Popular; famous. [Obs.] J. Webster. 3. Common; vulgar. [Obs.] Arden of Feversham. 4. Numerous; in large number. [Obs.] \"The dust . . . raised by your populous troops.\" Shak. -- Pop\"u*lous*ly, adv. -- Pop\"u*lous*ness, n.
poraille |Poor people; the poor. [Obs.] Chaucer.
porbeagle |A species of shark (Lamna cornubica), about eight feet long, having a pointed nose and a crescent-shaped tail; -- called also mackerel shark. [Written also probeagle.]
porcate |Having grooves or furrows broader than the intervening ridges; furrowed.
porcelain |Purslain. [Obs.]\n\nA fine translucent or semitransculent kind of earthenware, made first in China and Japan, but now also in Europe and America; -- called also China, or China ware. Porcelain, by being pure, is apt to break. Dryden. Ivory porcelain, porcelain with a surface like ivory, produced by depolishing. See Depolishing. -- Porcelain clay. See under Clay. -- Porcelain crab (Zoöl.), any crab of the genus Porcellana and allied genera (family Porcellanidæ). They have a smooth, polished carapace. -- Porcelain jasper. (Min.) See Porcelanite. -- Porcelain printing, the transferring of an impression of an engraving to porcelain. -- Porcelain shell (Zoöl.), a cowry.
porcelainized |Baked like potter's lay; -- applied to clay shales that have been converted by heat into a substance resembling porcelain.
porcelaneous |1. Of or pertaining to porcelain; resembling porcelain; as, porcelaneous shells. 2. (Zoöl.)  Having a smooth, compact shell without pores; -- said of certain Foraminifera.
porcelanite |A semivitrified clay or shale, somewhat resembling jasper; -- called also porcelain jasper.
porcelanous |Porcelaneous. Ure.
porcellaneous |1. Of or pertaining to porcelain; resembling porcelain; as, porcelaneous shells. 2. (Zoöl.)  Having a smooth, compact shell without pores; -- said of certain Foraminifera.
porcellanous |Porcelaneous. Ure.
porch |1. (Arch.)  A covered and inclosed entrance to a building, whether taken from the interior, and forming a sort of vestibule within the main wall, or projecting without and with a separate roof. Sometimes the porch is large enough to serve as a covered walk. See also Carriage porch, under Carriage, and Loggia. The graceless Helen in the porch I spied Of Vesta's temple. Dryden. 2. A portico; a covered walk. [Obs.] Repair to Pompey's porch, where you shall find find us. Shak. The Porch, a public portico, or great hall, in Athens, where Zeno, the philosopher, taught his disciples; hence, sometimes used as equivalent to the school of the Stoics. It was called \"h poiki`lh stoa`. [See Poicile.]
porcine |Of or pertaining to swine; characteristic of the hog. \"Porcine cheeks.\" G. Eliot.
porcupine |1. (Zoöl.)  Any Old Word rodent of the genus Hystrix, having the back covered with long, sharp, erectile spines or quills, sometimes a foot long. The common species of Europe and Asia (Hystrix cristata) is the best known. 2. (Zoöl.)  Any species of Erethizon and related genera, native of America. They are related to the true porcupines, but have shorter spines, and are arboreal in their habits. The Canada porcupine (Erethizon dorsatus) is a well known species. Porcupine ant-eater (Zoöl.), the echidna. -- Porcupine crab (Zoöl.), a large spiny Japanese crab (Acantholithodes hystrix). -- Porcupine disease (Med.). See Ichthyosis. -- Porcupine fish (Zoöl.), any plectognath fish having the body covered with spines which become erect when the body is inflated. See Diodon, and Globefish. -- Porcupine grass (Bot.), a grass (Stipa spartea) with grains bearing a stout twisted awn, which, by coiling and uncoiling through changes in moisture, propels the sharp-pointed and barbellate grain into the wool and flesh of sheep. It is found from Illinois westward. See Illustration in Appendix. -- Porcupine wood (Bot.), the hard outer wood of the cocoa palm; -- so called because, when cut horizontally, the markings of the wood resemble the quills of a porcupine.
pore |1. One of the minute orifices in an animal or vegetable membrane, for transpiration, absorption, etc. 2. A minute opening or passageway; an interstice between the constituent particles or molecules of a body; as, the pores of stones.\n\nTo look or gaze steadily in reading or studying; to fix the attention; to be absorbed; -- often with on or upon, and now usually with over.\"Painfully to pore upon a book.\" Shak. The eye grows weary with poring perpetually on the same thing. Dryden.
poreblind |Nearsighted; shortsighted; purblind. [Obs.] Bacon.
porer |One who pores.
porgy |(a) The scup. (b) The sailor's choice, or pinfish. (c) The margate fish. (d) The spadefish. (e) Any one of several species of embiotocoids, or surf fishes, of the Pacific coast. The name is also given locally to several other fishes, as the bur fish. [Written also porgee, porgie, and paugy.]
porifera |A grand division of the Invertebrata, including the sponges; -- called also Spongiæ, Spongida, and Spongiozoa. The principal divisions are Calcispongiæ, Keratosa or Fibrospongiæ, and Silicea.
poriferan |One of the Polifera.
poriferata |The Polifera.
poriform |Resembling a pore, or small puncture.
porime |A theorem or proposition so easy of demonstration as to be almost self-evident. [R.] Crabb.
poriness |Porosity. Wiseman.
porism |1. (Geom.)  A proposition affirming the possibility of finding such conditions as will render a certain determinate problem indeterminate or capable of innumerable solutions. Playfair. 2. (Gr. Geom.)  A corollary. Brande & C. Note: Three books of porisms of Euclid have been lost, but several attempts to determine the nature of these propositions and to restore them have been made by modern geometers.
porismatic |Of or pertaining to a porism; poristic.
porismatical |Of or pertaining to a porism; poristic.
poristic |Of or pertaining to a porism; of the nature of a porism.
poristical |Of or pertaining to a porism; of the nature of a porism.
porite |Any coral of the genus Porites, or family Poritidæ.
porites |An important genus of reef-building corals having small twelve- rayed calicles, and a very porous coral. Some species are branched, others grow in large massive or globular forms.
pork |The flesh of swine, fresh or salted, used for food.
porker |A hog. Pope.
porket |A young hog; a pig. [R.] Dryden. W. Howitt.
porkling |A pig; a porket. Tusser.
porkwood |The coarse-grained brownish yellow wood of a small tree (Pisonia obtusata) of Florida and the West Indies. Also called pigeon wood, beefwood, and corkwood.
pornerastic |Lascivious; licentious. [R.] F. Harrison.
pornographic |Of or pertaining to pornography; lascivious; licentious; as, pornographic writing.
pornography |1. Licentious painting or literature; especially, the painting anciently employed to decorate the walls of rooms devoted to bacchanalian orgies. 2. (Med.)  A treatise on prostitutes, or prostitution.
porosity |The quality or state of being porous; -- opposed to density.
porotic |A medicine supposed to promote the formation of callus.
porotype |A copy of a print, writing, etc., made by placing it upon a chemically prepared paper which is acted upon by a gas which permeates the paper of the print, writing, etc.
porous |Full of pores; having interstices in the skin or in the substance of the body; having spiracles or passages for fluids; permeable by liquids; as, a porous skin; porous wood. \"The veins of porous earth.\" Milton.
porously |In a porous manner.
porousness |1. The quality of being porous. 2. The open parts; the interstices of anything. [R.] They will forcibly get into the porousness of it. Sir K. Digby.
porpentine |Porcupine. [Obs.] Shak.
porpesse |A porpoise. [Obs.]
porphyraceous |Porphyritic.
porphyre |Porphyry. [Obs.] Locke.
porphyrite |A rock with a porphyritic structure; as, augite porphyrite.
porphyritic |Relating to, or resembling, porphyry, that is, characterized by the presence of distinct crystals, as of feldspar, quartz, or augite, in a relatively fine-grained base, often aphanitic or cryptocrystalline.
porphyrization |The act of porphyrizing, or the state of being porphyrized.
porphyrize |To cause to resemble porphyry; to make spotted in composition, like porphyry.
porphyrogenitism |The principle of succession in royal families, especially among the Eastern Roman emperors, by which a younger son, if born after the accession of his father to the throne, was preferred to an elder son who was not so born. Sir T. Palgrave.
porphyry |A term used somewhat loosely to designate a rock consisting of a fine-grained base (usually feldspathic) through which crystals, as of feldspar or quartz, are disseminated. There are red, purple, and green varieties, which are highly esteemed as marbles. Porphyry shell (Zoöl.), a handsome marine gastropod shell (Oliva porphyria), having a dark red or brown polished surface, marked with light spots, like porphyry.
porpita |A genus of bright-colored Siphonophora found floating in the warmer parts of the ocean. The individuals are round and disk-shaped, with a large zooid in the center of the under side, surrounded by smaller nutritive and reproductive zooids, and by slender dactylozooids near the margin. The disk contains a central float, or pneumatocyst.
porpoise |1. (Zoöl.)  Any small cetacean of the genus Phocæna, especially P. communis, or P. phocæna, of Europe, and the closely allied American species (P. Americana). The color is dusky or blackish above, paler beneath. They are closely allied to the dolphins, but have a shorter snout. Called also harbor porpoise, herring hag, puffing pig, and snuffer. 2. (Zoöl.)  A true dolphin (Delphinus); -- often so called by sailors. Skunk porpoise, or Bay porpoise (Zoöl.), a North American porpoise (Lagenorhynchus acutus), larger than the common species, and with broad stripes of white and yellow on the sides. See Illustration in Appendix.
porporino |A composition of quicksilver, tin, and sulphur, forming a yellow powder, sometimes used by mediæval artists, for the sake of economy, instead of gold. Fairholt.
porpus |A porpoise. [Obs.] Swift.
porraceous |Resembling the leek in color; greenish. [R.] \"Porraceous vomiting.\" Wiseman.
porrect |Extended horizontally; stretched out.
porrection |The act of stretching forth.
porret |A scallion; a leek or small onion. [R.] Sir T. Browne.
porridge |A food made by boiling some leguminous or farinaceous substance, or the meal of it, in water or in milk, making of broth or thin pudding; as, barley porridge, milk porridge, bean porridge, etc.
porringer |A porridge dish; esp., a bowl or cup from which children eat or are fed; as, a silver porringer. Wordsworth.
port |A dark red or purple astringent wine made in Portugal. It contains a large percentage of alcohol.\n\n1. A place where ships may ride secure from storms; a sheltered inlet, bay, or cove; a harbor; a haven. Used also figuratively. Peering in maps for ports and piers and roads. Shak. We are in port if we have Thee. Keble. 2. In law and commercial usage, a harbor where vessels are admitted to discharge and receive cargoes, from whence they depart and where they finish their voyages. Free port. See under Free. -- Port bar. (Naut,) (a) A boom. See Boom, 4, also Bar, 3. (b) A bar, as of sand, at the mouth of, or in, a port. -- Port charges (Com.), charges, as wharfage, etc., to which a ship or its cargo is subjected in a harbor. -- Port of entry, a harbor where a customhouse is established for the legal entry of merchandise. -- Port toll (Law), a payment made for the privilege of bringing goods into port. -- Port warden, the officer in charge of a port; a harbor master.\n\n1. A passageway; an opening or entrance to an inclosed place; a gate; a door; a portal. [Archaic] Him I accuse The city ports by this hath entered. Shak. Form their ivory port the cherubim Forth issuing. Milton. 2. (Naut.)  An opening in the side of a vessel; an embrasure through which cannon may be discharged; a porthole; also, the shutters which close such an opening. Her ports being within sixteen inches of the water. Sir W. Raleigh. 3. (Mach.)  A passageway in a machine, through which a fluid, as steam, water, etc., may pass, as from a valve to the interior of the cylinder of a steam engine; an opening in a valve seat, or valve face. Air port, Bridle port, etc. See under Air, Bridle, etc. -- Port bar (Naut.), a bar to secure the ports of a ship in a gale. -- Port lid (Naut.), a lid or hanging for closing the portholes of a vessel. -- Steam port, and Exhaust port (Steam Engine), the ports of the cylinder communicating with the valve or valves, for the entrance or exit of the steam, respectively.\n\n1. To carry; to bear; to transport. [Obs.] They are easily ported by boat into other shires. Fuller. 2. (Mil.)  To throw, as a musket, diagonally across the body, with the lock in front, the right hand grasping the small of the stock, and the barrel sloping upward and crossing the point of the left shoulder; as, to port arms. Began to hem him round with ported spears. Milton. Port arms, a position in the manual of arms, executed as above.\n\nThe manner in which a person bears himself; deportment; carriage; bearing; demeanor; hence, manner or style of living; as, a proud port. Spenser. And of his port as meek as is a maid. Chaucer. The necessities of pomp, grandeur, and a suitable port in the world. South.\n\nThe larboard or left side of a ship (looking from the stern toward the bow); as, a vessel heels to port. See Note under Larboard. Also used adjectively.\n\nTo turn or put to the left or larboard side of a ship; -- said of the helm, and used chiefly in the imperative, as a command; as, port your helm.
port-royalist |One of the dwellers in the Cistercian convent of Port Royal des Champs, near Paris, when it was the home of the Jansenists in the 17th century, among them being Arnauld, Pascal, and other famous scholars. Cf. Jansenist.
porta |(a) The part of the liver or other organ where its vessels and nerves enter; the hilus. (b) The foramen of Monro. B. G. Wilder.
portability |The quality or state of being portable; fitness to be carried.
portable |1. Capable of being borne or carried; easily transported; conveyed without difficulty; as, a portable bed, desk, engine. South. 2. Possible to be endured; supportable. [Obs.] How light and portable my pain seems now! Shak. Portable forge. See under Forge. -- Portable steam engine. See under Steam engine.
portableness |The quality or state of being portable; portability.
portace |See Portass. [Obs.]
portage |(a) A sailor's wages when in port. (b) The amount of a sailor's wages for a voyage.\n\nA porthole. [Obs.] Shak.\n\n1. The act of carrying or transporting. 2. The price of carriage; porterage. Bp. Fell. 3. Capacity for carrying; tonnage. [Obs.] Hakluyt. 4. A carry between navigable waters. See 3d Carry.\n\nTo carry (goods, boats, etc.) overland between navigable waters.
portage group |A subdivision of the Chemung period in American geology. See Chart of Geology.
portague |A Portuguese gold coin formerly current, and variously estimated to be worth from three and one half to four and one half pounds sterling. [Obs.] [Written also portegue and portigue.] Ten thousand portagues, besides great pearls. Marlowe.
portal |1. A door or gate; hence, a way of entrance or exit, especially one that is grand and imposing. Thick with sparkling orient gems The portal shone. Milton. From out the fiery portal of the east. Shak. 2. (Arch.) (a) The lesser gate, where there are two of different dimensions. (b) Formerly, a small square corner in a room separated from the rest of the apartment by wainscoting, forming a short passage to another apartment. (c) By analogy with the French portail, used by recent writers for the whole architectural composition which surrounds and includes the doorways and porches of a church. 3. (Bridge Building)  The space, at one end, between opposite trusses when these are terminated by inclined braces. 4. A prayer book or breviary; a portass. [Obs.] Portal bracing (Bridge Building), a combination of struts and ties which lie in the plane of the inclined braces at a portal, serving to transfer wind pressure from the upper parts of the trusses to an abutment or pier of the bridge.\n\nOf or pertaining to a porta, especially the porta of the liver; as, the portal vein, which enters the liver at the porta, and divides into capillaries after the manner of an artery. Note: Portal is applied to other veins which break up into capillaries; as, the renal portal veins in the frog.
portamento |In singing, or in the use of the bow, a gradual carrying or lifting of the voice or sound very smoothly from one note to another; a gliding from tone to tone.
portance |See Port, carriage, demeanor. [Obs.] Spenser. Shak.
portass |A breviary; a prayer book. [Written variously portace, portasse, portesse, portise, porthose, portos, portus, portuse, etc.] [Obs.] Spenser. Camden. By God and by this porthors I you swear. Chaucer.
portate |Borne not erect, but diagonally athwart an escutcheon; as, a cross portate.
portative |1. Portable. [Obs.] 2. (Physics)  Capable of holding up or carrying; as, the portative force of a magnet, of atmospheric pressure, or of capillarity.
portcluse |A portcullis. [Obs.]
portcrayon |A metallic handle with a clasp for holding a crayon.
portcullis |1. (Fort.)  A grating of iron or of timbers pointed with iron, hung over the gateway of a fortress, to be let down to prevent the entrance of an enemy. \"Let the portcullis fall.\" Sir W. Scott. She . . . the huge portcullis high updrew. Milton. 2. An English coin of the reign of Elizabeth, struck for the use of the East India Company; -- so called from its bearing the figure of a portcullis on the reverse.\n\nTo obstruct with, or as with, a portcullis; to shut; to bar. [R.] Shak.
porte |The Ottoman court; the government of the Turkish empire, officially called the Sublime Porte, from the gate (port) of the sultan's palace at which justice was administered.
porte-cochere |A large doorway allowing vehicles to drive into or through a building. It is common to have the entrance door open upon the passage of the porte-cochère. Also, a porch over a driveway before an entrance door.
ported |Having gates. [Obs.] We took the sevenfold-ported Thebes. Chapman.
portegue |See Portague. [Obs.]
portemonnaie |A small pocketbook or wallet for carrying money.
portend |1. To indicate (events, misfortunes, etc.) as in future; to foreshow; to foretoken; to bode; -- now used esp. of unpropitious signs. Bacon. Many signs portended a dark and stormy day. Macaulay. 2. To stretch out before. [R.] \"Doomed to feel the great Idomeneus' portended steel.\" Pope. Syn. -- To foreshow; foretoken; betoken; forebode; augur; presage; foreshadow; threaten.
portension |The act of foreshowing; foreboding. [R.] Sir T. Browne.
portent |That which portends, or foretoken; esp., that which portends evil; a sign of coming calamity; an omen; a sign. Shak. My loss by dire portents the god foretold. Dryden.
portentive |Presaging; foreshadowing.
portentous |1. Of the nature of a portent; containing portents; foreschadowing, esp. foreschadowing ill; ominous. For, I believe, they are portentous things. Shak. Victories of strange and almost portentous splendor. Macaulay. 2. Hence: Monstrous; prodigious; wonderful; dreadful; as, a beast of portentous size. Roscommon. -- Por*tent\"ous*ly, adv. -- Por*tent\"ous*ness, n.
porter |A man who has charge of a door or gate; a doorkeeper; one who waits at the door to receive messages. Shak. To him the porter openeth. John x. 3.\n\n1. A carrier; one who carries or conveys burdens, luggage, etc.; for hire. 2. (Forging)  A bar of iron or steel at the end of which a forging is made; esp., a long, large bar, to the end of which a heavy forging is attached, and by means of which the forging is lifted and handled is hammering and heating; -- called also porter bar. 3. A malt liquor, of a dark color and moderately bitter taste, possessing tonic and intoxicating qualities. Note: Porter is said to be so called as having been first used chiefly by the London porters, and this application of the word is supposed to be not older than 1750.
