prawn |Any one of numerous species of large shrimplike Crustacea having slender legs and long antennæ. They mostly belong to the genera Pandalus, Palæmon, Palæmonetes, and Peneus, and are much used as food. The common English prawn in Palæmon serratus. Note: The name is often applied to any large shrimp.
praxinoscope |An instrument, similar to the phenakistoscope, for presenting to view, or projecting upon a screen, images the natural motions of real objects.
praxis |1. Use; practice; especially, exercise or discipline for a specific purpose or object. \"The praxis and theory of music.\" Wood. 2. An example or form of exercise, or a collection of such examples, for practice.
pray |See Pry. [Obs.] Spenser.\n\nTo make request with earnestness or zeal, as for something desired; to make entreaty or supplication; to offer prayer to a deity or divine being as a religious act; specifically, to address the Supreme Being with adoration, confession, supplication, and thanksgiving. And to his goddess pitously he preyde. Chaucer. When thou prayest, enter into thy closet, and when thou hast shut thy door, pray to thy Father which is in secret; and thy Father which seeth in secret shall reward thee openly. Matt. vi. 6. I pray, or (by ellipsis) Pray, I beg; I request; I entreat you; -- used in asking a question, making a request, introducing a petition, etc.; as, Pray, allow me to go. I pray, sir. why am I beaten Shak. Syn. -- To entreat; supplicate; beg; implore; invoke; beseech; petition.\n\n1. To address earnest request to; to supplicate; to entreat; to implore; to beseech. And as this earl was preyed, so did he. Chaucer. We pray you . . . by ye reconciled to God. 2 Cor. v. 20. 2. To ask earnestly for; to seek to obtain by supplication; to entreat for. I know not how to pray your patience. Shak. 3. To effect or accomplish by praying; as, to pray a soul out of purgatory. Milman. To pray in aid. (Law) (a) To call in as a helper one who has an interest in the cause. Bacon. (b) A phrase often used to signify claiming the benefit of an argument. See under Aid. Mozley & W.
prayer |One who prays; a supplicant.\n\n1. The act of praying, or of asking a favor; earnest request or entreaty; hence, a petition or memorial addressed to a court or a legislative body. \"Their meek preyere.\" Chaucer 2. The act of addressing supplication to a divinity, especially to the true God; the offering of adoration, confession, supplication, and thanksgiving to the Supreme Being; as, public prayer; secret prayer. As he is famed for mildness, peace, and prayer. Shak. 3. The form of words used in praying; a formula of supplication; an expressed petition; especially, a supplication addressed to God; as, a written or extemporaneous prayer; to repeat one's prayers. He made those excellent prayers which were published immediately after his death. Bp. Fell. Prayer book, a book containing devotional prayers. -- Prayer meeting, a meeting or gathering for prayer to God. Syn. -- Petition; orison; supplication; entreaty; suit.
prayerful |Given to prayer; praying much or often; devotional. \"The prayerful man.\" J. S. Blackie. -- Prayer\"ful*ly, adv. -- Prayer\"ful*ness, n.
prayerless |Not using prayer; habitually neglecting prayer to God; without prayer. \"The next time you go prayerless to bed.\" Baxter. -- Prayer\"less*ly, adv. -- Prayer\"less*ness, n.
praying |a. & n. from Pray, v. Praying insect, locust, or mantis (Zoöl.), a mantis, especially Mantis religiosa. See Mantis. -- Praying machine, or Praying wheel, a wheel on which prayers are pasted by Buddhist priests, who then put the wheel in rapid revolution. Each turn in supposed to have the efficacy of an oral repetition of all the prayers on the wheel. Sometimes it is moved by a stream.
prayingly |With supplication to God.
pre- |A prefix denoting priority (of time, place, or rank); as, precede, to go before; precursor, a forerunner; prefix, to fix or place before; preëminent eminent before or above others. Pre- is sometimes used intensively, as in prepotent, very potent. [Written also præ-.]
pre-raphaelite |Popularly, any modern artist thought to be a would-be restorer of early ideas or methods, as one of the German painters often called Nazarenes, or one who paints and draws with extreme minuteness of detail.
preaccusation |Previous accusation.
preace |Press. [Obs.] Spenser.
preach |1. To proclaim or publish tidings; specifically, to proclaim the gospel; to discourse publicly on a religious subject, or from a text of Scripture; to deliver a sermon. How shall they preach, except they be sent Rom. x. 15. From that time Jesus began to preach. Matt. iv. 17. 2. To give serious advice on morals or religion; to discourse in the manner of a preacher.\n\n1. To proclaim by public discourse; to utter in a sermon or a formal religious harangue. That Cristes gospel truly wolde preche. Chaucer. The Lord hath anointed me to preach good tidings unto the meek. Isa. lxi. 1. 2. To inculcate in public discourse; to urge with earnestness by public teaching. \"I have preached righteousness in the great congregation.\" Ps. xl. 9. 3. To deliver or pronounce; as, to preach a sermon. 4. To teach or instruct by preaching; to inform by preaching. [R.] \"As ye are preached.\" Southey. 5. To advise or recommend earnestly. My master preaches patience to him. Shak. To preach down, to oppress, or humiliate by preaching. Tennyson. -- To preach up, to exalt by preaching; to preach in support of; as, to preach up equality.\n\nA religious discourse. [Obs.] Hooker.
preacher |1. One who preaches; one who discourses publicly on religious subjects. How shall they hear without a preacher Rom. x. 14. 2. One who inculcates anything with earnestness. No preacher is listened to but Time. Swift. Preacher bird (Zoöl.), a toucan.
preachership |The office of a preacher. \"The preachership of the Rolls.\" Macaulay.
preachify |To discourse in the manner of a preacher. [Colloq.] Thackeray.
preaching |The act of delivering a religious discourse; the art of sermonizing; also, a sermon; a public religious discourse; serious, earnest advice. Milner. Preaching cross, a cross, sometimes surmounting a pulpit, erected out of doors to designate a preaching place. -- Preaching friars. See Dominican.
preachman |A preacher; -- so called in contempt. [Obs.] Howell.
preachment |A religious harangue; a sermon; -- used derogatively. Shak.
preacquaint |To acquaint previously or beforehand. Fielding.
preacquaintance |Previous acquaintance or knowledge. Harris.
preact |To act beforehand; to perform previously.
preaction |Previous action.
preadamic |Prior to Adam.
preadamite |1. An inhabitant of the earth before Adam. 2. One who holds that men existed before Adam.
preadamitic |Existing or occurring before Adam; preadamic; as, preadamitic periods.
preadjustment |Previous adjustment.
preadministration |Previous administration. Bp. Pearson.
preadmission |Lit., previous admission; specif. (Engin.),  admission, as of steam, to the engine cylinder before the back stroke is completed, thus increasing the cushioning.
preadmonish |To admonish previously.
preadmonition |Previous warning or admonition; forewarning.
preadvertise |To advertise beforehand; to preannounce publicly.
preamble |A introductory portion; an introduction or preface, as to a book, document, etc.; specifically, the introductory part of a statute, which states the reasons and intent of the law.\n\nTo make a preamble to; to preface; to serve as a preamble. [R.] Feltham. Milton.
preambulary |Of or pertaining to a preamble; introductory; contained or provided for in a preamble. \"A preambulary tax.\" [R.] Burke.
preambulate |To walk before. [R.] Jordan.
preambulation |1. A walking or going before; precedence. [R.] 2. A preamble. [Obs.] Chaucer.
preambulatory |Preceding; going before; introductory. [R.] Simon Magus had preambulatory impieties. Jer. Taylor.
preambulous |See Perambulatory. [R.] Sir T. Browne.
preannounce |To announce beforehand. Coleridge.
preantenultimate |Being or indicating the fourth syllable from the end of a word, or that before the antepenult.
preaortic |In front, or on the ventral side, of the aorta.
preappoint |To appoint previously, or beforehand. Carlyle.
preappointment |Previous appointment.
preapprehension |An apprehension or opinion formed before examination or knowledge. [R.] Sir T. Browne.
prearm |To forearm. [R.]
prearrange |To arrange beforehand.
prease |To press; to crowd. [Obs.] -- n.  A press; a crowd. [Obs.] Spenser.
preassurance |Previous assurance. Coleridge.
preataxic |Occurring before the symptom ataxia has developed; -- applied to the early symptoms of locomotor ataxia.
preaudience |Precedence of rank at the bar among lawyers. Blackstone.
preaxial |Situated in front of any transverse axis in the body of an animal; anterior; cephalic; esp., in front, or on the anterior, or cephalic (that is, radial or tibial) side of the axis of a limb.
prebend |1. A payment or stipend; esp., the stipend or maintenance granted to a prebendary out of the estate of a cathedral or collegiate, church with which he is connected. See Note under Benefice. 2. A prebendary. [Obs.] Bacon. Dignitary prebend, one having jurisdiction annexed to it. -- Simple prebend, one without jurisdiction.
prebendal |Of or pertaining to a prebend; holding a prebend; as, a prebendal priest or stall. Chesterfield.
prebendary |1. A clergyman attached to a collegiate or cathedral church who enjoys a prebend in consideration of his officiating at stated times in the church. See Note under Benefice, n., 3. Hook. 2. A prebendaryship. [Obs.] Bailey.
prebendaryship |The office of a prebendary.
prebendate |To invest with the office of prebendary; to present to a prebend. [Obs.] Grafton.
prebendship |A prebendaryship. [Obs.] Foxe.
prebronchial |Situated in front of the bronchus; -- applied especially to an air sac on either side of the esophagus of birds.
precalculate |To calculate or determine beforehand; to prearrange. Masson.
precant |One who prays. [R.] Coleridge.
precarious |1. Depending on the will or pleasure of another; held by courtesy; liable to be changed or lost at the pleasure of another; as, precarious privileges. Addison. 2. Held by a doubtful tenure; depending on unknown causes or events; exposed to constant risk; not to be depended on for certainty or stability; uncertain; as, a precarious state of health; precarious fortunes. \"Intervals of partial and precarious liberty.\" Macaulay. Syn. -- Uncertain; unsettled; unsteady; doubtful; dubious; equivocal. -- Precarious, Uncertain. Precarious in stronger than uncertain. Derived originally from the Latin precari, it first signified \"granted to entreaty,\" and, hence, \"wholly dependent on the will of another.\" Thus it came to express the highest species of uncertainty, and is applied to such things as depend wholly on future casualties. -- Pre*ca\"ri*ous*ly, adv. -- Pre*ca\"ri*ous*ness, n.
precation |The act of praying; supplication; entreaty. Cotton.
precative |Suppliant; beseeching. Bp. Hopkins. Precatory words (Law), words of recommendation, request, entreaty, wish, or expectation, employed in wills, as distinguished from express directions; -- in some cases creating a trust. Jarman.
precatory |Suppliant; beseeching. Bp. Hopkins. Precatory words (Law), words of recommendation, request, entreaty, wish, or expectation, employed in wills, as distinguished from express directions; -- in some cases creating a trust. Jarman.
precaution |1. Previous caution or care; caution previously employed to prevent mischief or secure good; as, his life was saved by precaution. They [ancient philosophers] treasured up their supposed discoveries with miserable precaution. J. H. Newman. 2. A measure taken beforehand to ward off evil or secure good or success; a precautionary act; as, to take precautions against accident.\n\n1. To warn or caution beforehand. Locke. 2. To take precaution against. [R.] Dryden.
precautional |Precautionary.
precautionary |Of or pertaining to precaution, or precautions; as, precautionary signals.
precautious |Taking or using precaution; precautionary. -- Pre*cau\"tious*ly, adv. -- Pre*cau\"*tious*ness, n.
precedaneous |Preceding; antecedent; previous. [Obs.] Hammond.
precede |1. To go before in order of time; to occur first with relation to anything. \"Harm precedes not sin.\" Milton. 2. To go before in place, rank, or importance. 3. To cause to be preceded; to preface; to introduce; -- used with by or with before the instrumental object. [R.] It is usual to precede hostilities by a public declaration. Kent.
precedence |1. The act or state of preceding or going before in order of time; priority; as, one event has precedence of another. 2. The act or state of going or being before in rank or dignity, or the place of honor; right to a more honorable place; superior rank; as, barons have precedence of commoners. Which of them [the different desires] has the precedency in determining the will to the next action Locke. Syn. -- Antecedence; priority; preëminence; preference; superiority.
precedency |1. The act or state of preceding or going before in order of time; priority; as, one event has precedence of another. 2. The act or state of going or being before in rank or dignity, or the place of honor; right to a more honorable place; superior rank; as, barons have precedence of commoners. Which of them [the different desires] has the precedency in determining the will to the next action Locke. Syn. -- Antecedence; priority; preëminence; preference; superiority.
precedent |Going before; anterior; preceding; antecedent; as, precedent services. Shak. \"A precedent injury.\" Bacon. Condition precedent (Law), a condition which precede the vesting of an estate, or the accruing of a right.\n\n1. Something done or said that may serve as an example to authorize a subsequent act of the same kind; an authoritative example. Examples for cases can but direct as precedents only. Hooker. 2. A preceding circumstance or condition; an antecedent; hence, a prognostic; a token; a sign. [Obs.] 3. A rough draught of a writing which precedes a finished copy. [Obs.] Shak. 4. (Law)  A judicial decision which serves as a rule for future determinations in similar or analogous cases; an authority to be followed in courts of justice; forms of proceeding to be followed in similar cases. Wharton. Syn. -- Example; antecedent. -- Precedent, Example. An example in a similar case which may serve as a rule or guide, but has no authority out of itself. A precedent is something which comes down to us from the past with the sanction of usage and of common consent. We quote examples in literature, and precedents in law.
precedented |Having a precedent; authorized or sanctioned by an example of a like kind. Walpole.
precedential |Of the nature of a precedent; having force as an example for imitation; as, precedential transactions. All their actions in that time are not precedential to warrant posterity. Fuller.
precedently |Beforehand; antecedently.
preceding |1. Going before; -- opposed to following. 2. (Astron.)  In the direction toward which stars appear to move. See Following, 2.
precel |To surpass; to excel; to exceed. [Obs.] Howell.
precellence |Excellence; superiority. [Obs.] Sheldon.
precellency |Excellence; superiority. [Obs.] Sheldon.
precellent |Excellent; surpassing. [Obs.] Holland.
precentor |A leader of a choir; a directing singer. Specifically: (a) The leader of the choir in a cathedral; -- called also the chanter or master of the choir. Hook. (b) The leader of the congregational singing in Scottish and other churches.
precentorship |The office of a precentor.
precept |1. Any commandment, instruction, or order intended as an authoritative rule of action; esp., a command respecting moral conduct; an injunction; a rule. For precept must be upon precept. Isa. xxviii. 10. No arts are without their precepts. Dryden. 2. (Law)  A command in writing; a species of writ or process. Burrill. Syn. -- Commandment; injunction; mandate; law; rule; direction; principle; maxim. See Doctrine.\n\nTo teach by precepts. [Obs.] Bacon.
preceptial |Preceptive. [Obs.] [Passion] would give preceptial medicine to rage. Shak.
preception |A precept. [R.] Bp. Hall.
preceptive |Containing or giving precepts; of the nature of precepts; didactic; as, the preceptive parts of the Scriptures. The lesson given us here is preceptive to us. L'Estrange.
preceptor |1. One who gives commands, or makes rules; specifically, the master or principal of a school; a teacher; an instructor. 2. The head of a preceptory among the Knights Templars. Sir W. Scott.
preceptorial |Of or pertaining to a preceptor.
preceptory |Preceptive. \"A law preceptory.\" Anderson (1573).\n\nA religious house of the Knights Templars, subordinate to the temple or principal house of the order in London. See Commandery, n., 2.
preceptress |A woman who is the principal of a school; a female teacher.
precession |The act of going before, or forward. Lunisolar precession. (Astron.) See under Lunisolar. -- Planetary precession, that part of the precession of the equinoxes which depends on the action of the planets alone. -- Precession of the equinoxes (Astron.), the slow backward motion of the equinoctial points along the ecliptic, at the rate of 50.2\" annually, caused by the action of the sun, moon, and planets, upon the protuberant matter about the earth's equator, in connection with its diurnal rotation; -- so called because either equinox, owing to its westerly motion, comes to the meridian sooner each day than the point it would have occupied without the motion of precession, and thus precedes that point continually with reference to the time of transit and motion.
precessional |Of or pertaining to pression; as, the precessional movement of the equinoxes.
precessor |A predecessor. [Obs.] Fuller.
precieuse |An affected woman of polite society, esp. one of the literary women of the French salons of the 17th century.
precinct |1. The limit or exterior line encompassing a place; a boundary; a confine; limit of jurisdiction or authority; -- often in the plural; as, the precincts of a state. \"The precincts of light.\" Milton. 2. A district within certain boundaries; a minor territorial or jurisdictional division; as, an election precinct; a school precinct. 3. A parish or prescribed territory attached to a church, and taxed for its support. [U.S.] The parish, or precinct, shall proceed to a new choice. Laws of Massachusetts.
preciosity |Preciousness; something precious. [Obs.] Sir T. Browne.
precious |1. Of great price; costly; as, a precious stone. \"The precious bane.\" Milton. 2. Of great value or worth; very valuable; highly esteemed; dear; beloved; as, precious recollections. She is more precious than rules. Prov. iii. 15. Many things which are most precious are neglected only because the value of them lieth hid. Hooker. Note: Also used ironically; as, a precious rascal. 3. Particular; fastidious; overnice. [Obs.] Lest that precious folk be with me wroth. Chaucer. Precious metals, the uncommon and highly valuable metals, esp. gold and silver. -- Precious stones, gems; jewels.
preciously |In a precious manner; expensively; extremely; dearly. Also used ironically.
preciousness |The quality or state of being precious; costliness; dearness.
precipe |See Præcipe, and Precept.
precipice |1. A sudden or headlong fall. [Obs.] Fuller. 2. A headlong steep; a very steep, perpendicular, or overhanging place; an abrupt declivity; a cliff. Where wealth like fruit on precipices grew. Dryden.
precipient |Commanding; directing.
precipitability |The quality or state of being precipitable.
precipitance |The quality or state of being precipitant, or precipitate; headlong hurry; excessive or rash haste in resolving, forming an opinion, or executing a purpose; precipitation; as, the precipitancy of youth. \"Precipitance of judgment.\" I. Watts.
precipitancy |The quality or state of being precipitant, or precipitate; headlong hurry; excessive or rash haste in resolving, forming an opinion, or executing a purpose; precipitation; as, the precipitancy of youth. \"Precipitance of judgment.\" I. Watts.
precipitant |1. Falling or rushing headlong; rushing swiftly, violently, or recklessly; moving precipitately. They leave their little lives Above the clouds, precipitant to earth. J. Philips. Should he return, that troop so blithe and bold, Precipitant in fear would wing their flight. Pope. 2. Unexpectedly or foolishly brought on or hastened; rashly hurried; hasty; sudden; reckless. Jer. Taylor. \"Precipitant rebellion.\" Eikon Basilike.\n\nAny force or reagent which causes the formation of a precipitate.
precipitantly |With rash or foolish haste; in headlong manner. Milton.
precipitantness |The quality or state of being precipitant; precipitation.
precipitate |1. Overhasty; rash; as, the king was too precipitate in declaring war. Clarendon. 2. Lacking due deliberation or care; hurried; said or done before the time; as, a precipitate measure. \"The rapidity of our too precipitate course.\" Landor. 3. Falling, flowing, or rushing, with steep descent; headlong. Precipitate the furious torrent flows. Prior. 4. Ending quickly in death; brief and fatal; as, a precipitate case of disease. [Obs.] Arbuthnot.\n\nAn insoluble substance separated from a solution in a concrete state by the action of some reagent added to the solution, or of some force, such as heat or cold. The precipitate may fall to the bottom (whence the name), may be diffused through the solution, or may float at or near the surface. Red precipitate (Old. Chem), mercuric oxide (HgO) a heavy red crystalline powder obtained by heating mercuric nitrate, or by heating mercury in the air. Prepared in the latter manner, it was the precipitate per se of the alchemists. -- White precipitate (Old Chem.) (a) A heavy white amorphous powder (NH2.HgCl) obtained by adding ammonia to a solution of mercuric chloride or corrosive sublimate; -- formerly called also infusible white precipitate, and now amido-mercuric chloride. (b) A white crystalline substance obtained by adding a solution of corrosive sublimate to a solution of sal ammoniac (ammonium chloride); -- formerly called also fusible white precipitate.\n\n1. To throw headlong; to cast down from a precipice or height. She and her horse had been precipitated to the pebbled region of the river. W. Irving. 2. To urge or press on with eager haste or violence; to cause to happen, or come to a crisis, suddenly or too soon; as, precipitate a journey, or a conflict. Back to his sight precipitates her steps. Glover. If they be daring, it may precipitate their designs, and prove dangerous. Bacon. 3. (Chem.)  To separate from a solution, or other medium, in the form of a precipitate; as, water precipitates camphor when in solution with alcohol. The light vapor of the preceding evening had been precipitated by the cold. W. Irving.\n\n1. To dash or fall headlong. [R.] So many fathom down precipitating. Shak. 2. To hasten without preparation. [R.] 3. (Chem.)  To separate from a solution as a precipitate. See Precipitate, n.
precipitately |In a precipitate manner; headlong; hastily; rashly. Swift.
precipitation |1. The act of precipitating, or the state of being precipitated, or thrown headlong. In peril of precipitation From off rock Tarpeian. Shak. 2. A falling, flowing, or rushing downward with violence and rapidity. The hurry, precipitation, and rapid motion of the water, returning . . . towards the sea. Woodward. 3. Great hurry; rash, tumultuous haste; impetuosity. \"The precipitation of inexperience.\" Rambler. 4. (Chem.)  The act or process from a solution.
precipitator |One who precipitates, or urges on with vehemence or rashness. Hammond.
precipitious |Precipitous. [Obs.] -- Prec`i*pi\"tious*ly, adv. [Obs.] Dr. H. More.
precipitous |1. Steep, like a precipice; as, a precipitous cliff or mountain. 2. Headlong; as, precipitous fall. 3. Hasty; rash; quick; sudden; precipitate; as, precipitous attempts. Sir T. Browne. \"Marian's low, precipitous `Hush!'\" Mrs. Browning. -- Pre*cip\"i*tous*ly, adv. -- Pre*cip\"i*tous*ness, n.
precis |A concise or abridged statement or view; an abstract; a summary.
precise |1. Having determinate limitations; exactly or sharply defined or stated; definite; exact; nice; not vague or equivocal; as, precise rules of morality. The law in this point is not precise. Bacon. For the hour precise Exacts our parting hence. Milton. 2. Strictly adhering or conforming to rule; very nice or exact; punctilious in conduct or ceremony; formal; ceremonious. Addison. He was ever precise in promise-keeping. Shak. Syn. -- Accurate; exact; definite; correct; scrupulous; punctilious; particular; nice; formal. See Accurate. -- Pre*cise\"ly, adv. -- Pre*cise\"ness, n.
precisian |1. One who limits, or restrains. [Obs.] 2. An overprecise person; one rigidly or ceremoniously exact in the observance of rules; a formalist; -- formerly applied to the English Puritans. The most dissolute cavaliers stood aghast at the dissoluteness of the emancipated precisian. Macaulay.
precisianism |The quality or state of being a precisian; the practice of a precisian. Milton.
precisianist |A precisian.
precision |The quality or state of being precise; exact limitation; exactness; accuracy; strict conformity to a rule or a standard; definiteness. I have left out the utmost precisions of fractions. Locke. Syn. -- Preciseness; exactness; accuracy; nicety. -- Precision, Preciseness. Precision is always used in a good sense; as, precision of thought or language; precision in military evolutions. Preciseness is sometimes applied to persons or their conduct in a disparaging sense, and precise is often used in the same way.
precisive |Cutting off; (Logic) exactly limiting by cutting off all that is not absolutely relative to the purpose; as, precisive censure; precisive abstraction. I. Watts.
preclude |1. To put a barrier before; hence, to shut out; to hinder; to stop; to impede. The valves preclude the blood from entering the veins. E. Darwin. 2. To shut out by anticipative action; to prevent or hinder by necessary consequence or implication; to deter action of, access to, employment of, etc.; to render ineffectual; to obviate by anticipation. This much will obviate and preclude the objections. Bentley.
preclusion |The act of precluding, or the state of being precluded; a shutting out.
preclusive |Shutting out; precluding, or tending to preclude; hindering. -- Pre*clu\"sive*ly, adv.
precoce |Precocious. [Obs.]
precoces |Same as Præcoces.
precocious |1. Ripe or mature before the proper or natural time; early or prematurely ripe or developed; as, precocious trees. [R.] Sir T. Browne. 2. Developed more than is natural or usual at a given age; exceeding what is to be expected of one's years; too forward; -- used especially of mental forwardness; as, a precocious child; precocious talents.
precociously |In a precocious manner.
precociousness |The quality or state of being precocious; untimely ripeness; premature development, especially of the mental powers; forwardness. Saucy precociousness in learning. Bp. Mannyngham. That precocity which sometimes distinguishes uncommon genius. Wirt.
precocity |The quality or state of being precocious; untimely ripeness; premature development, especially of the mental powers; forwardness. Saucy precociousness in learning. Bp. Mannyngham. That precocity which sometimes distinguishes uncommon genius. Wirt.
precoetanean |One contemporary with, but older than, another. [Obs.] Fuller.
precogitate |To cogitate beforehand. [R.] Sherwood.
precogitation |Previous cogitation. [R.] Bailey.
precognition |1. Previous cognition. Fotherby. 2. (Scots Law)  A preliminary examination of a criminal case with reference to a prosecution. Erskine.
precognizable |Cognizable beforehand.
precognosce |To examine beforehand, as witnesses or evidence. A committee of nine precognoscing the chances. Masson.
precollection |A collection previously made. [R.]
precompose |To compose beforehand. Johnson.
preconceit |An opinion or notion formed beforehand; a preconception. Hooker.
preconceive |To conceive, or form an opinion of, beforehand; to form a previous notion or idea of. In a dead plain the way seemeth the longer, because the eye hath preconceived it shorter than the truth. Bacon.
preconception |The act of preconceiving; conception or opinion previously formed.
preconcert |To concert or arrange beforehand; to settle by previous agreement.\n\nSomething concerted or arranged beforehand; a previous agreement.
preconcerted |Previously arranged; agreed upon beforehand. -- Pre`con*cert\"ed*ly, adv. -- Pre`con*cert\"ed*ness, n.
preconcertion |The act of preconcerting; preconcert. Dr. T. Dwight.
precondemn |To condemn beforehand. -- Pre*con`dem*na\"tion, n.
precondition |A previous or antecedent condition; a preliminary condition.
preconform |To conform by way anticipation. De Quincey.
preconformity |Anticipative or antecedent conformity. Coleridge.
preconizate |To proclaim; to publish; also, to summon; to call. [Obs.] Bp. Burnet.
preconization |1. A publishing by proclamation; a public proclamation. Bp. Hall. 2. (Eccl.)  A formal approbation by the pope of a person nominated to an ecclesiastical dignity. Addis & Arnold.
preconize |To approve by preconization.
preconquer |To conquer in anticipation. [R.] Fuller.
preconscious |Of or pertaining to a state before consciousness.
preconsent |A previous consent.
preconsign |To consign beforehand; to make a previous consignment of.
preconsolidated |Consolidated beforehand.
preconstitute |To constitute or establish beforehand.
precontract |To contract, engage, or stipulate previously.\n\nTo make a previous contract or agreement. Ayliffe.\n\nA contract preceding another; especially (Law),  a contract of marriage which, according to the ancient law, rendered void a subsequent marriage solemnized in violation of it. Abbott.
precontrive |To contrive or plan beforehand.
precoracoid |The anterior part of the coracoid (often closely united with the clavicle) in the shoulder girdle of many reptiles and amphibians.
precordial |Situated in front of the heart; of or pertaining to the præcordia.
precrural |Situated in front of the leg or thigh; as, the precrural glands of the horse.
precurrer |A precursor. [Obs.] Shak.
precurse |A forerunning. [Obs.] Shak.
precursive |Preceding; introductory; precursory. \"A deep precursive sound.\" Coleridge.
precursor |One who, or that which, precedes an event, and indicates its approach; a forerunner; a harbinger. Evil thoughts are the invisible, airy precursors of all the storms and tempests of the soul. Buckminster. Syn. -- Predecessor; forerunner; harbinger; messenger; omen; sign.
precursorship |The position or condition of a precursor. Ruskin.
precursory |Preceding as a precursor or harbinger; indicating something to follow; as, precursory symptoms of a fever.\n\nAn introduction. [Obs.]
predacean |A carnivorous animal. Kirby.
predaceous |Living by prey; predatory. Derham.
predal |Of or pertaining to prey; plundering; predatory. [R.] Boyse.
predate |To date anticipation; to affix to (a document) an earlier than the actual date; to antedate; as, a predated deed or letter.
predation |The act of pillaging. E. Hall.
predatorily |In a predatory manner.
predatory |1. Characterized by plundering; practicing rapine; plundering; pillaging; as, a predatory excursion; a predatory party. \"A predatory war.\" Macaulay. 2. Hungry; ravenous; as, predatory spirits. [Obs.] Exercise . . . maketh the spirits more hot and predatory. Bacon. 3. (Zoöl.)  Living by preying upon other animals; carnivorous.
prede |To prey; to plunder. [Obs.] Holinshed.\n\nPrey; plunder; booty. [Obs.] Holinshed.
predecay |Premature decay.
predecease |To die sooner than. \"If children predecease progenitors.\" Shak.\n\nThe death of one person or thing before another. [R.] Brougham.
predecessive |Going before; preceding. \"Our predecessive students.\" Massinger.
predecessor |One who precedes; one who has preceded another in any state, position, office, etc.; one whom another follows or comes after, in any office or position. A prince who was as watchful as his predecessor had been over the interests of the state. Prescott.
predeclare |To declare or announce beforehand; to preannounce. Milman.
prededication |A dedication made previously or beforehand.
predefine |To define beforehand.
predeliberation |Previous deliberation.
predelineation |Previous delineation.
predella |The step, or raised secondary part, of an altar; a superaltar; hence, in Italian painting, a band or frieze of several pictures running along the front of a superaltar, or forming a border or frame at the foot of an altarpiece.
predesign |To design or purpose beforehand; to predetermine. Mitford.
predesignate |A term used by Sir William Hamilton to define propositions having their quantity indicated by a verbal sign; as, all, none, etc.; -- contrasted with preindesignate, defining propositions of which the quantity is not so indicated.
predestinarian |Of or pertaining to predestination; as, the predestinarian controversy. Waterland.\n\nOne who believes in or supports the doctrine of predestination. Dr. H. More.
predestinarianism |The system or doctrine of the predestinarians.
predestinary |Predestinarian. [Obs.] Heylin.
predestinate |Predestinated; foreordained; fated. \"A predestinate scratched face.\" Shak.\n\nTo predetermine or foreordain; to appoint or ordain beforehand by an unchangeable purpose or decree; to preëlect. Whom he did foreknow, he also did predestinate to be conformed to the image of his Son. Rom. viii. 29. Syn. -- To predetermine; foreordain; preordain; decree; predestine; foredoom.
predestination |1. The act of predestinating. Predestination had overruled their will. Milton. 2. (Theol.)  The purpose of Good from eternity respecting all events; especially, the preordination of men to everlasting happiness or misery. See Calvinism.
predestinative |Determining beforehand; predestinating. [R.] Coleridge.
predestinator |1. One who predestinates, or foreordains. 2. One who holds to the doctrine of predestination; a predestinarian. Cowley.
predestine |To decree beforehand; to foreordain; to predestinate. Young.
predestiny |Predestination. [Obs.]
predeterminable |Capable of being determined beforehand. Coleridge.
predeterminate |Determined beforehand; as, the predeterminate counsel of God.
predetermination |The act of previous determination; a purpose formed beforehand; as, the predetermination of God's will. Hammond.
predetermine |1. To determine (something) beforehand. Sir M. Hale. 2. To doom by previous decree; to foredoom.\n\nTo determine beforehand.
predial |1. Consisting of land or farms; landed; as, predial estate; that is, real estate. Ayliffe. 2. Attached to land or farms; as, predial slaves. 3. Issuing or derived from land; as, predial tithes.
prediastolic |Preceding the diastole of the heart; as, a prediastolic friction sound.
predicability |The quality or state of being predicable, or affirmable of something, or attributed to something. Reid.
predicable |Capable of being predicated or affirmed of something; affirmable; attributable.\n\n1. Anything affirmable of another; especially, a general attribute or notion as affirmable of, or applicable to, many individuals. 2. (Logic)  One of the five most general relations of attributes involved in logical arrangements, namely, genus, species, difference, property, and accident.
predicament |1. A class or kind described by any definite marks; hence, condition; particular situation or state; especially, an unfortunate or trying position or condition. \"O woeful sympathy; piteous predicament!\" Shak. 2. (Logic)  See Category. Syn. -- Category; condition; state; plight.
predicamental |Of or pertaining to a predicament. John Hall (1646).
predicant |Predicating; affirming; declaring; proclaiming; hence; preaching. \"The Roman predicant orders.\" N. Brit. Rev.\n\nOne who predicates, affirms, or proclaims; specifically, a preaching friar; a Dominican.
predicate |1. To assert to belong to something; to affirm (one thing of another); as, to predicate whiteness of snow. 2. To found; to base. [U.S.] Note: Predicate is sometimes used in the United States for found or base; as, to predicate an argument on certain principles; to predicate a statement on information received. Predicate is a term in logic, and used only in a single case, namely, when we affirm one thing of another. \"Similitude is not predicated of essences or substances, but of figures and qualities only.\" Cudworth.\n\nTo affirm something of another thing; to make an affirmation. Sir M. Hale.\n\n1. (Logic)  That which is affirmed or denied of the subject. In these propositions, \"Paper is white,\" \"Ink is not white,\" whiteness is the predicate affirmed of paper and denied of ink. 2. (Gram.)  The word or words in a proposition which express what is affirmed of the subject. Syn. -- Affirmation; declaration.\n\nPredicated.
predication |1. The act of predicating, or of affirming one thing of another; affirmation; assertion. Locke. 2. Preaching. [Obs. or Scot.] Chaucer.
predicative |Expressing affirmation or predication; affirming; predicating, as, a predicative term. -- Pred\"i*ca*tive*ly, adv.
predicatory |Affirmative; positive. Bp. Hall.
predicrotic |A term applied to the pulse wave sometimes seen in a pulse curve or sphygmogram, between the apex of the curve and the dicrotic wave. The predicrotic or tidal wave is best marked in a hard pulse, i. e., where the blood pressure is high. Landois & Stirling.
predict |To tell or declare beforehand; to foretell; to prophesy; to presage; as, to predict misfortune; to predict the return of a comet. Syn. -- To foretell; prophesy; prognosticate; presage; forebode; foreshow; bode.\n\nA prediction. [Obs.] Shak.
predictable |That may be predicted.
prediction |The act of foretelling; also, that which is foretold; prophecy. The predictions of cold and long winters. Bacon. Syn. -- Prophecy; prognostication; foreboding; augury; divination; soothsaying; vaticination.
predictional |Prophetic; prognostic. [R.]
predictive |Foretelling; prophetic; foreboding. -- Pre*dict\"ive*ly, adv.
predictor |One who predicts; a foreteller.
predictory |Predictive. [R.] Fuller.
predigest |To subject (food) to predigestion or artificial digestion.
predigestion |1. Digestion too soon performed; hasty digestion. [Obs.] Bacon. 2. (Med.)  Artificial digestion of food for use in illness or impaired digestion.
predilect |To elect or choose beforehand. [R.] Walter Harte.
predilection |A previous liking; a prepossession of mind in favor of something; predisposition to choose or like; partiality. Burke.
prediscover |To discover beforehand.
prediscovery |A previous discovery.
predisponency |The state of being predisposed; predisposition. [R.]
predisponent |Disposing beforehand; predisposing. -- n.  That which predisposes. Predisponent causes. (Med.) See Predisposing causes, under Predispose. Dunglison.
predispose |1. To dispose or incline beforehand; to give a predisposition or bias to; as, to predispose the mind to friendship. 2. To make fit or susceptible beforehand; to give a tendency to; as, debility predisposes the body to disease. Predisposing causes (Med.), causes which render the body liable to disease; predisponent causes.
predisposition |1. The act of predisposing, or the state of being predisposed; previous inclination, tendency, or propensity; predilection; -- applied to the mind; as, a predisposition to anger. 2. Previous fitness or adaptation to any change, impression, or purpose; susceptibility; -- applied to material things; as, the predisposition of the body to disease.
predominance |1. The quality or state of being predominant; superiority; ascendency; prevalence; predomination. The predominance of conscience over interest. South. 2. (Astrol.)  The superior influence of a planet. Shak.
predominancy |Predominance. Bacon.
predominant |Having the ascendency over others; superior in strength, influence, or authority; prevailing; as, a predominant color; predominant excellence. Those help . . . were predominant in the king's mind. Bacon. Foul subordination is predominant. Shak. Syn. -- Prevalent; superior; prevailing; ascendant; ruling; reigning; controlling; overruling.
predominantly |In a predominant manner.
predominate |To be superior in number, strength, influence, or authority; to have controlling power or influence; to prevail; to rule; to have the mastery; as, love predominated in her heart. [Certain] rays may predominate over the rest. Sir. I. Newton.\n\nTo rule over; to overpower. [R.]
predomination |The act or state of predominating; ascendency; predominance. W. Browne.
predoom |To foredoom.
predorsal |Situated in front of the back; immediately in front, or on the ventral side the dorsal part of the vertebral column.
predy |Cleared and ready for engagement, as a ship. Smart.
preedy |With ease. [Prov. Eng.]
preef |Proof. [Obs.] Chaucer.
preelect |To elect beforehand.
preelection |Election beforehand.
preeminence |The quality or state of being preëminent; superiority in prominence or in excellence; distinction above others in quality, rank, etc.; rarely, in a bad sense, superiority or notoriety in evil; as, preëminence in honor. The preëminence of Christianity to any other religious scheme. Addison. Painful preëminence! yourself to view Above life's weakness, and its comforts too. Pope. Beneath the forehead's walled preëminence. Lowell.
preeminent |Eminent above others; prominent among those who are eminent; superior in excellence; surpassing, or taking precedence of, others; rarely, surpassing others in evil, or in bad qualities; as, preëminent in guilt. In goodness and in power preëminent. Milton.
preeminently |In a preëminent degree.
preemploy |To employ beforehand. \"Preëmployed by him.\" Shak.
preempt |To settle upon (public land) with a right of preemption, as under the laws of the United States; to take by preëmption.
preemption |The act or right of purchasing before others. Specifically: (a) The privilege or prerogative formerly enjoyed by the king of buying provisions for his household in preference to others. [Eng.] (b) The right of an actual settler upon public lands (particularly those of the United States) to purchase a certain portion at a fixed price in preference to all other applicants. Abbott.
preemptioner |One who holds a prior to purchase certain public land. Abbott.
preemptive |Of or pertaining to preëmption; having power to preëmpt; preëmpting.
preemptor |One who preëmpts; esp., one who preëmpts public land.
preemptory |Pertaining to preëmption.
preen |A forked tool used by clothiers in dressing cloth.\n\n1. To dress with, or as with, a preen; to trim or dress with the beak, as the feathers; -- said of birds. Derham. 2. To trim up, as trees. [Prov. Eng.] Halliwell.
preengage |To engage by previous contract; to bind or attach previously; to preoccupy. But he was preëngaged by former ties. Dryden.
preengagement |Prior engagement, obligation, or attachment, as by contract, promise, or affection. My preëngagements to other themes were not unknown to those for whom I was to write. Boyle.
preerect |To erect beforehand.
prees |Press; throng. [Obs.] Chaucer.
preestablish |To establish beforehand.
preestablishment |Settlement beforehand.
preeternity |Infinite previous duration. [R.] \"The world's preëternity.\" Cudworth.
preexamination |Previous examination.
preexamine |To examine beforehand.
preexist |To exist previously; to exist before something else.
preexistence |1. Existence in a former state, or previous to something else. Wisdom declares her antiquity and preëxistence to all the works of this earth. T. Burnet. 2. Existence of the soul before its union with the body; -- a doctrine held by certain philosophers. Addison.
preexistency |Preëxistence. [Obs.]
preexistent |Existing previously; preceding existence; as, a preëxistent state. Pope.
preexistentism |The theory of a preëxistence of souls before their association with human bodies. Emerson.
preexistimation |Previous esteem or estimation. [Obs.] Sir T. Browne.
preexpectation |Previous expectation.
preface |1. Something spoken as introductory to a discourse, or written as introductory to a book or essay; a proem; an introduction, or series of preliminary remarks. This superficial tale Is but a preface of her worthy praise. Shak. Heaven's high behest no preface needs. Milton. 2. (R. C. Ch.)  The prelude or introduction to the canon of the Mass. Addis & Arnold. Proper preface (Ch. of Eng. & Prot. Epis. Ch.), a portion of the communion service, preceding the prayer of consecration, appointed for certain seasons. Syn. -- Introduction; preliminary; preamble; proem; prelude; prologue.\n\nTo introduce by a preface; to give a preface to; as, to preface a book discourse.\n\nTo make a preface. Jer. Taylor.
prefacer |The writer of a preface.
prefatorial |Prefatory.
prefatorily |In a prefatory manner; by way of preface.
prefatory |Pertaining to, or of the nature of, a preface; introductory to a book, essay, or discourse; as, prefatory remarks. That prefatory addition to the Creed. Dryden.
prefect |1. A Roman officer who controlled or superintended a particular command, charge, department, etc.; as, the prefect of the aqueducts; the prefect of a camp, of a fleet, of the city guard, of provisions; the pretorian prefect, who was commander of the troops guarding the emperor's person. 2. A superintendent of a department who has control of its police establishment, together with extensive powers of municipal regulation. [France] Brande & C. 3. In the Greek and Roman Catholic churches, a title of certain dignitaries below the rank of bishop. Apostolic prefect (R. C. Ch.), the head of a mission, not of episcopal rank. Shipley.
prefectorial |Of or pertaining to a prefect.
prefectship |The office or jurisdiction of a prefect.
prefecture |The office, position, or jurisdiction of a prefect; also, his official residence.
prefecundation |A term collectively applied to the changes or conditions preceding fecundation, especially to the changes which the ovum undergoes before fecundation.
prefecundatory |Of or pertaining to prefecundation.
prefer |1. To carry or bring (something) forward, or before one; hence, to bring for consideration, acceptance, judgment, etc.; to offer; to present; to proffer; to address; -- said especially of a request, prayer, petition, claim, charge, etc. He spake, and to her hand preferred the bowl. Pope. Presently prefer his suit to Cæsar. Shak. Three tongues prefer strange orisons on high. Byron. 2. To go before, or be before, in estimation; to outrank; to surpass. [Obs.] \"Though maidenhood prefer bigamy.\" Chaucer. 3. To cause to go before; hence, to advance before others, as to an office or dignity; to raise; to exalt; to promote; as, to prefer an officer to the rank of general. I would prefer him to a better place. Shak. 4. To set above or before something else in estimation, favor, or liking; to regard or honor before another; to hold in greater favor; to choose rather; -- often followed by to, before, or above. If I prefer not Jerusalem above my chief joy. Ps. cxxxvii. 6. Preferred an infamous peace before a most just war. Knolles. Preferred stock, stock which takes a dividend before other capital stock; -- called also preference stock and preferential stock. Syn. -- To choose; elect. See Choose.
preferability |The quality or state of being preferable; preferableness. J. S. Mill.
preferable |Worthy to be preferred or chosen before something else; more desirable; as, a preferable scheme. Addison.
preferableness |The quality or state of being preferable.
preferably |In preference; by choice. To choose Plautus preferably to Terence. Dennis.
preference |1. The act of Preferring, or the state of being preferred; the setting of one thing before another; precedence; higher estimation; predilection; choice; also, the power or opportunity of choosing; as, to give him his preference. Leave the critics on either side to contend about the preference due to this or that sort of poetry. Dryden. Knowledge of things alone gives a value to our reasonings, and preference of one man's knowledge over another's. Locke. 2. That which is preferred; the object of choice or superior favor; as, which is your preference
preferential |Giving, indicating, or having a preference or precedence; as, a preferential claim; preferential shares.
preferential voting |A system of voting, as at primaries, in which the voters are allowed to indicate on their ballots their preference (usually their first and second choices) between two or more candidates for an office, so that if no candidate receives a majority of first choices the one receiving the greatest number of first and second choices together in nominated or elected.
preferment |1. The act of choosing, or the state of being chosen; preference. [R.] Natural preferment of the one . . . before the other. Sir T. Browne. 2. The act of preferring, or advancing in dignity or office; the state of being advanced; promotion. Neither royal blandishments nor promises of valuable preferment had been spared. Macaulay. 3. A position or office of honor or profit; as, the preferments of the church.
preferrer |One who prefers.
prefidence |The quality or state of being prefident. [Obs.] Baxter.
prefident |Trusting beforehand; hence, overconfident. [Obs.] Baxter.
prefigurate |To prefigure. [R.] Grafton.
prefiguration |The act of prefiguring, or the state of being prefigured. A variety of prophecies and prefigurations. Norris.
prefigurative |Showing by prefiguration. \"The prefigurative atonement.\" Bp. Horne.
prefigure |To show, suggest, or announce, by antecedent types and similitudes; to foreshadow. \"Whom all the various types prefigured.\" South.
prefigurement |The act of prefiguring; prefiguration; also, that which is prefigured. Carlyle.
prefine |To limit beforehand. [Obs.] Knolles.
prefinite |Prearranged. [Obs.] \" Set and prefinite time.\" Holland.
prefinition |Previous limitation. [Obs.] Fotherby.
prefix |1. To put or fix before, or at the beginning of, another thing; as, to prefix a syllable to a word, or a condition to an agreement. 2. To set or appoint beforehand; to settle or establish antecedently. [Obs.] \" Prefixed bounds. \" Locke. And now he hath to her prefixt a day. Spenser.\n\nThat which is prefixed; esp., one or more letters or syllables combined or united with the beginning of a word to modify its signification; as, pre- in prefix, con- in conjure.
prefixion |The act of prefixing. [R.] Bailey.
prefloration |Æstivation.
prefoliation |Vernation.
preform |To form beforehand, or for special ends. \"Their natures and preformed faculties. \" Shak.
preformation |An old theory of the preëxistence of germs. Cf. Emboîtement.
preformative |A formative letter at the beginning of a word. M. Stuart.
prefrontal |Situated in front of the frontal bone, or the frontal region of the skull; ectethmoid, as a certain bone in the nasal capsule of many animals, and certain scales of reptiles and fishes. -- n.  A prefrontal bone or scale.
prefulgency |Superior brightness or effulgency. [R.] Barrow.
pregage |To preëngage. [Obs.] Fuller.
preglacial |Prior to the glacial or drift period.
pregnable |Capable of being entered, taken, or captured; expugnable; as, a pregnable fort. [R.] Cotgrave.
pregnance |Pregnancy. [Obs.] Milton.
pregnancy |1. The condition of being pregnant; the state of being with young. 2. Figuratively: The quality of being heavy with important contents, issue, significance, etc.; unusual consequence or capacity; fertility. Fuller.
pregnant |1. Being with young, as a female; having conceived; great with young; breeding; teeming; gravid; preparing to bring forth. 2. Heavy with important contents, significance, or issue; full of consequence or results; weighty; as, pregnant replies. \" A pregnant argument.\" Prynne. \" A pregnant brevity.\" E. Everett. 3. Full of promise; abounding in ability, resources, etc.; as, a pregnant youth. [Obs.] Evelyn. Wherein the pregnant enemy does much. Shak. Pregnant construction (Rhet.), one in which more is implied than is said; as, the beasts trembled forth from their dens, that is, came forth trembling with fright.\n\nA pregnant woman. [R.] Dunglison.\n\nAffording entrance; receptive; yielding; willing; open; prompt. [Obs.] \" Pregnant to good pity.\" Shak.
pregnantly |In a pregnant manner; fruitfully; significantly.\n\nUnresistingly; openly; hence, clearly; evidently. [Obs.] Shak.
pregravate |To bear down; to depress. [Obs.] Bp. Hall.
pregravitate |To descend by gravity; to sink. [R.] Boyle.
pregustant |Tasting beforehand; having a foretaste. [R.] Ed. Rev.
pregustation |The act of tasting beforehand; foretaste. [R.] Dr. Walker (1678).
prehallux |An extra first toe, or rudiment of a toe, on the preaxial side of the hallux.
prehend |To lay hold of; to seize. [Obs.] Middleton.
prehensi-ble |Capable of being seized.
prehensile |Adapted to seize or grasp; seizing; grasping; as, the prehensile tail of a monkey.
prehension |The act of taking hold, seizing, or grasping, as with the hand or other member.
prehensory |Adapted to seize or grasp; prehensile.
prehistoric |Of or pertaining to a period before written history begins; as, the prehistoric ages; prehistoric man.
prehnite |A pale green mineral occurring in crystalline aggregates having a botryoidal or mammillary structure, and rarely in distinct crystals. It is a hydrous silicate of alumina and lime.
prehnitic |Pertaining to, or designating, a tetrabasic acid of benzene obtained as a white crystalline substance; -- probably so called from the resemblance of the wartlike crystals to the mammillæ on the surface of prehnite.
preignition |Ignition in an internal-combustion engine while the inlet valve is open or before compression is completed.
preindesignate |Having no sign expressive of quantity; indefinite. See Predesignate.
preindispose |To render indisposed beforehand. Milman.
preinstruct |To instruct previously or beforehand. Dr. H. More.
preintimation |Previous intimation; a suggestion beforehand. T. Scott.
prejudge |To judge before hearing, or before full and sufficient examination; to decide or sentence by anticipation; to condemn beforehand. The committee of council hath prejudged the whole case, by calling the united sense of both houses of Parliament\" a universal clamor.\" Swift.
prejudgment |The act of prejudging; decision before sufficient examination.
prejudicacy |Prejudice; prepossession. [Obs.] Sir. H. Blount.
prejudical |Of or pertaining to the determination of some matter not previously decided; as, a prejudical inquiry or action at law.
prejudicant |Influenced by prejudice; biased. [R.] \" With not too hasty and prejudicant ears.\" Milton.
prejudicate |1. Formed before due examination. \"Ignorance and prejudicate opinions.\" Jer. Taylor. 2. Biased by opinions formed prematurely; prejudiced. \"Prejudicate readers.\" Sir T. Browne.\n\nTo determine beforehand, especially to disadvantage; to prejudge. Our dearest friend Prejudicates the business. Shak.\n\nTo prejudge. Sir P. Sidney.
prejudicately |With prejudice.
prejudication |1. The act of prejudicating, or of judging without due examination of facts and evidence; prejudgment. 2. (Rom. Law) (a) A preliminary inquiry and determination about something which belongs to a matter in dispute. (b) A previous treatment and decision of a point; a precedent.
prejudicative |Forming a judgment without due examination; prejudging. Dr. H. More.
prejudice |1. Foresight. [Obs.] Naught might hinder his quick prejudize. Spenser. 2. An opinion or judgment formed without due examination; prejudgment; a leaning toward one side of a question from other considerations than those belonging to it; an unreasonable predilection for, or objection against, anything; especially, an opinion or leaning adverse to anything, without just grounds, or before sufficient knowledge. Though often misled by prejudice and passion, he was emphatically an honest man. Macaulay. 3. (Law)  A bias on the part of judge, juror, or witness which interferes with fairness of judgment. 4. Mischief; hurt; damage; injury; detriment. Locke. England and France might, through their amity, Breed him some prejudice. Shak. Syn. -- Prejudgment; prepossession; bias; harm; hurt; damage; detriment; mischief; disadvantage.\n\n1. To cause to have prejudice; to prepossess with opinions formed without due knowledge or examination; to bias the mind of, by hasty and incorrect notions; to give an unreasonable bent to, as to one side or the other of a cause; as, to prejudice a critic or a juryman. Suffer not any beloved study to prejudice your mind so far as to despise all other learning. I. Watts 2. To obstruct or injure by prejudices, or by previous bias of the mind; hence, generally, to hurt; to damage; to injure; to impair; as, to prejudice a good cause. Seek how may prejudice the foe. Shak
prejudicial |1. Biased, possessed, or blinded by prejudices; as, to look with a prejudicial eye. [Obs.] Holyday. 2. Tending to obstruct or impair; hurtful; injurious; disadvantageous; detrimental. Hooker. His going away . . . was most prejudicial and most ruinous to the king's affairs. Clarendon. -- Prej`u*di\"cial*ly, adv. -- Prej`u*di\"cial*ness, n.
preknowledge |Prior knowledge.
prelacy |1. The office or dignity of a prelate; church government by prelates. Prelacies may be termed the greater benefices. Ayliffe. 2. The order of prelates, taken collectively; the body of ecclesiastical dignitaries. \"Divers of the reverend prelacy, and other most judicious men.\" Hooker.
prelal |Of or pertaining to printing; typographical. [Obs.] Fuller.
prelate |A clergyman of a superior order, as an archbishop or a bishop, having authority over the lower clergy; a dignitary of the church. Note: This word and the words derived from it are often used invidiously, in English ecclesiastical history, by dissenters, respecting the Established Church system. Hear him but reason in divinity, . . . You would desire the king were made a prelate. Shak.\n\nTo act as a prelate. [Obs.] Right prelating is busy laboring, and not lording. Latimer.
prelateity |Prelacy. [Obs.] Milton.
prelateship |The office of a prelate. Harmar.
prelatess |A woman who is a prelate; the wife of a prelate. Milton.
prelatial |Prelatical. Beaconsfield.
prelatic |Of or pertaining to prelates or prelacy; as, prelatical authority. Macaulay.
prelatical |Of or pertaining to prelates or prelacy; as, prelatical authority. Macaulay.
prelatically |In a prelatical manner; with reference to prelates. Milton. The last Georgic was a good prelude to the Æneis.
prelation |The setting of one above another; preference. [R.] Jer. Taylor.
prelatism |Prelacy; episcopacy.
prelatist |One who supports of advocates prelacy, or the government of the church by prelates; hence, a high-churchman. Hume. I am an Episcopalian, but not a prelatist. T. Scott.
prelatize |To bring under the influence of prelacy. Palfrey.\n\nTo uphold or encourage prelacy; to exercise prelatical functions. An episcopacy that began then to prelatize. Milton.
prelatry |Prelaty; prelacy. [Obs.]
prelature |The state or dignity of a prelate; prelacy. Milman.
prelatureship |The state or dignity of a prelate; prelacy. Milman.
prelaty |Prelacy. [Obs.] Milton.
prelect |To read publicly, as a lecture or discourse.\n\nTo discourse publicly; to lecture. Spitting . . . was publicly prelected upon. De. Quincey. To prelect upon the military art. Bp. Horsley.
prelection |A lecture or discourse read in public or to a select company. \"The prelections of Faber.\" Sir M. Hale.
prelector |A reader of lectures or discourses; a lecturer. Sheldon.
prelibation |1. A. tasting beforehand, or by anticipation; a foretaste; as, a prelibation of heavenly bliss. 2. A pouring out, or libation, before tasting.
preliminarily |In a preliminary manner.
preliminary |Introductory; previous; preceding the main discourse or business; prefatory; as, preliminary observations to a discourse or book; preliminary articles to a treaty; preliminary measures; preliminary examinations. Syn. -- Introductory; preparatory; prefatory; proemial; previous; prior; precedent; antecedent.\n\nThat which precedes the main discourse, work, design, or business; something introductory or preparatory; as, the preliminaries to a negotiation or duel; to take one's preliminaries the year before entering college. Syn. -- Introduction; preface; prelude.
prelimit |To limit previously. [R.]
prelook |To look forward. [Obs.] Surrey.
prelude |An introductory performance, preceding and preparing for the principal matter; a preliminary part, movement, strain, etc.; especially (Mus.), a strain introducing the theme or chief subject; a movement introductory to a fugue, yet independent; -- with recent composers often synonymous with overture. The last Georgic was a good prelude to the Ænis Addison. The cause is more than the prelude, the effect is more than the sequel, of the fact. Whewell. Syn. -- Preface; introduction; preliminary; preamble; forerunner; harbinger; precursor.\n\nTo play an introduction or prelude; to give a prefatory performance; to serve as prelude. The musicians preluded on their instruments. Sir. W. Scott. We are preluding too largely, and must come at once to the point. Jeffrey.\n\n1. To introduce with a previous performance; to play or perform a prelude to; as, to prelude a concert with a lively air. 2. To serve as prelude to; to precede as introductory. [Music] preluding some great tragedy. Longfellow
preluder |One who, or that which, preludes; one who plays a prelude. Mason.
preludial |Of or pertaining to a prelude; of the nature of a prelude; introductory. [R.]
preludious |Preludial. [R.] Dr. H. More.
prelumbar |Situated immediately in front of the loins;- applied to the dorsal part of the abdomen.
prelusive |Of the nature of a prelude; introductory; indicating that something of a like kind is to follow. \"Prelusive drops.\" Thomson. -- Pre*lu\"sive*ly, adv.
prelusorily |In a prelusory way.
prelusory |Introductory; prelusive. Bacon.
premature |1. Mature or ripe before the proper time; as, the premature fruits of a hotbed. 2. Happening, arriving, existing, or performed before the proper or usual time; adopted too soon; too early; untimely; as, a premature fall of snow; a premature birth; a premature opinion; premature decay. 3. Arriving or received without due authentication or evidence; as, a premature report. -- Pre`ma*ture\"ly, adv. -- Pre`ma*ture\"ness, n.
prematurity |The quality or state of being premature; early, or untimely, ripeness; as, the prematurity of genius.
premaxilla |A bone on either side of the middle line between the nose and mouth, forming the anterior part of each half of the upper jawbone; the intermaxilla. In man the premaxillæ become united and form the incisor part of the maxillary bone.
premaxillary |Situated in front of the maxillary bones; pertaining to the premaxillæ; intermaxillary. -- n.  A premaxilla.
premediate |To advocate. [R.]
premeditate |To think on, and revolve in the mind, beforehand; to contrive and design previously; as, to premeditate robbery. With words premeditated thus he said. Dryden.\n\nTo think, consider, deliberate, or revolve in the mind, beforehand.\n\nPremeditated; deliberate. [Archaic] Bp. Burnet.
premeditately |With premeditation. Burke.
premeditation |The act of meditating or contriving beforehand; previous deliberation; forethought.
premerit |To merit or deserve beforehand. [Obs.] Eikon Basi
premial |Serving to reward; rewarding. [R.] Baxter.
premiant |Serving to reward; rewarding. [R.] Baxter.
premices |First fruits. [Obs.] Dryden.
premier |1. First; chief; principal; as, the premier place; premier minister. Camden. Swift. 2. Most ancient; -- said of the peer bearing the oldest title of his degree.\n\nThe first minister of state; the prime minister.
premiere |First; chief; as, a première danseuse. -- n. fem.; pl. -mières (F. pre*myâr\"). (a) The leading woman of a group, esp. in a theatrical cast. (b) A first performance, as of a play; a first night.
premiership |The office of the premier.
premillennial |, Previous to the millennium.
premious |Rich in gifts. [R.] Clarke.
premise |1. A proposition antecedently supposed or proved; something previously stated or assumed as the basis of further argument; a condition; a supposition. The premises observed, Thy will by my performance shall be served. Shak. 2. (Logic)  Either of the first two propositions of a syllogism, from which the conclusion is drawn. Note: \"All sinners deserve punishment: A B is a sinner.\" These propositions, which are the premises, being true or admitted, the conclusion follows, that A B deserves punishment. While the premises stand firm, it is impossible to shake the conclusion. Dr. H. More. 3. pl. (Law)  Matters previously stated or set forth; esp., that part in the beginning of a deed, the office of which is to express the grantor and grantee, and the land or thing granted or conveyed, and all that precedes the habendum; the thing demised or granted. 4. pl.  A piece of real estate; a building and its adjuncts; as, to lease premises; to trespass on another's premises.\n\n1. To send before the time, or beforehand; hence, to cause to be before something else; to employ previously. [Obs.] The premised flames of the last day. Shak. If venesection and a cathartic be premised. E. Darwin. 2. To set forth beforehand, or as introductory to the main subject; to offer previously, as something to explain or aid in understanding what follows; especially, to lay down premises or first propositions, on which rest the subsequent reasonings. I premise these particulars that the reader may know that I enter upon it as a very ungrateful task. Addison.\n\nTo make a premise; to set forth something as a premise. Swift.
premiss |Premise. Whately. I. Watts
premit |To premise. [Obs.] Donne.
premium |1. A reward or recompense; a prize to be won by being before another, or others, in a competition; reward or prize to be adjudged; a bounty; as, a premium for good behavior or scholarship, for discoveries, etc. To think it not the necessity, but the premium and privilege of life, to eat and sleep without any regard to glory. Burke. The law that obliges parishes to support the poor offers a premium for the encouragement of idleness. Franklin. 2. Something offered or given for the loan of money; bonus; -- sometimes synonymous with interest, but generally signifying a sum in addition to the capital. People were tempted to lend, by great premiums and large interest. Swift. 3. A sum of money paid to underwriters for insurance, or for undertaking to indemnify for losses of any kind. 4. A sum in advance of, or in addition to, the nominal or par value of anything; as, gold was at a premium; he sold his stock at a premium.
premolar |Situated in front of the molar teeth. --n.  An anterior molar tooth which has replaced a deciduous molar. See Tooth.
premonish |To forewarn; to admonish beforehand. [R.] Herrick. To teach, and to premonish. Bk. of Com. Prayer.
premonishment |Previous warning or admonition; forewarning. Sir H. Wotton.
premonition |Previous warning, notice, or information; forewarning; as, a premonition of danger.
premonitor |One who, or that which, gives premonition.
premonitory |Giving previous warning or notice; as, premonitory symptoms of disease. -- Pre*mon\"i*to*ri*ly, adv.
premonstrant |A Premonstratensian.
premonstrate |To show beforehand; to foreshow. [R.] Herbert.
premonstratensian |One of a religious order of regular canons founded by St. Norbert at Prémontré, in France, in 1119. The members of the order are called also White Canons, Norbertines, and Premonstrants.
premonstration |A showing beforehand; foreshowing.
premonstrator |One who, or that which, premonstrates. [R.]
premorse |Terminated abruptly, or as it bitten off. Premorse root or leaves (Bot.), such as have an abrupt, ragged, and irregular termination, as if bitten off short.
premosaic |Relating to the time before Moses; as, premosaic history.
premotion |Previous motion or excitement to action.
premunire |See Præmunire.
premunite |To fortify beforehand; to guard against objection. [Obs.] Fotherby.
premunition |The act of fortifying or guarding against objections. [Obs.]
premunitory |Of or pertaining to a premunire; as, a premunitory process.
prenasal |Situated in front of the nose, or in front of the nasal chambers.
prenatal |Being or happening before birth.
prender |The power or right of taking a thing before it is offered. Burrill.
prenomen |See Prænomen.
prenominal |Serving as a prefix in a compound name. Sir T. Browne.
prenominate |Forenamed; named beforehand. [R.] \"Prenominate crimes.\" Shak.\n\nTo forename; to name beforehand; to tell by name beforehand. Shak.
prenomination |The act of prenominating; privilege of being named first. Sir T. Browne.
prenostic |A prognostic; an omen. [Obs.] Gower.
prenote |To note or designate beforehand. Foxe.
prenotion |A notice or notion which precedes something else in time; previous notion or thought; foreknowledge. Bacon.
prensation |The act of seizing with violence. [Obs.] Barrow .
prentice |An apprentice. [Obs. or Colloq.] Piers Plowman. \"My accuser is my prentice.\" Shak.
prenticehood |Apprenticehood. [Obs.] This jolly prentice with his master bode Till he was out nigh of his prenticehood. Chaucer.
prenticeship |Apprenticeship. [Obs. or Colloq.] He served a prenticeship who sets up shop. Pope.
prenunciation |The act of announcing or proclaiming beforehand. [Obs.]
prenuncious |Announcing beforehand; presaging. [Obs.] Blount.
preoblongata |The anterior part of the medulla oblongata. B. G. Wilder.
preobtain |To obtain beforehand.
preoccupancy |The act or right of taking possession before another; as, the preoccupancy of wild land.
preoccupate |1. To anticipate; to take before. [Obs.] \"Fear preoccupateth it [death].\" Bacon. 2. To prepossess; to prejudice. [Obs.] Sir H. Wotton.
preoccupation |1. The act of preoccupying, or taking possession of beforehand; the state of being preoccupied; prepossession. 2. Anticipation of objections. [R.] South.
preoccupy |1. To take possession of before another; as, to preoccupy a country not before held. 2. To prepossess; to engage, occupy, or engross the attention of, beforehand; hence, to prejudice. I Think it more respectful to the reader to leave something to reflections than to preoccupy his judgment. Arbuthnot.
preocular |Placed just in front of the eyes, as the antennæ of certain insects. -- n.  One of the scales just in front of the eye of a reptile or fish.
preominate |To ominate beforehand; to portend. [Obs.] Sir T. Browne.
preopercular |Situated in front of the operculum; pertaining to the preoperculum. -- n.  The preoperculum.
preoperculum |The anterior opercular bone in fishes.
preopinion |Opinion previously formed; prepossession; prejudice. Sir T. Browne.
preoption |Right of first choice.
preoral |Situated in front of, or anterior to, the mouth; as, preoral bands.
preorbital |a. (Anat.) Situated in front or the orbit.
preordain |To ordain or appoint beforehand: to predetermine: to foreordain. Milton.
preorder |To order to arrange beforehand; to foreordain. Sir W. Hamilton.
preordinance |Antecedent decree or determination. Shak.
preordinate |Preordained. [R.] Sir T. Elyot.
preordination |The act of foreordaining: previous determination. \"The preordination of God.\" Bale.
preparable |Capable of being prepared. \"Medicine preparable by art.\" Boyle.
preparation |1. The act of preparing or fitting beforehand for a particular purpose, use, service, or condition; previous arrangement or adaptation; a making ready; as, the preparation of land for a crop of wheat; the preparation of troops for a campaign. 2. The state of being prepared or made ready; preparedness; readiness; fitness; as, a nation in good preparation for war. 3. That which makes ready, prepares the way, or introduces; a preparatory act or measure. I will show what preparations there were in nature for this dissolution. T. Burnet. 4. That which is prepared, made, or compounded by a certain process or for a particular purpose; a combination. Specifically: (a) Any medicinal substance fitted for use. (b) Anything treated for preservation or examination as a specimen. (c) Something prepared for use in cookery. I wish the chemists had been more sparing who magnify their preparations. Sir T. Browne. In the preparations of cookery, the most volatile parts of vegetables are destroyed. Arbuthnot. 5. An army or fleet. [Obs.] Shak. 6. (Mus.)  The holding over of a note from one chord into the next chord, where it forms a temporary discord, until resolved in the chord that follows; the anticipation of a discordant note in the preceding concord, so that the ear is prepared for the shock. See Suspension. 7. Accomplishment; qualification. [Obs.] Shak.
preparative |Tending to prepare or make ready; having the power of preparing, qualifying, or fitting; preparatory. Laborious quest of knowledge preparative to this work. South.\n\n1. That which has the power of preparing, or previously fitting for a purpose; that which prepares. \"A preparative unto sermons.\" Hooker. 2. That which is done in the way of preparation. \"Necessary preparatives for our voyage.\" Dryden.
preparatively |By way of preparation.
preparator |One who prepares beforehand, as subjects for dissection, specimens for preservation in collections, etc. Agassiz.
preparatory |Preparing the way for anything by previous measures of adaptation; antecedent and adapted to what follows; introductory; preparative; as, a preparatory school; a preparatory condition.
prepare |1. To fit, adapt, or qualify for a particular purpose or condition; to make ready; to put into a state for use or application; as, to prepare ground for seed; to prepare a lesson. Our souls, not yet prepared for upper light. Dryden. 2. To procure as suitable or necessary; to get ready; to provide; as, to prepare ammunition and provisions for troops; to prepare ships for defence; to prepare an entertainment. Milton. That they may prepare a city for habitation. Ps. cvii. 36 Syn. -- To fit; adjust; adapt; qualify; equip; provide; form; make; make; ready.\n\n1. To make all things ready; to put things in order; as, to prepare for a hostile invasion. \"Bid them prepare for dinner.\" Shak. 2. To make one's self ready; to get ready; to take the necessary previous measures; as, to prepare for death.\n\nPreparation. [Obs.] Shak.
prepared |Made fit or suitable; adapted; ready; as, prepared food; prepared questions. -- Pre*par\"ed*ly, adv. Shak. -- Pre*par\"ed*ness, n.
preparer |One who, or that which, prepares, fits, or makes ready. Wood.
prepay |To pay in advance, or beforehand; as, to prepay postage.
prepayment |Payment in advance.
prepenial |Situated in front of, or anterior to, the penis.
prepense |To weigh or consider beforehand; to premeditate. [Obs.] Spenser. Sir T. Elyot.\n\nTo deliberate beforehand. [Obs.]\n\nDevised, contrived, or planned beforehand; preconceived; premeditated; aforethought; -- usually placed after the word it qualifies; as, malice prepense. This has not arisen from any misrepresentation or error prepense. Southey.
prepensely |In a premeditated manner.
prepollence |The quality or state of being prepollent; superiority of power; predominance; prevalence. [R.] Coventry.
prepollency |The quality or state of being prepollent; superiority of power; predominance; prevalence. [R.] Coventry.
prepollent |Having superior influence or power; prevailing; predominant. [R.] Boyle.\n\nAn extra first digit, or rudiment of a digit, on the preaxial side of the pollex.
preponder |To preponderate [Obs.]
preponderance |1. The quality or state of being preponderant; superiority or excess of weight, influence, or power, etc.; an outweighing. The mind should . . . reject or receive proportionably to the preponderancy of the greater grounds of probability. Locke. In a few weeks he had changed the relative position of all the states in Europe, and had restored the equilibrium which the preponderance of one power had destroyed. Macaulay. 2. (Gun.)  The excess of weight of that part of a canon behind the trunnions over that in front of them.
preponderancy |1. The quality or state of being preponderant; superiority or excess of weight, influence, or power, etc.; an outweighing. The mind should . . . reject or receive proportionably to the preponderancy of the greater grounds of probability. Locke. In a few weeks he had changed the relative position of all the states in Europe, and had restored the equilibrium which the preponderance of one power had destroyed. Macaulay. 2. (Gun.)  The excess of weight of that part of a canon behind the trunnions over that in front of them.
preponderant |Preponderating; outweighing; overbalancing; -- used literally and figuratively; as, a preponderant weight; of preponderant importance. -- Pre*pon\"der*ant*ly, adv.
preponderate |1. To outweigh; to overpower by weight; to exceed in weight; to overbalance. An inconsiderable weight, by distance from the center of the balance, will preponderate greater magnitudes. Glanvill. 2. To overpower by stronger or moral power. 3. To cause to prefer; to incline; to decide. [Obs.] The desire to spare Christian blood preponderates him for peace. Fuller.\n\nTo exceed in weight; hence, to incline or descend, as the scale of a balance; figuratively, to exceed in influence, power, etc.; hence; to incline to one side; as, the affirmative side preponderated. That is no just balance in which the heaviest side will not preponderate. Bp. Wilkins.
preponderatingly |In a preponderating manner; preponderantly.
preponderation |The act or state of preponderating; preponderance; as, a preponderation of reasons. I. Watts.
prepose |To place or set before; to prefix. [Obs.] Fuller.
preposition |1. (Gram.)  A word employed to connect a noun or a pronoun, in an adjectival or adverbial sense, with some other word; a particle used with a noun or pronoun (in English always in the objective case) to make a phrase limiting some other word; -- so called because usually placed before the word with which it is phrased; as, a bridge of iron; he comes from town; it is good for food; he escaped by running. 2. A proposition; an exposition; a discourse. [Obs.] He made a long preposition and oration. Fabyan.
prepositional |Of or pertaining to a preposition; of the nature of a preposition. Early. -- Prep`o*si\"tion*al*ly, adv.
prepositive |Put before; prefixed; as, a prepositive particle. -- n.  A prepositive word. Tooke.
prepositor |A scholar appointed to inspect other scholars; a monitor. Todd.
prepositure |The office or dignity of a provost; a provostship. Lowth.
prepossess |1. To preoccupy, as ground or land; to take previous possession of. Dryden. 2. To preoccupy, as the mind or heart, so as to preclude other things; hence, to bias or prejudice; to give a previous inclination to, for or against anything; esp., to induce a favorable opinion beforehand, or at the outset. It created him enemies, and prepossessed the lord general. Evelyn.
prepossessing |Tending to invite favor; attracting confidence, favor, esteem, or love; attractive; as, a prepossessing manner. -- Pre`pos*sess\"ing*ly, adv.
prepossession |1. Preoccupation; prior possession. Hammond. 2. Preoccupation of the mind by an opinion, or impression, already formed; preconceived opinion; previous impression; bias; -- generally, but not always, used in a favorable sense; as, the prepossessions of childhood. \"The prejudices and prepossessions of the country.\" Sir W. Scott. Syn. -- Bent; bias; inclination; preoccupancy; prejudgment. See Bent.
prepossessor |One who possesses, or occupies, previously. R. Brady.
preposterous |1. Having that first which ought to be last; inverted in order. [Obs.] The method I take may be censured as preposterous, because I thus treat last of the antediluvian earth, which was first in the order of nature. Woodward. 2. Contrary to nature or reason; not adapted to the end; utterly and glaringly foolish; unreasonably absurd; perverted. \"Most preposterous conclusions.\" Shak. Preposterous ass, that never read so far! Shak. Syn. -- Absurd; perverted; wrong; irrational; foolish; monstrous. See Absurd. -- Pre*pos\"ter*ous*ly, adv. -Pre*pos\"ter*ous*ness, n.
prepostor |See Prepositor.
prepotency |1. The quality or condition of being prepotent; predominance. [Obs.] Sir T. Browne. 2. (Biol.)  The capacity, on the part of one of the parents, as compared with the other, to transmit more than his or her own share of characteristics to their offspring.
prepotent |1. Very powerful; superior in force, influence, or authority; predominant. Plaifere. 2. (Biol.)  Characterized by prepotency. Darwin.
preprovide |To provide beforehand. \"The materials preprovided.\" Fuller.
prepubic |Situated in front of, or anterior to, the pubis; pertaining to the prepubis.
prepubis |A bone or cartilage, of some animals, situated in the middle line in front of the pubic bones.
prepuce |The foreskin.
preputial |Of or pertaining to the prepuce.
preraphaelism |The doctrine or practice of a school of modern painters who profess to be followers of the painters before Raphael. Its adherents advocate careful study from nature, delicacy and minuteness of workmanship, and an exalted and delicate conception of the subject.
preraphaelite |Of or pertaining to the style called preraphaelitism; as, a preraphaelite figure; a preraphaelite landscape. Ruskin.\n\nOne who favors or practices art as it was before Raphael; one who favors or advocates preraphaelitism.
preraphaelitism |The doctrine or practice of a school of modern painters who profess to be followers of the painters before Raphael. Its adherents advocate careful study from nature, delicacy and minuteness of workmanship, and an exalted and delicate conception of the subject.
preregnant |One who reigns before another; a sovereign predecessor. [R.] Warner.
preremote |More remote in previous time or prior order. In some cases two more links of causation may be introduced; one of them may be termed the preremote cause, the other the postremote effect. E. Darwin.
prerequire |To require beforehand. Some things are prerequired of us. Bp. Hall.
prerequisite |Previously required; necessary as a preliminary to any proposed effect or end; as, prerequisite conditions of success.\n\nSomething previously required, or necessary to an end or effect proposed. The necessary prerequisites of freedom. Goldsmith.
preresolve |To resolve beforehand; to predetermine. Sir E. Dering.
prerogative |1. An exclusive or peculiar privilege; prior and indefeasible right; fundamental and essential possession; -- used generally of an official and hereditary right which may be asserted without question, and for the exercise of which there is no responsibility or accountability as to the fact and the manner of its exercise. The two faculties that are the prerogative of man -- the powers of abstraction and imagination. I. Taylor. An unconstitutional exercise of his prerogative. Macaulay. 2. Precedence; preëminence; first rank. [Obs.] Then give me leave to have prerogative. Shak. Note: The term came into general use in the conflicts between the Crown and Parliaments of Great Britain, especially in the time of the Stuarts. Prerogative Court (Eng. Law), a court which formerly had authority in the matter of wills and administrations, where the deceased left bona notabilia, or effects of the value of five pounds, in two or more different dioceses. Blackstone. -- Prerogative office, the office in which wills proved in the Prerogative Court were registered. Syn. -- Privilege; right. See Privilege.
prerogatived |Endowed with a prerogative, or exclusive privilege. [R.] Shak.
prerogatively |By prerogative.
presage |1. Something which foreshows or portends a future event; a prognostic; an omen; an augury. \"Joy and shout -- presage of victory.\" Milton. 2. Power to look the future, or the exercise of that power; foreknowledge; presentiment. If there be aught of presage in the mind. Milton. Syn. -- Prognostic; omen; token; sign; presentiment.\n\n1. To have a presentiment of; to feel beforehand; to foreknow. 2. To foretell; to predict; to foreshow; to indicate. My dreams presage some joyful news at hand. Shak.\n\nTo form or utter a prediction; -- sometimes used with of. Dryden.
