pus |The yellowish white opaque creamy matter produced by the process of suppuration. It consists of innumerable white nucleated cells floating in a clear liquid.
pusane |A piece of armor for the breast; often, an addition to, or reënforcement of. the breastplate; -- called also pesane.
puseyism |The principles of Dr. Pusey and others at Oxford, England, as exhibited in various publications, esp. in a series which appeared from 1833 to 1841, designated \" Tracts for the Times;\" tractarianism. See Tractarianism.
puseyistic |Of or pertaining to Puseyism.
puseyite |Of or pertaining to Puseyism.\n\nOne who holds the principles of Puseyism; -- often used opprobriously.
push |A pustule; a pimple. [Obs. or Prov. Eng.] Bacon.\n\n1. To press against with force; to drive or impel by pressure; to endeavor to drive by steady pressure, without striking; -- opposed to draw. Sidelong had pushed a mountain from his seat. Milton. 2. To thrust the points of the horns against; to gore. If the ox shall push a manservant or maidservant, . . . the ox shall be stoned. Ex. xxi. 32. 3. To press or urge forward; to drive; to push an objection too far. \" To push his fortune.\" Dryden. Ambition pushes the soul to such actions as are apt to procure honor to the actor. Spectator. We are pushed for an answer. Swift. 4. To bear hard upon; to perplex; to embarrass. 5. To importune; to press with solicitation; to tease. To push down, to overthrow by pushing or impulse.\n\n1. To make a thrust; to shove; as, to push with the horns or with a sword. Shak. 2. To make an advance, attack, or effort; to be energetic; as, a man must push in order to succeed. At the time of the end shall the kind of the south push at him and the king of the north shall come against him. Dan. xi. 40. War seemed asleep for nine long years; at length Both sides resolved to push, we tried our strength. Dryden. 3. To burst pot, as a bud or shoot. To push on, to drive or urge forward; to hasten. The rider pushed on at a rapid pace. Sir W. Scott.\n\n1. A thrust with a pointed instrument, or with the end of a thing. 2. Any thrust. pressure, impulse, or force, or force applied; a shove; as, to give the ball the first push. 3. An assault or attack; an effort; an attempt; hence, the time or occasion for action. Exact reformation is not perfected at the first push. Milton. hen it comes to the push, tic no more than talk. L' Estrange. 4. The faculty of overcoming obstacles; aggressive energy; as, he has push, or he has no push. [Colloq.] Syn. -- See Thrust.
push button |A simple device, resembling a button in form, so arranged that pushing it closes an electric circuit, as of an electric bell.
pusher |One who, or that which, pushes.
pushing |Pressing forward in business; enterprising; driving; energetic; also, forward; officious, intrusive. -- Push\"ing*ly, adv.
pushpin |A child's game played with pins. L. Estrange.
pusil |Very small; little; petty. [Obs.] Bacon.
pusillanimity |The quality of being pusillanimous; weakness of spirit; cowardliness. The badge of pusillanimity and cowardice. Shak. It is obvious to distinguished between an act of . . . pusillanimity and an act of great modesty or humility. South. Syn. -- Cowardliness; cowardice; fear; timidity.
pusillanimous |1. Destitute of a manly or courageous strength and firmness of mind; of weak spirit; mean-spirited; spiritless; cowardly; -- said of persons, as, a pussillanimous prince. 2. Evincing, or characterized by, weakness of mind, and want of courage; feeble; as, pusillanimous counsels. \"A low and pusillanimous spirit.\" Burke. Syn. -- Cowardly; dastardly; mean-spirited; fainthearted; timid; weak; feeble.
pusillanimously |With pusillanimity.
pusley |Purslane. [Colloq. U. S]
puss |1. A cat; -- a fondling appellation. 2. A hare; -- so called by sportsmen. Puss in the corner, a game in which all the players but one occupy corners of a room, or certain goals in the open air, and exchange places, the one without a corner endeavoring to get a corner while it is vacant, leaving some other without one. -- Puss moth (Zoöl.), any one of several species of stout bombycid moths belonging to Cerura, Harpyia, and allied genera, esp. Harpyia vinuli, of Europe. The larvæ are humpbacked, and have two caudal appendages.
pussy |1. A pet name for a cat; also, an endearing name for a girl. 2. A catkin of the pussy willow. 3. The game of tipcat; -- also called pussy cat. Pussy willow (Bot.), any kind of willow having large cylindrical catkins clothed with long glossy hairs, especially the American Salix discolor; -- called also glaucous willow, and swamp willow.\n\nSee Pursy. [Colloq. or Low]
pustulant |Producing pustules. -- n.  A medicine that produces pustules, as croton oil.
pustular |1. Of or pertaining to pustules; as, pustular prominences; pustular eruptions. 2. Covered with pustulelike prominences; pustulate.
pustulate |To form into pustules, or blisters.\n\nCovered with pustulelike prominences; pustular; pustulous; as, a pustulate leaf; a pustulate shell or coral.
pustulated |Covered with pustulelike prominences; pustular; pustulous; as, a pustulate leaf; a pustulate shell or coral.
pustulation |The act of producing pustules; the state of being pustulated.
pustule |A vesicle or an elevation of the cuticle with an inflamed base, containing pus. Malignant pustule. See under Malignant.
pustulous |Resembling, or covered with, pustules; pustulate; pustular.
put |A pit. [Obs.] Chaucer.\n\n3d pers. sing. pres. of Put, contracted from putteth. Chaucer.\n\nA rustic; a clown; an awkward or uncouth person. Queer country puts extol Queen Bess's reign. Bramston. What droll puts the citizens seem in it all. F. Harrison.\n\n1. To move in any direction; to impel; to thrust; to push; -- nearly obsolete, except with adverbs, as with by (to put by = to thrust aside; to divert); or with forth (to put forth = to thrust out). His chief designs are . . . to put thee by from thy spiritual employment. Jer. Taylor. 2. To bring to a position or place; to place; to lay; to set; figuratively, to cause to be or exist in a specified relation, condition, or the like; to bring to a stated mental or moral condition; as, to put one in fear; to put a theory in practice; to put an enemy to fight. This present dignity, In which that I have put you. Chaucer. I will put enmity between thee and the woman. Gen. iii. 15. He put no trust in his servants. Job iv. 18. When God into the hands of their deliverer Puts invincible might. Milton. In the mean time other measures were put in operation. Sparks. 3. To attach or attribute; to assign; as, to put a wrong construction on an act or expression. 4. To lay down; to give up; to surrender. [Obs.] No man hath more love than this, that a man put his life for his friends. Wyclif (John xv. 13). 5. To set before one for judgment, acceptance, or rejection; to bring to the attention; to offer; to state; to express; figuratively, to assume; to suppose; -- formerly sometimes followed by that introducing a proposition; as, to put a question; to put a case. Let us now put that ye have leave. Chaucer. Put the perception and you put the mind. Berkeley. These verses, originally Greek, were put in Latin. Milton. All this is ingeniously and ably put. Hare. 6. To incite; to entice; to urge; to constrain; to oblige. These wretches put us upon all mischief. Swift. Put me not use the carnal weapon in my own defense. Sir W. Scott. Thank him who puts me, loath, to this revenge. Milton. 7. To throw or cast with a pushing motion \"overhand,\" the hand being raised from the shoulder; a practice in athletics; as, to put the shot or weight. 8. (Mining)  To convey coal in the mine, as from the working to the tramway. Raymond. Put case, formerly, an elliptical expression for, put or suppose the case to be. Put case that the soul after departure from the body may live. Bp. Hall. -- To put about (Naut.), to turn, or change the course of, as a ship. -- To put away. (a) To renounce; to discard; to expel. (b) To divorce. -- To put back. (a) To push or thrust backwards; hence, to hinder; to delay. (b) To refuse; to deny. Coming from thee, I could not put him back. Shak. (c) To set, as the hands of a clock, to an earlier hour. (d) To restore to the original place; to replace. -- To put by. (a) To turn, set, or thrust, aside. \"Smiling put the question by.\" Tennyson. (b) To lay aside; to keep; to sore up; as, to put by money. -- To put down. (a) To lay down; to deposit; to set down. (b) To lower; to diminish; as, to put down prices. (c) To deprive of position or power; to put a stop to; to suppress; to abolish; to confute; as, to put down rebellion of traitors. Mark, how a plain tale shall put you down. Shak. Sugar hath put down the use of honey. Bacon. (d) To subscribe; as, to put down one's name. -- To put forth. (a) To thrust out; to extend, as the hand; to cause to come or push out; as, a tree puts forth leaves. (b) To make manifest; to develop; also, to bring into action; to exert; as, to put forth strength. (c) To propose, as a question, a riddle, and the like. (d) To publish, as a book. -- To put forward. (a) To advance to a position of prominence responsibility; to promote. (b) To cause to make progress; to aid. (c) To set, as the hands of a clock, to a later hour. -- To put in. (a) To introduce among others; to insert; sometimes, to introduce with difficulty; as, to put in a word while others are discoursing. (b) (Naut.) To conduct into a harbor, as a ship. (c) (Law) To place in due form before a court; to place among the records of a court. Burrill. (d) (Med.) To restore, as a dislocated part, to its place. -- To put off. (a) To lay aside; to discard; as, to put off a robe; to put off mortality. \"Put off thy shoes from off thy feet.\" Ex. iii. 5. (b) To turn aside; to elude; to disappoint; to frustrate; to baffle. I hoped for a demonstration, but Themistius hoped to put me off with an harangue. Boyle. We might put him off with this answer. Bentley. (c) To delay; to defer; to postpone; as, to put off repentance. (d) To get rid of; to dispose of; especially, to pass fraudulently; as, to put off a counterfeit note, or an ingenious theory. (e) To push from land; as, to put off a boat. -- To put on or upon. (a) To invest one's self with, as clothes; to assume. \"Mercury . . . put on the shape of a man.\" L'Estrange. (b) To impute (something) to; to charge upon; as, to put blame on or upon another. (c) To advance; to promote. [Obs.] \"This came handsomely to put on the peace.\" Bacon. (d) To impose; to inflict. \"That which thou puttest on me, will I bear.\" 2 Kings xviii. 14. (e) To apply; as, to put on workmen; to put on steam. (f) To deceive; to trick. \"The stork found he was put upon.\" L'Estrange. (g) To place upon, as a means or condition; as, he put him upon bread and water. \"This caution will put them upon considering.\" Locke. (h) (Law) To rest upon; to submit to; as, a defendant puts himself on or upon the country. Burrill. -- To put out. (a) To eject; as, to put out and intruder. (b) To put forth; to shoot, as a bud, or sprout. (c) To extinguish; as, to put out a candle, light, or fire. (d) To place at interest; to loan; as, to put out funds. (e) To provoke, as by insult; to displease; to vex; as, he was put out by my reply. [Colloq.] (f) To protrude; to stretch forth; as, to put out the hand. (g) To publish; to make public; as, to put out a pamphlet. (h) To confuse; to disconcert; to interrupt; as, to put one out in reading or speaking. (i) (Law) To open; as, to put out lights, that is, to open or cut windows. Burrill. (j) (Med.) To place out of joint; to dislocate; as, to put out the ankle. (k) To cause to cease playing, or to prevent from playing longer in a certain inning, as in base ball. -- To put over. (a) To place (some one) in authority over; as, to put a general over a division of an army. (b) To refer. For the certain knowledge of that knowledge of that truthput you o'er to heaven and to my mother. Shak. (c) To defer; to postpone; as, the court put over the cause to the next term. (d) To transfer (a person or thing) across; as, to put one over the river. -- To put the hand to or unto. (a) To take hold of, as of an instrument of labor; as, to put the hand to the plow; hence, to engage in (any task or affair); as, to put one's hand to the work. (b) To take or seize, as in theft. \"He hath not put his hand unto his neighbor's goods.\" Ex. xxii. 11. -- To put through, to cause to go through all conditions or stages of a progress; hence, to push to completion; to accomplish; as, he put through a measure of legislation; he put through a railroad enterprise. [U.S.] -- To put to. (a) To add; to unite; as, to put one sum to another. (b) To refer to; to expose; as, to put the safety of the state to hazard. \"That dares not put it to the touch.\" Montrose. (c) To attach (something) to; to harness beasts to. Dickens. -- To put to a stand, to stop; to arrest by obstacles or difficulties. -- To put to bed. (a) To undress and place in bed, as a child. (b) To deliver in, or to make ready for, childbirth. -- To put to death, to kill. -- To put together, to attach; to aggregate; to unite in one. -- To put this and that (or two and two) together, to draw an inference; to form a correct conclusion. -- To put to it, to distress; to press hard; to perplex; to give difficulty to. \"O gentle lady, do not put me to 't.\" Shak. -- To put to rights, to arrange in proper order; to settle or compose rightly. -- To put to the sword, to kill with the sword; to slay. -- To put to trial, or on trial, to bring to a test; to try. -- To put trust in, to confide in; to repose confidence in. -- To put up. (a) To pass unavenged; to overlook; not to punish or resent; to put up with; as, to put up indignities. [Obs.] \"Such national injuries are not to be put up.\" Addison. (b) To send forth or upward; as, to put up goods for sale. (d) To start from a cover, as game. \"She has been frightened; she has been put up.\" C. Kingsley. (e) To hoard. \"Himself never put up any of the rent.\" Spelman. (f) To lay side or preserve; to pack away; to store; to pickle; as, to put up pork, beef, or fish. (g) To place out of sight, or away; to put in its proper place; as, put up that letter. Shak. (h) To incite; to instigate; -- followed by to; as, he put the lad up to mischief. (i) To raise; to erect; to build; as, to put up a tent, or a house. (j) To lodge; to entertain; as, to put up travelers. -- To put up a job, to arrange a plot. [Slang] Syn. -- To place; set; lay; cause; produce; propose; state. -- Put, Lay, Place, Set. These words agree in the idea of fixing the position of some object, and are often used interchangeably. To put is the least definite, denoting merely to move to a place. To place has more particular reference to the precise location, as to put with care in a certain or proper place. To set or to lay may be used when there is special reference to the position of the object.\n\n1. To go or move; as, when the air first puts up. [Obs.] Bacon. 2. To steer; to direct one's course; to go. His fury thus appeased, he puts to land. Dryden. 3. To play a card or a hand in the game called put. To put about (Naut.), to change direction; to tack. -- To put back (Naut.), to turn back; to return. \"The French . . . had put back to Toulon.\" Southey. -- To put forth. (a) To shoot, bud, or germinate. \"Take earth from under walls where nettles put forth.\" Bacon. (b) To leave a port or haven, as a ship. Shak. -- To put in (Naut.), to enter a harbor; to sail into port. -- To put in for. (a) To make a request or claim; as, to put in for a share of profits. (b) To go into covert; -- said of a bird escaping from a hawk. (c) To offer one's self; to stand as a candidate for. Locke. -- To put off, to go away; to depart; esp., to leave land, as a ship; to move from the shore. -- To put on, to hasten motion; to drive vehemently. -- To put over (Naut.), to sail over or across. -- To put to sea (Naut.), to set sail; to begin a voyage; to advance into the ocean. -- To put up. (a) To take lodgings; to lodge. (b) To offer one's self as a candidate. L'Estrange. -- To put up to, to advance to. [Obs.] \"With this he put up to my lord.\" Swift. -- To put up with. (a) To overlook, or suffer without recompense, punishment, or resentment; as, to put up with an injury or affront. (b) To take without opposition or expressed dissatisfaction; to endure; as, to put up with bad fare.\n\n1. The act of putting; an action; a movement; a thrust; a push; as, the put of a ball. \"A forced put.\" L'Estrange. 2. A certain game at cards. Young. 3. A privilege which one party buys of another to \"put\" (deliver) to him a certain amount of stock, grain, etc., at a certain price and date. [Brokers' Cant] A put and a call may be combined in one instrument, the holder of which may either buy or sell as he chooses at the fixed price. Johnson's Cyc.\n\nA prostitute. [Obs.]
put-off |A shift for evasion or delay; an evasion; an excuse. L'Estrange.
put-up |Arranged; plotted; -- in a bad sense; as, a put-up job. [Colloq.]
putage |Prostitution or fornication on the part of a woman.
putamen |The shell of a nut; the stone of a drupe fruit. See Endocarp.
putanism |Habitual lewdness or prostitution of a woman; harlotry.
putative |Commonly thought or deemed; supposed; reputed; as, the putative father of a child. \"His other putative (I dare not say feigned) friends.\" E. Hall. Thus things indifferent, being esteemed useful or pious, became customary, and then came for reverence into a putative and usurped authority. Jer. Taylor.
putchuck |Same as Pachak.
puteal |An inclosure surrounding a well to prevent persons from falling into it; a well curb. Weale.
puteli |Same as Patela.
putery |Putage. [Obs.]
putid |Rotten; fetid; stinking; base; worthless. Jer. Taylor. \"Thy putid muse.\" Dr. H. More.
putidity |The quality or state of being putrid.
putidness |The quality or state of being putrid.
putlog |One of the short pieces of timber on which the planks forming the floor of a scaffold are laid, -- one end resting on the ledger of the scaffold, and the other in a hole left in the wall temporarily for the purpose. Oxf. Gloss.
putour |A keeper of a brothel; a procurer. [Obs.] Chaucer.
putredinous |Proceeding from putrefaction, or partaking of the putrefactive process; having an offensive smell; stinking; rotten.
putrefaction |1. The act or the process of putrefying; the offensive decay of albuminous or other matter. Note: Putrefaction is a complex phenomenon involving a multiplicity of chemical reactions, always accompanied by, and without doubt caused by, bacteria and vibriones; hence, putrefaction is a form of fermentation, and is sometimes called putrefaction fermentative. Putrefaction is not possible under conditions that preclude the development of living organisms. Many of the products of putrefaction are powerful poisons, and are called cadaveric poisons, or ptomaïnes. 2. The condition of being putrefied; also, that which putrefied. \"Putrefaction's breath.\" Shelley.
putrefactive |1. Of or pertaining to putrefaction; as, the putrefactive smell or process. Wiseman. 2. Causing, or tending to promote, putrefaction. -- Pu``tre*fac\"tive*ness, n.
putrefy |1. To render putrid; to cause to decay offensively; to cause to be decomposed; to cause to rot. 2. To corrupt; to make foul. Private suits do putrefy the public good. Bacon. They would but stink, and putrefy the air. Shak. 3. To make morbid, carious, or gangrenous; as, to putrefy an ulcer or wound.\n\nTo become putrid; to decay offensively; to rot. Isa. 1. 6.
putresce |To become putrescent or putrid; to putrefy. Ordinarily sewage does not putresce until from twenty-four to sixty hours after its discharge. Nature.
putrescence |The state of being putrescent; putrescent matter.
putrescent |1. Becoming putrid or rotten. Externally powerful, although putrescent at the core. Motley. 2. Of or pertaining to the process of putrefaction; as, a putrescent smell.
putrescible |Capable of putrefaction; liable to become putrid; as, putrescible substances.\n\nA substance, usually nitrogenous, which is liable to undergo decomposition when in contact with air and moisture at ordinary temperatures.
putrescin |A nontoxic diamine, C4H12N2, formed in the putrefaction of the flesh of mammals and some other animals.
putrid |1. Tending to decomposition or decay; decomposed; rotten; -- said of animal or vegetable matter; as, putrid flesh. See Putrefaction. 2. Indicating or proceeding from a decayed state of animal or vegetable matter; as, a putrid smell. Putrid fever (Med.), typhus fever; -- so called from the decomposing and offensive state of the discharges and diseased textures of the body. -- Putrid sore throat (Med.), a gangrenous inflammation of the fauces and pharynx.
putridity |The quality of being putrid; putrefaction; rottenness.
putridness |Putridity. Floyer.
putrifacted |Putrefied. [Obs.] What vermin bred of putrifacted slime. Marston.
putrification |Putrefaction.
putrify |To putrefy.
putrilage |That which is undergoing putrefaction; the products of putrefaction.
putry |Putrid. [Obs.] Marston.\n\nPutage. [Obs.] Chaucer.
putt |A stroke made on the putting green to play the ball into a hole.\n\nTo make a putt.
puttee |Same as Putty, a kind of gaiter.
putter |1. One who puts or plates. 2. Specifically, one who pushes the small wagons in a coal mine, and the like. [Prov. Eng.]\n\nTo act inefficiently or idly; to trifle; to potter.
putter-on |An instigator. Shak.
puttier |One who putties; a glazier.
putting |The throwing of a heavy stone, shot, etc., with the hand raised or extended from the shoulder; -- originally, a Scottish game. Putting stone, a heavy stone used in the game of putting.
putting green |The green, or plot of smooth turf, surrounding a hole. \"The term putting green shall mean the ground within twenty yards of the hole, excepting hazards.\"  Golf Rules.
puttock |(a) The European kite. (b) The buzzard. (c) The marsh harrier. [Prov. Eng.]\n\nSee Futtock. [Obs.]
putty |A kind of thick paste or cement compounded of whiting, or soft carbonate of lime, and linseed oil, when applied beaten or kneaded to the consistence of dough, -- used in fastening glass in sashes, stopping crevices, and for similar purposes. Putty powder, an oxide of tin, or of tin and lead in various proportions, much used in polishing glass, metal, precious stones, etc.\n\nTo cement, or stop, with putty.
putty-faced |White-faced; -- used contemptuously. Clarke.
puttyroot |An American orchidaceous plant (Aplectrum hyemale) which flowers in early summer. Its slender naked rootstock produces each year a solid corm, filled with exceedingly glutinous matter, which sends up later a single large oval evergreen plaited leaf. Called also Adam-and-Eve.
puy |See Poy.
puzzel |A harlot; a drab; a hussy. [Obs.] Shak.
puzzle |1. Something which perplexes or embarrasses; especially, a toy or a problem contrived for testing ingenuity; also, something exhibiting marvelous skill in making. 2. The state of being puzzled; perplexity; as, to be in a puzzle.\n\n1. To perplex; to confuse; to embarrass; to put to a stand; to nonplus. A very shrewd disputant in those points is dexterous in puzzling others. Dr. H. More. He is perpetually puzzled and perplexed amidst his own blunders. Addison. 2. To make intricate; to entangle. They disentangle from the puzzled skein. Cowper. The ways of Heaven are dark and intricate, Puzzled in mazes, and perplexed with error. Addison. 3. To solve by ingenuity, as a puzzle; -- followed by out; as, to puzzle out a mystery. Syn. -- To embarrass; perplex; confuse; bewilder; confound. See Embarrass.\n\n1. To be bewildered, or perplexed. A puzzling fool, that heeds nothing. L'Estrange. 2. To work, as at a puzzle; as, to puzzle over a problem.
puzzle-headed |Having the head full of confused notions. Johnson.
puzzledom |The domain of puzzles; puzzles, collectively. C. Kingsley.
puzzlement |The state of being puzzled; perplexity. Miss Mitford.
puzzler |One who, or that which, puzzles or perplexes. Hebrew, the general puzzler of old heads. Brome.
puzzlingly |In a puzzling manner.
puzzolan |See Pozzuolana.
puzzolana |See Pozzuolana.
pyaemia |A form of blood poisoning produced by the absorption into the blood of morbid matters usually originating in a wound or local inflammation. It is characterized by the development of multiple abscesses throughout the body, and is attended with irregularly recurring chills, fever, profuse sweating, and exhaustion.
pyaemic |Of or pertaining to pyæmia; of the nature of pyæmia.
pycnaspidean |Having the posterior side of the tarsus covered with small irregular scales; -- said of certain birds.
pycnidium |In certain fungi, a flask-shaped cavity from the surface of the inner walls of which spores are produced.
pycnite |A massive subcolumnar variety of topaz.
pycnodont |Any fossil fish belonging to the Pycnodontini. They have numerous round, flat teeth, adapted for crushing.
pycnodontini |An extinct order of ganoid fishes. They had a compressed body, covered with dermal ribs (pleurolepida) and with enameled rhomboidal scales.
pycnogonid |One of the Pycnogonida.
pycnogonida |A class of marine arthropods in which the body is small and thin, and the eight legs usually very long; -- called also Pantopoda. Note: The abdomen is rudimentary, and the triangular mouth is at the end of a tubular proboscis. Many of them live at great depths in the sea, and the largest of them measure two feet across the extended legs.
pycnometer |A specific gravity bottle; a standard flask for measuring and comparing the densities of liquids. [Also written pyknometer.]
pycnostyle |See under Intercolumniation. -n.  A pycnostyle colonnade.
pye |See 2d Pie (b).
pyebald |See Piebald.
pyelitis |Inflammation of the pelvis of the kidney.
pyemia |See PyÆmia.
pyet |A magpie; a piet. [Prov. Eng.] Here cometh the worthy prelate as pert as a pyet. Sir W. Scott.
pygal |Situated in the region of the rump, or posterior end of the backbone; -- applied especially to the posterior median plates in the carapace of chelonians.
pygarg |1. (Zoöl.)  A quadruped, probably the addax, an antelope having a white rump. Deut. xiv. 5. 2. (Zoöl.) (a) The female of the hen harrier. (b) The sea eagle.
pygargus |1. (Zoöl.)  A quadruped, probably the addax, an antelope having a white rump. Deut. xiv. 5. 2. (Zoöl.) (a) The female of the hen harrier. (b) The sea eagle.
pygidium |The caudal plate of trilobites, crustacean, and certain insects. See Illust. of Limulus and Trilobite.
pygmean |Of or pertaining to a pygmy; resembling a pygmy or dwarf; dwarfish; very small. \" Like that Pygmean race.\" Milton. Pygmy antelope (Zoöl.), the kleeneboc. -- Pygmy goose (Zoöl.), any species of very small geese of the genus Nettapus, native of Africa, India, and Australia. -- Pygmy owl (Zoöl.), the gnome. Pygmy parrot (Zoöl.), any one of several species of very small green parrots (Nasiternæ), native of New Guinea and adjacent islands. They are not larger than sparrows. Pygmy chimpanzee, a species of anthropoid ape (Pan paniscus) resembling the chimpanzee, but somewhat smaller; also called bonobo. It is considered (1996) as having the closest genetic relationship to humans of any other animal. It is found in forests in Zaire, and is an endangered species.
pygmy |Of or pertaining to a pygmy; resembling a pygmy or dwarf; dwarfish; very small. \" Like that Pygmean race.\" Milton. Pygmy antelope (Zoöl.), the kleeneboc. -- Pygmy goose (Zoöl.), any species of very small geese of the genus Nettapus, native of Africa, India, and Australia. -- Pygmy owl (Zoöl.), the gnome. Pygmy parrot (Zoöl.), any one of several species of very small green parrots (Nasiternæ), native of New Guinea and adjacent islands. They are not larger than sparrows. Pygmy chimpanzee, a species of anthropoid ape (Pan paniscus) resembling the chimpanzee, but somewhat smaller; also called bonobo. It is considered (1996) as having the closest genetic relationship to humans of any other animal. It is found in forests in Zaire, and is an endangered species.\n\n1. (Class. Myth.)  One of a fabulous race of dwarfs who waged war with the cranes, and were destroyed. 2. Hence, a short, insignificant person; a dwarf. Pygmies are pygmies still, though perched on Alps. And pyramids are pyramids in vales. Young.
pygobranchia |A division of opisthobranchiate mollusks having the branchiæ in a wreath or group around the anal opening, as in the genus Doris.
pygopod |1. (Zoöl.)  One of the Pygopodes. 2. (Zoöl.)  Any species of serpentiform lizards of the family Pygopodidæ, which have rudimentary hind legs near the anal cleft, but lack fore legs.
pygopodes |A division of swimming birds which includes the grebes, divers, auks, etc., in which the legs are placed far back.
pygopodous |Of or pertaining to the Pygopodes.
pygostyle |The plate of bone which forms the posterior end of the vertebral column in most birds; the plowshare bone; the vomer. It is formed by the union of a number of the last caudal vertebræ, and supports the uropigium.
pyin |An albuminoid constituent of pus, related to mucin, possibly a mixture of substances rather than a single body.
pyjama |In India and Persia, thin loose trowsers or drawers; in Europe and America, drawers worn at night, or a kind of nightdress with legs. [Written also paijama.]
pyjamas |A garment, similar to the Oriental pyjama (which see), adopted among Europeans, Americans, and other Occidentals, for wear in the dressing room and during sleep; also, a suit of drawers and blouse for such wear.
pykar |An ancient English fishing boat.
pyla |The passage between the iter and optocoele in the brain. B. G. Wilder.
pylagore |a deputy of a State at the Amphictyonic council.
pylangium |The first and undivided part of the aortic trunk in the amphibian heart. -- Py*lan\"gi*al, a.
pylon |(a) A low tower, having a truncated pyramidal form, and flanking an ancient Egyptian gateway. Massive pylons adorned with obelisks in front. J. W. Draper. (b) An Egyptian gateway to a large building (with or without flanking towers).
pyloric |Of, pertaining to, or in the region of, the pylorus; as, the pyloric end of the stomach.
pylorus |(a) The opening from the stomach into the intestine. (b) A posterior division of the stomach in some invertebrates.
pyne |See Pine. [Obs.] Chaucer.
pynoun |A pennant. [Obs.] Chaucer.
pyocyanin |A blue coloring matter found in the pus from old sores, supposed to be formed through the agency of a species of bacterium (Bacillus pyocyaneus).C13H10N2O
pyogenic |Producing or generating pus.
pyoid |Of or pertaining to pus; of the nature of, or like, pus. Pyoid corpuscles (Med.), cells of a size larger than pus corpuscles, containing two or more of the latter.
pyopneumothorax |Accumulation of air, or other gas, and of pus, in the pleural cavity.
pyot |The magpie. See Piet.
pyoxanthose |A greenish yellow crystalline coloring matter found with pyocyanin in pus.
pyr- |Combining forms designating fire or heat; specifically (Chem.), used to imply an actual or theoretical derivative by the action of heat; as in pyrophosphoric, pyrosulphuric, pyrotartaric, pyrotungstic, etc.
pyracanth |The evergreen thorn (Cratægus Pyracantha), a shrub native of Europe.
pyral |Of or pertaining to a pyre. [R.]
pyralid |Any moth of the family Pyralidæ. The species are numerous and mostly small, but some of them are very injurious, as the bee moth, meal moth, hop moth, and clover moth.
pyramid |1. A solid body standing on a triangular, square, or polygonal base, and terminating in a point at the top; especially, a structure or edifice of this shape. 2. (Geom.)  A solid figure contained by a plane rectilineal figure as base and several triangles which have a common vertex and whose bases are sides of the base. 3. pl. (Billiards)  The game of pool in which the balls are placed in the form of a triangle at spot. [Eng.] Altitude of a pyramid (Geom.), the perpendicular distance from the vertex to the plane of the base. -- Axis of a pyramid (Geom.), a straight line drawn from the vertex to the center of the base. -- Earth pyramid. (Geol.) See Earth pillars, under Earth. -- Right pyramid (Geom.) a pyramid whose axis is perpendicular to the base.
pyramidal |1. Of or pertaining to a pyramid; in the form of a a pyramid; pyramidical; as, pyramidal cleavage. The mystic obelisks stand up Triangular, pyramidal. Mrs. Browning. 2. (Crystallog.)  Same as Tetragonal. Pyramidal numbers (Math.), certain series of figurate numbers expressing the number of balls or points that may be arranged in the form of pyramids. Thus 1, 4, 10, 20, 35, etc., are trangular pyramidal numbers; and 1, 5, 14, 30, 55, etc., are square pyramidal numbers.\n\nOne of the carpal bones. See Cuneiform, n., 2 (b).
pyramidally |Like a pyramid.
pyramidic |Of or pertaining to a pyramid; having the form of a pyramid; pyramidal. \" A pyramidical rock.\" Goldsmith. \"Gold in pyramidic plenty piled.\" Shenstone. -- Pyr`a*mid\"ic*al*ly, adv. Pyr`a*mild\"ic*al*ness, n.
pyramidical |Of or pertaining to a pyramid; having the form of a pyramid; pyramidal. \" A pyramidical rock.\" Goldsmith. \"Gold in pyramidic plenty piled.\" Shenstone. -- Pyr`a*mid\"ic*al*ly, adv. Pyr`a*mild\"ic*al*ness, n.
pyramidion |The small pyramid which crowns or completes an obelisk.
pyramidoid |A solid resembling a pyramid; -- called also pyramoid. Barlow.
pyramis |A pyramid.
pyramoid |See Pyramidoid.
pyrargyrite |Ruby silver; dark red silver ore. It is a sulphide of antimony and silver, occurring in rhombohedral crystals or massive, and is of a dark red or black color with a metallic adamantine luster.
pyrazin |A feebly basic solid, C4H4N2, obtained by distilling piperazine with zinc dust, and in other ways. Also, by extension, any of various derivatives of the same.
pyrazine |A feebly basic solid, C4H4N2, obtained by distilling piperazine with zinc dust, and in other ways. Also, by extension, any of various derivatives of the same.
pyre |A funeral pile; a combustible heap on which the dead are burned; hence, any pile to be burnt. For nine long nights, through all the dusky air, The pyres thick flaming shot a dismal glare. Pope.
pyrena |A nutlet resembling a seed, or the kernel of a drupe. Gray.
pyrene |One of the less volatile hydrocarbons of coal tar, obtained as a white crystalline substance, C16H10.\n\nSame as Pyrena.
pyrenean |Of or pertaining to the Pyrenees, a range of mountains separating France and Spain. -- n.  The Pyrenees. Shak.
pyrenoid |A transparent body found in the chromatophores of certain Infusoria.
pyrethrin |A substance resembling, and isomeric with, ordinary camphor, and extracted from the essential oil of feverfew; -- called also Pyrethrum camphor.
pyrethrine |An alkaloid extracted from the root of the pellitory of Spain (Anacyclus pyrethrum).
pyretic |Of or pertaining to fever; febrile.
pyretology |A discourse or treatise on fevers; the doctrine of fevers. Hooper.
pyrexia |The febrile condition.
pyrexial |Of or pertaining to fever; feverish.
pyrexical |Of or pertaining to fever; feverish.
pyrgom |A variety of pyroxene; -- called also fassaite.
pyrheliometer |An instrument for measuring the direct heating effect of the sun's rays.
pyridic |Related to, or formed from, pyridin or its homologues; as, the pyridic bases.
pyridine |A nitrogenous base, C5H5N, obtained from the distillation of bone oil or coal tar, and by the decomposition of certain alkaloids, as a colorless liquid with a peculiar pungent odor. It is the nucleus of a large number of organic substances, among which several vegetable alkaloids, as nicotine and certain of the ptomaïnes, may be mentioned. See Lutidine.
pyridyl |A hypothetical radical, C5H4N, regarded as the essential residue of pyridine, and analogous to phenyl.
pyriform |Having the form of a pear; pear-shaped.
pyritaceous |Of or pertaining to pyrites. See Pyritic.
pyrite |A common mineral of a pale brass-yellow color and brilliant metallic luster, crystallizing in the isometric system; iron pyrites; iron disulphide. Hence sable coal his massy couch extends, And stars of gold the sparkling pyrite blends. E. Darwin.
pyrites |A name given to a number of metallic minerals, sulphides of iron, copper, cobalt, nickel, and tin, of a white or yellowish color. Note: The term was originally applied to the mineral pyrite, or iron pyrites, in allusion to its giving sparks when struck with steel. Arsenical pyrites, arsenopyrite. -- Auriferous pyrites. See under Auriferous. -- Capillary pyrites, millerite. -- Common pyrites, isometric iron disulphide; pyrite. -- Hair pyrites, millerite. -- Iron pyrites. See Pyrite. -- Magnetic pyrites, pyrrhotite. -- Tin pyrites, stannite. -- White iron pyrites, orthorhombic iron disulphide; marcasite. This includes cockscomb pyrites (a variety of marcasite, named in allusion to its form), spear pyrites, etc. -- Yellow, or Copper, pyrites, the sulphide of copper and iron; chalcopyrite.
pyritic |Of or pertaining to pyrites; consisting of, or resembling, pyrites.
pyritical |Of or pertaining to pyrites; consisting of, or resembling, pyrites.
pyritiferous |Containing or producing pyrites.
pyritize |To convert into pyrites.
pyritohedral |Like pyrites in hemihedral form.
pyritohedron |The pentagonal dodecahedron, a common form of pyrite.
pyritoid |Pyritohedron. [R.]
pyritology |The science of blowpipe analysis.
pyritous |Pyritic.
pyro |Abbreviation of pyrogallic acid. [Colloq.]
pyro- |Combining forms designating fire or heat; specifically (Chem.), used to imply an actual or theoretical derivative by the action of heat; as in pyrophosphoric, pyrosulphuric, pyrotartaric, pyrotungstic, etc.
pyroacetic |Pertaining to, and designating, a substance (acetone) obtained by the distillation of the acetates. It is now called also pyroacetic ether, and formerly was called pyroacetic spirit.
pyroacid |An acid obtained by sybjecting another acid to the action of heat. Cf. Pyro-.
pyroantimonate |A salt of pyroantimonic acid.
pyroantimonic |Pertaining to, or designating, an acid of antimony analogous to pyrophosphoric acid.
pyroarsenate |A salt of pyroarsenic acid.
pyroarsenic |Pertaining to or designating, an acid of arsenic analogous to pyrophosphoric acid.
pyroborate |A salt of pyroboric acid.
pyroboric |Pertaining to derived from, or designating, an acid, H2B4O7 (called also tetraboric acid), which is the acid ingredient of ordinary borax, and is obtained by heating boric acid.
pyrocatechin |A white crystalline substance, C6H4(OH)2, of the phenol series, found in various plants; -- so called because first obtained by distillation of gum catechu. Called also catechol, oxyphenol. etc.
pyrochlore |A niobate of calcium, cerium, and other bases, occurring usually in octahedrons of a yellowish or brownish color and resinous luster; -- so called from its becoming grass-green on being subjected to heat under the blowpipe.
pyrocitric |Pertaining to, or designating, any one of three acids obtained by the distillation of citric acid, and called respectively citraconic, itaconic, and mesaconic acid.
pyrocoll |A yellow crystalline substance allied to pyrrol, obtained by the distillation of gelatin.
pyroelectric |Pertaining to, or dependent on, pyroelectricity; receiving electric polarity when heated.\n\nA substance which becomes electrically polar when heated, exhibiting opposite charges of statical electricity at two separate parts, especially the two extremities.
pyroelectricity |Electricity developed by means of heat; the science which treats of electricity thus developed.
pyrogallate |A salt of pyrogallic acid; an ether of pyrogallol.
pyrogallic |Pertaining to, derived from, or designating, an acid called pyrogallol. See Pyrogallol.
pyrogallol |A phenol metameric with phloroglucin, obtained by the distillation of gallic acid as a poisonous white crystalline substance having acid properties, and hence called also pyrogallic acid. It is a strong reducer, and is used as a developer in photography and in the production of certain dyes.
pyrogen |1. Electricity. [R.] 2. (Physiol. Chem.)  A poison separable from decomposed meat infusions, and supposed to be formed from albuminous matter through the agency of bacteria.
pyrogenic |Producing heat; -- said of substances, as septic poisons, which elevate the temperature of the body and cause fever.
pyrogenous |Produced by fire; igneous. Mantell. .
pyrognostic |Of or pertaining to characters developed by the use of heat; pertaining to the characters of minerals when examined before the blowpipe; as, the pyrognostic characters of galena.
pyrognostics |The characters of a mineral observed by the use of the blowpipe, as the degree of fusibility, flame coloration, etc.
pyrograph |A production of pyrography.
pyrography |A process of printing, ornamenting, or carving, by burning with heated instruments.
pyrogravure |Pyrography; also, a design or picture made by pyrography.
pyrolator |A fire worshiper. [R.] Southey.
pyrolatry |The worship of fire. Young.
pyroligneous |Pertaining to, or designating, the acid liquid obtained in the distillation of wood, consisting essentially of impure acetic acid.
pyrolignic |Pertaining to, or designating, the acid liquid obtained in the distillation of wood, consisting essentially of impure acetic acid.
pyrolignite |A crude acetate produced by treating pyroligneous acid with a metal or basic compound; as, pyrolignite of iron (iron liquor).
pyrolignous |Same as Pyroligneous.
pyrolithic |Same as Pyrouric, or Cyanuric.
pyrologist |One who is versed in, or makes a study of, pyrology.
pyrology |That branch of physical science which treats of the properties, phenomena, or effects of heat; also, a treatise on heat.
pyrolusite |Manganese dioxide, a mineral of an iron-black or dark steel- gray color and metallic luster, usually soft. Pyrolusite parts with its oxygen at a red heat, and is extensively used in discharging the brown and green tints of glass (whence its name).
pyromagnetic |Acting by the agency of heat and magnetism; as, a pyromagnetic machine for producing electric currents.
pyromalate |A salt of pyromalic acid. [Obs.]
pyromalic |Pertaining to, or designating, an acid now called maleic acid.
pyromancy |Divination by means of fire.
pyromania |An insane disposition to incendiarism.
pyromantic |Of or pertaining to pyromancy.\n\nOne who pretends to divine by fire. Sir T. Herbert.
pyrometer |1. (Physics)  An instrument used for measuring the expansion of solid bodies by heat. 2. (Physics)  An instrument for measuring degrees of heat above those indicated by the mercurial thermometer. Note: It is usually constructed so as to register the change which the heat to be measured produces in the length of some expansible substance, as a metallic rod, or in the intensity of a thermo- electric current.
pyrometric |Pertaining to, or obtained by, the pyrometer; as, pyrometrical instruments; pyrometrical measurements.
pyrometrical |Pertaining to, or obtained by, the pyrometer; as, pyrometrical instruments; pyrometrical measurements.
pyrometry |The art of measuring degrees of heat, or the expansion of bodies by heat.
pyromorphite |Native lead phosphate with lead chloride, occurring in bright green and brown hexagonal crystals and also massive; -- so called because a fused globule crystallizes in cooling.
pyromorphous |Having the property of crystallizing by the agency of fire.
pyromucate |A salt of pyromucic acid.
pyromucic |Pertaining to, derived from, or designating, an acid obtained as a white crystalline substance by the distillation of mucic acid, or by the oxidation of furfurol.
pyrone |An unsaturated cyclic compound, C5H4O2, of which two varieties are known, a and g. g-pyrone is the parent substance of several natural yellow dyestuffs.
pyronomics |The science of heat.
pyrope |A variety of garnet, of a poppy or blood-red color, frequently with a tinge of orange. It is used as a gem. See the Note under Garnet.
pyrophane |A mineral which is opaque in its natural state, but is said to change its color and become transparent by heat.
pyrophanous |Rendered transparent by heat.
pyrophone |A musical instrument in which the tones are produced by flames of hydrogen, or illuminating gas, burning in tubes of different sizes and lengths.
pyrophoric |Light-producing; of or pertaining to pyrophorus. Pyrophoric iron (Chem.), finely reduced iron, which ignites spontaneously on contact with air.
pyrophorous |Light-producing; of or pertaining to pyrophorus. Pyrophoric iron (Chem.), finely reduced iron, which ignites spontaneously on contact with air.
pyrophorus |Any one of several substances or mixtures which phosphoresce or ignite spontaneously on exposure to air, as a heated mixture of alum, potash, and charcoal, or a mixture of charcoal and finely divided lead.
pyrophosphate |A salt of pyrophosphoric acid.
pyrophosphoric |Pertaining to, or designating, an acid, H4P2O7, which is obtained as a white crystalline substance. Its salts are obtained by heating the phosphates.
pyrophyllite |A mineral, usually of a white or greenish color and pearly luster, consisting chiefly of the hydrous silicate of alumina.
pyroscope |An instrument for measuring the intensity of heat radiating from a fire, or the cooling influence of bodies. It is a differential thermometer, having one bulb coated with gold or silver leaf. [R.]
pyrosis |See Water brash, under Brash.
pyrosmalite |A mineral, usually of a pale brown or of a gray or grayish green color, consisting chiefly of the hydrous silicate of iron and manganese; -- so called from the odor given off before the blowpipe.
pyrosome |Any compound ascidian of the genus Pyrosoma. The pyrosomes form large hollow cylinders, sometimes two or three feet long, which swim at the surface of the sea and are very phosphorescent.
pyrosulphate |A salt of pyrosulphuric acid.
pyrosulphuric |Pertaining to, or designating, an acid called also disulphuric acid) obtained by distillation of certain sulphates, as a colorless, thick, oily liquid, H2S2O7 resembling sulphuric acid. It is used in the solution of indigo, in the manufacture of alizarin, and in dehydration.
pyrotartaric |Pertaining to, or designating, an acid obtained as a white crystalline substance by the distillation of tartaric acid.
pyrotartrate |A salt of pyrotartaric acid.
pyrotechnian |A pyrotechnist.
pyrotechnic |Of or pertaining to fireworks, or the art of forming them. Pyrotechnical sponge. See under Sponge.
pyrotechnical |Of or pertaining to fireworks, or the art of forming them. Pyrotechnical sponge. See under Sponge.
pyrotechnician |A pyrotechnist.
pyrotechnics |The art of making fireworks; the manufacture and use of fireworks; pyrotechny.
pyrotechnist |One skilled in pyrotechny; one who manufactures fireworks. Steevens.
pyrotechny |1. The use and application of fire in science and the arts. [Obs.] Sir M. Hale. 2. Same as Pyrotechnics.
pyrothonide |A kind of empyreumatic oil produced by the combustion of textures of hemp, linen, or cotton in a copper vessel, -- formerly used as a remedial agent. Dunglison.
pyrotic |Caustic. See Caustic. -- n. (Med.)  A caustic medicine.
pyrotritartaric |Designating an acid which is more commonly called uric acid.
pyrotungstic |Polytungstic. See Metatungstic.
pyroueric |Pertaining to, or designating, an acid now called cyanuric acid. See Cyanuric.
pyrouric |Pertaining to, or designating, an acid now called cyanuric acid. See Cyanuric.
pyrovanadic |Pertaining to, or designating, an acid of vanadium, analogous to pyrophosphoric acid.
pyroxanthin |A yellow crystalline hydrocardon extracted from crude wood spirit; -- called also eblanin.
pyroxene |A common mineral occurring in monoclinic crystals, with a prismatic angle of nearly 90º, and also in massive forms which are often laminated. It varies in color from white to dark green and black, and includes many varieties differing in color and composition, as diopside, malacolite, salite, coccolite, augite, etc. They are all silicates of lime and magnesia with sometimes alumina and iron. Pyroxene is an essential constituent of many rocks, especially basic igneous rocks, as basalt, gabbro, etc. Note: The pyroxene group contains pyroxene proper, also the related orthorhombic species, enstatite, bronzite, hypersthene, and various monoclinic and triclinic species, as rhodonite, etc.
pyroxenic |Containing pyroxene; composed chiefly of pyroxene.
pyroxenite |A rock consisting essentially of pyroxene.
pyroxyle |See Pyroxylic, -yl.
pyroxylic |Derived from wood by distillation; -- formerly used in designating crude wood spirit.
pyroxylin |A substance resembling gun cotton in composition and properties, but distinct in that it is more highly nitrified and is soluble in alcohol, ether, etc.; -- called also pyroxyle.
pyrrhic |1. Of or pertaining to an ancient Greek martial dance. \" ye have the pyrrhic dance as yet.\" Byron. 2. (Pros.)  Of or pertaining to a pyrrhic, or to pyrrhics; containing pyrrhic; as, a pyrrhic verse.\n\n1. Etym: [Gr. pyrrhique, fem.]  An ancient Greek martial dance, to the accompaniment of the flute, its time being very quick. 2. Etym: [L. pyrrhichius (sc. pes), Gr. pyrrhique, masc.] (Pros.)  A foot consisting of two short syllables.
pyrrhicist |One two danced the pyrrhic.
pyrrhonean |Of or pertaining to pyrrhonism.
pyrrhonic |Of or pertaining to pyrrhonism.
pyrrhonism |Skepticism; universal doubt.
pyrrhonist |A follower of Pyrrho; a skeptic.
pyrrhotine |A bronze-colored mineral, of metallic luster. It is a sulphide of iron, and is remarkable for being attracted by the magnet. Called also magnetic pyrites.
pyrrhotite |A bronze-colored mineral, of metallic luster. It is a sulphide of iron, and is remarkable for being attracted by the magnet. Called also magnetic pyrites.
pyrrol |A nitrogenous base found in coal tar, bone oil, and other distillates of organic substances, and also produced synthetically as a colorless liquid, C4H5N, having on odor like that of chloroform. It is the nucleus and origin of a large number of derivatives. So called because it colors a splinter of wood moistened with hydrochloric acid a deep red.
pyrroline |A nitrogenous base, C4H7N, obtained as a colorless liquid by the reduction of pyrrol.
pyrula |A genus of large marine gastropods. having a pear-shaped shell. It includes the fig-shells. See Illust. in Appendix.
pyruric |Same as Pyroüric.
pyrus |A genus of rosaceous trees and shrubs having pomes for fruit. It includes the apple, crab apple, pear, chokeberry, sorb, and mountain ash.
pyruvic |Pertaining to, or designating, an acid (called also pyroracemic acid) obtained, as a liquid having a pungent odor, by the distillation of racemic acid.
pyruvil |A complex nitrogenous compound obtained by heating together pyruvic acid and urea.
pythagorean |Of or pertaining to Pythagoras (a Greek philosopher, born about 582 b. c.), or his philosophy. The central thought of the Pythagorean philosophy is the idea of number, the recognition of the numerical and mathematical relations of things. Encyc. Brit. Pythagorean proposition (Geom.), the theorem that the square described upon the hypothenuse of a plane right-angled triangle is equal to the sum of the squares described upon the other two sides. -- Pythagorean system (Astron.), the commonly received system of astronomy, first taught by Pythagoras, and afterward revived by Copernicus, whence it is also called the Copernican system. -- Pythagorean letter. See Y.\n\nA follower of Pythagoras; one of the school of philosophers founded by Pythagoras.
pythagoreanism |The doctrines of Pythagoras or the Pythagoreans. As a philosophic school Pythagoreanism became extinct in Greece about the middle of the 4th century [B. C.]. Encyc. Brit.
pythagoric |See Pythagorean, a.
pythagorical |See Pythagorean, a.
pythagorism |The doctrines taught by Pythagoras. Note: Pythagoras made numbers the basis of his philosophical system, as well physical as metaphysical. The doctrine of the transmigration of souls (metempsychosis) is associated closely with name of Pythagoras.
pythagorize |To speculate after the manner of Pythagoras.
pythiad |The period intervening between one celebration of the Pythian games and the next.
pythian |Of or pertaining to Delphi, to the temple of Apollo, or to the priestess of Apollo, who delivered oracles at Delphi. Pythian games (Gr. Antiq.), one of the four great national festivals of ancient Greece, celebrated near Delphi, in honor of Apollo, the conqueror of the dragon Python, at first once in eight years, afterward once in four.
pythocenic |Producing decomposition, as diseases which are supposed to be accompanied or caused by decomposition.
python |1. (Zoöl.)  Any species of very large snakes of the genus Python, and allied genera, of the family Pythonidæ. They are nearly allied to the boas. Called also rock snake. Note: The pythons have small pelvic bones, or anal spurs, two rows of subcaudal scales, and pitted labials. They are found in Africa, Asia, and the East Indies. 2. A diviner by spirits. \"[Manasses] observed omens, and appointed pythons.\" 4 Kings xxi. 6 (Douay version).
pythoness |1. (Gr. Antiq.)  The priestess who gave oracular answers at Delphi in Greece. 2. Any woman supposed to have a spirit of divination; a sort of witch. Bp. Hall.
pythonic |Prophetic; oracular; pretending to foretell events.
pythonism |The art of predicting events after the manner of the priestess of Apollo at Delphi; equivocal prophesying.
pythonist |A conjurer; a diviner.
pythonomorpha |Same as Mosasauria.
pyuria |A morbid condition in which pus is discharged in the urine.
pyx |1. ( R. C. Ch.)  The box, case, vase, or tabernacle, in which the host is reserved. 2. A box used in the British mint as a place of deposit for certain sample coins taken for a trial of the weight and fineness of metal before it is sent from the mint. Mushet. 3. (Naut.)  The box in which the compass is suspended; the binnacle. Weale. 4. (Anat.)  Same as Pyxis. Pyx cloth (R. C. Ch., a veil of silk or lace covering the pyx. Trial of the pyx, the annual testing, in the English mint, of the standard of gold and silver coins. Encyc. Brit.\n\nTo test as to weight and fineness, as the coins deposited in the pyx. [Eng.] Mushet.
pyxidate |Having a pyxidium.
pyxidium |(a) A pod which divides circularly into an upper and lower half, of which the former acts as a kind of lid, as in the pimpernel and purslane. (b) The theca of mosses.
pyxie |Same as Pixy.
pyxis |1. A box; a pyx. 2. (Bot.)  A pyxidium. 3. (Anat.)  The acetabulum. See Acetabulum, 2.
q |, the seventeenth letter of the English alphabet, has but one sound (that of k), and is always followed by u, the two letters together being sounded like kw, except in some words in which the u is silent. See Guide to Pronunciation, § 249. Q is not found in Anglo-Saxon, cw being used instead of qu; as in cwic, quick; cwen, queen. The name (ku) is from the French ku, which is from the Latin name of the same letter; its form is from the Latin, which derived it, through a Greek alphabet, from the Phoenician, the ultimate origin being Egyptian. Etymologically, q or qu is most nearly related to a (ch, tch), p, q, and wh; as in cud, quid, L. equus, ecus, horse, Gr. equine, hippic; L. quod which, E. what; L. aquila, E. eaqle; E. kitchen, OE. kichene, AS. cycene, L. coquina.
qua |In so far as; in the capacity or character of; as. It is with Shelley's biographers qua biographers that we have to deal. London Spectator.
qua-bird |The American night heron. See under Night.
quab |An unfledged bird; hence, something immature or unfinished. Ford.\n\nSee Quob, v. i.
quacha |The quagga.
quack |1. To utter a sound like the cry of a duck. 2. To make vain and loud pretensions; to boast. \" To quack of universal cures.\" Hudibras. 3. To act the part of a quack, or pretender.\n\n1. The cry of the duck, or a sound in imitation of it; a hoarse, quacking noise. Chaucer. 2. Etym: [Cf. Quacksalver.]  A boastful pretender to medical skill; an empiric; an ignorant practitioner. 3. Hence, one who boastfully pretends to skill or knowledge of any kind not possessed; a charlatan. Quacks political; quacks scientific, academical. Carlyle.\n\nPertaining to or characterized by, boasting and pretension; used by quacks; pretending to cure diseases; as, a quack medicine; a quack doctor.
quack grass |See Quitch grass.
quackery |The acts, arts, or boastful pretensions of a quack; false pretensions to any art; empiricism. Carlyle.
quackish |Like a quack; boasting; characterized by quackery. Burke.
quackism |Quackery. Carlyle.
quackle |To suffocate; to choke. [Prov. Eng.]
quacksalver |One who boasts of his skill in medicines and salves, or of the efficacy of his prescriptions; a charlatan; a quack; a mountebank. [Obs.] Burton.
quad |Evil; bad; baffling; as, a quade wind. [Obs.] Sooth play, quad play, as the Fleming saith. Chaucer.\n\nA quadrat.\n\nA quadrangle; hence, a prison. [Cant or Slang]
quade |Evil; bad; baffling; as, a quade wind. [Obs.] Sooth play, quad play, as the Fleming saith. Chaucer.
quadra |(a) The plinth, or lowest member, of any pedestal, podium, water table, or the like. (b) A fillet, or listel.
quadrable |That may be sqyared, or reduced to an equivalent square; -- said of a surface when the area limited by a curve can be exactly found, and expressed in a finite number of algebraic terms.
quadragenarious |Consisting of forty; forty years old.
quadragene |An indulgence of forty days, corresponding to the forty days of ancient canonical penance.
quadragesima |The forty days of fast preceding Easter; Lent. Quadragesima Sunday, the first Sunday in Lent, about forty days before Easter.
quadragesimal |Belonging to Lent; used in Lent; Lenten.
quadragesimals |Offerings formerly made to the mother church of a diocese on Mid-Lent Sunday.
quadrangle |1. (Geom.)  A plane figure having four angles, and consequently four sides; any figure having four angles. 2. A square or quadrangular space or inclosure, such a space or court surrounded by buildings, esp. such a court in a college or public school in England.
quadrangular |Having four angles, and consequently four sides; tetragonal. -- Quad*ran\"gu*lar*ly, adv.
quadrans |1. (Rom. Antiq.)  A fourth part of the coin called an as. See 3d As, 2. 2. The fourth of a penny; a farthing. See Cur.
quadrant |1. The fourth part; the quarter. [Obs.] Sir T. Browne. 2. (Geom.)  The quarter of a circle, or of the circumference of a circle, an arc of 90º, or one subtending a right angle at the center. 3. (Anal. (Geom.)  One of the four parts into which a plane is divided by the coördinate axes. The upper right-hand part is the first quadrant; the upper left-hand part the second; the lower left-hand part the third; and the lower right-hand part the fourth quadrant. 4. An instrument for measuring altitudes, variously constructed and mounted for different specific uses in astronomy, surveying, gunnery, etc., consisting commonly of a graduated arc of 90º, with an index or vernier, and either plain or telescopic sights, and usually having a plumb line or spirit level for fixing the vertical or horizontal direction. Gunner's quadrant, an instrument consisting of a graduated limb, with a plumb line or spirit level, and an arm by which it is applied to a cannon or mortar in adjusting it to the elevation required for attaining the desired range. -- Gunter's quadrant. See Gunter's quadrant, in the Vocabulary. Hadley's quadrant, a hand instrument used chiefly at sea to measure the altitude of the sun or other celestial body in ascertaining the vessel's position. It consists of a frame in the form of an octant having a graduated scale upon its arc, and an index arm, or alidade pivoted at its apex. Mirrors, called the index glass and the horizon glass, are fixed one upon the index arm and the other upon one side of the frame, respectively. When the instrument is held upright, the index arm may be swung so that the index glass will reflect an image of the sun upon the horizon glass, and when the reflected image of the sun coincides, to the observer's eye, with the horizon as seen directly through an opening at the side of the horizon glass, the index shows the sun's altitude upon the scale; -- more properly, but less commonly, called an octant. -- Quadrant of altitude, an appendage of the artificial globe, consisting of a slip of brass of the length of a quadrant of one of the great circles of the globe, and graduated. It may be fitted to the meridian, and being movable round to all points of the horizon, serves as a scale in measuring altitudes, azimuths, etc.
quadrantal |Of or pertaining to a quadrant; also, included in the fourth part of a circle; as, quadrantal space. Quadrantal triangle, a spherical triangle having one side equal to a quadrant or arc of 90º. -- Quadrantal versor, a versor that expresses rotation through one right angle.\n\n1. (Rom. Antiq.)  A cubical vessel containing a Roman cubic foot, each side being a Roman square foot; -- used as a measure. 2. A cube. [R.]
quadrat |1. (Print.)  A block of type metal lower than the letters, -- used in spacing and in blank lines. [Abbrev. quad.] 2. An old instrument used for taking altitudes; -- called also geometrical square, and line of shadows.
quadrate |1. Having four equal sides, the opposite sides parallel, and four right angles; square. Figures, some round, some triangle, some quadrate. Foxe. 2. Produced by multiplying a number by itself; square. \" Quadrate and cubical numbers.\" Sir T. Browne. 3. Square; even; balanced; equal; exact. [Archaic] \" A quadrate, solid, wise man.\" Howell. 4. Squared; suited; correspondent. [Archaic] \" A generical description quadrate to both.\" Harvey. Quadrate bone (Anat.), a bone between the base of the lower jaw and the skull in most vertebrates below the mammals. In reptiles and birds it articulates the lower jaw with the skull; in mammals it is represented by the malleus or incus.\n\n1. (Geom.)  A plane surface with four equal sides and four right angles; a square; hence, figuratively, anything having the outline of a square. At which command, the powers militant That stood for heaven, in mighty quadrate joined. Milton. 2. (Astrol.)  An aspect of the heavenly bodies in which they are distant from each other 90º, or the quarter of a circle; quartile. See the Note under Aspect, 6. 3. (Anat.)  The quadrate bone.\n\nTo square; to agree; to suit; to correspond; -- followed by with. [Archaic] The objections of these speculatists of its forms do not quadrate with their theories. Burke.\n\nTo adjust (a gun) on its carriage; also, to train (a gun) for horizontal firing.
quadratic |1. Of or pertaining to a square, or to squares; resembling a quadrate, or square; square. 2. (Crystallog.)  Tetragonal. 3. (Alg.)  Pertaining to terms of the second degree; as, a quadratic equation, in which the highest power of the unknown quantity is a square.
quadratics |That branch of algebra which treats of quadratic equations.
quadratojugal |(a) Of or pertaining to the quadrate and jugal bones. (b) Of or pertaining to the quadratojugal bone. -- n.  The quadratojugal bone. Quadratojugal bone (Anat.), a bone at the base of the lower jaw in many animals.
quadratrix |A curve made use of in the quadrature of other curves; as the quadratrix, of Dinostratus, or of Tschirnhausen.
quadrature |1. (Math.)  The act of squaring; the finding of a square having the same area as some given curvilinear figure; as, the quadrature of a circle; the operation of finding an expression for the area of a figure bounded wholly or in part by a curved line, as by a curve, two ordinates, and the axis of abscissas. 2. A quadrate; a square. Milton. 3. (Integral Calculus)  The integral used in obtaining the area bounded by a curve; hence, the definite integral of the product of any function of one variable into the differential of that variable. 4. (Astron.)  The position of one heavenly body in respect to another when distant from it 90º, or a quarter of a circle, as the moon when at an equal distance from the points of conjunction and opposition. Quadrature of the moon (Astron.), the position of the moon when one half of the disk is illuminated. -- Quadrature of an orbit (Astron.), a point in an orbit which is at either extremity of the latus rectum drawn through the empty focus of the orbit.
quadrel |1. A square piece of turf or peat. [Prov. Eng.] 2. A square brick, tile, or the like.
quadrennial |1. Comprising four years; as, a quadrennial period. 2. Occurring once in four years, or at the end of every four years; as, quadrennial games.
quadrennially |Once in four years.
quadrennium |A space or period of four years.
quadri- |A combining form meaning four, four times, fourfold; as, quadricapsular, having four capsules.
quadri-syllabical |Having four syllables; of or pertaining to quadrisyllables; as, a quadrisyllabic word.
quadribasic |Same as Tetrabasic.
quadrible |Quadrable. [R.]
quadric |Of or pertaining to the second degree.\n\n(a) (Alg.) A quantic of the second degree. See Quantic. (b) (Geom.) A surface whose equation in three variables is of the second degree. Spheres, spheroids, ellipsoids, paraboloids, hyperboloids, also cones and cylinders with circular bases, are quadrics.
quadricapsular |Having four capsules.
quadriceps |The great extensor muscle of the knee, divided above into four parts which unite in a single tendon at the knee.
quadricipital |Of or pertaining to the quadriceps.
quadricorn |Any quadricornous animal.
quadricornous |Having four horns, or hornlike organs; as, a quadricornous beetle.
quadricostate |Having four ribs.
quadridentate |Having four teeth; as, a quadridentate leaf.
quadriennial |Same as Quadrennial.
quadrifarious |Arranged in four rows or ranks; as, quadrifarious leaves. Loudon.
quadrifid |Divided, or deeply cleft, into four parts; as, a quadrifid perianth; a quadrifid leaf.
quadrifoil |Four-leaved; having the leaves in whorls of four.
quadrifoliate |Four-leaved; having the leaves in whorls of four.
quadrifurcated |Having four forks, or branches.
quadriga |A car or chariot drawn by four horses abreast.
quadrigeminal |Fourfold; having four similar parts, or two pairs of similar parts. Quadrigeminal bodies (Anat.), two pairs of lobes, or elevations, on the dorsal side of the midbrain of most mammals; the optic lobes. The anterior pair are called the nates, and the posterior the testes.
quadrigeminous |Fourfold; having four similar parts, or two pairs of similar parts. Quadrigeminal bodies (Anat.), two pairs of lobes, or elevations, on the dorsal side of the midbrain of most mammals; the optic lobes. The anterior pair are called the nates, and the posterior the testes.
quadrigenarious |Consisting of four hundred.
quadrijugate |Same as Quadrijugous.
quadrijugous |Pinnate, with four pairs of leaflets; as, a quadrijugous leaf.
quadrilateral |Having four sides, and consequently four angles; quadrangular.\n\n1. (Geom.)  A plane figure having four sides, and consequently four angles; a quadrangular figure; any figure formed by four lines. 2. An area defended by four fortresses supporting each other; as, the Venetian quadrilateral, comprising Mantua, Peschiera, Verona, and Legnano. Complete quadrilateral (Geom.), the figure made up of the six straight lines that can be drawn through four points, A., B, C, I, the lines being supposed to be produced indefinitely.
quadrilateralness |The property of being quadrilateral.
quadriliteral |Consisting of four letters.
quadrille |1. A dance having five figures, in common time, four couples of dancers being in each set. 2. The appropriate music for a quadrille.\n\nA game played by four persons with forty cards, being the remainder of an ordinary pack after the tens, nines, and eights are discarded. Hoyle.
quadrillion |According to the French notation, which is followed also upon the Continent and in the United States, a unit with fifteen ciphers annexed; according to the English notation, the number produced by involving a million to the fourth power, or the number represented by a unit with twenty-four ciphers annexed. See the Note under Numeration.
quadrilobate |Having four lobes; as, a quadrilobate leaf.
quadrilobed |Having four lobes; as, a quadrilobate leaf.
quadrilocular |Having four cells, or cavities; as, a quadrilocular heart.
quadrin |A small piece of money, in value about a farthing, or a half cent. [Obs.]
quadrinodal |Possessing four nodes; as, quadrinodal curves.
quadrinomial |A polynomial of four terms connected by the signs plus or minus.
quadrinomical |Quadrinomial.
quadrinominal |Quadrinomial. Sir W. R. Hamilton.
quadripartite |Divided into four parts.
quadripartitely |In four parts.
quadripartition |A division or distribution by four, or into four parts; also, a taking the fourth part of any quantity or number.
quadripennate |Having four wings; -- said of insects.
quadriphyllous |Having four leaves; quadrifoliate.
quadrireme |A galley with four banks of oars or rowers.
quadrisection |A subdivision into four parts.
quadrisulcate |Having four hoofs; as, a quadrisulcate foot; a quadrisulcate animal.
quadrisyllabic |Having four syllables; of or pertaining to quadrisyllables; as, a quadrisyllabic word.
quadrisyllable |A word consisting of four syllables. De Quincey.
quadrivalence |The quality or state of being quadrivalent; tetravalence.
quadrivalent |Having a valence of four; capable of combining with, being replaced by, or compared with, four monad atoms; tetravalent; -- said of certain atoms and radicals; thus, carbon and silicon are quadrivalent elements.
quadrivalve |Dehiscent into four similar parts; four-valved; as, a quadrivalve pericarp.\n\nA door, shutter, or the like, having four folds.
quadrivalvular |Having four valves; quadrivalve.
quadrivial |Having four ways meeting in a point. B. Jonson.\n\nOne of the four \"liberal arts\" making up the quadrivium.
quadrivium |The four \"liberal arts,\" arithmetic, music, geometry, and astronomy; -- so called by the schoolmen. See Trivium.
quadroon |The offspring of a mulatto and a white person; a person quarter-blooded. [Written also quarteron, quarteroon, and quateron.]
quadroxide |A tetroxide. [R.]
quadrumana |A division of the Primates comprising the apes and monkeys; -- so called because the hind foot is usually prehensile, and the great toe opposable somewhat like a thumb. Formerly the Quadrumana were considered an order distinct from the Bimana, which last included man alone.
quadrumane |One of the Quadrumana.
quadrumanous |Having four hands; of or pertaining to the Quadrumana.
quadruped |Having four feet.\n\nAn animal having four feet, as most mammals and reptiles; -- often restricted to the mammals.
quadrupedal |Having four feet; of or pertaining to a quadruped.
quadruplane |An aëroplane with four superposed main supporting surfaces.
quadruple |Fourfold; as, to make quadruple restitution; a quadruple alliance. Quadruple time (Mus.), that in which each measure is divided into four equal parts.\n\nfour times the sum or number; a fourfold amount; as, to receive to quadruple of the amount in damages.\n\nTo multiply by four; to increase fourfold; to double; to double twice. A. Smith.\n\nTo be multiplied by four; to increase fourfold; to become four times as much.
quadruplet |1. A collection or combination of four of a kind. 2.  pl. Four children born in the same labor. 3.  A cycle for carrying four riders, so arranged that all the reders can assist in the propulsion.
quadruplex |Fourfold; folded or doubled twice. Quadruplex system (Electric Telegraph), a system by which four messages, two in each direction, may be sent simultaneously over the wire.
quadruplicate |To make fourfold; to double twice; to quadruple.\n\n1. Fourfold; doubled twice; four times repeated; as, a quadruplicate ratio, or a quadruplicate proportion. 2. (Math.)  Raised to the fourth power. [R.]
quadruplication |The act of making fourfold; a taking four times the simple sum or amount.
quadruply |To a fourfold quantity; so as to be, or cause to be, quadruple; as, to be quadruply recompensed.
quaere |Inquire; question; see; -- used to signify doubt or to suggest investigation.
quaestor |Same as Questor.
quaff |To drink with relish; to drink copiously of; to swallow in large draughts. \"Quaffed off the muscadel.\" Shak. They eat, they drink, and in communion sweet Quaff immortality and joy. Milton.\n\nTo drink largely or luxuriously. Twelve days the gods their solemn revels keep, And quaff with blameless Ethiops in the deep. Dryden.
quaffer |One who quaffs, or drinks largely.
quag |A quagmire. [R.] \"Crooked or straight, through quags or thorny dells.\" Cowper.
quagga |A South African wild ass (Equus, or Hippotigris, quagga). The upper parts are reddish brown, becoming paler behind and behind and beneath, with dark stripes on the face, neck, and fore part of the body.
quaggy |Of the nature of a quagmire; yielding or trembling under the foot, as soft, wet earth; spongy; boggy. \"O'er the watery strath, or quaggy moss.\" Collins.
quagmire |Soft, wet, miry land, which shakes or yields under the feet. \"A spot surrounded by quagmires, which rendered it difficult of access.\" Palfrey. Syn. -- Morass; marsh; bog; swamp; fen; slough.
quahaug |An American market clam (Venus mercenaria). It is sold in large quantities, and is highly valued as food. Called also round clam, and hard clam. Note: The name is also applied to other allied species, as Venus Mortoni of the Gulf of Mexico.
quahog |An American market clam (Venus mercenaria). It is sold in large quantities, and is highly valued as food. Called also round clam, and hard clam. Note: The name is also applied to other allied species, as Venus Mortoni of the Gulf of Mexico.
quaich |A small shallow cup or drinking vessel. [Scot.] [Written also quegh.]
quaigh |A small shallow cup or drinking vessel. [Scot.] [Written also quegh.]
quail |1. To die; to perish; hence, to wither; to fade. [Obs.] Spenser. 2. To become quelled; to become cast down; to sink under trial or apprehension of danger; to lose the spirit and power of resistance; to lose heart; to give way; to shrink; to cower. The atheist power shall quail, and confess his fears. I. Taylor. Stouter hearts than a woman's have quailed in this terrible winter. Longfellow. Syn. -- to cower; flinch; shrink; quake; tremble; blench; succumb; yield.\n\nTo cause to fail in spirit or power; to quell; to crush; to subdue. [Obs.] Spenser.\n\nTo curdle; to coagulate, as milk. [Obs.] Holland.\n\n1. (Zoöl.)  Any gallinaceous bird belonging to Coturnix and several allied genera of the Old World, especially the common European quail (C. communis), the rain quail (C. Coromandelica) of India, the stubble quail (C. pectoralis), and the Australian swamp quail (Synoicus australis). 2. (Zoöl.)  Any one of several American partridges belonging to Colinus, Callipepla, and allied genera, especially the bobwhite (called Virginia quail, and Maryland quail), and the California quail (Calipepla Californica). 3. (Zoöl.)  Any one of numerous species of Turnix and allied genera, native of the Old World, as the Australian painted quail (Turnix varius). See Turnix. 4. A prostitute; -- so called because the quail was thought to be a very amorous bird.[Obs.] Shak. Bustard quail (Zoöl.), a small Asiatic quail-like bird of the genus Turnix, as T. taigoor, a black-breasted species, and the hill bustard quail (T. ocellatus). See Turnix. -- Button quail (Zoöl.), one of several small Asiatic species of Turnix, as T. Sykesii, which is said to be the smallest game bird of India. -- Mountain quail. See under Mountain. -- Quail call, a call or pipe for alluring quails into a net or within range. -- Quail dove (Zoöl.), any one of several American ground pigeons belonging to Geotrygon and allied genera. -- Quail hawk (Zoöl.), the New Zealand sparrow hawk (Hieracidea Novæ-Hollandiæ). -- Quail pipe. See Quail call, above. -- Quail snipe (Zoöl.), the dowitcher, or red-breasted snipe; -- called also robin snipe, and brown snipe. -- Sea quail (Zoöl.), the turnstone. [Local, U. S.]
quaily |The upland plover. [Canadian]
quaint |1. Prudent; wise; hence, crafty; artful; wily. [Obs.] Clerks be full subtle and full quaint. Chaucer. 2. Characterized by ingenuity or art; finely fashioned; skillfully wrought; elegant; graceful; nice; neat. [Archaic] \" The queynte ring.\" \" His queynte spear.\" Chaucer. \" A shepherd young quaint.\" Chapman. Every look was coy and wondrous quaint. Spenser. To show bow quaint an orator you are. Shak. 3. Curious and fanciful; affected; odd; whimsical; antique; archaic; singular; unusual; as, quaint architecture; a quaint expression. Some stroke of quaint yet simple pleasantry. Macaulay. An old, long-faced, long-bodied servant in quaint livery. W. Irving. Syn. -- Quaint, Odd, Antique. Antique is applied to that which has come down from the ancients, or which is made to imitate some ancient work of art. Odd implies disharmony, incongruity, or unevenness. An odd thing or person is an exception to general rules of calculation and procedure, or expectation and common experience. In the current use of quaint, the two ideas of odd and antique are combined, and the word is commonly applied to that which is pleasing by reason of both these qualities. Thus, we speak of the quaint architecture of many old buildings in London; or a quaint expression, uniting at once the antique and the fanciful.
quaintise |1. Craft; subtlety; cunning. [Obs.] Chaucer. R. of Glouces. 2. Elegance; beauty. [Obs.] Chaucer.
quaintly |In a quaint manner. Shak.
quaintness |The quality of being quaint. Pope.
quair |A quire; a book. [Obs.] \" The king's quhair.\" James I. (of Scotland).
quake |1. To be agitated with quick, short motions continually repeated; to shake with fear, cold, etc.; to shudder; to tremble. Quaking for dread.\" Chaucer. She stood quaking like the partridge on which the hawk is ready to seize. Sir P. Sidney. 2. To shake, vibrate, or quiver, either from not being solid, as soft, wet land, or from violent convulsion of any kind; as, the earth quakes; the mountains quake. \" Over quaking bogs.\" Macaulay.\n\nTo cause to quake. [Obs.] Shak.\n\nA tremulous agitation; a quick vibratory movement; a shudder; a quivering.
quaker |1. One who quakes. 2. One of a religious sect founded by George Fox, of Leicestershire, England, about 1650, -- the members of which call themselves Friends. They were called Quakers, originally, in derision. See Friend, n., 4. Fox's teaching was primarily a preaching of repentance . . . The trembling among the listening crowd caused or confirmed the name of Quakers given to the body; men and women sometimes fell down and lay struggling as if for life. Encyc. Brit. 3. (Zoöl.) (a) The nankeen bird. (b) The sooty albatross. (c) Any grasshopper or locust of the genus (Edipoda; -- so called from the quaking noise made during flight. Quaker buttons. (Bot.) See Nux vomica. -- Quaker gun, a dummy cannon made of wood or other material; -- so called because the sect of Friends, or Quakers, hold to the doctrine, of nonresistance. -- Quaker ladies (Bot.), a low American biennial plant (Houstonia cærulea), with pretty four-lobed corollas which are pale blue with a yellowish center; -- also called bluets, and little innocents.
quakeress |A woman who is a member of the Society of Friends.
quakerish |Like or pertaining to a Quaker; Quakerlike.
quakerism |The peculiar character, manners, tenets, etc., of the Quakers.
quakerlike |Like a Quaker.
quakerly |Resembling Quakers; Quakerlike; Quakerish. Macaulay.
quakery |Quakerism. [Obs.] Hallywell.
quaketail |A wagtail.
quakiness |The state of being quaky; liability to quake.
quaking |a. & n. from Quake, v. Quaking aspen (Bot.), an American species of poplar (Populus tremuloides), the leaves of which tremble in the lightest breeze. It much resembles the European aspen. See Aspen. -- Quaking bog, a bog of forming peat so saturated with water that it shakes when trodden upon. -- Quaking grass. (Bot.) (a) One of several grasses of the genus Briza, having slender-stalked and pendulous ovate spikelets, which quake and rattle in the wind. Briza maxima is the large quaking grass; B. media and B. minor are the smaller kinds. (b) Rattlesnake grass (Glyceria Canadensis).
quakingly |In a quaking manner; fearfully. Sir P. Sidney.
quaky |Shaky, or tremulous; quaking.
qualifiable |Capable of being qualified; abatable; modifiable. Barrow.
qualification |1. The act of qualifying, or the condition of being qualified. 2. That which qualifies; any natural endowment, or any acquirement, which fits a person for a place, office, or employment, or which enables him to sustian any character with success; an enabling quality or circumstance; requisite capacity or possession. There is no qualification for government but virtue and wisdom, actual or presumptive. Burke. 3. The act of limiting, or the state of being limited; that which qualifies by limiting; modification; restriction; hence, abatement; diminution; as, to use words without any qualification.
qualificative |That which qualifies, modifies, or restricts; a qualifying term or statement. How many qualificatives, correctives, and restrictives he inserteth in this relation. Fuller.
qualificator |An officer whose business it is to examine and prepare causes for trial in the ecclesiastical courts.
qualified |1. Fitted by accomplishments or endowments. 2. Modified; limited; as, a qualified statement. Qualified fee (Law), a base fee, or an estate which has a qualification annexed to it, the fee ceasing with the qualification, as a grant to A and his heirs, tenants of the manor of Dale. -- Qualified indorsement (Law), an indorsement which modifies the liability of the indorser that would result from the general principles of law, but does not affect the negotiability of the instrument. Story. -- Qualified negative (Legislation), a limited veto power, by which the chief executive in a constitutional government may refuse assent to bills passed by the legislative body, which bills therefore fail to become laws unless upon a reconsideration the legislature again passes them by a certain majority specified in the constitution, when they become laws without the approval of the executive. Qualified property (Law), that which depends on temporary possession, as that in wild animals reclaimed, or as in the case of a bailment. Syn. -- Competent; fit; adapted. -- Qualified, Competent. Competent is most commonly used with respect to native endowments and general ability suited to the performance of a task or duty; qualified with respect to specific acquirements and training.
qualifiedly |In the way of qualification; with modification or qualification.
qualifiedness |The state of being qualified.
qualifier |, One who, or that which, qualifies; that which modifies, reduces, tempers or restrains.
qualify |1. To make such as is required; to give added or requisite qualities to; to fit, as for a place, office, occupation, or character; to furnish with the knowledge, skill, or other accomplishment necessary for a purpose; to make capable, as of an employment or privilege; to supply with legal power or capacity. He had qualified himself for municipal office by taking the oaths to the sovereigns in possession. Macaulay. 2. To give individual quality to; to modulate; to vary; to regulate. It hath no larynx . . . to qualify the sound. Sir T. Browne. 3. To reduce from a general, undefined, or comprehensive form, to particular or restricted form; to modify; to limit; to restrict; to restrain; as, to qualify a statement, claim, or proposition. 4. Hence, to soften; to abate; to diminish; to assuage; to reduce the strength of, as liquors. I do not seek to quench your love's hot fire, But qualify the fire's extreme rage. Shak. 5. To soothe; to cure; -- said of persons. [Obs.] In short space he has them qualified. Spenser. Syn. -- To fit; equip; prepare; adapt; capacitate; enable; modify; soften; restrict; restrain; temper.\n\n1. To be or become qualified; to be fit, as for an office or employment. 2. To obtain legal power or capacity by taking the oath, or complying with the forms required, on assuming an office.
qualitative |Relating to quality; having the character of quality. -- Qual\"i*ta*tive*ly, adv. Qualitative analysis (Chem.), analysis which merely determines the constituents of a substance without any regard to the quantity of each ingredient; -- contrasted with quantitative analysis.
qualitied |Furnished with qualities; endowed. [Obs.] \"He was well qualitied.\" Chapman.
quality |1. The condition of being of such and such a sort as distinguished from others; nature or character relatively considered, as of goods; character; sort; rank. We lived most joyful, obtaining acquaintance with many of the city not of the meanest quality. Bacon 2. Special or temporary character; profession; occupation; assumed or asserted rank, part, or position. I made that inquiry in quality of an antiquary. Gray. 3. That which makes, or helps to make, anything such as it is; anything belonging to a subject, or predicable of it; distinguishing property, characteristic, or attribute; peculiar power, capacity, or virtue; distinctive trait; as, the tones of a flute differ from those of a violin in quality; the great quality of a statesman. Note: Qualities, in metaphysics, are primary or secondary. Primary are those essential to the existence, and even the conception, of the thing, as of matter or spirit Secondary are those not essential to such a conception. 4. An acquired trait; accomplishment; acquisition. He had those qualities of horsemanship, dancing, and fencing which accompany a good breeding. Clarendon. 5. Superior birth or station; high rank; elevated character. \"Persons of quality.\" Bacon. Quality binding, a kind of worsted tape used in Scotland for binding carpets, and the like. The quality, those of high rank or station, as distinguished from the masses, or common people; the nobility; the gentry. I shall appear at the masquerade dressed up in my feathers, that the quality may see how pretty they will look in their traveling habits. Addison. Syn. -- Property; attribute; nature; peculiarity; character; sort; rank; disposition; temper.
qualm |1. Sickness; disease; pestilence; death. [Obs.] thousand slain and not of qualm ystorve [dead]. Chaucer. 2. A sudden attack of illness, faintness, or pain; an agony. \" Qualms of heartsick agony.\" Milton. 3. Especially, a sudden sensation of nausea. For who, without a qualm, hath ever looked On holy garbage, though by Homer cooked Roscommon. 4. A prick or scruple of conscience; uneasiness of conscience; compunction. Dryden.
qualmish |Sick at the stomach; affected with nausea or sickly languor; inclined to vomit. Shak. -- Qualm\"ish*ly, adv. -- Qualm\"ish*ness, n.
quamash |See Camass.
quamoclit |Formerly, a genus of plants including the cypress vine (Quamoclit vulgaris, now called Ipomoea Quamoclit). The genus is now merged in Ipomoea.
quandary |A state of difficulty or perplexity; doubt; uncertainty.\n\nTo bring into a state of uncertainty, perplexity, or difficulty. [Obs.] Otway.
quandong |The edible drupaceous fruit of an Australian tree (Fusanus acuminatus) of the Sandalwood family; -- called also quandang.
quandy |The old squaw. [Local, U. S.]
quannet |A flat file having the handle at one side, so as to be used like a plane.
quant |A punting pole with a broad flange near the end to prevent it from sinking into the mud; a setting pole.
quantic |A homogeneous algebraic function of two or more variables, in general containing only positive integral powers of the variables, and called quadric, cubic, quartic, etc., according as it is of the second, third, fourth, fifth, or a higher degree. These are further called binary, ternary, quaternary, etc., according as they contain two, three, four, or more variables; thus, the quantic is a binary cubic.
quantification |Modification by a reference to quantity; the introduction of the element of quantity. The quantification of the predicate belongs in part to Sir William Hamilton; viz., in its extension to negative propositions. De Quincey.
quantify |To modify or qualify with respect to quantity; to fix or express the quantity of; to rate.
quantitative |Relating to quantity. -- Quan\"ti*ta*tive*ly, adv. Quantitative analysis (Chem.), analysis which determines the amount or quantity of each ingredient of a substance, by weight or by volume; -- contrasted with qualitative analysis.
quantitive |Estimable according to quantity; quantitative. Sir K. Digby.
quantitively |So as to be measurable by quantity; quantitatively.
quantity |1. The attribute of being so much, and not more or less; the property of being measurable, or capable of increase and decrease, multiplication and division; greatness; and more concretely, that which answers the question \"How much\"; measure in regard to bulk or amount; determinate or comparative dimensions; measure; amount; bulk; extent; size. Hence, in specific uses: (a) (Logic) The extent or extension of a general conception, that is, the number of species or individuals to which it may be applied; also, its content or comprehension, that is, the number of its constituent qualities, attributes, or relations. (b) (Gram.) The measure of a syllable; that which determines the time in which it is pronounced; as, the long or short quantity of a vowel or syllable. (c) (Mus.) The relative duration of a tone. 2. That which can be increased, diminished, or measured; especially (Math.), anything to which mathematical processes are applicable. Note: Quantity is discrete when it is applied to separate objects, as in number; continuous, when the parts are connected, either in succession, as in time, motion, etc., or in extension, as by the dimensions of space, viz., length, breadth, and thickness. 3. A determinate or estimated amount; a sum or bulk; a certain portion or part; sometimes, a considerable amount; a large portion, bulk, or sum; as, a medicine taken in quantities, that is, in large quantities. The quantity of extensive and curious information which he had picked up during many months of desultory, but not unprofitable, study. Macaulay. Quantity of estate (Law), its time of continuance, or degree of interest, as in fee, for life, or for years. Wharton (Law Dict. ) -- Quantity of matter, in a body, its mass, as determined by its weight, or by its momentum under a given velocity. -- Quantity of motion (Mech.), in a body, the relative amount of its motion, as measured by its momentum, varying as the product of mass and velocity. -- Known quantities (Math.), quantities whose values are given. -- Unknown quantities (Math.), quantities whose values are sought.
quantivalence |Valence. [Archaic]
quantivalent |Of or pertaining to quantivalence. [Archaic]
quantum |1. Quantity; amount. \"Without authenticating . . . the quantum of the charges.\" Burke. 2. (Math.)  A definite portion of a manifoldness, limited by a mark or by a boundary. W. K. Clifford. Quantum meruit ( Etym: [L., as much as he merited] (Law), a count in an action grounded on a promise that the defendant would pay to the plaintiff for his service as much as he should deserve. -- Quantum sufficit (, or Quantum suff. Etym: [L., as much suffices] (Med.), a sufficient quantity. -- Quantum valebat ( Etym: [L., as much at it was worth] (Law), a count in an action to recover of the defendant, for goods sold, as much as they were worth. Blackstone.
quap |To quaver. [Obs.] See Quob.
quaquaversal |1. Turning or dipping in any or every direction. 2. (Geol.)  Dipping toward all points of the compass round a center, as beds of lava round a crater.
quar |A quarry. [Prov. Eng.] B. Jonson.
quarantine |1. A space of forty days; -- used of Lent. 2. Specifically, the term, originally of forty days, during which a ship arriving in port, and suspected of being infected a malignant contagious disease, is obliged to forbear all intercourse with the shore; hence, such restraint or inhibition of intercourse; also, the place where infected or prohibited vessels are stationed. Note: Quarantine is now applied also to any forced stoppage of travel or communication on account of malignant contagious disease, on land as well as by sea. 3. (Eng. Law)  The period of forty days during which the widow had the privilege of remaining in the mansion house of which her husband died seized. Quarantine flag, a yellow flag hoisted at the fore of a vessel or hung from a building, to give warning of an infectious disease; -- called also the yellow jack, and yellow flag.\n\nTo compel to remain at a distance, or in a given place, without intercourse, when suspected of having contagious disease; to put under, or in, quarantine.
quarl |A medusa, or jellyfish. [R.] The jellied quarl that flings At once a thousand streaming stings. J. R. Drake.
quarrel |1. An arrow for a crossbow; -- so named because it commonly had a square head. [Obs.] To shoot with arrows and quarrel. Sir J. Mandeville. Two arblasts, . . . with windlaces and quarrels. Sir W. Scott. 2. (Arch.)  Any small square or quadrangular member; as: (a) A square of glass, esp. when set diagonally. (b) A small opening in window tracery, of which the cusps, etc., make the form nearly square. (c) A square or lozenge-shaped paving tile. 3. A glazier's diamond. Simmonds. 4. A four-sided cutting tool or chisel having a diamond-shaped end.\n\n1. A breach of concord, amity, or obligation; a falling out; a difference; a disagreement; an antagonism in opinion, feeling, or conduct; esp., an angry dispute, contest, or strife; a brawl; an altercation; as, he had a quarrel with his father about expenses. I will bring a sword upon you that shall avenge the quarrel of my covenant. Lev. xxvi. 25. On open seas their quarrels they debate. Dryden. 2. Ground of objection, dislike, difference, or hostility; cause of dispute or contest; occasion of altercation. Herodias had a quarrel against him, and would have killed him. Mark vi. 19. No man hath any quarrel to me. Shak. He thought he had a good quarrel to attack him. Holinshed. 3. Earnest desire or longing. [Obs.] Holland. To pick a quarrel. See under Pick, v. t. Syn. -- Brawl; broil; squabble; affray; feud; tumult; contest; dispute; altercation; contention; wrangle.\n\n1. To violate concord or agreement; to have a difference; to fall out; to be or become antagonistic. Our people quarrel with obedience. Shak. But some defect in her Did quarrel with the noblest grace she owed. Shak. 2. To dispute angrily, or violently; to wrangle; to scold; to altercate; to contend; to fight. Beasts called sociable quarrel in hunger and lust. Sir W. Temple. 3. To find fault; to cavil; as, to quarrel with one's lot. I will not quarrel with a slight mistake. Roscommon.\n\n1. To quarrel with. [R.] \"I had quarelled my brother purposely.\" B. Jonson. 2. To compel by a quarrel; as, to quarrel a man out of his estate or rights.\n\nOne who quarrels or wrangles; one who is quarrelsome. Shak.
quarrelet |A little quarrel. See 1st Quarrel, 2. [Obs.] \"Quarrelets of pearl [teeth].\" Herrick.
quarreling |Engaged in a quarrel; apt or disposed to quarrel; as, quarreling factions; a quarreling mood. -- Quar\"rel*ing*ly, adv.
quarrellous |Quarrelsome. [Obs.] [Written also quarrellous.] Shak.
quarrelsome |Apt or disposed to quarrel; given to brawls and contention; easily irritated or provoked to contest; irascible; choleric. Syn. -- Pugnacious; irritable; irascible; brawling; choleric; fiery; petulant. -- Quar\"rel*some*ly, adv. -- Quar\"rel*some*ness, n.
quarried |Provided with prey. Now I am bravely quarried. Beau. & Fl.
quarrier |A worker in a stone quarry.
quarry |Same as 1st Quarrel. [Obs.] Fairfax.\n\nQuadrate; square. [Obs.]\n\n1. (a) A part of the entrails of the beast taken, given to the hounds. (b) A heap of game killed. 2. The object of the chase; the animal hunted for; game; especially, the game hunted with hawks. \"The stone-dead quarry.\" Spenser. The wily quarry shunned the shock. Sir W. Scott.\n\nTo secure prey; to prey, as a vulture or harpy. L'Estrange.\n\nA place, cavern, or pit where stone is taken from the rock or ledge, or dug from the earth, for building or other purposes; a stone pit. See 5th Mine (a).\n\nTo dig or take from a quarry; as, to quarry marble.
quarry-faced |Having a face left as it comes from the quarry and not smoothed with the chisel or point; -- said of stones.
quarry-man |A man who is engaged in quarrying stones; a quarrier.
quart |The fourth part; a quarter; hence, a region of the earth. [Obs.] Camber did possess the western quart. Spenser.\n\n1. A measure of capacity, both in dry and in liquid measure; the fourth part of a gallon; the eighth part of a peck; two pints. Note: In imperial measure, a quart is forty English fluid ounces; in wine measure, it is thirty-two American fluid ounces. The United States dry quart contains 67.20 cubic inches, the fluid quart 57.75. The English quart contains 69.32 cubic inches. 2. A vessel or measure containing a quart.\n\nIn cards, four successive cards of the same suit. Cf. Tierce, 4. Hoyle.
quartan |Of or pertaining to the fourth; occurring every fourth day, reckoning inclusively; as, a quartan ague, or fever.\n\n1. (Med.)  An intermittent fever which returns every fourth day, reckoning inclusively, that is, one in which the interval between paroxysms is two days. 2. A measure, the fourth part of some other measure.
quartane |Butane, each molecule of which has four carbon atoms.
quartation |The act, process, or result (in the process of parting) of alloying a button of nearly pure gold with enough silver to reduce the fineness so as to allow acids to attack and remove all metals except the gold; -- called also inquartation. Compare Parting.
quarte |Same as 2d Carte.
quartene |Same as Butylene.
quartenylic |Pertaining to, or designating, an acid of the acrylic acid series, metameric with crotonic acid, and obtained as a colorless liquid; -- so called from having four carbon atoms in the molecule. Called also isocrotonic acid.
quarter |1. One of four equal parts into which anything is divided, or is regarded as divided; a fourth part or portion; as, a quarter of a dollar, of a pound, of a yard, of an hour, etc. Hence, specifically: (a) The fourth of a hundred-weight, being 25 or 28 pounds, according as the hundredweight is reckoned at 100 or 112 pounds. (b) The fourth of a ton in weight, or eight bushels of grain; as, a quarter of wheat; also, the fourth part of a chaldron of coal. Hutton. (c) (Astron.) The fourth part of the moon's period, or monthly revolution; as, the first quarter after the change or full. (d) One limb of a quadruped with the adjacent parts; one fourth part of the carcass of a slaughtered animal, including a leg; as, the fore quarters; the hind quarters. (e) That part of a boot or shoe which forms the side, from the heel to the vamp. (f) (Far.) That part on either side of a horse's hoof between the toe and heel, being the side of the coffin. (g) A term of study in a seminary, college, etc, etc.; properly, a fourth part of the year, but often longer or shorter. (h) pl. (Mil.)  The encampment on one of the principal passages round a place besieged, to prevent relief and intercept convoys. (i) (Naut.) The after-part of a vessel's side, generally corresponding in extent with the quarter-deck; also, the part of the yardarm outside of the slings. (j) (Her.) One of the divisions of an escutcheon when it is divided into four portions by a horizontal and a perpendicular line meeting in the fess point. Note: When two coats of arms are united upon one escutcheon, as in case of marriage, the first and fourth quarters display one shield, the second and third the other. See Quarter, v. t., 5. (k) One of the four parts into which the horizon is regarded as divided; a cardinal point; a direction' principal division; a region; a territory. Scouts each coast light-armed scour, Each quarter, to descry the distant foe. Milton. (l) A division of a town, city, or county; a particular district; a locality; as, the Latin quarter in Paris. (m) (Arch.) A small upright timber post, used in partitions; -- in the United States more commonly called stud. (n) (Naut.) The fourth part of the distance from one point of the compass to another, being the fourth part of 11° 15', that is, about 2° 49'; -- called also quarter point. 2. Proper station; specific place; assigned position; special location. Swift to their several quarters hasted then The cumbrous elements. Milton. Hence, specifically: (a) (Naut.) A station at which officers and men are posted in battle; -- usually in the plural. (b) Place of lodging or temporary residence; shelter; entertainment; -- usually in the plural. The banter turned as to what quarters each would find. W. Irving. (c) pl. (Mil.)  A station or encampment occupied by troops; a place of lodging for soldiers or officers; as, winter quarters. (d) Treatment shown by an enemy; mercy; especially, the act of sparing the life a conquered enemy; a refraining from pushing one's advantage to extremes. He magnified his own clemency, now they were at his mercy, to offer them quarter for their lives. Clarendon. Cocks and lambs . . . at the mercy of cats and wolves . . . must never expect better quarter. L'Estrange. 3. Friendship; amity; concord. [Obs.] To keep quarter, to keep one's proper place, and so be on good terms with another. [Obs.] In quarter, and in terms like bride and groom. Shak. I knew two that were competitors for the secretary's place, . . . and yet kept good quarter between themselves. Bacon. False quarter, a cleft in the quarter of a horse's foot. -- Fifth quarter, the hide and fat; -- a butcher's term. -- On the quarter (Naut.), in a direction between abeam and astern; opposite, or nearly opposite, a vessel's quarter. -- Quarter aspect. (Astrol.) Same as Quadrate. -- Quarter back (Football), the player who has position next behind center rush, and receives the ball on the snap back. -- Quarter badge (Naut.), an ornament on the side of a vessel near, the stern. Mar. Dict. -- Quarter bill (Naut.), a list specifying the different stations to be taken by the officers and crew in time of action, and the names of the men assigned to each. -- Quarter block (Naut.), a block fitted under the quarters of a yard on each side of the slings, through which the clew lines and sheets are reeved. R. H. Dana, Jr. -- Quarter boat (Naut.), a boat hung at a vessel's quarter. -- Quarter cloths (Naut.), long pieces of painted canvas, used to cover the quarter netting. -- Quarter day, a day regarded as terminating a quarter of the year; hence, one on which any payment, especially rent, becomes due. In matters influenced by United States statutes, quarter days are the first days of January, April, July, and October. In New York and many other places, as between landlord and tenant, they are the first days of May, August, November, and February. The quarter days usually recognized in England are 25th of March (Lady Day), the 24th of June (Midsummer Day), the 29th of September (Michaelmas Day), and the 25th of December (Christmas Day). -- Quarter face, in fine arts, portrait painting, etc., a face turned away so that but one quarter is visible. -- Quarter gallery (Naut.), a balcony on the quarter of a ship. See Gallery, 4. -- Quarter gunner (Naut.), a petty officer who assists the gunner. -- Quarter look, a side glance. [Obs.] B. Jonson. -- Quarter nettings (Naut.), hammock nettings along the quarter rails. -- Quarter note (Mus.), a note equal in duration to half a minim or a fourth of semibreve; a crochet. -- Quarter pieces (Naut.), several pieces of timber at the after- part of the quarter gallery, near the taffrail. Totten. -- Quarter point. (Naut.) See Quarter, n., 1 (n). -- Quarter railing, or Quarter rails (Naut.), narrow molded planks reaching from the top of the stern to the gangway, serving as a fence to the quarter-deck. -- Quarter sessions (Eng. Law), a general court of criminal jurisdiction held quarterly by the justices of peace in counties and by the recorders in boroughs. -- Quarter square (Math.), the fourth part of the square of a number. Tables of quarter squares have been devised to save labor in multiplying numbers. -- Quarter turn, Quarter turn belt (Mach.), an arrangement in which a belt transmits motion between two shafts which are at right angles with each other. -- Quarter watch (Naut.), a subdivision of the full watch (one fourth of the crew) on a man-of- war. -- To give, or show, quarter (Mil.), to accept as prisoner, on submission in battle; to forbear to kill, as a vanquished enemy. -- To keep quarter. See Quarter, n., 3.\n\n1. To divide into four equal parts. 2. To divide; to separate into parts or regions. Then sailors quartered heaven. Dryden. 3. To furnish with shelter or entertainment; to supply with the means of living for a time; especially, to furnish shelter to; as, to quarter soldiers. They mean this night in Sardis to be quartered. Shak. 4. To furnish as a portion; to allot. [R.] This isle . . . He quarters to his blue-haired deities. Milton. 5. (Her.)  To arrange (different coats of arms) upon one escutcheon, as when a man inherits from both father and mother the right to bear arms. Note: When only two coats of arms are so combined they are arranged in four compartments. See Quarter, n., 1 (f).\n\nTo lodge; to have a temporary residence.\n\nTo drive a carriage so as to prevent the wheels from going into the ruts, or so that a rut shall be between the wheels. Every creature that met us would rely on us for quartering. De Quincey.
quarter round |An ovolo.
quarter-deck |That part of the upper deck abaft the mainmast, including the poop deck when there is one. Note: The quarter-deck is reserved as a promenade for the officers and (in passenger vessels) for the cabin passengers.
quarter-saw |To saw (a log) into quarters; specif., to saw into quarters and then into boards, as by cutting alternately from each face of a quarter, to secure lumber that will warp relatively little or show the grain advantageously.
quarterage |A quarterly allowance.
quartered |1. Divided into four equal parts or quarters; separated into four parts or regions. 2.  Furnished with quarters; provided with shelter or entertainment. 3.  Quarter-sawed; -- said of timber, commonly oak.
quarterfoil |An ornamental foliation having four lobes, or foils.
quarterhung |Having trunnions the axes of which lie below the bore; -- said of a cannon.
quartering |1. (Naut.)  Coming from a point well abaft the beam, but not directly astern; -- said of waves or any moving object. 2. (Mach.)  At right angles, as the cranks of a locomotive, which are in planes forming a right angle with each other.\n\n1. A station. [Obs.] Bp. Montagu. 2. Assignment of quarters for soldiers; quarters. 3. (Her.) (a) The division of a shield containing different coats of arms into four or more compartments. (b) One of the different coats of arms arranged upon an escutcheon, denoting the descent of the bearer. 4. (Arch.)  A series of quarters, or small upright posts. See Quarter, n., 1 (m) (Arch.) Gwilt. Quartering block, a block on which the body of a condemned criminal was quartered. Macaulay.
quarterly |1. Containing, or consisting of, a fourth part; as, quarterly seasons. 2. Recurring during, or at the end of, each quarter; as, quarterly payments of rent; a quarterly meeting.\n\nA periodical work published once a quarter, or four times in a year.\n\n1. By quarters; once in a quarter of a year; as, the returns are made quarterly. 2. (Her.)  In quarters, or quarterings; as, to bear arms quarterly; in four or more parts; -- said of a shield thus divided by lines drawn through it at right angles.
quartermaster |1. (Mil.)  An officer whose duty is to provide quarters, provisions, storage, clothing, fuel, stationery, and transportation for a regiment or other body of troops, and superintend the supplies. 2. (Naut.)  A petty officer who attends to the helm, binnacle, signals, and the like, under the direction of the master. Totten. Quartermaster general (Mil.), in the United States a staff officer, who has the rank of brigadier general and is the chief officer in the quartermaster's department; in England, an officer of high rank stationed at the War Office having similar duties; also, a staff officer, usually a general officer, accompanying each complete army in the field. -- Quartermaster sergeant. See Sergeant.
quartern |1. A quarter. Specifically: (a) The fourth part of a pint; a gill. (b) The fourth part of a peck, or of a stone (14 ibs.). 2. A loaf of bread weighing about four pounds; -- called also quartern loaf. Simmonds.
quarteron |A quarter; esp., a quarter of a pound, or a quarter of a hundred. Piers Plowman.\n\nA quadroon.
quarteroon |A quadroon.
quarterpace |A platform of a staircase where the stair turns at a right angle only. See Halfpace.
quarterstaff |A long and stout staff formerly used as a weapon of defense and offense; -- so called because in holding it one hand was placed in the middle, and the other between the middle and the end.
quartet |1. (Mus.) (a) A composition in four parts, each performed by a single voice or instrument. (b) The set of four person who perform a piece of music in four parts. 2. (Poet.)  A stanza of four lines.
quartette |1. (Mus.) (a) A composition in four parts, each performed by a single voice or instrument. (b) The set of four person who perform a piece of music in four parts. 2. (Poet.)  A stanza of four lines.
quartic |Of the fourth degree.\n\n(a) (Alg.) A quantic of the fourth degree. See Quantic. (b) (Geom.) A curve or surface whose equation is of the fourth degree in the variables.
quartile |Same as Quadrate.
quartine |A supposed fourth integument of an ovule, counting from the outside.
quarto |Having four leaves to the sheet; of the form or size of a quarto.\n\nOriginally, a book of the size of the fourth of sheet of printing paper; a size leaves; in present usage, a book of a square or nearly square form, and usually of large size.
quartridge |Quarterage. [Obs.]
quartz |A form of silica, or silicon dioxide (SiO2), occurring in hexagonal crystals, which are commonly colorless and transparent, but sometimes also yellow, brown, purple, green, and of other colors; also in cryptocrystalline massive forms varying in color and degree of transparency, being sometimes opaque. Note: The crystalline varieties include: amethyst, violet; citrine and false topaz, pale yellow; rock crystal, transparent and colorless or nearly so; rose quartz, rosecolored; smoky quartz, smoky brown. The chief crypto-crystalline varieties are: agate, a chalcedony in layers or clouded with different colors, including the onyx and sardonyx; carnelian and sard, red or flesh-colored chalcedony; chalcedony, nearly white, and waxy in luster; chrysoprase, an apple- green chalcedony; flint, hornstone, basanite, or touchstone, brown to black in color and compact in texture; heliotrope, green dotted with red; jasper, opaque, red yellow, or brown, colored by iron or ferruginous clay; prase, translucent and dull leek-green. Quartz is an essential constituent of granite, and abounds in rocks of all ages. It forms the rocks quartzite (quartz rock) and sandstone, and makes most of the sand of the seashore.
quartziferous |Consisting chiefly of quartz; containing quartz.
quartzite |Massive quartz occurring as a rock; a metamorphosed sandstone; -- called also quartz rock.
