backward |1. With the back in advance or foremost; as, to ride backward. 2. Toward the back; toward the rear; as, to throw the arms backward. 3. On the back, or with the back downward. Thou wilt fall backward. Shak. 4. Toward, or in, past time or events; ago. Some reigns backward. Locke. 5. By way of reflection; reflexively. Sir J. Davies. 6. From a better to a worse state, as from honor to shame, from religion to sin. The work went backward. Dryden. 7. In a contrary or reverse manner, way, or direction; contrarily; as, to read backwards. We might have . . . beat them backward home. Shak.\n\n1. Directed to the back or rear; as, backward glances. 2. Unwilling; averse; reluctant; hesitating; loath. For wiser brutes were backward to be slaves. Pope. 3. Not well advanced in learning; not quick of apprehension; dull; inapt; as, a backward child. \"The backward learner.\" South. 4. Late or behindhand; as, a backward season. 5. Not advanced in civilization; undeveloped; as, the country or region is in a backward state. 6. Already past or gone; bygone. [R.] And flies unconscious o'er each backward year. Byron.\n\nThe state behind or past. [Obs.] In the dark backward and abysm of time. Shak.\n\nTo keep back; to hinder. [Obs.]
backwardation |The seller's postponement of delivery of stock or shares, with the consent of the buyer, upon payment of a premium to the latter; -- also, the premium so paid. See Contango. Biddle.
backwardly |1. Reluctantly; slowly; aversely. [Obs.] Sir P. Sidney. 2. Perversely; ill.[Obs.] And does he think so backwardly of me Shak.
backwardness |The state of being backward.
backwards |1. With the back in advance or foremost; as, to ride backward. 2. Toward the back; toward the rear; as, to throw the arms backward. 3. On the back, or with the back downward. Thou wilt fall backward. Shak. 4. Toward, or in, past time or events; ago. Some reigns backward. Locke. 5. By way of reflection; reflexively. Sir J. Davies. 6. From a better to a worse state, as from honor to shame, from religion to sin. The work went backward. Dryden. 7. In a contrary or reverse manner, way, or direction; contrarily; as, to read backwards. We might have . . . beat them backward home. Shak.
backwash |To clean the oil from (wood) after combing.
backwater |1. Water turned back in its course by an obstruction, an opposing current , or the flow of the tide, as in a sewer or river channel, or across a river bar. 2. An accumulation of water overflowing the low lands, caused by an obstruction. 3. Water thrown back by the turning of a waterwheel, or by the paddle wheels of a steamer.
backwoods |The forests or partly cleared grounds on the frontiers.
backwoodsman |A men living in the forest in or beyond the new settlements, especially on the western frontiers of the older portions of the United States. Fisher Ames.
backworm |A disease of hawks. See Filanders. Wright.
bacon |The back and sides of a pig salted and smoked; formerly, the flesh of a pig salted or fresh. Bacon beetle (Zoöl.), a beetle (Dermestes lardarius) which, especially in the larval state, feeds upon bacon, woolens, furs, etc. See Dermestes. -- To save one's bacon, to save one's self or property from harm or less. [Colloq.]
baconian |Of or pertaining to Lord Bacon, or to his system of philosophy. Baconian method, the inductive method. See Induction.
bacteria |See Bacterium.
bacterial |Of or pertaining to bacteria.
bactericidal |Destructive of bacteria.
bactericide |Same as Germicide.
bacterin |A bacterial vaccine.
bacteriological |Of or pertaining to bacteriology; as, bacteriological studies.
bacteriologist |One skilled in bacteriology.
bacteriology |The science relating to bacteria.
bacteriolysis |1. Chemical decomposition brought about by bacteria without the addition of oxygen. 2.  The destruction or dissolution of bacterial cells. -- Bac*te`ri*o*lyt\"ic (#), a.
bacterioscopic |Relating to bacterioscopy; as, a bacterioscopic examination.
bacterioscopist |One skilled in bacterioscopic examinations.
bacterioscopy |The application of a knowledge of bacteria for their detection and identification, as in the examination of polluted water.
bacterium |A microscopic vegetable organism, belonging to the class Algæ, usually in the form of a jointed rodlike filament, and found in putrefying organic infusions. Bacteria are destitute of chlorophyll, and are the smallest of microscopic organisms. They are very widely diffused in nature, and multiply with marvelous rapidity, both by fission and by spores. Certain species are active agents in fermentation, while others appear to be the cause of certain infectious diseases. See Bacillus.
bacteroid |Resembling bacteria; as, bacteroid particles.
bacteroidal |Resembling bacteria; as, bacteroid particles.
bactrian |Of or pertaining to Bactria in Asia. -- n.  A native of Bactria. Bactrian camel, the two-humped camel.
bacule |See Bascule.
baculine |Of or pertaining to the rod or punishment with the rod.
baculite |A cephalopod of the extinct genus Baculites, found fossil in the Cretaceous rocks. It is like an uncoiled ammonite.
baculometry |Measurement of distance or altitude by a staff or staffs.
bad |of Bid. Bade. [Obs.] Dryden.\n\nWanting good qualities, whether physical or moral; injurious, hurtful, inconvenient, offensive, painful, unfavorable, or defective, either physically or morally; evil; vicious; wicked; -- the opposite of good; as a bad man; bad conduct; bad habits; bad soil; bad health; bad crop; bad news. Note: Sometimes used substantively. The strong antipathy of good to bad. Pope. Syn. -- Pernicious; deleterious; noxious; baneful; injurious; hurtful; evil; vile; wretched; corrupt; wicked; vicious; imperfect.
bad lands |Barren regions, especially in the western United States, where horizontal strata (Tertiary deposits) have been often eroded into fantastic forms, and much intersected by canons, and where lack of wood, water, and forage increases the difficulty of traversing the country, whence the name, first given by the Canadian French, Mauvaises Terres (bad lands).
badaud |A person given to idle observation of everything, with wonder or astonishment; a credulous or gossipy idler. A host of stories . . . dealing chiefly with the subject of his great wealth, an ever delightful topic to the badauds of Paris. Pall Mall Mag.
badder |compar. of Bad, a. [Obs.] Chaucer.
badderlocks |A large black seaweed (Alaria esculenta) sometimes eaten in Europe; -- also called murlins, honeyware, and henware.
baddish |Somewhat bad; inferior. Jeffrey.
bade |A form of the pat tense of Bid.
badge |1. A distinctive mark, token, sign, or cognizance, worn on the person; as, the badge of a society; the badge of a policeman. \"Tax gatherers, recognized by their official badges. \" Prescott. 2. Something characteristic; a mark; a token. Sweet mercy is nobility's true badge. Shak. 3. (Naut.)  A carved ornament on the stern of a vessel, containing a window or the representation of one.\n\nTo mark or distinguish with a badge.
badgeless |Having no badge. Bp. Hall.
badger |An itinerant licensed dealer in commodities used for food; a hawker; a huckster; -- formerly applied especially to one who bought grain in one place and sold it in another. [Now dialectic, Eng.]\n\n1. A carnivorous quadruped of the genus Meles or of an allied genus. It is a burrowing animal, with short, thick legs, and long claws on the fore feet. One species (M. vulgaris), called also brock, inhabits the north of Europe and Asia; another species (Taxidea Americana or Labradorica) inhabits the northern parts of North America. See Teledu. 2. A brush made of badgers' hair, used by artists. Badger dog. (Zoöl.) See Dachshund.\n\n1. To tease or annoy, as a badger when baited; to worry or irritate persistently. 2. To beat down; to cheapen; to barter; to bargain.
badger game |The method of blackmailing by decoying a person into a compromising situation and extorting money by threats of exposure. [Cant]
badger state |Wisconsin; -- a nickname.
badger-legged |Having legs of unequal length, as the badger was thought to have. Shak.
badgerer |1. One who badgers. 2. A kind of dog used in badger baiting.
badgering |1. The act of one who badgers. 2. The practice of buying wheat and other kinds of food in one place and selling them in another for a profit. [Prov. Eng.]
badiaga |A fresh-water sponge (Spongilla), common in the north of Europe, the powder of which is used to take away the livid marks of bruises.
badian |An evergreen Chinese shrub of the Magnolia family (Illicium anisatum), and its aromatic seeds; Chinese anise; star anise.
badigeon |A cement or paste (as of plaster and freestone, or of sawdust and glue or lime) used by sculptors, builders, and workers in wood or stone, to fill holes, cover defects, or finish a surface.
badinage |Playful raillery; banter. \"He . . . indulged himself only in an elegant badinage.\" Warburton.
badly |In a bad manner; poorly; not well; unskillfully; imperfectly; unfortunately; grievously; so as to cause harm; disagreeably; seriously. Note: Badly is often used colloquially for very much or very greatly, with words signifying to want or need.
badminton |1. A game, similar to lawn tennis, played with shuttlecocks. 2. A preparation of claret, spiced and sweetened.
badness |The state of being bad.
baenomere |One of the somites (arthromeres) that make up the thorax of Arthropods. Packard.
baenopod |One of the thoracic legs of Arthropods.
baenosome |The thorax of Arthropods. Packard.
baetulus |A meteorite, or similar rude stone artificially shaped, held sacred or worshiped as of divine origin. All the evidence goes to prove that these menhirs are bætuli, i. e., traditional and elementary images of the deity. I. Gonino (Perrot & Chipiez).
baff |A blow; a stroke. [Scot.] H. Miller.
baffle |1. To cause to undergo a disgraceful punishment, as a recreant knight. [Obs.] He by the heels him hung upon a tree, And baffled so, that all which passed by The picture of his punishment might see. Spenser. 2. To check by shifts and turns; to elude; to foil. The art that baffles time's tyrannic claim. Cowper. 3. To check by perplexing; to disconcert, frustrate, or defeat; to thwart. \"A baffled purpose.\" De Quincey. A suitable scripture ready to repel and baffle them all. South. Calculations so difficult as to have baffled, until within a . . . recent period, the most enlightened nations. Prescott. The mere intricacy of a question should not baffle us. Locke. Baffling wind (Naut.), one that frequently shifts from one point to another. Syn. -- To balk; thwart; foil; frustrate; defeat.\n\n1. To practice deceit. [Obs.] Barrow. 2. To struggle against in vain; as, a ship baffles with the winds. [R.]\n\nA defeat by artifice, shifts, and turns; discomfiture. [R.] \"A baffle to philosophy.\" South.
bafflement |The process or act of baffling, or of being baffled; frustration; check.
baffler |One who, or that which, baffles.
baffling |Frustrating; discomfiting; disconcerting; as, baffling currents, winds, tasks. -- Bafflingly, adv. -- Bafflingness, n.
baffy |A short wooden club having a deeply concave face, seldom used.
baft |Same as Bafta.
bafta |A coarse stuff, usually of cotton, originally made in India. Also, an imitation of this fabric made for export.
bag |1. A sack or pouch, used for holding anything; as, a bag of meal or of money. 2. A sac, or dependent gland, in animal bodies, containing some fluid or other substance; as, the bag of poison in the mouth of some serpents; the bag of a cow. 3. A sort of silken purse formerly tied about men's hair behind, by way of ornament. [Obs.] 4. The quantity of game bagged. 5. (Com.)  A certain quantity of a commodity, such as it is customary to carry to market in a sack; as, a bag of pepper or hops; a bag of coffee. Bag and baggage, all that belongs to one. -- To give one the bag, to disappoint him. [Obs.] Bunyan.\n\n1. To put into a bag; as, to bag hops. 2. To seize, capture, or entrap; as, to bag an army; to bag game. 3. To furnish or load with a bag or with a well filled bag. A bee bagged with his honeyed venom. Dryden.\n\n1. To swell or hang down like a full bag; as, the skin bags from containing morbid matter. 2. To swell with arrogance. [Obs.] Chaucer. 3. To become pregnant. [Obs.] Warner. (Alb. Eng. ).
bag net |A bag-shaped net for catching fish.
bagasse |Sugar cane, as it
bagatelle |1. A trifle; a thing of no importance. Rich trifles, serious bagatelles. Prior. 2. A game played on an oblong board, having, at one end, cups or arches into or through which balls are to be driven by a rod held in the hand of the player.
baggage |1. The clothes, tents, utensils, and provisions of an army. Note: \"The term itself is made to apply chiefly to articles of clothing and to small personal effects.\" Farrow. 2. The trunks, valises, satchels, etc., which a traveler carries with him on a journey; luggage. The baronet's baggage on the roof of the coach. Thackeray. We saw our baggage following below. Johnson. Note: The English usually call this luggage. 3. Purulent matter. [Obs.] Barrough. 4. Trashy talk. [Obs.] Ascham. 5. A man of bad character. [Obs.] Holland. 6. A woman of loose morals; a prostitute. A disreputable, daring, laughing, painted French baggage. Thackeray. 7. A romping, saucy girl. [Playful] Goldsmith.
baggage master |One who has charge of the baggage at a railway station or upon a line of public travel. [U.S.]
baggager |One who takes care of baggage; a camp follower. [Obs.] Sir W. Raleigh.
baggala |A two-masted Arab or Indian trading vessel, used in Indian Ocean.
baggily |In a loose, baggy way.
bagging |1. Cloth or other material for bags. 2. The act of putting anything into, or as into, a bag. 3. The act of swelling; swelling.\n\nReaping peas, beans, wheat, etc., with a chopping stroke. [Eng.]
baggy |Resembling a bag; loose or puffed out, or pendent, like a bag; flabby; as, baggy trousers; baggy cheeks.
bagman |A commercial traveler; one employed to solicit orders for manufacturers and tradesmen. Thackeray.
bagnio |1. A house for bathing, sweating, etc.; -- also, in Turkey, a prison for slaves. [Obs.] 2. A brothel; a stew; a house of prostitution.
bagpipe |A musical wind instrument, now used chiefly in the Highlands of Scotland. Note: It consists of a leather bag, which receives the air by a tube that is stopped by a valve; and three sounding pipes, into which the air is pressed by the performer. Two of these pipes produce fixed tones, namely, the bass, or key tone, and its fifth, and form together what is called the drone; the third, or chanter, gives the melody.\n\nTo make to look like a bagpipe. To bagpipe the mizzen (Naut.), to lay it aback by bringing the sheet to the mizzen rigging. Totten.
bagpiper |One who plays on a bagpipe; a piper. Shak.
bagreef |The lower reef of fore and aft sails; also, the upper reef of topsails. Ham. Nav. Encyc.
bague |The annular molding or group of moldings dividing a long shaft or clustered column into two or more parts.
baguet |1. (Arch.)  A small molding, like the astragal, but smaller; a bead. 2. (Zoöl)  One of the minute bodies seen in the divided nucleoli of some Infusoria after conjugation.
baguette |1. (Arch.)  A small molding, like the astragal, but smaller; a bead. 2. (Zoöl)  One of the minute bodies seen in the divided nucleoli of some Infusoria after conjugation.
bagwig |A wig, in use in the 18th century, with the hair at the back of the head in a bag.
bagworm |One of several lepidopterous insects which construct, in the larval state, a baglike case which they carry about for protection. One species (Platoeceticus Gloveri) feeds on the orange tree. See Basket worm.
bah |An exclamation expressive of extreme contempt. Twenty-five years ago the vile ejaculation, Bah! was utterly unknown to the English public. De Quincey.
bahadur |A title of respect or honor given to European officers in East Indian state papers, and colloquially, and among the natives, to distinguished officials and other important personages.
bahai |A member of the sect of the Babis consisting of the adherents of Baha (Mirza Husain Ali, entitled \"Baha 'u 'llah,\" or, \"the Splendor of God\"), the elder half brother of Mirza Yahya of Nur, who succeeded the Bab as the head of the Babists. Baha in 1863 declared himself the supreme prophet of the sect, and became its recognized head. There are upwards of 20,000 Bahais in the United States.
bahaism |The religious tenets or practices of the Bahais.
bahar |A weight used in certain parts of the East Indies, varying considerably in different localities, the range being from 223 to 625 pounds.
bahaudur |A title of respect or honor given to European officers in East Indian state papers, and colloquially, and among the natives, to distinguished officials and other important personages.
baigne |To soak or drench. [Obs.]
baignoire |A box of the lowest tier in a theater.  Du Maurier.
bail |A bucket or scoop used in bailing water out of a boat. [Obs.] The bail of a canoe . . . made of a human skull. Capt. Cook.\n\n1. To lade; to dip and throw; -- usually with out; as, to bail water out of a boat. Buckets . . . to bail out the water. Capt. J. Smith. 2. To dip or lade water from; -- often with out to express completeness; as, to bail a boat. By the help of a small bucket and our hats we bailed her out. R. H. Dana, Jr.\n\n1. To deliver; to release. [Obs.] Ne none there was to rescue her, ne none to bail. Spenser. 2. (Law) (a) To set free, or deliver from arrest, or out of custody, on the undertaking of some other person or persons that he or they will be responsible for the appearance, at a certain day and place, of the person bailed. Note: The word is applied to the magistrate or the surety. The magistrate bails (but admits to bail is commoner) a man when he liberates him from arrest or imprisonment upon bond given with sureties. The surety bails a person when he procures his release from arrest by giving bond for his appearance. Blackstone. (b) To deliver, as goods in trust, for some special object or purpose, upon a contract, expressed or implied, that the trust shall be faithfully executed on the part of the bailee, or person intrusted; as, to bail cloth to a tailor to be made into a garment; to bail goods to a carrier. Blackstone. Kent.\n\n1. Custody; keeping. [Obs.] Silly Faunus now within their bail. Spenser. 2. (Law) (a) The person or persons who procure the release of a prisoner from the custody of the officer, or from imprisonment, by becoming surely for his appearance in court. The bail must be real, substantial bondsmen. Blackstone. A. and B. were bail to the arrest in a suit at law. Kent. (b) The security given for the appearance of a prisoner in order to obtain his release from custody of the officer; as, the man is out on bail; to go bail for any one. Excessive bail ought not to be required. Blackstone.\n\n1. The arched handle of a kettle, pail, or similar vessel, usually movable. Forby. 2. A half hoop for supporting the cover of a carrier's wagon, awning of a boat, etc.\n\n1. (Usually pl.)  A line of palisades serving as an exterior defense. [Written also bayle.] [Obs.] 2. The outer wall of a feudal castle. Hence: The space inclosed by it; the outer court. Holinshed. 3. A certain limit within a forest. [Eng.] 4. A division for the stalls of an open stable. 5. (Cricket)  The top or cross piece ( or either of the two cross pieces) of the wicket.
bail bond |(a) A bond or obligation given by a prisoner and his surety, to insure the prisoner's appearance in court, at the return of the writ. (b) Special bail in court to abide the judgment. Bouvier.
bailable |1. Having the right or privilege of being admitted to bail, upon bond with sureties; -- used of persons. \"He's bailable, I'm sure.\" Ford. 2. Admitting of bail; as, a bailable offense. 3. That can be delivered in trust; as, bailable goods.
bailee |The person to whom goods are committed in trust, and who has a temporary possession and a qualified property in them, for the purposes of the trust. Blackstone. Note: In penal statutes the word includes those who receive goods for another in good faith. Wharton.
bailer |See Bailor.\n\n1. One who bails or lades. 2. A utensil, as a bucket or cup, used in bailing; a machine for bailing water out of a pit.
bailey |1. The outer wall of a feudal castle. [Obs.] 2. The space immediately within the outer wall of a castle or fortress. [Obs.] 3. A prison or court of justice; -- used in certain proper names; as, the Old Bailey in London; the New Bailey in Manchester. [Eng.] Oxf. Gloss.
bailie |An officer in Scotland, whose office formerly corresponded to that of sheriff, but now corresponds to that of an English alderman.
bailiff |1. Originally, a person put in charge of something especially, a chief officer, magistrate, or keeper, as of a county, town, hundred, or castle; one to whom power Abbott. Lausanne is under the canton of Berne, governed by a bailiff sent every three years from the senate. Addison. 2. (Eng. Law)  A sheriff's deputy, appointed to make arrests, collect fines, summon juries, etc. Note: In American law the term bailiff is seldom used except sometimes to signify a sheriff's officer or constable, or a party liable to account to another for the rent and profits of real estate. Burrill. 3. An overseer or under steward of an estate, who directs husbandry operations, collects rents, etc. [Eng.]
bailiffwick |See Bailiwick. [Obs.]
bailiwick |The precincts within which a bailiff has jurisdiction; the limits of a bailiff's authority.
baillie |1. Bailiff. [Obs.] 2. Same as Bailie. [Scot.]
bailment |1. (Law)  The action of bailing a person accused. Bailment . . . is the saving or delivery of a man out of prison before he hath satisfied the law. Dalton. 2. (Law)  A delivery of goods or money by one person to another in trust, for some special purpose, upon a contract, expressed or implied, that the trust shall be faithfully executed. Blackstone. Note: In a general sense it is sometimes used as comprehending all duties in respect to property. Story.
bailor |One who delivers goods or money to another in trust.
bailpiece |A piece of parchment, or paper, containing a recognizance or bail bond. BAILY'S BEADS Bai\"ly's beads. (Astron.)  A row of bright spots observed in connection with total eclipses of the sun. Just before and after a total eclipse, the slender, unobscured crescent of the sun's disk appears momentarily like a row of bright spots resembling a string of beads. The phenomenon (first fully described by Francis Baily, 1774 -- 1844) is thought to be an effect of irradiation, and of inequalities of the moon's edge.
bain |A bath; a bagnio. [Obs.] Holland.
bain-marie |A vessel for holding hot water in which another vessel may be heated without scorching its contents; -- used for warming or preparing food or pharmaceutical preparations.
bairam |The name of two Mohammedan festivals, of which one is held at the close of the fast called Ramadan, and the other seventy days after the fast.
bairn |A child. [Scot. & Prov. Eng.] Has he not well provided for the bairn ! Beau. & Fl.
baisemains |Respects; compliments. [Obs.]
bait |1. Any substance, esp. food, used in catching fish, or other animals, by alluring them to a hook, snare, inclosure, or net. 2. Anything which allures; a lure; enticement; temptation. Fairfax. 3. A portion of food or drink, as a refreshment taken on a journey; also, a stop for rest and refreshment. 4. A light or hasty luncheon. Bait bug (Zoöl), a crustacean of the genus Hippa found burrowing in sandy beaches. See Anomura.\n\n1. To provoke and harass; esp., to harass or torment for sport; as, to bait a bear with dogs; to bait a bull. 2. To give a portion of food and drink to, upon the road; as, to bait horses. Holland. 3. To furnish or cover with bait, as a trap or hook. A crooked pin . . . bailed with a vile earthworm. W. Irving.\n\nTo stop to take a portion of food and drink for refreshment of one's self or one's beasts, on a journey. Evil news rides post, while good news baits. Milton. My lord's coach conveyed me to Bury, and thence baiting aEvelyn.\n\nTo flap the wings; to flutter as if to fly; or to hover, as a hawk when she stoops to her prey. \"Kites that bait and beat.\" Shak.
baiter |One who baits; a tormentor.
baize |A coarse woolen stuff with a long nap; -- usually dyed in plain colors. A new black baize waistcoat lined with silk. Pepys.
bajocco |A small cooper coin formerly current in the Roman States, worth about a cent and a half.
bake |1. To prepare, as food, by cooking in a dry heat, either in an oven or under coals, or on heated stone or metal; as, to bake bread, meat, apples. Note: Baking is the term usually applied to that method of cooking which exhausts the moisture in food more than roasting or broiling; but the distinction of meaning between roasting and baking is not always observed. 2. To dry or harden (anything) by subjecting to heat, as, to bake bricks; the sun bakes the ground. 3. To harden by cold. The earth . . . is baked with frost. Shak. They bake their sides upon the cold, hard stone. Spenser.\n\n1. To do the work of baking something; as, she brews, washes, and bakes. Shak. 2. To be baked; to become dry and hard in heat; as, the bread bakes; the ground bakes in the hot sun.\n\nThe process, or result, of baking.
baked-meat |A pie; baked food. [Obs.] Gen. xl. 17. Shak.
bakehouse |A house for baking; a bakery.
bakemeat |A pie; baked food. [Obs.] Gen. xl. 17. Shak.
baken |p. p. of Bake. [Obs. or. Archaic]
baker |1. One whose business it is to bake bread, biscuit, etc. 2. A portable oven in which baking is done. [U.S.] A baker's dozen, thirteen. -- Baker foot, a distorted foot. [Obs.] Jer. Taylor. -- Baker's itch, a rash on the back of the hand, caused by the irritating properties of yeast. -- Baker's salt, the subcarbonate of ammonia, sometimes used instead of soda, in making bread.
baker-legged |Having legs that bend inward at the knees.
bakery |1. The trade of a baker. [R.] 2. The place for baking bread; a bakehouse.
baking |1. The act or process of cooking in an oven, or of drying and hardening by heat or cold. 2. The quantity baked at once; a batch; as, a baking of bread. Baking powder, a substitute for yeast, usually consisting of an acid, a carbonate, and a little farinaceous matter.
bakingly |In a hot or baking manner.
bakistre |A baker. [Obs.] Chaucer.
baksheesh |Same as Backsheesh.
bakshish |Same as Backsheesh.
balaam |A paragraph describing something wonderful, used to fill out a newspaper column; -- an allusion to the miracle of Balaam's ass speaking. Numb. xxii. 30. [Cant] Balaam basket or box (Print.), the receptacle for rejected articles. Blackw. Mag.
balachong |A condiment formed of small fishes or shrimps, pounded up with salt and spices, and then dried. It is much esteemed in China.
balaenoidea |A division of the Cetacea, including the right whale and all other whales having the mouth fringed with baleen. See Baleen.
balance |1. An apparatus for weighing. Note: In its simplest form, a balance consists of a beam or lever supported exactly in the middle, having two scales or basins of equal weight suspended from its extremities. Another form is that of the Roman balance, our steelyard, consisting of a lever or beam, suspended near one of its extremities, on the longer arm of which a counterpoise slides. The name is also given to other forms of apparatus for weighing bodies, as to the combinations of levers making up platform scales; and even to devices for weighing by the elasticity of a spring. 2. Act of weighing mentally; comparison; estimate. A fair balance of the advantages on either side. Atterbury. 3. Equipoise between the weights in opposite scales. 4. The state of being in equipoise; equilibrium; even adjustment; steadiness. And hung a bottle on each side To make his balance true. Cowper. The order and balance of the country were destroyed. Buckle. English workmen completely lose their balance. J. S. Mill. 5. An equality between the sums total of the two sides of an account; as, to bring one's accounts to a balance; -- also, the excess on either side; as, the balance of an account. \" A balance at the banker's. \" Thackeray. I still think the balance of probabilities leans towards the account given in the text. J. Peile. 6. (Horol.)  A balance wheel, as of a watch, or clock. See Balance wheel (in the Vocabulary). 7. (Astron.) (a) The constellation Libra. (b) The seventh sign in the Zodiac, called Libra, which the sun enters at the equinox in September. 8. A movement in dancing. See Balance, v. i., S. Balance electrometer, a kind of balance, with a poised beam, which indicates, by weights suspended from one arm, the mutual attraction of oppositely electrified surfaces. Knight. -- Balance fish. (Zoöl) See Hammerhead. -- Balance knife, a carving or table knife the handle of which overbalances the blade, and so keeps it from contact with the table. -- Balance of power. (Politics), such an adjustment of power among sovereign states that no one state is in a position to interfere with the independence of the others; international equilibrium; also, the ability ( of a state or a third party within a state) to control the relations between sovereign states or between dominant parties in a state. -- Balance sheet (Bookkeeping), a paper showing the balances of the open accounts of a business, the debit and credit balances footing up equally, if the system of accounts be complete and the balances correctly taken. -- Balance thermometer, a thermometer mounted as a balance so that the movement of the mercurial column changes the indication of the tube. With the aid of electrical or mechanical devices adapted to it, it is used for the automatic regulation of the temperature of rooms warmed artificially, and as a fire alarm. -- Balance of torsion. See Torsion Balance. -- Balance of trade (Pol. Econ.), an equilibrium between the money values of the exports and imports of a country; or more commonly, the amount required on one side or the other to make such an equilibrium. -- Balance valve, a valve whose surfaces are so arranged that the fluid pressure tending to seat, and that tending to unseat the valve, are nearly in equilibrium; esp., a puppet valve which is made to operate easily by the admission of steam to both sides. See Puppet valve. -- Hydrostatic balance. See under Hydrostatic. -- To lay in balance, to put up as a pledge or security. [Obs.] Chaucer. -- To strike a balance, to find out the difference between the debit and credit sides of an account.\n\n1. To bring to an equipoise, as the scales of a balance by adjusting the weights; to weigh in a balance. 2. To support on a narrow base, so as to keep from falling; as, to balance a plate on the end of a cane; to balance one's self on a tight rope. 3. To equal in number, weight, force, or proportion; to counterpoise, counterbalance, counteract, or neutralize. One expression . . . must check and balance another. Kent. 4. To compare in relative force, importance, value, etc.; to estimate. Balance the good and evil of things. L'Estrange. 5. To settle and adjust, as an account; to make two accounts equal by paying the difference between them. I am very well satisfied that it is not in my power to balance accounts with my Maker. Addison. 6. To make the sums of the debits and credits of an account equal; -- said of an item; as, this payment, or credit, balances the account. 7. To arrange accounts in such a way that the sum total of the debits is equal to the sum total of the credits; as, to balance a set of books. 8. (Dancing)  To move toward, and then back from, reciprocally; as, to balance partners. 9. (Naut.)  To contract, as a sail, into a narrower compass; as, to balance the boom mainsail. Balanced valve. See Balance valve, under Balance, n. Syn. -- To poise; weigh; adjust; counteract; neutralize; equalize.\n\n1. To have equal weight on each side; to be in equipoise; as, the scales balance. 2. To fluctuate between motives which appear of equal force; to waver; to hesitate. He would not balance or err in the determination of his choice. Locke. 3. (Dancing)  To move toward a person or couple, and then back.
balance wheel |1. (Horology) (a) A wheel which regulates the beats or pulses of a watch or chronometer, answering to the pendulum of a clock; -- often called simply a balance. (b) A ratchet-shaped scape wheel, which in some watches is acted upon by the axis of the balance wheel proper (in those watches called a balance). 2. (Mach.)  A wheel which imparts regularity to the movements of any engine or machine; a fly wheel.
balanceable |Such as can be balanced.
balancement |The act or result of balancing or adjusting; equipoise; even adjustment of forces. [R.] Darwin.
balancer |1. One who balances, or uses a balance. 2. (Zoöl.)  In Diptera, the rudimentary posterior wing.
balancereef |The last reef in a fore-and-aft sail, taken to steady the ship.
balaniferous |Bearing or producing acorns.
balanite |A fossil balanoid shell.
balanoglossus |A peculiar marine worm. See Enteropneusta, and Tornaria.
balanoid |Resembling an acorn; -- applied to a group of barnacles having shells shaped like acorns. See Acornshell, and Barnacle.
balas ruby |A variety of spinel ruby, of a pale rose red, or inclining to orange. See Spinel.
balata |1.  A West Indian sapotaceous tree (Bumelia retusa). 2.  The bully tree (Minusops globosa); also, its milky juice (balata gum), which when dried constitutes an elastic gum called chicle, or chicle gum.
balaustine |The pomegranate tree (Punica granatum). The bark of the root, the rind of the fruit, and the flowers are used medicinally.
balayeuse |A protecting ruffle or frill, as of silk or lace, sewed close to the lower edge of a skirt on the inside.
balbucinate |To stammer. [Obs.]
balbutiate |To stammer. [Obs.]
balbuties |The defect of stammering; also, a kind of incomplete pronunciation.
balcon |A balcony. [Obs.] Pepys.
balconied |Having balconies.
balcony |1. (Arch.)  A platform projecting from the wall of a building, usually resting on brackets or consoles, and inclosed by a parapet; as, a balcony in front of a window. Also, a projecting gallery in places of amusement; as, the balcony in a theater. 2. A projecting gallery once common at the stern of large ships. Note: \"The accent has shifted from the second to the first syllable within these twenty years.\" Smart (1836).
bald |1. Destitute of the natural or common covering on the head or top, as of hair, feathers, foliage, trees, etc.; as, a bald head; a bald oak. On the bald top of an eminence. Wordsworth. 2. Destitute of ornament; unadorned; bare; literal. In the preface to his own bald translation. Dryden. 3. Undisguised. \" Bald egotism.\" Lowell. 4. Destitute of dignity or value; paltry; mean. [Obs.] 5. (Bot.)  Destitute of a beard or awn; as, bald wheat. 6. (Zoöl.) (a) Destitute of the natural covering. (b) Marked with a white spot on the head; bald-faced. Bald buzzard (Zoöl.), the fishhawk or osprey. -- Bald coot (Zoöl.), a name of the European coot (Fulica atra), alluding to the bare patch on the front of the head.
bald eagle |The white-headed eagle (Haliæetus leucocephalus) of America. The young, until several years old, lack the white feathers on the head. Note: The bald eagle is represented in the coat of arms, and on the coins, of the United States.
bald-faced |Having a white face or a white mark on the face, as a stag.
baldachin |1. A rich brocade; baudekin. [Obs.] 2. (Arch.)  A structure in form of a canopy, sometimes supported by columns, and sometimes suspended from the roof or projecting from the wall; generally placed over an altar; as, the baldachin in St. Peter's. 3. A portable canopy borne over shrines, etc., in procession. [Written also baldachino, baldaquin, etc.]
balder |The most beautiful and beloved of the gods; the god of peace; the son of Odin and Freya. [Written also Baldur.]
balderdash |1. A worthless mixture, especially of liquors. Indeed beer, by a mixture of wine, hath lost both name and nature, and is called balderdash. Taylor (Drink and Welcome). 2. Senseless jargon; ribaldry; nonsense; trash.\n\nTo mix or adulterate, as liquors. The wine merchants of Nice brew and balderdash, and even mix it with pigeon's dung and quicklime. Smollett.
baldhead |1. A person whose head is bald. 2 Kings ii. 23. 2. (Zoöl.)  A white-headed variety of pigeon.
baldheaded |Having a bald head.
baldly |Nakedly; without reserve; inelegantly.
baldness |The state or condition of being bald; as, baldness of the head; baldness of style. This gives to their syntax a peculiar character of simplicity and baldness. W. D. Whitney.
baldpate |1. A baldheaded person. Shak. 2. (Zoöl.)  The American widgeon (Anas Americana).\n\nDestitute of hair on the head; baldheaded. Shak.
baldpated |Destitute of hair on the head; baldheaded. Shak.
baldrib |A piece of pork cut lower down than the sparerib, and destitute of fat. [Eng.] Southey.
baldric |A broad belt, sometimes richly ornamented, worn over one shoulder, across the breast, and under the opposite arm; less properly, any belt. [Also spelt bawdrick.] A radiant baldric o'er his shoulder tied Sustained the sword that glittered at his side. Pope.
baldwin |A kind of reddish, moderately acid, winter apple. [U.S.]
bale |A bundle or package of goods in a cloth cover, and corded for storage or transportation; also, a bundle of straw Bale of dice, a pair of dice. [Obs.] B. Jonson.\n\nTo make up in a bale. Goldsmith.\n\nSee Bail, v. t., to lade.\n\n1. Misery; Let now your bliss be turned into bale. Spenser. 2. Evil; an evil, pernicious influence; something causing great injury. [Now chiefly poetic]
balearic |Of or pertaining to the isles of Majorca, Minorca, Ivica, etc., in the Mediterranean Sea, off the coast of Valencia. Balearic crane. (Zoöl.) See Crane.
baleen |Plates or blades of \"whalebone,\" from two to twelve feet long, and sometimes a foot wide, which in certain whales (Balænoidea) are attached side by side along the upper jaw, and form a fringelike sieve by which the food is retained in the mouth.
balefire |A signal fire; an alarm fire. Sweet Teviot! on thy silver tide The glaring balefires blaze no more. Sir W. Scott.
baleful |1. Full of deadly or pernicious influence; destructive. \"Baleful enemies.\" Shak. Four infernal rivers that disgorge Into the burning lake their baleful streams. Milton. 2. Full of grief or sorrow; woeful; sad. [Archaic]
balefully |In a baleful manner; perniciously.
balefulness |The quality or state of being baleful.
balisaur |A badgerlike animal of India (Arcionyx collaris).
balister |A crossbow. [Obs.] Blount.
balistoid |Like a fish of the genus Balistes; of the family Balistidæ. See Filefish.
balistraria |A narrow opening, often cruciform, through which arrows might be discharged.
balize |A pole or a frame raised as a sea beacon or a landmark.
balk |1. A ridge of land left unplowed between furrows, or at the end of a field; a piece missed by the plow slipping aside. Bad plowmen made balks of such ground. Fuller. 2. A great beam, rafter, or timber; esp., the tie-beam of a house. The loft above was called \"the balks.\" Tubs hanging in the balks. Chaucer. 3. (Mil.)  One of the beams connecting the successive supports of a trestle bridge or bateau bridge. 4. A hindrance or disappointment; a check. A balk to the confidence of the bold undertaker. South. 5. A sudden and obstinate stop; a failure. 6. (Baseball)  A deceptive gesture of the pitcher, as if to deliver the ball. Balk line (Billiards), a line across a billiard table near one end, marking a limit within which the cue balls are placed in beginning a game; also, a line around the table, parallel to the sides, used in playing a particular game, called the balk line game.\n\n1. To leave or make balks in. [Obs.] Gower. 2. To leave heaped up; to heap up in piles. [Obs.] Ten thousand bold Scots, two and twenty knights, Balk'd in their own blood did Sir Walter see. Shak. 3. To omit, miss, or overlook by chance. [Obs.] 4. To miss intentionally; to avoid; to shun; to refuse; to let go by; to shirk. [Obs. or Obsolescent] By reason of the contagion then in London, we balked the Evelyn. Sick he is, and keeps his bed, and balks his meat. Bp. Hall. Nor doth he any creature balk, But lays on all he meeteth. Drayton. 5. To disappoint; to frustrate; to foil; to baffle; to as, to balk expectation. They shall not balk my entrance. Byron.\n\n1. To engage in contradiction; to be in opposition. [Obs.] In strifeful terms with him to balk. Spenser. 2. To stop abruptly and stand still obstinately; to jib; to stop short; to swerve; as, the horse balks. Note: This has been regarded as an Americanism, but it occurs in Spenser's \"Faërie Queene,\" Book IV., 10, xxv. Ne ever ought but of their true loves talkt, Ne ever for rebuke or blame of any balkt.\n\nTo indicate to fishermen, by shouts or signals from shore, the direction taken by the shoals of herring.
balker |One who, or that which balks.\n\nA person who stands on a rock or eminence to espy the shoals of herring, etc., and to give notice to the men in boats which way they pass; a conder; a huer.
balkingly |In manner to balk or frustrate.
balkish |Uneven; ridgy. [R.] Holinshed.
balky |Apt to balk; as, a balky horse.
ball |1. Any round or roundish body or mass; a sphere or globe; as, a ball of twine; a ball of snow. 2. A spherical body of any substance or size used to play with, as by throwing, knocking, kicking, etc. 3. A general name for games in which a ball is thrown, kicked, or knocked. See Baseball, and Football. 4. Any solid spherical, cylindrical, or conical projectile of lead or iron, to be discharged from a firearm; as, a cannon ball; a rifball; -- often used collectively; as, powder and ball. Spherical balls for the smaller firearms are commonly called bullets. 5. (Pirotechnics & Mil.)  A flaming, roundish body shot into the air; a case filled with combustibles intended to burst and give light or set fire, or to produce smoke or stench; as, a fire ball; a stink ball. 6. (Print.)  A leather-covered cushion, fastened to a handle called a ballstock; -- formerly used by printers for inking the form, but now superseded by the roller. 7. A roundish protuberant portion of some part of the body; as, the ball of the thumb; the ball of the foot. 8. (Far.)  A large pill, a form in which medicine is commonly given to horses; a bolus. White. 9. The globe or earth. Pope. Move round the dark terrestrial ball. Addison. Ball and socket joint, a joint in which a ball moves within a socket, so as to admit of motion in every direction within certain limits. -- Ball bearings, a mechanical device for lessening the friction of axle bearings by means of small loose metal balls. -- Ball cartridge, a cartridge containing a ball, as distinguished from a blank cartridge, containing only powder. -- Ball cock, a faucet or valve which is opened or closed by the fall or rise of a ball floating in water at the end of a lever. -- Ball gudgeon, a pivot of a spherical form, which permits lateral deflection of the arbor or shaft, while retaining the pivot in its socket. Knight. -- Ball lever, the lever used in a ball cock. -- Ball of the eye, the eye itself, as distinguished from its lids and socket; -- formerly, the pupil of the eye. -- Ball valve (Mach.), a contrivance by which a ball, placed in a circular cup with a hole in its bottom, operates as a valve. -- Ball vein (Mining), a sort of iron ore, found in loose masses of a globular form, containing sparkling particles. -- Three balls, or Three golden balls, a pawnbroker's sign or shop. Syn. -- See Globe.\n\nTo gather balls which cling to the feet, as of damp snow or clay; to gather into balls; as, the horse balls; the snow balls.\n\n1. (Metal.)  To heat in a furnace and form into balls for rolling. 2. To form or wind into a ball; as, to ball cotton.\n\nA social assembly for the purpose of dancing.
ball-flower |An ornament resembling a ball placed in a circular flower, the petals of which form a cup round it, -- usually inserted in a hollow molding.
ballad |A popular kind of narrative poem, adapted for recitation or singing; as, the ballad of Chevy Chase; esp., a sentimental or romantic poem in short stanzas.\n\nTo make or sing ballads. [Obs.]\n\nTo make mention of in ballads. [Obs.]
ballad monger |A seller or maker of ballads; a poetaster. Shak.
ballade |A form of French versification, sometimes imitated in English, in which three or four rhymes recur through three stanzas of eight or ten lines each, the stanzas concluding with a refrain, and the whole poem with an envoy.
ballader |A writer of ballads.
balladry |Ballad poems; the subject or style of ballads. \"Base balladry is so beloved.\" Drayton.
ballahoo |A fast-sailing schooner, used in the Bermudas and West Indies.
ballahou |A fast-sailing schooner, used in the Bermudas and West Indies.
ballarag |To bully; to threaten. [Low] T. Warton.
ballast |1. (Naut.)  Any heavy substance, as stone, iron, etc., put into the hold to sink a vessel in the water to such a depth as to prevent capsizing. 2. Any heavy matter put into the car of a balloon to give it steadiness. 3. Gravel, broken stone, etc., laid in the bed of a railroad to make it firm and solid. 4. The larger solids, as broken stone or gravel, used in making concrete. 5. Fig.: That which gives, or helps to maintain, uprightness, steadiness, and security. It [piety] is the right ballast of prosperity. Barrow. Ballast engine, a steam engine used in excavating and for digging and raising stones and gravel for ballast. -- Ship in ballast, a ship carring only ballast.\n\n1. To steady, as a vessel, by putting heavy substances in the hold. 2. To fill in, as the bed of a railroad, with gravel, stone, etc., in order to make it firm and solid. 3. To keep steady; to steady, morally. 'T is charity must ballast the heart. Hammond.
ballastage |A toll paid for the privilege of taking up ballast in a port or harbor.
ballasting |That which is used for steadying anything; ballast.
ballatry |See Balladry. [Obs.] Milton.
ballet |1. An artistic dance performed as a theatrical entertainment, or an interlude, by a number of persons, usually women. Sometimes, a scene accompanied by pantomime and dancing. 2. The company of persons who perform the ballet. 3. (Mus.)  A light part song, or madrigal, with a fa la burden or chorus, -- most common with the Elizabethan madrigal composers. 4. (Her.)  A bearing in coats of arms, representing one or more balls, which are denominated bezants, plates, etc., according to color.
ballista |An ancient military engine, in the form of a crossbow, used for hurling large missiles.
ballister |A crossbow. [Obs.]
ballistic |1. Of or pertaining to the ballista, or to the art of hurling stones or missile weapons by means of an engine. 2. Pertaining to projection, or to a projectile. Ballistic pendulum, an instrument consisting of a mass of wood or other material suspended as a pendulum, for measuring the force and velocity of projectiles by means of the arc through which their impact impels it.
ballistics |The science or art of hurling missile weapons by the use of an engine. Whewell.
ballistite |A smokeless powder containing equal parts of soluble nitrocellulose and nitroglycerin.
ballium |See Bailey.
balloon |1. A bag made of silk or other light material, and filled with hydrogen gas or heated air, so as to rise and float in the atmosphere; especially, one with a car attached for aërial navigation. 2. (Arch.)  A ball or globe on the top of a pillar, church, etc., as at St. Paul's, in London. [R.] 3. (Chem.)  A round vessel, usually with a short neck, to hold or receive whatever is distilled; a glass vessel of a spherical form. 4. (Pyrotechnics)  A bomb or shell. [Obs.] 5. A game played with a large inf [Obs.] 6. (Engraving)  The outline inclosing words represented as coming from the mouth of a pictured figure. Air balloon, a balloon for aërial navigation. -- Balloon frame (Carp.), a house frame constructed altogether of small timber. -- Balloon net, a variety of woven lace in which the weft threads are twisted in a peculiar manner around the warp.\n\nTo take up in, or as if in, a balloon.\n\n1. To go up or voyage in a balloon. 2. To expand, or puff out, like a balloon.
balloon fish |A fish of the genus Diodon or the genus Tetraodon, having the power of distending its body by taking air or water into its dilatable esophagus. See Globefish, and Bur fish.
ballooned |Swelled out like a balloon.
ballooner |One who goes up in a balloon; an aëronaut.
ballooning |1. The art or practice of managing balloons or voyaging in them. 2. (Stock Exchange)  The process of temporarily raising the value of a stock, as by fictitious sales. [U.S.]
ballooning spider |A spider which has the habit of rising into the air. Many kinds ( esp. species of Lycosa) do this while young by ejecting threads of silk until the force of the wind upon them carries the spider aloft.
balloonist |An aëronaut.
balloonry |The art or practice of ascending in a balloon; aëronautics.
ballot |1. Originally, a ball used for secret voting. Hence: Any printed or written ticket used in voting. 2. The act of voting by balls or written or printed ballots or tickets; the system of voting secretly by balls or by tickets. The insufficiency of the ballot. Dickens. 3. The whole number of votes cast at an election, or in a given territory or electoral district. Ballot box, a box for receiving ballots.\n\nTo vote or decide by ballot; as, to ballot for a candidate.\n\nTo vote for or in opposition to. None of the competitors arriving to a sufficient number of balls, they fell to ballot some others. Sir H. Wotton.
ballotade |A leap of a horse, as between two pillars, or upon a straight line, so that when his four feet are in the air, he shows only the shoes of his hind feet, without jerking out.
ballotage |In France, a second ballot taken after an indecisive first ballot to decide between two or several candidates.
ballotation |Voting by ballot. [Obs.] Sir H. Wotton.
balloter |One who votes by ballot.
ballotin |An officer who has charge of a ballot box. [Obs.] Harrington.
ballow |A cudgel. [Obs.] Shak.
ballproof |Incapable of being penetrated by balls from firearms.
ballroom |A room for balls or dancing.
balm |1. (Bot.)  An aromatic plant of the genus Melissa. 2. The resinous and aromatic exudation of certain trees or shrubs. Dryden. 3. Any fragrant ointment. Shak. 4. Anything that heals or that mitigates pain. \"Balm for each ill.\" Mrs. Hemans. Balm cricket (Zoöl.), the European cicada. Tennyson. -- Balm of Gilead (Bot.), a small evergreen African and Asiatic tree of the terebinthine family (Balsamodendron Gileadense). Its leaves yield, when bruised, a strong aromatic scent; and from this tree is obtained the balm of Gilead of the shops, or balsam of Mecca. This has a yellowish or greenish color, a warm, bitterish, aromatic taste, and a fragrant smell. It is valued as an unguent and cosmetic by the Turks. The fragrant herb Dracocephalum Canariense is familiarly called balm of Gilead, and so are the American trees, Populus balsamifera, variety candicans (balsam poplar), and Abies balsamea (balsam fir).\n\nTo anoint with balm, or with anything medicinal. Hence: To soothe; to mitigate. [Archaic] Shak.
balmify |To render balmy. [Obs.] Cheyne.
balmily |In a balmy manner. Coleridge.
balmoral |1. A long woolen petticoat, worn immediately under the dress. 2. A kind of stout walking shoe, laced in front. A man who uses his balmorals to tread on your toes. George Eliot.
balmy |1. Having the qualities of balm; odoriferous; aromatic; assuaging; soothing; refreshing; mild. \"The balmy breeze.\" Tickell. Tired nature's sweet restorer, balmy sleep ! Young. 2. Producing balm. \"The balmy tree.\" Pope. Syn. -- Fragrant; sweet-scented; odorous; spicy.
balneal |Of or pertaining to a bath. Howell.
balneary |A bathing room. Sir T. Browne.
balneation |The act of bathing. [R.]
balneatory |Belonging to a bath. [Obs.]
balneography |A description of baths.
balneology |A treatise on baths; the science of bathing.
balneotherapy |The treatment of disease by baths.
balopticon |See Projector, below.
balotade |See Ballotade.
balsa |A raft or float, used principally on the Pacific coast of South America.
balsam |1. A resin containing more or less of an essential or volatile oil. Note: The balsams are aromatic resinous substances, flowing spontaneously or by incision from certain plants. A great variety of substances pass under this name, but the term is now usually restricted to resins which, in addition to a volatile oil, contain benzoic and cinnamic acid. Among the true balsams are the balm of Gilead, and the balsams of copaiba, Peru, and Tolu. There are also many pharmaceutical preparations and resinous substances, possessed of a balsamic smell, to which the name balsam has been given. 2. (Bot.) (a) A species of tree (Abies balsamea). (b) An annual garden plant (Impatiens balsamina) with beautiful flowers; balsamine. 3. Anything that heals, soothes, or restores. Was not the people's blessing a balsam to thy blood Tennyson. Balsam apple (Bot.), an East Indian plant ( Momordica balsamina), of the gourd family, with red or orange-yellow cucumber-shaped fruit of the size of a walnut, used as a vulnerary, and in liniments and poultices. -- Balsam fir (Bot.), the American coniferous tree, Abies balsamea, from which the useful Canada balsam is derived. -- Balsam of copaiba. See Copaiba. -- Balsam of Mecca, balm of Gilead. -- Balsam of Peru, a reddish brown, syrupy balsam, obtained from a Central American tree ( Myroxylon Pereiræ and used as a stomachic and expectorant, and in the treatment of ulcers, etc. It was long supposed to be a product of Peru. -- Balsam of Tolu, a reddish or yellowish brown semisolid or solid balsam, obtained from a South American tree ( Myxoxylon toluiferum.). It is highly fragrant, and is used as a stomachic and expectorant. -- Balsam tree, any tree from which balsam is obtained, esp. the Abies balsamea. -- Canada balsam, Balsam of fir, Canada turpentine, a yellowish, viscid liquid, which, by time and exposure, becomes a transparent solid mass. It is obtained from the balm of Gilead (or balsam) fir (Abies balsamea) by breaking the vesicles upon the trunk and branches. See Balm.\n\nTo treat or anoint with balsam; to relieve, as with balsam; to render balsamic.
balsamation |1. The act of imparting balsamic properties. 2. The art or process of embalming.
balsamic |Having the qualities of balsam; containing, or resembling, balsam; soft; mitigative; soothing; restorative.
balsamical |Having the qualities of balsam; containing, or resembling, balsam; soft; mitigative; soothing; restorative.
balsamiferous |Producing balsam.
balsamine |The Impatiens balsamina, or garden balsam.
balsamous |Having the quality of balsam; containing balsam. \"A balsamous substance.\" Sterne.
balter |To stick together.[Obs.] Holland.
baltic |Of or pertaining to the sea which separates Norway and Sweden from Jutland, Denmark, and Germany; situated on the Baltic Sea.
baltimore bird |A common American bird (Icterus galbula), named after Lord Baltimore, because its colors (black and orange red) are like those of his coat of arms; -- called also golden robin.
baltimore oriole |A common American bird (Icterus galbula), named after Lord Baltimore, because its colors (black and orange red) are like those of his coat of arms; -- called also golden robin.
baluster |A row of balusters topped by a rail, serving as an open parapet, as along the edge of a balcony, terrace, bridge, staircase, or the eaves of a building.
balustered |Having balusters.  Dryden.
balustrade |A row of balusters topped by a rail, serving as an open parapet, as along the edge of a balcony, terrace, bridge, staircase, or the eaves of a building.
bam |An imposition; a cheat; a hoax. Garrick. To relieve the tediumbams. Prof. Wilson.\n\nTo cheat; to wheedle. [Slang] Foote.
bambino |A child or baby; esp., a representation in art of the infant Christ wrapped in swaddling clothes.
bambocciade |A representation of a grotesque scene from common or rustic life.
bamboo |A plant of the family of grasses, and genus Bambusa, growing in tropical countries. Note: The most useful species is Bambusa arundinacea, which has a woody, hollow, round, straight, jointed stem, and grows to the height of forty feet and upward. The flowers grow in large panicles, from the joints of the stalk, placed three in a parcel, close to their receptacles. Old stalks grow to five or six inches in diameter, and are so hard and durable as to be used for building, and for all sorts of furniture, for water pipes, and for poles to support palanquins. The smaller stalks are used for walking sticks, flutes, etc.\n\nTo flog with the bamboo.
bamboozle |To deceive by trickery; to cajole by confusing the senses; to hoax; to mystify; to humbug. [Colloq.] Addison. What oriental tomfoolery is bamboozling you J. H. Newman.
bamboozler |A swindler; one who deceives by trickery. [Colloq.] Arbuthnot.
ban |1. A public proclamation or edict; a public order or notice, mandatory or prohibitory; a summons by public proclamation. 2. (Feudal & Mil.)  A calling together of the king's (esp. the French king's) vassals for military service; also, the body of vassals thus assembled or summoned. In present usage, in France and Prussia, the most effective part of the population liable to military duty and not in the standing army. 3. pl.  Notice of a proposed marriage, proclaimed in church. See Banns (the common spelling in this sense). 4. An interdiction, prohibition, or proscription. \"Under ban to touch.\" Milton. 5. A curse or anathema. \"Hecate's ban.\" Shak. 6. A pecuniary mulct or penalty laid upon a delinquent for offending against a ban; as, a mulct paid to a bishop by one guilty of sacrilege or other crimes. Ban of the empire (German Hist.), an imperial interdict by which political rights and privileges, as those of a prince, city, or district, were taken away.\n\n1. To curse; to invoke evil upon. Sir W. Scott. 2. To forbid; to interdict. Byron.\n\nTo curse; to swear. [Obs.] Spenser.\n\nAn ancient title of the warden of the eastern marches of Hungary; now, a title of the viceroy of Croatia and Slavonia.
banal |Commonplace; trivial; hackneyed; trite.
banality |Something commonplace, hackneyed, or trivial; the commonplace, in speech. The highest things were thus brought down to the banalities of discourse. J. Morley.
banana |A perennial herbaceous plant of almost treelike size (Musa sapientum); also, its edible fruit. See Musa. Note: The banana has a soft, herbaceous stalk, with leaves of great length and breadth. The flowers grow in bunches, covered with a sheath of a green or purple color; the fruit is five or six inches long, and over an inch in diameter; the pulp is soft, and of a luscious taste, and is eaten either raw or cooked. This plant is a native of tropical countries, and furnishes an important article of food. Banana bird (Zoöl.), a small American bird (Icterus leucopteryx), which feeds on the banana. -- Banana quit (Zoöl.), a small bird of tropical America, of the genus Certhiola, allied to the creepers.
banana solution |A solution used as a vehicle in applying bronze pigments. In addition to acetote, benzine, and a little pyroxylin, it contains amyl acetate, which gives it the odor of bananas.
banat |The territory governed by a ban.
banc |A bench; a high seat, or seat of distinction or judgment; a tribunal or court. In banc, In banco (the ablative of bancus), In bank, in full court, or with full judicial authority; as, sittings in banc (distinguished from sittings at nisi prius).
bancal |An ornamental covering, as of carpet or leather, for a bench or form.
banco |A bank, especially that of Venice. Note: This term is used in some parts of Europe to indicate bank money, as distinguished from the current money, when this last has become depreciated.
bancus |A bench; a high seat, or seat of distinction or judgment; a tribunal or court. In banc, In banco (the ablative of bancus), In bank, in full court, or with full judicial authority; as, sittings in banc (distinguished from sittings at nisi prius).
band |1. A fillet, strap, or any narrow ligament with which a thing is encircled, or fastened, or by which a number of things are tied, bound together, or confined; a fetter. Every one's bands were loosed. Acis xvi 26. 2. (Arch.) (a) A continuous tablet, stripe, or series of ornaments, as of carved foliage, of color, or of brickwork, etc. (b) In Gothic architecture, the molding, or suite of moldings, which encircles the pillars and small shafts. 3. That which serves as the means of union or connection between persons; a tie. \"To join in Hymen's bands.\" Shak. 4. A linen collar or ruff worn in the 16th and 17th centuries. 5. pl.  Two strips of linen hanging from the neck in front as part of a clerical, legal, or academic dress. 6. A narrow strip of cloth or other material on any article of dress, to bind, strengthen, ornament, or complete it. \"Band and gusset and seam.\" Hood. 7. A company of persons united in any common design, especially a body of armed men. Troops of horsemen with his bands of foot. Shak. 8. A number of musicians who play together upon portable musical instruments, especially those making a loud sound, as certain wind instruments (trumpets, clarinets, etc.), and drums, or cymbals. 9. (Bot.)  A space between elevated lines or ribs, as of the fruits of umbelliferous plants. 10. (Zoöl.)  A stripe, streak, or other mark transverse to the axis of the body. 11. (Mech.)  A belt or strap. 12. A bond [Obs.] \"Thy oath and band.\" Shak. 13. Pledge; security. [Obs.] Spenser. Band saw, a saw in the form of an endless steel belt, with teeth on one edge, running over wheels.\n\n1. To bind or tie with a band. 2. To mark with a band. 3. To unite in a troop, company, or confederacy. \"Banded against his throne.\" Milton. Banded architrave, pier, shaft, etc. (Arch.), an architrave, pier, etc., of which the regular profile is interrupted by blocks or projections crossing it at right angles.\n\nTo confederate for some common purpose; to unite; to conspire together. Certain of the Jews banded together. Acts xxiii. 12.\n\nTo bandy; to drive away. [Obs.]\n\nof Bind. [Obs.]
band fish |A small red fish of the genus Cepola; the ribbon fish.
bandage |1. A fillet or strip of woven material, used in dressing and binding up wounds, etc. 2. Something resembling a bandage; that which is bound over or round something to cover, strengthen, or compress it; a ligature. Zeal too had a place among the rest, with a bandage over her eyes. Addison.\n\nTo bind, dress, or cover, with a bandage; as, to bandage the eyes.
bandala |A fabric made in Manilla from the older leaf sheaths of the abaca (Musa textilis).
bandana |1. A species of silk or cotton handkerchief, having a uniformly dyed ground, usually of red or blue, with white or yellow figures of a circular, lozenge, or other simple form. 2. A style of calico printing, in which white or bright spots are produced upon cloth previously dyed of a uniform red or dark color, by discharging portions of the color by chemical means, while the rest of the cloth is under pressure. Ure.
bandanna |1. A species of silk or cotton handkerchief, having a uniformly dyed ground, usually of red or blue, with white or yellow figures of a circular, lozenge, or other simple form. 2. A style of calico printing, in which white or bright spots are produced upon cloth previously dyed of a uniform red or dark color, by discharging portions of the color by chemical means, while the rest of the cloth is under pressure. Ure.
bandbox |A light box of pasteboard or thin wood, usually cylindrical, for holding ruffs (the bands of the 17th century), collars, caps, bonnets, etc.
bandeau |A narrow band or fillet; a part of a head-dress. Around the edge of this cap was a stiff bandeau of leather. Sir W. Scott.
bandelet |A small band or fillet; any little band or flat molding, compassing a column, like a ring. Gwilt.
bander |One banded with others. [R.]
banderilla |A barbed dart carrying a banderole which the banderillero thrusts into the neck or shoulder of the bull in a bullfight.
banderillero |One who thrusts in the banderillas in bullfighting.  W. D. Howells.
banderole |A little banner, flag, or streamer. [Written also bannerol.] From the extremity of which fluttered a small banderole or streamer bearing a cross. Sir W. Scott.
bandicoot |(a) A species of very large rat (Mus giganteus), found in India and Ceylon. It does much injury to rice fields and gardens. (b) A ratlike marsupial animal (genus Perameles) of several species, found in Australia and Tasmania.
banding plane |A plane used for cutting out grooves and inlaying strings and bands in straight and circular work.
bandit |An outlaw; a brigand. No savage fierce, bandit, or mountaineer. Milton. Note: The plural banditti was formerly used as a collective noun. Deerstealers are ever a desperate banditti. Sir W. Scott.
bandle |An Irish measure of two feet in length.
bandlet |A small band or fillet; any little band or flat molding, compassing a column, like a ring. Gwilt.\n\nSame as Bandelet.
bandmaster |The conductor of a musical band.
bandog |A mastiff or other large and fierce dog, usually kept chained or tied up. The keeper entered leading his bandog, a large bloodhound, tied in a leam, or band, from which he takes his name. Sir W. Scott.
bandoleer |1. A broad leather belt formerly worn by soldiers over the right shoulder and across the breast under the left arm. Originally it was used for supporting the musket and twelve cases for charges, but later only as a cartridge belt. 2. One of the leather or wooden cases in which the charges of powder were carried. [Obs.]
bandolier |1. A broad leather belt formerly worn by soldiers over the right shoulder and across the breast under the left arm. Originally it was used for supporting the musket and twelve cases for charges, but later only as a cartridge belt. 2. One of the leather or wooden cases in which the charges of powder were carried. [Obs.]
bandoline |A glutinous pomatum for the fair.
bandon |Disposal; control; license. [Obs.] Rom. of R.
bandore |A musical stringed instrument, similar in form to a guitar; a pandore.
bandrol |A little banner, flag, or streamer. [Written also bannerol.] From the extremity of which fluttered a small banderole or streamer bearing a cross. Sir W. Scott.\n\nSame as Banderole.
bandy |A carriage or cart used in India, esp. one drawn by bullocks.\n\n1. A club bent at the lower part for striking a ball at play; a hockey stick. Johnson. 2. The game played with such a club; hockey; shinney; bandy ball.\n\n1. To beat to and fro, as a ball in playing at bandy. Like tennis balls bandied and struck upon us . . . by rackets from without. Cudworth. 2. To give and receive reciprocally; to exchange. \"To bandy hasty words.\" Shak. 3. To toss about, as from man to man; to agitate. Let not obvious and known truth be bandied about in a disputation. I. Watts.\n\nTo content, as at some game in which each strives to drive the ball his own way. Fit to bandy with thy lawless sons. Shak.\n\nBent; crooked; curved laterally, esp. with the convex side outward; as, a bandy leg.
bandy-legged |Having crooked legs.
bane |1. That which destroys life, esp. poison of a deadly quality. [Obs. except in combination, as in ratsbane, henbane, etc.] 2. Destruction; death. [Obs.] The cup of deception spiced and tempered to their bane. Milton. 3. Any cause of ruin, or lasting injury; harm; woe. Money, thou bane of bliss, and source of woe. Herbert. 4. A disease in sheep, commonly termed the rot. Syn. -- Poison; ruin; destruction; injury; pest.\n\nTo be the bane of; to ruin. [Obs.] Fuller.
baneberry |A genus (Actæa) of plants, of the order Ranunculaceæ, native in the north temperate zone. The red or white berries are poisonous.
baneful |Having poisonous qualities; deadly; destructive; injurious; noxious; pernicious. \"Baneful hemlock.\" Garth. \"Baneful wrath.\" Chapman. -- Bane\"ful*ly, adv. --Bane\"ful*ness, n.
banewort |Deadly nightshade.
bang |1. To beat, as with a club or cudgel; to treat with violence; to handle roughly. The desperate tempest hath so banged the Turks. Shak. 2. To beat or thump, or to cause ( something) to hit or strike against another object, in such a way as to make a loud noise; as, to bang a drum or a piano; to bang a door (against the doorpost or casing) in shutting it.\n\nTo make a loud noise, as if with a blow or succession of blows; as, the window blind banged and waked me; he was banging on the piano.\n\n1. A blow as with a club; a heavy blow. Many a stiff thwack, many a bang. Hudibras. 2. The sound produced by a sudden concussion.\n\nTo cut squarely across, as the tail of a hors, or the forelock of human beings; to cut (the hair). His hair banged even with his eyebrows. The Century Mag.\n\nThe short, front hair combed down over the forehead, esp. when cut squarely across; a false front of hair similarly worn. His hair cut in front like a young lady's bang. W. D. Howells.\n\nSee Bhang.
banging |Huge; great in size. [Colloq.] Forby.
bangle |To waste by little and little; to fritter away. [Obs.]\n\nAn ornamental circlet, of glass, gold, silver, or other material, worn by women in India and Africa, and in some other countries, upon the wrist or ankle; a ring bracelet. Bangle ear, a loose hanging ear of a horse, like that of a spaniel.
bangue |See Bhang.
banian |1. A Hindoo trader, merchant, cashier, or money changer. [Written also banyan.] 2. A man's loose gown, like that worn by the Banians. 3. (Bot.)  The Indian fig. See Banyan. Banian days (Naut.), days in which the sailors have no flesh meat served out to them. This use seems to be borrowed from the Banians or Banya race, who eat no flesh.
banish |1. To condemn to exile, or compel to leave one's country, by authority of the ruling power. \"We banish you our territories.\" Shak. 2. To drive out, as from a home or familiar place; -- used with from and out of. How the ancient Celtic tongue came to be banished from the Low Countries in Scotland. Blair. 3. To drive away; to compel to depart; to dispel. \"Banish all offense.\" Shak. Syn. -- To Banish, Exile, Expel. The idea of a coercive removal from a place is common to these terms. A man is banished when he is forced by the government of a country (be he a foreigner or a native) to leave its borders. A man is exiled when he is driven into banishment from his native country and home. Thus to exile is to banish, but to banish is not always to exile. To expel is to eject or banish, summarily or authoritatively, and usually under circumstances of disgrace; as, to expel from a college; expelled from decent society.
banisher |One who banishes.
banishment |The act of banishing, or the state of being banished. He secured himself by the banishment of his enemies. Johnson. Round the wide world in banishment we roam. Dryden. Syn. -- Expatriation; ostracism; expulsion; proscription; exile; outlawry.
banister |A stringed musical instrument having a head and neck like the guitar, and its body like a tambourine. It has five strings, and is played with the fingers and hands.
banjo |A stringed musical instrument having a head and neck like the guitar, and its body like a tambourine. It has five strings, and is played with the fingers and hands.
banjorine |A kind of banjo, with a short neck, tuned a fourth higher than the common banjo; -- popularly so called.
bank |A bench; a high seat, or seat of distinction or judgment; a tribunal or court. In banc, In banco (the ablative of bancus), In bank, in full court, or with full judicial authority; as, sittings in banc (distinguished from sittings at nisi prius).\n\n1. A mound, pile, or ridge of earth, raised above the surrounding level; hence, anything shaped like a mound or ridge of earth; as, a bank of clouds; a bank of snow. They cast up a bank against the city. 2 Sam. xx. 15. 2. A steep acclivity, as the slope of a hill, or the side of a ravine. 3. The margin of a watercourse; the rising ground bordering a lake, river, or sea, or forming the edge of a cutting, or other hollow. Tiber trembled underneath her banks. Shak. 4. An elevation, or rising ground, under the sea; a shoal, shelf, or shallow; as, the banks of Newfoundland. 5. (Mining) (a) The face of the coal at which miners are working. (b) A deposit of ore or coal, worked by excavations above water level. (c) The ground at the top of a shaft; as, ores are brought to bank. Bank beaver (Zoöl.), the otter. [Local, U.S.] -- Bank swallow, a small American and European swallow (Clivicola riparia) that nests in a hole which it excavates in a bank.\n\n1. To raise a mound or dike about; to inclose, defend, or fortify with a bank; to embank. \"Banked well with earth.\" Holland. 2. To heap or pile up; as, to bank sand. 3. To pass by the banks of. [Obs.] Shak. To bank a fire, To bank up a fire, to cover the coals or embers with ashes or cinders, thus keeping the fire low but alive.\n\n1. A bench, as for rowers in a galley; also, a tier of oars. Placed on their banks, the lusty Trojan sweep Neptune's smooth face, and cleave the yielding deep. Waller. 2. (Law) (a) The bench or seat upon which the judges sit. (b) The regular term of a court of law, or the full court sitting to hear arguments upon questions of law, as distinguished from a sitting at Nisi Prius, or a court held for jury trials. See Banc. Burrill. 3. (Printing)  A sort of table used by printers. 4. (Music)  A bench, or row of keys belonging to a keyboard, as in an organ. Knight.\n\n1. An establishment for the custody, loan, exchange, or issue, of money, and for facilitating the transmission of funds by drafts or bills of exchange; an institution incorporated for performing one or more of such functions, or the stockholders (or their representatives, the directors), acting in their corporate capacity. 2. The building or office used for banking purposes. 3. A fund from deposits or contributions, to be used in transacting business; a joint stock or capital. [Obs.] Let it be no bank or common stock, but every man be master of his own money. Bacon. 4. (Gaming)  The sum of money or the checks which the dealer or banker has as a fund, from which to draw his stakes and pay his losses. 5. In certain games, as dominos, a fund of pieces from which the players are allowed to draw. Bank credit, a credit by which a person who has give -- Bank of deposit, a bank which receives money for safe keeping. -- Bank of issue, a bank which issues its own notes payable to bearer.\n\nTo deposit in a bank.\n\n1. To keep a bank; to carry on the business of a banker. 2. To deposit money in a bank; to have an account with a banker.
bank bill |1. In America (and formerly in England), a promissory note of a bank payable to the bearer on demand, and used as currency; a bank note. 2. In England, a note, or a bill of exchange, of a bank, payable to order, and usually at some future specified time. Such bills are negotiable, but form, in the strict sense of the term, no part of the currency.
bank book |A book kept by a depositor, in which an officer of a bank enters the debits and credits of the depositor's account with the bank.
bank discount |A sum equal to the interest at a given rate on the principal (face) of a bill or note from the time of discounting until it becomes due.
bank note |1. A promissory note issued by a bank or banking company, payable to bearer on demand. Note: In the United States popularly called a bank bill. 2. Formerly, a promissory note made by a banker, or banking company, payable to a specified person at a fixed date; a bank bill. See Bank bill, 2. [Obs.] 3. A promissory note payable at a bank.
bank swallow |See under 1st Bank, n.
bank-sided |Having sides inclining inwards, as a ship; -- opposed to wall- sided.
bankable |Receivable at a bank.
banker |1. One who conducts the business of banking; one who, individually, or as a member of a company, keeps an establishment for the deposit or loan of money, or for traffic in money, bills of exchange, etc. 2. A money changer. [Obs.] 3. The dealer, or one who keeps the bank in a gambling house. 4. A vessel employed in the cod fishery on the banks of Newfoundland. Grabb. J. Q. Adams. 5. A ditcher; a drain digger. [Prov. Eng.] 6. The stone bench on which masons cut or square their work. Weale.
bankeress |A female banker. Thackeray.
banking |The business of a bank or of a banker. Banking house, an establishment or office in which, or a firm by whom, banking is done.
bankrupt |1. (Old Eng. Low)  A trader who secretes himself, or does certain other acts tending to defraud his creditors. Blackstone. 2. A trader who becomes unable to pay his debts; an insolvent trader; popularly, any person who is unable to pay his debts; an insolvent person. M 3. (Law)  A person who, in accordance with the terms of a law relating to bankruptcy, has been judicially declared to be unable to meet his liabilities. Note: In England, until the year 1861 none but a \"trader\" could be made a bankrupt; a non-trader failing to meet his liabilities being an \"insolvent\". But this distinction was abolished by the Bankruptcy Act of 1861. The laws of 1841 and 1867 of the United States relating to bankruptcy applied this designation bankrupt to others besides those engaged in trade.\n\n1. Being a bankrupt or in a condition of bankruptcy; unable to pay, or legally discharged from paying, one's debts; as, a bankrupt merchant. 2. Depleted of money; not having the means of meeting pecuniary liabilities; as, a bankrupt treasury. 3. Relating to bankrupts and bankruptcy. 4. Destitute of, or wholly wanting (something once possessed, or something one should possess). \"Bankrupt in gratitude.\" Sheridan. Bankrupt law, a law by which the property of a person who is unable or unwilling to pay his debts may be taken and distributed to his creditors, and by which a person who has made a full surrender of his property, and is free from fraud, may be discharged from the legal obligation of his debts. See Insolvent, a.\n\nTo make bankrupt; to bring financial ruin upon; to impoverish.
bankruptcy |1. The state of being actually or legally bankrupt. 2. The act or process of becoming a bankrupt. 3. Complete loss; -- followed by of.
bankside |The slope of a bank, especially of the bank of a steam.
banlieue |The territory without the walls, but within the legal limits, of a town or city. Brande & C.
banner |1. A kind of flag attached to a spear or pike by a crosspiece, and used by a chief as his standard in battle. Hang out our banners on the outward walls. Shak. 2. A large piece of silk or other cloth, with a device or motto, extended on a crosspiece, and borne in a procession, or suspended in some conspicuous place. 3. Any flag or standard; as, the star-spangled banner. Banner fish (Zoöl.), a large fish of the genus Histiophorus, of the Swordfish family, having a broad bannerlike dorsal fin; the sailfish. One species (H. Americanus) inhabits the North Atlantic.
bannered |Decorated with a banner or banners \"bannered host.\" Milton.
banneret |1. Originally, a knight who led his vassals into the field under his own banner; -- commonly used as a title of rank. 2. A title of rank, conferred for heroic deeds, and hence, an order of knighthood; also, the person bearing such title or rank. Note: The usual mode of conferring the rank on the field of battle was by cutting or tearing off the point of the pennon or pointed flag on the spear of the candidate, thereby making it a banner. 3. A civil officer in some Swiss cantons. 4. A small banner. Shak.
bannerol |A banderole; esp. a banner displayed at a funeral procession and set over the tomb. See Banderole.
bannition |The act of expulsion.[Obs.] Abp. Laud.
bannock |A kind of cake or bread, in shape flat and roundish, commonly made of oatmeal or barley meal and baked on an iron plate, or griddle; -- used in Scotland and the northern counties of England. Jamieson. Bannock fluke, the turbot. [Scot.]
banns |Notice of a proposed marriage, proclaimed in a church, or other place prescribed by law, in order that any person may object, if he knows of just cause why the marriage should not take place.
banquet |1. A feast; a sumptuous entertainment of eating and drinking; often, a complimentary or ceremonious feast, followed by speeches. 2. A dessert; a course of sweetmeats; a sweetmeat or sweetmeats. [Obs.] We'll dine in the great room, but let the music And banquet be prepared here. Massinger.\n\nTo treat with a banquet or sumptuous entertainment of food; to feast. Just in time to banquet The illustrious company assembled there. Coleridge.\n\n1. To regale one's self with good eating and drinking; to feast. Were it a draught for Juno when she banquets, I would not taste thy treasonous offer. Milton. 2. To partake of a dessert after a feast. [Obs.] Where they did both sup and banquet. Cavendish.
banqueter |One who banquets; one who feasts or makes feasts.
banquette |1. (Fort.)  A raised way or foot bank, running along the inside of a parapet, on which musketeers stand to fire upon the enemy. 2. (Arch.)  A narrow window seat; a raised shelf at the back or the top of a buffet or dresser.
banquetter |One who banquets; one who feasts or makes feasts.
banshee |A supernatural being supposed by the Irish and Scotch peasantry to warn a family of the speedy death of one of its members, by wailing or singing in a mournful voice under the windows of the house.
banshie |A supernatural being supposed by the Irish and Scotch peasantry to warn a family of the speedy death of one of its members, by wailing or singing in a mournful voice under the windows of the house.\n\nA supernatural being supposed to warn a family of the approaching death of one of its members, by wailing or singing in a mournful voice.
bansshee |A supernatural being supposed to warn a family of the approaching death of one of its members, by wailing or singing in a mournful voice.
banstickle |A small fish, the three-spined stickleback.
bantam |A variety of small barnyard fowl, with feathered legs, probably brought from Bantam, a district of Java.
bantam work |Carved and painted work in imitation of Japan ware.
banteng |The wild ox of Java (Bibos Banteng).
banter |1. To address playful good-natured ridicule to, -- the person addressed, or something pertaining to him, being the subject of the jesting; to rally; as, he bantered me about my credulity. Hag-ridden by my own fancy all night, and then bantered on my haggard looks the next day. W. Irving. 2. To jest about; to ridicule in speaking of, as some trait, habit, characteristic, and the like. [Archaic] If they banter your regularity, order, and love of study, banter in return their neglect of them. Chatham. 3. To delude or trick, -- esp. by way of jest. [Obs.] We diverted ourselves with bantering several poor scholars with hopes of being at least his lordship's chaplain. De Foe. 4. To challenge or defy to a match. [Colloq. Southern and Western U.S.]\n\nThe act of bantering; joking or jesting; humorous or good- humored raillery; pleasantry. Part banter, part affection. Tennyson.
banterer |One who banters or rallies.
bantingism |A method of reducing corpulence by avoiding food containing much farinaceous, saccharine, or oily matter; -- so called from William Banting of London.
bantling |A young or small child; an infant. [Slightly contemptuous or depreciatory.] In what out of the way corners genius produces her bantlings. W. Irving.
bantu |A member of one of the great family of Negroid tribes occupying equatorial and southern Africa. These tribes include, as important divisions, the Kafirs, Damaras, Bechuanas, and many tribes whose names begin with Aba-, Ama-, Ba-, Ma-, Wa-, variants of the Bantu plural personal prefix Aba-, as in Ba-ntu, or Aba-ntu, itself a combination of this prefix with the syllable -ntu, a person. -- Ban\"tu, a.
banxring |An East Indian insectivorous mammal of the genus Tupaia.
banyan |A tree of the same genus as the common fig, and called the Indian fig (Ficus Indica), whose branches send shoots to the ground, which take root and become additional trunks, until it may be the tree covers some acres of ground and is able to shelter thousands of men.
banzai |Lit., May you live ten thousand years; -- used in salutation of the emperor and as a battle cry. [Japan]
baobab |A gigantic African tree (Adansonia digitata), also naturalized in India. See Adansonia.
baphomet |An idol or symbolical figure which the Templars were accused of using in their mysterious rites.
baptism |The act of baptizing; the application of water to a person, as a sacrament or religious ceremony, by which he is initiated into the visible church of Christ. This is performed by immersion, sprinkling, or pouring.
baptismal |Pertaining to baptism; as, baptismal vows. Baptismal name, the Christian name, which is given at baptism.
baptismally |In a baptismal manner.
baptist |1. One who administers baptism; -- specifically applied to John, the forerunner of Christ. Milton. 2. One of a denomination of Christians who deny the validity of infant baptism and of sprinkling, and maintain that baptism should be administered to believers alone, and should be by immersion. See Anabaptist. Note: In doctrine the Baptists of this country [the United States] are Calvinistic, but with much freedom and moderation. Amer. Cyc. Freewill Baptists, a sect of Baptists who are Arminian in doctrine, and practice open communion. -- Seventh-day Baptists, a sect of Baptists who keep the seventh day of the week, or Saturday, as the Sabbath. See Sabbatarian. The Dunkers and Campbellites are also Baptists.
baptistery |(a) In early times, a separate building, usually polygonal, used for baptismal services. Small churches were often changed into baptisteries when larger churches were built near. (b) A part of a church containing a font and used for baptismal services.
baptistic |Of or for baptism; baptismal.
baptistical |Baptistic. [R.]
baptistry |(a) In early times, a separate building, usually polygonal, used for baptismal services. Small churches were often changed into baptisteries when larger churches were built near. (b) A part of a church containing a font and used for baptismal services.
baptizable |Capable of being baptized; fit to be baptized. Baxter.
baptization |Baptism. [Obs.] Their baptizations were null. Jer. Taylor.
baptize |1. To administer the sacrament of baptism to. 2. To christen ( because a name is given to infants at their baptism); to give a name to; to name. I'll be new baptized; Henceforth I never will be Romeo. Shak. 3. To sanctify; to consecrate.
baptizement |The act of baptizing.[R.]
baptizer |One who baptizes.
bar |1. A piece of wood, metal, or other material, long in proportion to its breadth or thickness, used as a lever and for various other purposes, but especially for a hindrance, obstruction, or fastening; as, the bars of a fence or gate; the bar of a door. Thou shalt make bars of shittim wood. Ex. xxvi. 26. 2. An indefinite quantity of some substance, so shaped as to be long in proportion to its breadth and thickness; as, a bar of gold or of lead; a bar of soap. 3. Anything which obstructs, hinders, or prevents; an obstruction; a barrier. Must I new bars to my own joy create Dryden. 4. A bank of sand, gravel, or other matter, esp. at the mouth of a river or harbor, obstructing navigation. 5. Any railing that divides a room, or office, or hall of assembly, in order to reserve a space for those having special privileges; as, the bar of the House of Commons. 6. (Law) (a) The railing that incloses the place which counsel occupy in courts of justice. Hence, the phrase at the bar of the court signifies in open court. (b) The place in court where prisoners are stationed for arraignment, trial, or sentence. (c) The whole body of lawyers licensed in a court or district; the legal profession. (d) A special plea constituting a sufficient answer to plaintiff's action. 7. Any tribunal; as, the bar of public opinion; the bar of God. 8. A barrier or counter, over which liquors and food are passed to customers; hence, the portion of the room behind the counter where liquors for sale are kept. 9. (Her.)  An ordinary, like a fess but narrower, occupying only one fifth part of the field. 10. A broad shaft, or band, or stripe; as, a bar of light; a bar of color. 11. (Mus.)  A vertical line across the staff. Bars divide the staff into spaces which represent measures, and are themselves called measures. Note: A double bar marks the end of a strain or main division of a movement, or of a whole piece of music; in psalmody, it marks the end of a line of poetry. The term bar is very often loosely used for measure, i.e., for such length of music, or of silence, as is included between one bar and the next; as, a passage of eight bars; two bars' rest. 12. (Far.) pl. (a) The space between the tusks and grinders in the upper jaw of a horse, in which the bit is placed. (b) The part of the crust of a horse's hoof which is bent inwards towards the frog at the heel on each side, and extends into the center of the sole. 13. (Mining) (a) A drilling or tamping rod. (b) A vein or dike crossing a lode. 14. (Arch.) (a) A gatehouse of a castle or fortified town. (b) A slender strip of wood which divides and supports the glass of a window; a sash bar. Bar shoe (Far.), a kind of horseshoe having a bar across the usual opening at the heel, to protect a tender frog from injury. -- Bar shot, a double headed shot, consisting of a bar, with a ball or half ball at each end; -- formerly used for destroying the masts or rigging in naval combat. -- Bar sinister (Her.), a term popularly but erroneously used for baton, a mark of illegitimacy. See Baton. -- Bar tracery (Arch.), ornamental stonework resembling bars of iron twisted into the forms required. -- Blank bar (Law). See Blank. -- Case at bar (Law), a case presently before the court; a case under argument. -- In bar of, as a sufficient reason against; to prevent. -- Matter in bar, or Defence in bar, a plea which is a final defense in an action. -- Plea in bar, a plea which goes to bar or defeat the plaintiff's action absolutely and entirely. -- Trial at bar (Eng. Law), a trial before all the judges of one the superior courts of Westminster, or before a quorum representing the full court.\n\n1. To fasten with a bar; as, to bar a door or gate. 2. To restrict or confine, as if by a bar; to hinder; to obstruct; to prevent; to prohibit; as, to bar the entrance of evil; distance bars our intercourse; the statute bars my right; the right is barred by time; a release bars the plaintiff's recovery; -- sometimes with up. He barely looked the idea in the face, and hastened to bar it in its dungeon. Hawthorne. 3. To except; to exclude by exception. Nay, but I bar to-night: you shall not gauge me By what we do to- night. Shak. 4. To cross with one or more stripes or lines. For the sake of distinguishing the feet more clearly, I have barred them singly. Burney.
bar iron |See under Iron.
baraca |An international, interdenominational organization of Bible classes of young men; -- so named in allusion to the Hebrew word Berachah (Meaning blessing) occurring in 2 Chron. xx. 26 and 1 Chron. xii.
barad |The pressure of one dyne per square centimeter; -- used as a unit of pressure.
baraesthesiometer |An instrument for determining the delicacy of the sense of pressure. -- Bar`æs*the`si*o*met\"ric, Bar`es*the`si*o*met\"ric (#), a.
barathea |A soft fabric with a kind of basket weave and a diapered pattern.
barb |1. Beard, or that which resembles it, or grows in the place of it. The barbel, so called by reason of his barbs, or wattles in his mouth. Walton. 2. A muffler, worn by nuns and mourners. [Obs.] 3. pl.  Paps, or little projections, of the mucous membrane, which mark the opening of the submaxillary glands under the tongue in horses and cattle. The name is mostly applied when the barbs are inflamed and swollen. [Written also barbel and barble.] 4. The point that stands backward in an arrow, fishhook, etc., to prevent it from being easily extracted. Hence: Anything which stands out with a sharp point obliquely or crosswise to something else. \"Having two barbs or points.\" Ascham. 5. A bit for a horse. [Obs.] Spenser. 6. (Zoöl.)  One of the side branches of a feather, which collectively constitute the vane. See Feather. 7. (Zoöl.)  A southern name for the kingfishes of the eastern and southeastern coasts of the United States; -- also improperly called whiting. 8. (Bot.)  A hair or bristle ending in a double hook.\n\n1. To shave or dress the beard of. [Obs.] 2. To clip; to mow. [Obs.] Marston. 3. To furnish with barbs, or with that which will hold or hurt like barbs, as an arrow, fishhook, spear, etc. But rattling storm of arrows barbed with fire. Milton.\n\n1. The Barbary horse, a superior breed introduces from Barbary into Spain by the Moors. 2. (Zoöl.)  A blackish or dun variety of the pigeon, originally brought from Barbary.\n\nArmor for a horse. Same as 2d Bard, n., 1.
barbacan |See Barbican.\n\n1. ( Fort.) A tower or advanced work defending the entrance to a castle or city, as at a gate or bridge. It was often large and strong, having a ditch and drawbridge of its own. 2. An opening in the wall of a fortress, through which missiles were discharged upon an enemy.
barbacanage |See Barbicanage.\n\nMoney paid for the support of a barbican. [Obs.]
barbadian |Of or pertaining to Barbados. -- n.  A native of Barbados.
barbadoes |A West Indian island, giving its name to a disease, to a cherry, etc. Barbados cherry (Bot.), a genus of trees of the West Indies (Malpighia) with an agreeably acid fruit resembling a cherry. -- Barbados leg (Med.), a species of elephantiasis incident to hot climates. -- Barbados nuts, the seeds of the Jatropha curcas, a plant growing in South America and elsewhere. The seeds and their acrid oil are used in medicine as a purgative. See Physic nut.
barbados |A West Indian island, giving its name to a disease, to a cherry, etc. Barbados cherry (Bot.), a genus of trees of the West Indies (Malpighia) with an agreeably acid fruit resembling a cherry. -- Barbados leg (Med.), a species of elephantiasis incident to hot climates. -- Barbados nuts, the seeds of the Jatropha curcas, a plant growing in South America and elsewhere. The seeds and their acrid oil are used in medicine as a purgative. See Physic nut.
barbara |The first word in certain mnemonic lines which represent the various forms of the syllogism. It indicates a syllogism whose three propositions are universal affirmatives. Whately.
barbaresque |Barbaric in form or style; as, barbaresque architecture. De Quincey.
barbarian |1. A foreigner. [Historical] Therefore if I know not the meaning of the voice, I shall be unto him that speaketh a barbarian, and he that speaketh shall be a barbarian unto me. 2. A man in a rule, savage, or uncivilized state. 3. A person destitute of culture. M. Arnold. 4. A cruel, savage, brutal man; one destitute of pity or humanity. \"Thou fell barbarian.\" Philips.\n\nOf, or pertaining to, or resembling, barbarians; rude; uncivilized; barbarous; as, barbarian governments or nations.
barbaric |1. Of, or from, barbarian nations; foreign; -- often with reference to barbarous nations of east. \"Barbaric pearl and gold.\" Milton. 2. Of or pertaining to, or resembling, an uncivilized person or people; barbarous; barbarian; destitute of refinement. \"Wild, barbaric music.\" Sir W. Scott.
barbarism |1. An uncivilized state or condition; rudeness of manners; ignorance of arts, learning, and literature; barbarousness. Prescott. 2. A barbarous, cruel, or brutal action; an outrage. A heinous barbarism . . . against the honor of marriage. Milton. 3. An offense against purity of style or language; any form of speech contrary to the pure idioms of a particular language. See Solecism. The Greeks were the first that branded a foreign term in any of their writers with the odious name of barbarism. G. Campbell.
barbarity |The state or manner of a barbarian; lack of civilization. 2. Cruelty; ferociousness; inhumanity. Treating Christians with a barbarity which would have shocked the very Moslem. Macaulay. 3. A barbarous or cruel act. 4. Barbarism; impurity of speech. [Obs.] Swift.
barbarize |1. To become barbarous. The Roman empire was barbarizing rapidly from the time of Trajan. De Quincey. 2. To adopt a foreign or barbarous mode of speech. The ill habit . . . of wretched barbarizing against the Latin and Greek idiom, with their untutored Anglicisms. Milton.\n\nTo make barbarous. The hideous changes which have barbarized France. Burke.
barbarous |1. Being in the state of a barbarian; uncivilized; rude; peopled with barbarians; as, a barbarous people; a barbarous country. 2. Foreign; adapted to a barbaric taste.[Obs.] Barbarous gold. Dryden. 3. Cruel; ferocious; inhuman; merciless. By their barbarous usage he died within a few days, to the grief of all that knew him. Clarendon. 4. Contrary to the pure idioms of a language. A barbarous expression G. Campbell. Syn. -- Uncivilized; unlettered; uncultivated; untutored; ignorant; merciless; brutal. See Ferocious.
barbarously |In a barbarous manner.
barbarousness |The quality or state of being barbarous; barbarity; barbarism.
barbary |The countries on the north coast of Africa from Egypt to the Atlantic. Hence: A Barbary horse; a barb. [Obs.] Also, a kind of pigeon. Barbary ape (Zoöl.), an ape (Macacus innus) of north Africa and Gibraltar Rock, being the only monkey inhabiting Europe. It is very commonly trained by showmen.
barbastel |A European bat (Barbastellus communis), with hairy lips.
barbate |Bearded; beset with long and weak hairs.
barbated |Having barbed points. A dart uncommonly barbated. T. Warton.
barbecue |1. A hog, ox, or other large animal roasted or broiled whole for a feast. 2. A social entertainment, where many people assemble, usually in the open air, at which one or more large animals are roasted or broiled whole. 3. A floor, on which coffee beans are sun-dried.\n\n1. To dry or cure by exposure on a frame or gridiron. They use little or no salt, but barbecue their game and fish in the smoke. Stedman. 2. To roast or broil whole, as an ox or hog. Send me, gods, a whole hog barbecued. Pope.
barbed |Accoutered with defensive armor; -- said of a horse. See Barded ( which is the proper form.) Sir W. Raleigh.\n\nFurnished with a barb or barbs; as, a barbed arrow; barbed wire. Barbed wire, a wire, or a strand of twisted wires, armed with barbs or sharp points. It is used for fences.
barbel |1. (Zoöl.)  A slender tactile organ on the lips of certain fished. 2. (Zoöl.)  A large fresh-water fish ( Barbus vulgaris) found in many European rivers. Its upper jaw is furnished with four barbels. 3. pl.  Barbs or paps under the tongued of horses and cattle. See 1st Barb, 3.
barbellate |Having short, stiff hairs, often barbed at the point. Gray.
barbellulate |Barbellate with diminutive hairs or barbs.
barber |One whose occupation it is to shave or trim the beard, and to cut and dress the hair of his patrons. Barber's itch. See under Itch. Note: Formerly the barber practiced some offices of surgery, such as letting blood and pulling teeth. Hence such terms as barber surgeon ( old form barber chirurgeon), barber surgery, etc.\n\nTo shave and dress the beard or hair of. Shak.
barber fish |See Surgeon fish.
barbermonger |A fop. [Obs.]
barberry |A shrub of the genus Berberis, common along roadsides and in neglected fields. B. vulgaris is the species best known; its oblong red berries are made into a preserve or sauce, and have been deemed efficacious in fluxes and fevers. The bark dyes a fine yellow, esp. the bark of the root. [Also spelt berberry.]
barbet |(a) A variety of small dog, having long curly hair. (b) A bird of the family Bucconidæ, allied to the Cuckoos, having a large, conical beak swollen at the base, and bearded with five bunches of stiff bristles; the puff bird. It inhabits tropical America and Africa. (c) A larva that feeds on aphides.
barbette |A mound of earth or a platform in a fortification, on which guns are mounted to fire over the parapet. En barbette, In barbette, said of guns when they are elevated so as to fire over the top of a parapet, and not through embrasures. -- Barbette gun, or Barbette battery, a single gun, or a number of guns, mounted in barbette, or partially protected by a parapet or turret. -- Barbette carriage, a gun carriage which elevates guns sufficiently to be in barbette. [See Illust. of Casemate.]
barbican |1. ( Fort.) A tower or advanced work defending the entrance to a castle or city, as at a gate or bridge. It was often large and strong, having a ditch and drawbridge of its own. 2. An opening in the wall of a fortress, through which missiles were discharged upon an enemy.
barbicanage |Money paid for the support of a barbican. [Obs.]
barbicel |One of the small hooklike processes on the barbules of feathers.
barbiers |A variety of paralysis, peculiar to India and the Malabar coast; -- considered by many to be the same as beriberi in chronic form.
barbigerous |Having a beard; bearded; hairy.
barbison school |A French school of the middle of the 19th century centering in the village of Barbizon near the forest of Fontainebleau. Its members went straight to nature in disregard of academic tradition, treating their subjects faithfully and with poetic feeling for color, light, and atmosphere. It is exemplified, esp. in landscapes, by Corot, Rousseau, Daubigny, Jules Dupré, and Diaz. Associated with them are certain painters of animals, as Troyon and Jaque, and of peasant life, as Millet and Jules Breton.
barbiton |An ancient Greek instrument resembling a lyre.
barbituric acid |A white, crystalline substance,
barbizon school |A French school of the middle of the 19th century centering in the village of Barbizon near the forest of Fontainebleau. Its members went straight to nature in disregard of academic tradition, treating their subjects faithfully and with poetic feeling for color, light, and atmosphere. It is exemplified, esp. in landscapes, by Corot, Rousseau, Daubigny, Jules Dupré, and Diaz. Associated with them are certain painters of animals, as Troyon and Jaque, and of peasant life, as Millet and Jules Breton.
barble |See Barbel.
barbotine |A paste of clay used in decorating coarse pottery in relief.
barbre |Barbarian. [Obs.] Chaucer.
barbule |1. A very minute barb or beard. Booth. 2. (Zoöl.)  One of the processes along the edges of the barbs of a feather, by which adjacent barbs interlock. See Feather.
barcarolle |(a) A popular song or melody sung by Venetian gondoliers. (b) A piece of music composed in imitation of such a song.
barcon |A vessel for freight; -- used in Mediterranean.
bard |1. A professional poet and singer, as among the ancient Celts, whose occupation was to compose and sing verses in honor of the heroic achievements of princes and brave men. 2. Hence: A poet; as, the bard of Avon.\n\n1. A piece of defensive (or, sometimes, ornamental) armor for a horse's neck, breast, and flanks; a barb. [Often in the pl.] 2. pl.  Defensive armor formerly worn by a man at arms. 3. (Cookery)  A thin slice of fat bacon used to cover any meat or game.\n\nTo cover (meat or game) with a thin slice of fat bacon.\n\n1. The exterior covering of the trunk and branches of a tree; the rind. 2. Specifically, Peruvian bark. Bark bed. See Bark stove (below). -- Bark pit, a pit filled with bark and water, in which hides are steeped in tanning. -- Bark stove (Hort.), a glazed structure for keeping tropical plants, having a bed of tanner's bark (called a bark bed) or other fermentable matter which produces a moist heat.
barde |1. A piece of defensive (or, sometimes, ornamental) armor for a horse's neck, breast, and flanks; a barb. [Often in the pl.] 2. pl.  Defensive armor formerly worn by a man at arms. 3. (Cookery)  A thin slice of fat bacon used to cover any meat or game.
barded |1. Accoutered with defensive armor; -- said of a horse. 2. (Her.)  Wearing rich caparisons. Fifteen hundred men . . . barded and richly trapped. Stow.
bardic |Of or pertaining to bards, or their poetry. \"The bardic lays of ancient Greece.\" G. P. Marsh.
bardiglio |An Italian marble of which the principal varieties occur in the neighborhood of Carrara and in Corsica. It commonly shows a dark gray or bluish ground traversed by veins.
bardish |Pertaining to, or written by, a bard or bards. \"Bardish impostures.\" Selden.
bardism |The system of bards; the learning and maxims of bards.
bardling |An inferior bard. J. Cunningham.
bardship |The state of being a bard.
bare |1. Without clothes or covering; stripped of the usual covering; naked; as, his body is bare; the trees are bare. 2. With head uncovered; bareheaded. When once thy foot enters the church, be bare. Herbert. 3. Without anything to cover up or conceal one's thoughts or actions; open to view; exposed. Bare in thy guilt, how foul must thou appear ! Milton. 4. Plain; simple; unadorned; without polish; bald; meager. \"Uttering bare truth.\" Shak. 5. Destitute; indigent; empty; unfurnished or scantily furnished; -- used with of (rarely with in) before the thing wanting or taken away; as, a room bare of furniture. \"A bare treasury.\" Dryden. 6. Threadbare; much worn. It appears by their bare liveries that they live by your bare words. Shak. 7. Mere; alone; unaccompanied by anything else; as, a bare majority. \"The bare necessaries of life.\" Addison. Nor are men prevailed upon by bare of naked truth. South. Under bare poles (Naut.), having no sail set.\n\n1. Surface; body; substance. [R.] You have touched the very bare of naked truth. Marston. 2. (Arch.)  That part of a roofing slate, shingle, tile, or metal plate, which is exposed to the weather.\n\nTo strip off the covering of; to make bare; as, to bare the breast.\n\nBore; the old preterit of Bear, v.
bareback |On the bare back of a horse, without using a saddle; as, to ride bareback.
barebacked |Having the back uncovered; as, a barebacked horse.
barebone |A very lean person; one whose bones show through the skin. Shak.
barefaced |1. With the face uncovered; not masked. \"You will play barefaced.\" Shak. 2. Without concealment; undisguised. Hence: Shameless; audacious. \"Barefaced treason.\" J. Baillie.
barefacedly |Openly; shamelessly. Locke.
barefacedness |The quality of being barefaced; shamelessness; assurance; audaciousness.
barefoot |With the feet bare; without shoes or stockings.
barefooted |Having the feet bare.
barege |A gauzelike fabric for ladies' dresses, veils, etc. of worsted, silk and worsted, or cotton and worsted.
barehanded |Having bare hands.
barehead |Having the head uncovered; as, a bareheaded girl.
bareheaded |Having the head uncovered; as, a bareheaded girl.
barelegged |Having the legs bare.
barely |1. Without covering; nakedly. 2. Without concealment or disguise. 3. Merely; only. R. For now his son is duke. W. Barely in title, not in revenue. Shak. 4. But just; without any excess; with nothing to spare ( of quantity, time, etc.); hence, scarcely; hardly; as, there was barely enough for all; he barely escaped.
barenecked |Having the neck bare.
bareness |The state of being bare.
baresark |A Berserker, or Norse warrior who fought without armor, or shirt of mail. Hence, adverbially: Without shirt of mail or armor.
baresthesiometer |An instrument for determining the delicacy of the sense of pressure. -- Bar`æs*the`si*o*met\"ric, Bar`es*the`si*o*met\"ric (#), a.
barfish |Same as Calico bass.
barful |Full of obstructions. [Obs.] Shak.
bargain |1. An agreement between parties concerning the sale of property; or a contract by which one party binds himself to transfer the right to some property for a consideration, and the other party binds himself to receive the property and pay the consideration. A contract is a bargain that is legally binding. Wharton. 2. An agreement or stipulation; mutual pledge. And whon your honors mean to solemnize The bargain of your faith. Shak. 3. A purchase; also ( when not qualified), a gainful transaction; an advantageous purchase; as, to buy a thing at a bargain. 4. The thing stipulated or purchased; also, anything bought cheap. She was too fond of her most filthy bargain. Shak. Bargain and sale (Law), a species of conveyance, by which the bargainor contracts to convey the lands to the bargainee, and becomes by such contract a trustee for and seized to the use of the bargainee. The statute then completes the purchase; i.e., the bargain vests the use, and the statute vests the possession. Blackstone. -- Into the bargain, over and above what is stipulated; besides. -- To sell bargains, to make saucy ( usually indelicate) repartees. [Obs.] Swift. -- To strike a bargain, to reach or ratify an agreement. \"A bargain was struck.\" Macaulay. Syn. -- Contract; stipulation; purchase; engagement.\n\nTo make a bargain; to make a contract for the exchange of property or services; -- followed by with and for; as, to bargain with a farmer for a cow. So worthless peasants bargain for their wives. Shak.\n\nTo transfer for a consideration; to barter; to trade; as, to bargain one horse for another. To bargain away, to dispose of in a bargain; -- usually with a sense of loss or disadvantage; as, to bargain away one's birthright. \"The heir . . . had somehow bargained away the estate.\" G. Eliot.
bargainee |The party to a contract who receives, or agrees to receive, the property sold. Blackstone.
bargainer |One who makes a bargain; -- sometimes in the sense of bargainor.
bargainor |One who makes a bargain, or contracts with another; esp., one who sells, or contracts to sell, property to another. Blackstone.
barge |1. A pleasure boat; a vessel or boat of state, elegantly furnished and decorated. 2. A large, roomy boat for the conveyance of passengers or goods; as, a ship's barge; a charcoal barge. 3. A large boat used by flag officers. 4. A double-decked passenger or freight vessel, towed by a steamboat. [U.S.] 5. A large omnibus used for excursions. [Local, U.S.]
bargeboard |A vergeboard.
bargecourse |A part of the tiling which projects beyond the principal rafters, in buildings where there is a gable. Gwilt.
bargee |A bargeman. [Eng.]
bargeman |The man who manages a barge, or one of the crew of a barge.
bargemastter |The proprietor or manager of a barge, or one of the crew of a barge.
barger |The manager of a barge. [Obs.]
barghest |A goblin, in the shape of a large dog, portending misfortune. [Also written barguest.]
baria |Baryta.
baric |Of or pertaining to barium; as, baric oxide.\n\nOf or pertaining to weight, esp. to the weight or pressure of the atmosphere as measured by the barometer.
barilla |1. (Bot.)  A name given to several species of Salsola from which soda is made, by burning the barilla in heaps and lixiviating the ashes. 2. (Com.) (a) The alkali produced from the plant, being an impure carbonate of soda, used for making soap, glass, etc., and for bleaching purposes. (b) Impure soda obtained from the ashes of any seashore plant, or kelp. Ure. Copper barilla (Min.), native copper in granular form mixed with sand, an ore brought from Bolivia; -- called also Barilla de cobre.
barillet |A little cask, or something resembling one. Smart.
barite |Native sulphate of barium, a mineral occurring in transparent, colorless, white to yellow crystals (generally tabular), also in granular form, and in compact massive forms resembling marble. It has a high specific gravity, and hence is often called heavy spar. It is a common mineral in metallic veins.
baritone |See Barytone.\n\n1. (Mus.)  Grave and deep, as a kind of male voice. 2. (Greek Gram.)  Not marked with an accent on the last syllable, the grave accent being understood.\n\n1. (Mus.) (a) A male voice, the compass of which partakes of the common bass and the tenor, but which does not descend as low as the one, nor rise as high as the other. (b) A person having a voice of such range. (c) The viola di gamba, now entirely disused. 2. (Greek Gram.)  A word which has no accent marked on the last syllable, the grave accent being understood.
barium |One of the elements, belonging to the alkaline earth group; a metal having a silver-white color, and melting at a very high temperature. It is difficult to obtain the pure metal, from the facility with which it becomes oxidized in the air. Atomic weight, 137. Symbol, Ba. Its oxide called baryta. [Rarely written barytum.] Note: Some of the compounds of this element are remarkable for their high specific gravity, as the sulphate, called heavy spar, and the like. The oxide was called barote, by Guyton de Morveau, which name was changed by Lavoisier to baryta, whence the name of the metal.
bark |1. To strip the bark from; to peel. 2. To abrade or rub off any outer covering from; as to bark one's heel. 3. To girdle. See Girdle, v. t., 3. 4. To cover or inclose with bark, or as with bark; as, to bark the roof of a hut.\n\n1. To make a short, loud, explosive noise with the vocal organs; -- said of some animals, but especially of dogs. 2. To make a clamor; to make importunate outcries. They bark, and say the Scripture maketh heretics. Tyndale. Where there is the barking of the belly, there no other commands will be heard, much less obeyed. Fuller.\n\nThe short, loud, explosive sound uttered by a dog; a similar sound made by some other animals.\n\n1. Formerly, any small sailing vessel, as a pinnace, fishing smack, etc.; also, a rowing boat; a barge. Now applied poetically to a sailing vessel or boat of any kind. Byron. 2. (Naut.)  A three-masted vessel, having her foremast and mainmast squarerigged, and her mizzenmast schooner-rigged.
bark beetle |A small beetle of many species (family Scolytidæ), which in the larval state bores under or in the bark of trees, often doing great damage.
bark louse |An insect of the family Coccidæ, which infests the bark of trees and vines. Note: The wingless females assume the shape of scales. The bark louse of vine is Pulvinaria innumerabilis; that of the pear is Lecanium pyri. See Orange scale.
barkantine |Same as Barkentine.
barkbound |Prevented from growing, by having the bark too firm or close.
barkeeper |One who keeps or tends a bar for the sale of liquors.
barken |Made of bark. [Poetic] Whittier.
barkentine |A threemasted vessel, having the foremast square-rigged, and the others schooner-rigged. [Spelled also barquentine, barkantine, etc.] See Illust. in Append.
barker |1. An animal that barks; hence, any one who clamors unreasonably. 2. One who stands at the doors of shops to urg [Cant, Eng.] 3. A pistol. [Slang] Dickens. 4. (Zoöl.)  The spotted redshank.\n\nOne who strips trees of their bark. BARKER'S MILL Bark\"er's mill`. Etym: [From Dr. Barker, the inventor.]  A machine, invented in the 17th century, worked by a form of reaction wheel. The water flows into a vertical tube and gushes from apertures in hollow horizontal arms, causing the machine to revolve on its axis.
barkery |A tanhouse.
barking irons |1. Instruments used in taking off the bark of trees. Gardner. 2. A pair of pistols. [Slang]
barkless |Destitute of bark.
barky |Covered with, or containing, bark. \"The barky fingers of the elm.\" Shak.
barley |A valuable grain, of the family of grasses, genus Hordeum, used for food, and for making malt, from which are prepared beer, ale, and whisky. Barley bird (Zoöl.), the siskin. -- Barley sugar, sugar boiled till it is brittle (formerly with a decoction of barley) and candied. -- Barley water, a decoction of barley, used in medicine, as a nutritive and demulcent.
barley-bree |Liquor made from barley; strong ale. [Humorous] [Scot.] Burns.
barleybrake |An ancient rural game, commonly played round stacks of barley, or other grain, in which some of the party attempt to catch others who run from a goal.
barleybreak |An ancient rural game, commonly played round stacks of barley, or other grain, in which some of the party attempt to catch others who run from a goal.
barleycorn |1. A grain or \"corn\" of barley. 2. Formerly , a measure of length, equal to the average length of a grain of barley; the third part of an inch. John Barleycorn, a humorous personification of barley as the source of malt liquor or whisky.
barm |Foam rising upon beer, or other malt liquors, when fermenting, and used as leaven in making bread and in brewing; yeast. Shak.\n\nThe lap or bosom. [Obs.] Chaucer.
barmaid |A girl or woman who attends the customers of a bar, as in a tavern or beershop. A bouncing barmaid. W. Irving.
barmaster |Formerly, a local judge among miners; now, an officer of the barmote. [Eng.]
barmcloth |Apron. [Obs.] Chaucer.
barmecidal |Unreal; illusory. \"A sort of Barmecidal feast.\" Hood.
barmecide |One who proffers some illusory advantage or benefit. Also used as an adj.: Barmecidal. \"A Barmecide feast.\" Dickens.
barmote |A court held in Derbyshire, in England, for deciding controversies between miners. Blount.
barmy |Full of barm or froth; in a ferment. \"Barmy beer.\" Dryden.\n\nFull of barm or froth; in a ferment. \"Barmy beer.\"  Dryden.
barn |A covered building used chiefly for storing grain, hay, and other productions of a farm. In the United States a part of the barn is often used for stables. Barn owl (Zoöl.), an owl of Europe and America (Aluco flammeus, or Strix flammea), which frequents barns and other buildings. -- Barn swallow (Zoöl.), the common American swallow (Hirundo horreorum), which attaches its nest of mud to the beams and rafters of barns.\n\nTo lay up in a barn. [Obs.] Shak. Men . . . often barn up the chaff, and burn up the grain. Fuller.\n\nA child. [Obs.] See Bairn.
barnabite |A member of a religious order, named from St. Barnabas.
barnacle |Any cirriped crustacean adhering to rocks, floating timber, ships, etc., esp. (a) the sessile species (genus Balanus and allies), and (b) the stalked or goose barnacles (genus Lepas and allies). See Cirripedia, and Goose barnacle. Barnacle eater (Zoöl.), the orange filefish. -- Barnacle scale (Zoöl.), a bark louse (Ceroplastes cirripediformis) of the orange and quince trees in Florida. The female scale curiously resembles a sessile barnacle in form.\n\nA bernicle goose.\n\n1. pl. (Far.)  An instrument for pinching a horse's nose, and thus restraining him. Note: [Formerly used in the sing.] The barnacles . . . give pain almost equal to that of the switch. Youatt. 2. pl.  Spectacles; -- so called from their resemblance to the barnacles used by farriers. [Cant, Eng.] Dickens.
barnburner |A member of the radical section of the Democratic party in New York, about the middle of the 19th century, which was hostile to extension of slavery, public debts, corporate privileges, etc., and supported Van Buren against Cass for president in 1848; --opposed to Hunker. [Political Cant, U. S.]
barnstormer |An itinerant theatrical player who plays in barns when a theatre is lacking; hence, an inferior actor, or one who plays in the country away from the larger cities. --Barn\"storm`ing, n. [Theatrical Cant]
barnyard |A yard belonging to a barn.
barocco |See Baroque.
barocyclonometer |An aneroid barometer for use with accompanying graphic diagrams and printed directions designed to aid mariners to interpret the indications of the barometer so as to determine the existence of a violent storm at a distance of several hundred miles.
barogram |A tracing, usually made by the barograph, showing graphically the variations of atmospheric pressure for a given time.
barograph |An instrument for recording automatically the variations of atmospheric pressure.
baroko |A form or mode of syllogism of which the first proposition is a universal affirmative, and the other two are particular negative.
barology |The science of weight or gravity.
baromacrometer |An instrument for ascertaining the weight and length of a newborn infant.
barometer |An instrument for determining the weight or pressure of the atmosphere, and hence for judging of the probable changes of weather, or for ascertaining the height of any ascent. Note: The barometer was invented by Torricelli at Florence about 1643. It is made in its simplest form by filling a graduated glass tube about 34 inches long with mercury and inverting it in a cup containing mercury. The column of mercury in the tube descends until balanced by the weight of the atmosphere, and its rise or fall under varying conditions is a measure of the change in the atmospheric pressure. At the sea level its ordinary height is about 30 inches (760 millimeters). See Sympiesometer. Nichol. Aneroid barometer. See Aneroid barometer, under Aneroid. -- Marine barometer, a barometer with tube contracted at bottom to prevent rapid oscillations of the mercury, and suspended in gimbals from an arm or support on shipboard. -- Mountain barometer, a portable mercurial barometer with tripod support, and long scale, for measuring heights. -- Siphon barometer, a barometer having a tube bent like a hook with the longer leg closed at the top. The height of the mercury in the longer leg shows the pressure of the atmosphere. -- Wheel barometer, a barometer with recurved tube, and a float, from which a cord passes over a pulley and moves an index.
barometric |Pertaining to the barometer; made or indicated by a barometer; as, barometric changes; barometrical observations.
barometrical |Pertaining to the barometer; made or indicated by a barometer; as, barometric changes; barometrical observations.
barometrically |By means of a barometer, or according to barometric observations.
