ruddy |1. Of a red color; red, or reddish; as, a ruddy sky; a ruddy flame. Milton. They were more ruddy in body than rubies. Lam. iv. 7. 2. Of a lively flesh color, or the color of the human skin in high health; as, ruddy cheeks or lips. Dryden. Ruddy duck (Zoöl.), an American duck (Erismatura rubida) having a broad bill and a wedge- shaped tail composed of stiff, sharp feathers. The adult male is rich brownish red on the back, sides, and neck, black on the top of the head, nape, wings, and tail, and white on the cheeks. The female and young male are dull brown mixed with blackish on the back; grayish below. Called also dunbird, dundiver, ruddy diver, stifftail, spinetail, hardhead, sleepy duck, fool duck, spoonbill, etc. -- Ruddy plover (Zoöl.) the sanderling.\n\nTo make ruddy. [R.] Sir W. Scott.
rude |1. Characterized by roughness; umpolished; raw; lacking delicacy or refinement; coarse. Such gardening tools as art, yet rude, . . . had formed. Milton. 2. Hence, specifically: (a) Unformed by taste or skill; not nicely finished; not smoothed or polished; -- said especially of material things; as, rude workmanship. \"Rude was the cloth.\" Chaucer. Rude and unpolished stones. Bp. Stillingfleet. The heaven-born child All meanly wrapt in the rude manger lies. Milton. (b) Of untaught manners; unpolished; of low rank; uncivil; clownish; ignorant; raw; unskillful; -- said of persons, or of conduct, skill, and the like. \"Mine ancestors were rude.\" Chaucer. He was but rude in the profession of arms. Sir H. Wotton. the rude forefathers of the hamlet sleep. Gray. (c) Violent; tumultuous; boisterous; inclement; harsh; severe; -- said of the weather, of storms, and the like; as, the rude winter. [Clouds] pushed with winds, rude in their shock. Milton. The rude agitation [of water] breaks it into foam. Boyle. (d) Barbarous; fierce; bloody; impetuous; -- said of war, conflict, and the like; as, the rude shock of armies. (e) Not finished or complete; inelegant; lacking chasteness or elegance; not in good taste; unsatisfactory in mode of treatment; -- said of literature, language, style, and the like. \"The rude Irish books.\" Spenser. Rude am I in my speech. Shak. Unblemished by my rude translation. Dryden. Syn. -- Impertinent; rough; uneven; shapeless; unfashioned; rugged; artless; unpolished; uncouth; inelegant; rustic; coarse; vulgar; clownish; raw; unskillful; untaught; illiterate; ignorant; uncivil; impolite; saucy; impudent; insolent; surly; currish; churlish; brutal; uncivilized; barbarous; savage; violent; fierce; tumultuous; turbulent; impetuous; boisterous; harsh; inclement; severe. See Impertiment. -- Rude\"ly, adv. -- Rude\"ness, n.
rudenture |Cabling. See Cabling. gwilt.
ruderary |Of or pertaining to rubbish.. [Obs.] Bailey.
rudesby |An uncivil, turbulent fellow. [Obs.] Shak.
rudesheimer |A German wine made near Rüdesheim, on the Rhine.
rudiment |1. That which is unformed or undeveloped; the principle which lies at the bottom of any development; an unfinished beginning. but I will bring thee where thou soon shalt quit Those rudiments, and see before thine eyes The monarchies of the earth. Milton. the single leaf is the rudiment of beauty in landscape. I. Taylor. 2. Hence, an element or first principle of any art or science; a beginning of any knowledge; a first step. This boy is forest-born, And hath been tutored in the rudiments of many desperate studies. Shak. There he shall first lay down the rudiments Of his great warfare. Milton. 3. (Biol.)  An imperfect organ or part, or one which is never developed.\n\nTo furnish with first principles or rules; to insrtuct in the rudiments. Gayton.
rudimental |Rudimentary. Addison.
rudimentary |1. Of or pertaining to rudiments; consisting in first principles; elementary; initial; as, rudimental essays. 2. (Biol.)  Very imperfectly developed; in an early stage of development; embryonic.
rudish |Somewhat rude. Foote.
rudistes |An extinct order or suborder of bivalve mollusks characteristic of the Cretaceous period; -- called also Rudista. See Illust. under Hippurite.
rudity |Rudeness; ignorance. [R.]
rudmasday |Either of the feasts of the Holy Cross, occuring on May 3 and September 14, annually.
rudolphine |Pertaining to, or designating, a set of astronomical tables computed by Kepler, and founded on the observations of Tycho Brahe; - - so named from Rudolph II., emperor of Germany.
rue |1. (Bot.)  A perennial suffrutescent plant (Ruta graveolens), having a strong, heavy odor and a bitter taste; herb of grace. It is used in medicine. Then purged with euphrasy and rue The visual nerve, for he had much to see. Milton. They [the exorcists] are to try the devil by holy water, incense, sulphur, rue, which from thence, as we suppose, came to be called herb of grace. Jer. Taylor. 2. Fig.: Bitterness; disappointment; grief; regret. Goat's rue. See under Goat. -- Rue anemone, a pretty springtime flower (Thalictrum anemonides) common in the United States. -- Wall rue, a little fern (Asplenium Ruta-muraria) common on walls in Europe.\n\n1. To lament; to regret extremely; to grieve for or over. Chaucer. I wept to see, and rued it from my heart. Chapmen. Thy will Chose freely what it now so justly rues. Milton. 2. To cause to grieve; to afflict. [Obs.] \"God wot, it rueth me.\" Chaucer. 3. To repent of, and withdraw from, as a bargain; to get released from. [Prov. Eng.]\n\n1. To have compassion. [Obs.] God so wisly [i. e., truly] on my soul rue. Chaucer. Which stirred men's hearts to rue upon them. Ridley. 2. To feel sorrow and regret; to repent. Work by counsel and thou shalt not rue. Chaucer. Old year, we'll dearly rue for you. Tennyson.\n\nSorrow; repetance. [Obs.] Shak.
ruedesheimer |A German wine made near Rüdesheim, on the Rhine.
rueful |1. Causing one to rue or lament; woeful; mournful; sorrowful. 2. Expressing sorrow. \"Rueful faces.\" Dryden. Two rueful figures, with long black cloaks. Sir W. Scott. -- Rue\"ful*ly, adv. -- Rue\"ful*ness, n.
ruell bone |See rewel bone. [Obs.]
ruelle |A private circle or assembly at a private house; a circle. [Obs.] Dryden.
rufescent |Reddish; tinged with red.
ruff |(a) A game similar to whist, and the predecessor of it. Nares. (b) The act of trumping, especially when one has no card of the suit led.\n\nTo trump.\n\n1. A muslin or linen collar plaited, crimped, or fluted, worn formerly by both sexes, now only by women and children. Here to-morrow with his best ruff on. Shak. His gravity is much lessened since the late proclamation came out against ruffs; . . . they were come to that height of excess herein, that twenty shillings were used to be paid for starching of a ruff. Howell. 2. Something formed with plaits or flutings, like the collar of this name. I reared this flower; . . . Soft on the paper ruff its leaves I spread. Pope. 3. An exhibition of pride or haughtiness. How many princes . . . in the ruff of all their glory, have been taken down from the head of a conquering army to the wheel of the victor's chariot! L'Estrange. 4. Wanton or tumultuous procedure or conduct. [Obs.] To ruffle it out in a riotous ruff. Latimer. 5. (Mil.)  A low, vibrating beat of a drum, not so loud as a roll; a ruffle. 6. (Mach.)  A collar on a shaft ot other piece to prevent endwise motion. See Illust. of Collar. 7. (Zoöl.)  A set of lengthened or otherwise modified feathers round, or on, the neck of a bird. 8. (Zoöl.) (a) A limicoline bird of Europe and Asia (Pavoncella, or Philommachus, pugnax) allied to the sandpipers. The males during the breeding season have a large ruff of erectile feathers, variable in their colors, on the neck, and yellowish naked tubercles on the face. They are polygamous, and are noted for their pugnacity in the breeding season. The female is called reeve, or rheeve. (b) A variety of the domestic pigeon, having a ruff of its neck.\n\n1. To ruffle; to disorder. Spenser. 2. (Mil.)  To beat with the ruff or ruffle, as a drum. 3. (Hawking)  To hit, as the prey, without fixing it.\n\nA small freshwater European perch (Acerina vulgaris); -- called also pope, blacktail, and stone, or striped, perch.
ruffe |A small freshwater European perch (Acerina vulgaris); -- called also pope, blacktail, and stone, or striped, perch.
ruffed |Furnished with a ruff. Ruffed grouse (Zoöl.), a North American grouse (Bonasa umbellus) common in the wooded districts of the Northern United States. The male has a ruff of brown or black feathers on each side of the neck, and is noted for the loud drumming sound he makes during the breeding season. Called also tippet grouse, partridge, birch partridge, pheasant, drummer, and white-flesher. -- ruffed lemur (Zoöl.), a species of lemur (lemur varius) having a conspicuous ruff on the sides of the head. Its color is varied with black and white. Called also ruffed maucaco.
ruffian |1. A pimp; a pander; also, a paramour. [Obs.] he [her husband] is no sooner abroad than she is instantly at home, reveling with her ruffians. Bp. Reynolds. 2. A boisterous, cruel, brutal fellow; a desperate fellow ready for murderous or cruel deeds; a cutthroat. Wilt thou on thy deathbed play the ruffian Shak.\n\nbrutal; cruel; savagely boisterous; murderous; as, ruffian rage.\n\nTo play the ruffian; to rage; to raise tumult. [R.] Shak.
ruffianage |Ruffians, collectively; a body of ruffians. \"The vilest ruffianage.\" Sir F. Palgrave.
ruffianish |Having the qualities or manners of a ruffian; ruffianly.
ruffianlike |Ruffianly. Fulke.
ruffianly |Like a ruffian; bold in crimes; characteristic of a ruffian; violent; brutal.
ruffianous |Ruffianly. [Obs.] Chapman.
ruffin |Disordered. [Obs.] His ruffin rainment all was stained with blood. Spenser.
ruffle |1. To make into a ruff; to draw or contract into puckers, plaits, or folds; to wrinkle. 2. To furnish with ruffles; as, to ruffle a shirt. 3. To oughen or disturb the surface of; to make uneven by agitation or commotion. The fantastic revelries . . . that so often ruffled the placid bosom of the Nile. I. Taylor. She smoothed the ruffled seas. Dryden. 4. To erect in a ruff, as feathers. [the swan] ruffles her pure cold plume. Tennyson. 5. (Mil.)  To beat with the ruff or ruffle, as a drum. 6. To discompose; to agitate; to disturb. These ruffle the tranquillity of the mind. Sir W. Hamilton. But, ever after, the small violence done Rankled in him and ruffled all his heart. Tennyson. 7. To throw into disorder or confusion. Where best He might the ruffled foe infest. Hudibras. 8. To throw together in a disorderly manner. [R.] I ruffled up falen leaves in heap. Chapman To ruffle the feathers of, to exite the resentment of; to irritate.\n\n1. To grow rough, boisterous, or turbulent. [R.] The night comes on, and the bleak winds Do sorely ruffle. Shak. 2. To become disordered; to play loosely; to flutter. On his right shoulder his thick mane reclined, Ruffles at speed, and dances in the wind. Dryden. 3. To be rough; to jar; to be in contention; hence, to put on airs; to swagger. They would ruffle with jurors. Bacon. Gallants who ruffled in silk and embroidery. Sir W. Scott.\n\n1. That which is ruffled; specifically, a strip of lace, cambric, or other fine cloth, plaited or gathered on one edge or in the middle, and used as a trimming; a frill. 2. A state of being ruffled or disturbed; disturbance; agitation; commotion; as, to put the mind in a ruffle. 3. (Mil.)  A low, vibrating beat of a drum, not so loud as a roll; -- called also ruff. H. L. Scott. 4. (Zoöl.)  The connected series of large egg capsules, or oöthecæ, of any one of several species of American marine gastropods of the genus Fulgur. See Oötheca. Ruffle of a boot, the top turned down, and scalloped or plaited. Halliwell.
ruffleless |Having no ruffle.
rufflement |The act of ruffling. [R.]
ruffler |1. One who ruffles; a swaggerer; a bully; a ruffian. Assaults, if not murders, done at his own doors by that crew of rufflers. Milton. 2. That which ruffles; specifically, a sewing machine attachment for making ruffles.
rufigallic |Pertaining to, or designating, an acid which is obtained from gallic acid as a brown or red crystalline substance, and is related to rufiopin and anthracene.
rufiopin |A yellowish red crystalline substance related to anthracene, and obtained from opianic acid.
rufol |A phenol derivative of anthracene obtained as a white crystalline substance, which on oxidation produces a red dyestuff related to anthraquinone.
rufous |Reddish; of a yellowish red or brownish red color; tawny.
ruft |Eructation; belching. [Obs.]
rufterhood |A kind of hood for a hawk.
rug |1. A kind of coarse, heavy frieze, formerly used for garments. They spin the choicest rug in Ireland. A friend of mine . . . repaired to Paris Garden clad in one of these Waterford rugs. The mastiffs, . . . deeming he had been a bear, would fain have baited him. Holinshed. 2. A piece of thick, nappy fabric, commonly made of wool, -- used for various purposes, as for covering and ornamenting part of a bare floor, for hanging in a doorway as a potière, for protecting a portion of carpet, for a wrap to protect the legs from cold, etc. 3. A rough, woolly, or shaggy dog. Rug gown, a gown made of rug, of or coarse, shaggy cloth. B. Johnson.\n\nTo pull roughly or hastily; to plunder; to spoil; to tear. [Scot.] Sir W. Scott.
rug-gowned |Wearing a coarse gown or shaggy garment made of rug. Beau. & Fl.
rug-headed |Having shaggy hair; shock-headed. [Obs.] Those rough rug-headed kerns. Shak.
ruga |A wrinkle; a fold; as, the rugæ of the stomach.
rugate |Having alternate ridges and depressions; wrinkled. Dana.
rugged |1. Full of asperities on the surface; broken into sharp or irregular points, or otherwise uneven; not smooth; rough; as, a rugged mountain; a rugged road. The rugged bark of some broad elm. Milton. 2. Not neat or regular; uneven. His well-proportioned beard made rough and rugged. Shak. 3. Rough with bristles or hair; shaggy. \"The rugged Russian bear.\" Shak. 4. Harsh; hard; crabbed; austere; -- said of temper, character, and the like, or of persons. Neither melt nor endear him, but leave him as hard, rugged, and unconcerned as ever. South. 5. Stormy; turbulent; tempestuous; rude. Milton. 6. Rough to the ear; harsh; grating; -- said of sound, style, and the like. Through the harsh cadence of a rugged line. Dryden. 7. Sour; surly; frowning; wrinkled; -- said of looks, etc. \"Sleek o'er your rugged looks.\" Shak. 8. Violent; rude; boisterrous; -- said of conduct, manners, etc. 9. Vigorous; robust; hardy; -- said of health, physique, etc. [Colloq. U.S.] Syn. -- Rough; uneven; wrinkled; cragged; coarse; rude; harsh; hard; crabbed; severe; austere; surly; sour; frowning; violent; boisterous; tumultuous; turbulent; stormy; tempestuous; inclement. -- Rug\"ged*ly, adv. -- Rug\"ged*ness, n.
rugging |A coarse kind of woolen cloth, used for wrapping, blanketing, etc.
ruggy |Rugged; rough. [Obs.] \"With ruggy, ashy hairs.\" Chaucer.
rugin |A nappy cloth. [Obs.] Wiseman.
rugine |An instrument for scraping the periosteum from bones; a raspatory.\n\nTo scrape or rasp, as a bone; to scale. [R.] Wiseman.
rugosa |An extinct tribe of fossil corals, including numerous species, many of them of large size. They are characteristic of the Paleozoic formations. The radiating septs, when present, are usually in multiples of four. See Cyathophylloid.
rugose |Wrinkled; full of wrinkles; specifically (Bot.), having the veinlets sunken and the spaces between them elevated, as the leaves of the sage and horehound.
rugosity |The quality or state of being rugose.
rugous |Wrinkled; rugose.
rugulose |Somewhat rugose. RUHMKORFF'S COIL Ruhm\"korff's coil`. Etym: [So called from its inventor, Ruhmkorff, a german physicist.] (Elec.)  See Induction coil, under Induction.
ruin |1. The act of falling or tumbling down; fall. [Obs.] \"His ruin startled the other steeds.\" Chapman. 2. Such a change of anything as destroys it, or entirely defeats its object, or unfits it for use; destruction; overthrow; as, the ruin of a ship or an army; the ruin of a constitution or a government; the ruin of health or hopes. \"Ruin seize thee, ruthless king!\" Gray. 3. That which is fallen down and become worthless from injury or decay; as, his mind is a ruin; especially, in the plural, the remains of a destroyed, dilapidated, or desolate house, fortress, city, or the like. The Veian and the Gabian towers shall fall, And one promiscuous ruin cover all; Nor, after length of years, a stone betray The place where once the very ruins lay. Addison. The labor of a day will not build up a virtuous habit on the ruins of an old and vicious character. Buckminster. 4. The state of being dcayed, or of having become ruined or worthless; as, to be in ruins; to go to ruin. 5. That which promotes injury, decay, or destruction. The errors of young men are the ruin of business. Bacon. Syn. -- Destruction; downfall; perdition; fall; overthrow; subversion; defeat; bane; pest; mischief.\n\nTo bring to ruin; to cause to fall to pieces and decay; to make to perish; to bring to destruction; to bring to poverty or bankruptcy; to impair seriously; to damage essentially; to overthrow. this mortal house I'll ruin. Shak. By thee raised, I ruin all my foes. Milton. The eyes of other people are the eyes that ruin us. Franklin. By the fireside there are old men seated, Seeling ruined cities in the ashes. Longfellow.\n\nTo fall to ruins; to go to ruin; to become decayed or dilapidated; to perish. [R.] Though he his house of polished marble build, Yet shall it ruin like the moth's frail cell. Sandys. If we are idle, and disturb the industrious in their business, we shall ruin the faster. Locke.
ruinable |Capable of being ruined.
ruinate |1. To demolish; to subvert; to destroy; to reduce to poverty; to ruin. I will not ruinate my fShak. Ruinating thereby the health of their bodies. Burton. 2. To cause to fall; to cast down. On the other side they saw that perilous rock Threatening itself on them to ruinate. Spenser.\n\nTo fall; to tumble. [Obs.]\n\nInvolved in ruin; ruined. My brother Edward lives in pomp and state, I in a mansion here all ruinate. J. Webster.
ruination |The act of ruining, or the state of being ruined.
ruiner |One who, or that which, ruins.
ruiniform |Having the appearance of ruins, or of the ruins of houses; -- said of certain minerals.
ruinous |1. Causing, or tending to cause, ruin; destructive; baneful; pernicious; as, a ruinous project. After a night of storm so ruinous. Milton. 2. Characterized by ruin; ruined; dilapidated; as, an edifice, bridge, or wall in a ruinous state. 3. Composed of, or consisting in, ruins. Behold, Damascus . . . shall be a ruinous heap. Isa. xvii. 1. Syn. -- Dilapidated; decayed; demolished; pernicious; destructive; baneful; wasteful; mischievous. -- Ru\"in*ous*ly, adv. -- Ru\"in*ous*ness, n.
rukh |1. The roc. 2. (Zoöl.)  A large bird, supposed by some to be the same as the extinct Epiornis of Madagascar. [Obs.]
rulable |That may be ruled; subject to rule; accordant or conformable to rule. Bacon.
rule |1. That which is prescribed or laid down as a guide for conduct or action; a governing direction for a specific purpose; an authoritative enactment; a regulation; a prescription; a precept; as, the rules of various societies; the rules governing a school; a rule of etiquette or propriety; the rules of cricket. We profess to have embraced a religion which contains the most exact rules for the government of our lives. Tillotson. 2. Hence: (a) Uniform or established course of things. 'T is against the rule of nature. Shak. (b) Systematic method or practice; as, my ule is to rise at six o'clock. (c) Ordibary course of procedure; usual way; comon state or condition of things; as, it is a rule to which there are many exeptions. (d) Conduct in general; behavior. [Obs.] This uncivil rule; she shall know of it. Shak. 3. The act of ruling; administration of law; government; empire; authority; control. Obey them that have the rule over you. Heb. xiii. 17. His stern rule the groaning land obeyed. Pope. 4. (Law)  An order regulating the practice of the courts, or an order made between parties to an action or a suit. Wharton. 5. (Math.)  A determinate method prescribed for performing any operation and producing a certain result; as, a rule for extracting the cube root. 6. (Gram.)  A general principle concerning the formation or use of words, or a concise statement thereof; thus, it is a rule in England, that s or es , added to a noun in the singular number, forms the plural of that noun; but \"man\" forms its plural \"men\| and is an exception to the rule. 7. (a) A straight strip of wood| metal| or the like| which serves as a guide in drawing a straight line; a ruler. (b) A measuring instrument consisting of a graduated bar of wood| ivory| metal| or the like| which is usually marked so as to show inches and fractions of an inch| and jointed so that it may be folded compactly. A judicious artist will use his eye| but he will trust only to his rule. South. 8. (Print.) (a) A thin plate of metal (usually brass) of the same height as the type| and used for printing lines| as between columns on the same page| or in tabular work. (b) A composing rule. See under Conposing. As a rule| as a general thing; in the main; usually; as| he behaves well| as a rule. -- Board rule| Caliber rule|etc. See under Board| Caliber| etc. -- Rule joint| a knuckle joint having shoulders that abut when the connected pieces come in line with each other| and thus permit folding in one direction only. -- Rule of three (Arith.)| that rule which directs| when three terms are given| how to find a fourth| which shall have the same ratio to the third term as the second has to the first; proportion. See Proportion| 5 (b). -- Rule of thumb| any rude process or operation| like that of using the thumb as a rule in measuring; hence| judgment and practical experience as distinguished from scientific knowledge. Syn. -- regulation; law; precept; maxim; guide; canon; order; method; direction; control; government; sway; empire.\n\n1. To control the will and actions of; to exercise authority or dominion over; to govern; to manage. Chaucer. A bishop then must be blameless; . . . one that ruleth well his own house| having his children in subjection. 1 Tim. iii. 2| 4. 2. To control or direct by influence| counsel| or persuasion; to guide; -- used chiefly in the passive. I think she will be ruled In all respects by me. Shak. 3. To establish or settle by| or as by| a rule; to fix by universal or general consent| or by common practice. That's are ruled case with the schoolmen. Atterbury. 4. (Law)  To require or command by rule; to give as a direction or order of court. 5. To mark with lines made with a pen| pencil| etc.| guided by a rule or ruler; to print or mark with lines by means of a rule or other contrivance effecting a similar result; as| to rule a sheet of paper of a blank book. Ruled surface (Geom.)| any surface that may be described by a straight line moving according to a given law; -- called also a scroll.\n\n1. To have power or command; to exercise supreme authority; -- often followed by over. By me princes rule| and nobles. Prov. viii. 16. We subdue and rule over all other creatures. Ray. 2. (Law)  To lay down and settle a rule or order of court; to decide an incidental point; to enter a rule. Burril. Bouvier. 3. (Com.)  To keep within a (certain) range for a time; to be in general| or as a rule; as| prices ruled lower yesterday than the day before."
rule-monger |A stickler for rules; a slave of rules [R.] Hare.
ruleless |Destitute of rule; lawless. Spenser.
ruler |1. One who rules; one who exercises sway or authority; a governor. And he made him ruler over all the land. Gen. xii. 43. A prince and ruler of the land. Shak. 2. A straight or curved strip of wood, metal, etc., with a smooth edge, used for guiding a pen or pencil in drawing lines. Cf. Rule, n., 7 (a). Parallel ruler. See under Parallel.
ruling |1. Predominant; chief; reigning; controlling; as, a ruling passion; a ruling sovereign. 2. Used in marking or engraving lines; as, a ruling machine or pen. Syn. -- Predominant; chief; controlling; directing; guilding; governing; prevailing; prevalent.\n\n1. The act of one who rules; ruled lines. 2. (Law)  A decision or rule of a judge or a court, especially an oral decision, as in excluding evidence.
rulingly |In a ruling manner; so as to rule.
rullichies |Chopped meat stuffed into small bags of tripe. They are cut in slices and fried. [Local, New York]
ruly |orderly; easily restrained; -- opposed to Ant: unruly. [Obs.] Gascoigne.
rum |A kind of intoxicating liquor distilled from cane juice, or from the scumming of the boiled juice, or from treacle or molasses, or from the lees of former distillations. Also, sometimes used colloquially as a generic or a collective name for intoxicating liquor. Rum bud, a grog blossom. [Colloq.] -- Rum shrub, a drink composed of rum, water, sugar, and lime juice or lemon juice, with some flavoring extract.\n\nOld-fashioned; queer; odd; as, a rum idea; a rum fellow. [Slang] Dickens.\n\nA queer or odd person or thing; a country parson. [Slang, Obs.] Swift.
rumble |1. To make a low, heavy, continued sound; as, the thunder rumbles at a distance. In the mean while the skies 'gan rumble sore. Surrey. The people cried and rombled up and down. Chaucer. 2. To murmur; to ripple. To rumble gently down with murmur soft. Spenser.\n\n1. A noisy report; rumor. [Obs.] Delighting ever in rumble that is new. Chaucer. 2. A low, heavy, continuous sound like that made by heavy wagons or the reverberation of thunder; a confused noise; as, the rumble of a railboard train. Clamor and rumble, and ringing and clatter. tennyson. Merged in the rumble of awakening day. H. James. 3. A seat for servants, behind the body of a carriage. Kit, well wrapped, . . . was in the rumble behind. Dickens. 4. A rotating cask or box in which small articles are smoothed or poliched by friction against each other. rumble seat, a seat in the rear of an automobile, outside the passenger cabin, which folds out from the body\n\nTo cause to pass through a rumble, or shaking machine. See Rumble, n., 4.
rumbler |One who, or that which, rumbles.
rumbling |a. & n. from Rumble, v. i.
rumblingly |In a rumbling manner.
rumbo |grog. [Obs.] Sir W. Scott.
rumbowline |Same as Rombowline.
rumen |1. (Anat.)  The first stomach of ruminants; the paunch; the fardingbag. See Illust. below. 2. The cud of a ruminant.
rumicin |A yellow crystalline substance found in the root of yellow dock (Rumex crispus) and identical with chrysophanic acid.
ruminal |Ruminant; ruminating. [R.]
ruminant |Chewing the cud; characterized by chewing again what has been swallowed; of or pertaining to the Ruminantia.\n\nA ruminant animal; one of the Ruminantia.
ruminantia |A division of Artiodactyla having four stomachs. This division includes the camels, deer, antelopes, goats, sheep, neat cattle, and allies. Note: The vegetable food, after the first mastication, enters the first stomach (r). It afterwards passes into the second (n), where it is moistened, and formed into pellets which the animal has the power of bringing back to the mouth to be chewed again, after which it is swallowed into the third stomach (m), whence it passes to the fourth (s), where it is finally digested.
ruminantly |In a ruminant manner; by ruminating, or chewing the cud.
ruminate |1. To chew the cud; to chew again what has been slightly chewed and swallowed. \"Cattle free to ruminate.\" Wordsworth. 2. Fig.: To think again and again; to muse; to meditate; to ponder; to reflect. Cowper. Apart from the hope of the gospel, who is there that ruminates on the felicity of heaven I. Taylor.\n\n1. To chew over again. 2. Fig.: To meditate or ponder over; to muse on. Mad with desire, she ruminates her sin. Dryden. What I know Is ruminated, plotted, and set down. Shak.\n\nHaving a hard albumen penetrated by irregular channels filled with softer matter, as the nutmeg and the seeds of the North American papaw.
ruminated |Having a hard albumen penetrated by irregular channels filled with softer matter, as the nutmeg and the seeds of the North American papaw.
rumination |1. The act or process of ruminating, or chewing the cud; the habit of chewing the cud. Rumination is given to animals to enable them at once to lay up a great store of food, and afterward to chew it. Arbuthnot. 2. The state of being disposed to ruminate or ponder; deliberate meditation or reflection. Retiring full of rumination sad. Thomson. 3. (Physiol.)  The regurgitation of food from the stomach after it has been swallowed, -- occasionally oberved as a morbid phenomenon in man.
ruminative |Inclined to, or engaged in, rumination or meditation.
ruminator |One who ruminates or muses; a meditator.
rumkin |A popular or jocular name for a drinking vessel. [Obs.]
rummage |1. (Naut.)  A place or room for the stowage of cargo in a ship; also, the act of stowing cargo; the pulling and moving about of packages incident to close stowage; -- formerly written romage. [Obs.] 2. A searching carefully by looking into every corner, and by turning things over. He has such a general rummage and reform in the office of matrimony. Walpole. Rummage sale, a clearance sale of unclaimed goods in a public store, or of odds and ends which have accumulated in a shop. Simmonds.\n\n1. (Naut.)  To make room in, as a ship, for the cargo; to move about, as packages, ballast, so as to permit close stowage; to stow closely; to pack; -- formerly written roomage, and romage. [Obs.] They night bring away a great deal more than they do, if they would take pain in the romaging. Hakluyt. 2. To search or examine thoroughly by looking into every corner, and turning over or removing goods or other things; to examine, as a book, carefully, turning over leaf after leaf. He . . . searcheth his pockets, and taketh his keys, and so rummageth all his closets and trunks. Howell. What schoolboy of us has not rummaged his Greek dictionary in vain for a satisfactory account! M. Arnold.\n\nTo search a place narrowly. I have often rummaged for old books in Little Britain and Duck Lane. Swift. [His house] was haunted with a jolly ghost, that . . . . . . rummaged like a rat. Tennyson.
rummager |1. One who rummages. 2. (Naut.)  A person on shipboard whose business was to take charge of stowing the cargo; -- formerly written roomager, and romager. [Obs.] The master must provide a perfect mariner, called a romager, to range and bestow all merchandise. Hakluyt .
rummer |A large and tall glass, or drinking cup. [Obs.] J. Philips.
rummy |Of or pertaining to rum; characteristic of rum; as a rummy flavor.\n\nOne who drinks rum; an habitually intemperate person. [Low]\n\nStrange; odd. [Slang]
rumney |A sort of Spanish wine. [Obs.]
rumor |1. A flying or popular report; the common talk; hence, public fame; notoriety. This rumor of him went forth throughout all Judea, and throughout all the region round about. Luke vii. 17. Great is the rumor of this dreadful knight. Shak. 2. A current story passing from one person to another, without any known authority for its truth; -- in this sense often personified. Rumor next, and Chance, And Tumult, and Confusion, all embroiled. Milton. 3. A prolonged; indistinct noise. [Obs.] Shak.\n\nTo report by rumor; to tell. 'T was rumored My father 'scaped from out the citadel. Dryden.
rumorer |A teller of news; especially, one who spreads false reports. Shak.
rumorous |1. Of or pertaining to a rumor; of the nature of rumors. [Obs.] Sir H. Wotton. 2. Famous; notorious. [Obs.] Bale. 3. Murmuring. [Obs. or Poetic] Drayton.
rump |1. The end of the backbone of an animal, with the parts adjacent; the buttock or buttoks. 2. Among butchers, the piece of beef betwen the sirloin and the aitchbone piece. See Illust. of Beef. 3. Fig.: The hind or tail end; a fag-end; a remnant. Rump Parliament, or The Rump (Eng. Hist.), the remnant of the Long Parliament after the expulsion by Cromwell in 1648 of those who opposed his purposes. It was dissolved by Cromwell in 1653, but twice revived for brief sessions, ending finally in 1659. The rump abolished the House of Lords, the army abolished the Rump, and by this army of saints Cromwell governed. Swift. -- Rump steak, a beefsteak from the rump. Goldsmith.
rump-fed |A Shakespearean word of uncertain meaning. Perhaps \"fattened in the rump, pampered.\" \"The rump-fed ronyon.\",
  "saponacity |The quality or state of being saponaceous.
rumper |A member or a supporter of the Rump Parliament. I. Disraeli.
rumple |To make uneven; to form into irregular inequalities; to wrinkle; to crumple; as, to rumple an apron or a cravat. They would not give a dog's ear of their most rumpled and ragged Scoth paper for twenty of your fairest assignats. Burke.\n\nA fold or plait; a wrinkle. Dryden.
rumpled |Wrinkled; crumpled. Pope.
rumpless |Destitute of a rump.
rumply |Rumpled. Carlyle.
rumpus |A disturbance; noise and confusion; a quarrel. [Colloq.]
rumseller |One who sells rum; one who deals in intoxicating liquors; especially, one who sells spirituous beverages at retail.
run |1. To move, proceed, advance, pass, go, come, etc., swiftly, smoothly, or with quick action; -- said of things animate or inanimate. Hence, to flow, glide, or roll onward, as a stream, a snake, a wagon, etc.; to move by quicker action than in walking, as a person, a horse, a dog. Specifically: -- 2. Of voluntary or personal action: (a) To go swiftly; to pass at a swift pace; to hasten. \"Ha, ha, the fox!\" and after him they ran. Chaucer. (b) To flee, as from fear or danger. As from a bear a man would run for life. Shak. (c) To steal off; to depart secretly. My conscience will serve me to run from this jew. Shak. (d) To contend in a race; hence, to enter into a contest; to become a candidate; as, to run for Congress. Know ye not that they which run in a race run all, but one receiveth the prize So run, that ye may obtain. 1 Cor. ix. 24. (e) To pass from one state or condition to another; to come into a certain condition; -- often with in or into; as, to run into evil practices; to run in debt. Have I not cause to rave and beat my breast, to rend my heart with grief and run distracted Addison. (f) To exert continuous activity; to proceed; as, to run through life; to run in a circle. (g) To pass or go quickly in thought or conversation; as, to run from one subject to another. Virgil, in his first Georgic, has run into a set of precepts foreign to his subject. Addison. (h) To discuss; to continue to think or speak about something; -- with on. (i) To make numerous drafts or demands for payment, as upon a bank; - - with on. (j) To creep, as serpents. 3. Of involuntary motion: (a) To flow, as a liquid; to ascend or descend; to course; as, rivers run to the sea; sap runs up in the spring; her blood ran cold. (b) To proceed along a surface; to extend; to spread. The fire ran along upon the ground. Ex. ix. 23. (c) To become fluid; to melt; to fuse. As wax dissolves, as ice begins to run. Addison. Sussex iron ores run freely in the fire. Woodward. (d) To turn, as a wheel; to revolve on an axis or pivot; as, a wheel runs swiftly round. (e) To travel; to make progress; to be moved by mechanical means; to go; as, the steamboat runs regularly to Albany; the train runs to Chicago. (f) To extend; to reach; as, the road runs from Philadelphia to New York; the memory of man runneth not the contrary. She saw with joy the line immortal run, Each sire impressed, and glaring in his son. Pope. (g) To go back and forth from place to place; to ply; as, the stage runs between the hotel and the station. (h) To make progress; to proceed; to pass. As fast as our time runs, we should be very glad in most part of our lives that it ran much faster. Addison. (i) To continue in operation; to be kept in action or motion; as, this engine runs night and day; the mill runs six days in the week. When we desire anything, our minds run wholly on the good circumstances of it; when it is obtained, our minds run wholly on the bad ones. Swift. (j) To have a course or direction; as, a line runs east and west. Where the generally allowed practice runs counter to it. Locke. Little is the wisdom, where the flight So runs against all reason. Shak. (k) To be in form thus, as a combination of words. The king's ordinary style runneth, \"Our sovereign lord the king.\" Bp. Sanderson. (l) To be popularly known; to be generally received. Men gave them their own names, by which they run a great while in Rome. Sir W. Temple. Neither was he ignorant what report ran of himself. Knolle (m) To have growth or development; as, boys and girls run up rapidly. if the richness of the ground cause turnips to run to leaves. Mortimer. (n) To tend, as to an effect or consequence; to incline. A man's nature runs either to herbs or weeds. Bacon. Temperate climates run into moderate governments. Swift. (o) To spread and blend together; to unite; as, colors run in washing. In the middle of a rainbow the colors are . . . distinguished, but near the borders they run into one another. I. Watts. (p) To have a legal course; to be attached; to continue in force, effect, or operation; to follow; to go in company; as, certain covenants run with the land. Customs run only upon our goods imported or exported, and that but once for all; whereas interest runs as well upon our ships as goods, and must be yearly paid. Sir J. Child. (q) To continue without falling due; to hold good; as, a note has thirty days to run. (r) To discharge pus or other matter; as, an ulcer runs. (s) To be played on the stage a number of successive days or nights; as, the piece ran for six months. (t) (Naut.) To sail before the wind, in distinction from reaching or sailing closehauled; -- said of vessels. 4. Specifically, of horse: To move rapidly in a gait in which each leg acts in turn as a propeller and a supporter, and in which for an instant all the limbs are gathered in the air under the body. Stillman (The Horse in Motion). 5. (Athletics)  To move rapidly by springing steps so that there is an instant in each step when neither foot touches the ground; -- so distinguished from walking in athletic competition. As thing run, according to the usual order, conditions, quality, etc.; on the average; without selection or specification. -- To let run (Naut.), to allow to pass or move freely; to slacken or loosen. -- To run after, to pursue or follow; to search for; to endeavor to find or obtain; as to run after similies. Locke. -- To run away, to flee; to escape; to elope; to run without control or guidance. -- To run away with. (a) To convey away hurriedly; to accompany in escape or elopement. (b) To drag rapidly and with violence; as, a horse runs away with a carriage. -- To run down. (a) To cease to work or operate on account of the exhaustion of the motive power; -- said of clocks, watches, etc. (b) To decline in condition; as, to run down in health. -- To run down a coast, to sail along it. -- To run for an office, to stand as a candidate for an office. -- To run in or into. (a) To enter; to step in. (b) To come in collision with. -- To run in trust, to run in debt; to get credit. [Obs.] -- To run in with. (a) To close; to comply; to agree with. [R.] T. Baker. (b) (Naut.) To make toward; to near; to sail close to; as, to run in with the land. -- To run mad, To run mad after or on. See under Mad. -- To run on. (a) To be continued; as, their accounts had run on for a year or two without a settlement. (b) To talk incessantly. (c) To continue a course. (d) To press with jokes or ridicule; to abuse with sarcasm; to bear hard on. (e) (Print.) To be continued in the same lines, without making a break or beginning a new paragraph. -- To run out. (a) To come to an end; to expire; as, the lease runs out Michaelmas. (b) To extend; to spread. \"Insectile animals . . . run all out into legs.\" Hammond. (c) To expatiate; as, to run out into beautiful digressions. (d) To be wasted or exhausted; to become poor; to become extinct; as, an estate managed without economy will soon run out. And had her stock been less, no doubt She must have long ago run out. Dryden. -- To run over. (a) To overflow; as, a cup runs over, or the liquor runs over. (b) To go over, examine, or rehearse cursorily. (c) To ride or drive over; as, to run over a child. -- To run riot, to go to excess. -- To run through. (a) To go through hastily; as to run through a book. (b) To spend wastefully; as, to run through an estate. -- To run to seed, to expend or exhaust vitality in producing seed, as a plant; figuratively and colloquially, to cease growing; to lose vital force, as the body or mind. -- To run up, to rise; to swell; to grow; to increase; as, accounts of goods credited run up very fast. But these, having been untrimmed for many years, had run up into great bushes, or rather dwarf trees. Sir W. Scott. -- To run with. (a) To be drenched with, so that streams flow; as, the streets ran with blood. (b) To flow while charged with some foreign substance. \"Its rivers ran with gold.\" J. H. Newman.\n\n1. To cause to run (in the various senses of Run, v. i.); as, to run a horse; to run a stage; to run a machine; to run a rope through a block. 2. To pursue in thought; to carry in contemplation. To run the world back to its first original. South. I would gladly understand the formation of a soul, and run it up to its \"punctum saliens.\" Collier. 3. To cause to enter; to thrust; as, to run a sword into or through the body; to run a nail into the foot. You run your head into the lion's mouth. Sir W. Scott. Having run his fingers through his hair. Dickens. 4. To drive or force; to cause, or permit, to be driven. They ran the ship aground. Acts xxvii. 41. A talkative person runs himself upon great inconveniences by blabbing out his own or other's secrets. Ray. Others, accustomed to retired speculations, run natural philosophy into metaphysical notions. Locke. 5. To fuse; to shape; to mold; to cast; as, to run bullets, and the like. The purest gold must be run and washed. Felton. 6. To cause to be draw; to mark out; to indicate; to determine; as, to run a line. 7. To cause to pass, to evade, offical restrictions; to smuggle; -- said of contraband or dutiable goods. heavy impositions . . . are a strong temptation of running goods. Swift. 8. To go through or accomplish by running; as, to run a race; to run a certain career. 9. To cause to stand as a candidate for office; to support for office; as, to run some one for Congress. [Colloq. U.S.] 10. To encounter or incur, as a danger or risk; as, to run the risk of losing one's life. See To run the chance, below. \"He runneth two dangers.\" Bacon. 11. To put at hazard; to venture; to risk. He would himself be in the Highlands to receive them, and run his fortune with them. Clarendon. 12. To discharge; to emit; to give forth copiously; to be bathed with; as, the pipe or faucet runs hot water. At the base of Pompey's statua, Which all the while ran blood, great Cæsar fell. Shak. 13. To be charged with, or to contain much of, while flowing; as, the rivers ran blood. 14. To conduct; to manage; to carry on; as, to run a factory or a hotel. [Colloq. U.S.] 15. To tease with sarcasms and ridicule. [Colloq.] 16. To sew, as a seam, by passing the needle through material in a continuous line, generally taking a series of stitches on the needle at the same time. 17. To migrate or move in schools; -- said of fish; esp., to ascend a river in order to spawn. To run a blockade, to get to, or away from, a blockaded port in safety. -- To run down. (a) (Hunting) To chase till the object pursued is captured or exhausted; as, to run down, a stag. (b) (Naut.) To run against and sink, as a vessel. (c) To crush; to overthrow; to overbear. \"religion is run down by the license of these times.\" Berkeley. (d) To disparage; to traduce. F. W. Newman. -- To run hard. (a) To press in competition; as, to run one hard in a race. (b) To urge or press importunately. (c) To banter severely. -- To run into the ground, to carry to an absurd extreme; to overdo. [Slang, U.S.] -- To run off, to cause to flow away, as a charge of molten metal from a furnace. -- To run on (Print.), to carry on or continue, as the type for a new sentence, without making a break or commencing a new paragraph. -- To run out. (a) To thrust or push out; to extend. (b) To waste; to exhaust; as, to run out an estate. (c) (Baseball) To put out while running between two bases. -- To run the chances, or one's chances, to encounter all the risks of a certain course. -- To run through, to transfix; to pierce, as with a sword. \"[He] was run through the body by the man who had asked his advice.\" Addison. -- To run up. (a) To thrust up, as anything long and slender. (b) To increase; to enlarge by additions, as an account.run up a bill (c) To erect hastily, as a building.\n\n1. The act of running; as, a long run; a good run; a quick run; to go on the run. 2. A small stream; a brook; a creek. 3. That which runs or flows in the course of a certain operation, or during a certain time; as, a run of must in wine making; the first run of sap in a maple orchard. 4. A course; a series; that which continues in a certain course or series; as, a run of good or bad luck. They who made their arrangements in the first run of misadventure . . . put a seal on their calamities. Burke. 5. State of being current; currency; popularity. it is impossible for detached papers to have a general run, or long continuance, if not diversified with humor. Addison. 6. Continued repetition on the stage; -- said of a play; as, to have a run of a hundred successive nights. A canting, mawkish play . . . had an immense run. Macaulay. 7. A continuing urgent demand; especially, a pressure on a bank or treasury for payment of its notes. 8. A range or extent of ground for feeding stock; as, a sheep run. Howitt. 9. (Naut.) (a) The aftermost part of a vessel's hull where it narrows toward the stern, under the quarter (b) The distance sailed by a ship; as, a good run; a run of fifty miles. (c) A voyage; as, run to China. 10. A pleasure excursion; a trip. [Colloq.] A think of giving her a run in London. Dickens. 11. (Mining)  The horizontal distance to which a drift may be carried, either by license of the proprietor of a mine or by the nature of the formation; also, the direction which a vein of ore or other substance takes. 12. (Mus.)  A roulade, or series of running tones. 13. (Mil.)  The greatest degree of swiftness in marching. It is executed upon the same principles as the double-quick, but with greater speed. 14. The act of migrating, or ascending a river to spawn; -- said of fish; also, an assemblage or school of fishes which migrate, or ascend a river for the purpose of spawning. 15. In baseball, a complete circuit of the bases made by a player, which enables him to score one; in cricket, a passing from one wicket to the other, by which one point is scored; as, a player made three runs; the side went out with two hundred runs. The \"runs\" are made from wicket to wicket, the batsmen interchanging ends at each run. R. A. Proctor. 16. A pair or set of millstones. At the long run, now, commonly, In the long run, in or during the whole process or course of things taken together; in the final result; in the end; finally. [Man] starts the inferior of the brute animals, but he surpasses them in the long run. J. H. Newman. -- Home run. (a) A running or returning toward home, or to the point from which the start was made. Cf. Home stretch. (b) (Baseball) See under Home. -- The run, or The common run, etc., ordinary persons; the generality or average of people or things; also, that which ordinarily occurs; ordinary current, course, or kind. I saw nothing else that is superior to the common run of parks. Walpole. Burns never dreamed of looking down on others as beneath him, merely because he was conscious of his own vast superiority to the common run of men. Prof. Wilson. His whole appearance was something out of the common run. W. Irving. -- To let go by the run (Naut.), to loosen and let run freely, as lines; to let fall without restraint, as a sail.\n\n1. Melted, or made from molten material; cast in a mold; as, run butter; run iron or lead. 2. Smuggled; as, run goods. [Colloq.] Miss Edgeworth. Run steel, malleable iron castings. See under Malleable. Raymond.
run-around |A whitlow running around the finger nail, but not affecting the bone. [Colloq.]
runagate |A fugitive; a vagabond; an apostate; a renegade. See Renegade. Bunyan. Wretched runagates from the jail. De Quincey. Who has not been a runagate from duty Hare.
runaway |1. One who, or that which, flees from danger, duty, restraint, etc.; a fugitive. Thou runaway, thou coward, art thou fled Shak. 2. The act of running away, esp. of a horse or teams; as, there was a runaway yesterday.\n\n1. Running away; fleeing from danger, duty, restraint, etc.; as, runaway soldiers; a runaway horse. 2. Accomplished by running away or elopment, or during flight; as, a runaway marriage. 3. (a) Won by a long lead; as, a runaway victory. (b) Very successful; accomplishing success quickly; as, a runaway bestseller.
runcation |A weedling. [Obs.] Evelyn.
runch |The wild radish. Dr. Prior.
runcinate |Pinnately cut with the lobes pointing downwards, as the leaf of the dandelion.
rundel |A moat with water in it; also, a small stream; a runlet. [Prov. Eng.] Halliwell.\n\nA circle. [Prov. Eng.]
rundle |1. A round; a step of a ladder; a rung. Duppa. 2. A ball. [Obs.] Holland. 3. Something which rotates about an axis, as a wheel, or the drum of a capstan. \"An axis or cylinder having a rundle about it.\" Bp. Wilkins. 4. (Mach.)  One of the pins or trundles of a lantern wheel.
rundlet |A small barrel of no certain dimensions. It may contain from 3 to 20 gallons, but it usually holds about 14 [Written also runlet.]
rune |1. A letter, or character, belonging to the written language of the ancient Norsemen, or Scandinavians; in a wider sense, applied to the letters of the ancient nations of Northern Europe in general. Note: The Norsemen had a peculiar alphabet, consisting of sixteen letters, or characters, called runes, the origin of which is lost in the remotest antiquity. The signification of the word rune (mystery) seems to allude to the fact that originally only a few were acquainted with the use of these marks, and that they were mostly applied to secret tricks, witchcrafts and enchantments. But the runes were also used in communication by writing. 2. pl.  Old Norse poetry expressed in runes. Runes were upon his tongue, As on the warrior's sword. Longfellow. Rune stone, a stone bearing a runic inscription.
runer |A bard, or learned man, among the ancient Goths. Sir W. Temple.
rung |imp. & p. p. of Ring.\n\n1. (Shipbuilding)  A floor timber in a ship. 2. One of the rounds of a ladder. 3. One of the stakes of a cart; a spar; a heavy staff. 4. (Mach.)  One of the radial handles projecting from the rim of a steering wheel; also, one of the pins or trundles of a lantern wheel.
runghead |The upper end of a floor timber in a ship.
runic |Of or pertaining to a rune, to runes, or to the Norsemen; as, runic verses; runic letters; runic names; runic rhyme. Runic staff. See Clog almanac, under Clog. -- Runic wand, a willow wand bearing runes, formerly thought to have been used by the heathen tribes of Northern Europe in magical ceremonies.
runlet |A little run or stream; a streamlet; a brook. To trace out to its marshy source every runlet that has cast in its tiny pitcherful with the rest. Lowell.\n\nSame as Rundlet. \"A stoup of sack, or a runlet of canary.\" Sir W. Scott.
runnel |A rivulet or small brook. Buddling rundels joined the sound. Collins. By the very sides of the way . . . there are slow runnels, in which one can see the minnows swimming. Masson.
runner |1. One who, or that which, runs; a racer. 2. A detective. [Slang, Eng.] Dickens. 3. A messenger. Swift. 4. A smuggler. [Colloq.] R. North. 5. One employed to solicit patronage, as for a steamboat, hotel, shop, etc. [Cant, U.S.] 6. (Bot.)  A slender trailing branch which takes root at the joints or end and there forms new plants, as in the strawberry and the common cinquefoil. 7. The rotating stone of a set of millstones. 8. (Naut.)  A rope through a block and used to increase the mechanical power of a tackle. Totten. 9. One of the pieces on which a sled or sleigh slides; also the part or blade of a skate which slides on the ice. 10. (Founding) (a) A horizontal channel in a mold, through which the metal flows to the cavity formed by the pattern; also, the waste metal left in such a channel. (b) A trough or channel for leading molten metal from a furnace to a ladle, mold, or pig bed. 11. The movable piece to which the ribs of an umbrella are attached. 12. (Zoöl.)  A food fish (Elagatis pinnulatis) of Florida and the West Indies; -- called also skipjack, shoemaker, and yellowtail. The name alludes to its rapid successive leaps from the water. 13. (Zoöl.)  Any cursorial bird. 14. (Mech.) (a) A movable slab or rubber used in grinding or polishing a surface of stone. (b) A tool on which lenses are fastened in a group, for polishing or grinding.
runnet |See Rennet.
running |1. Moving or advancing by running. Specifically, of a horse; (a) Having a running gait; not a trotter or pacer. (b) trained and kept for running races; as, a running horse. Law. 2. Successive; one following the other without break or intervention; -- said of periods of time; as, to be away two days running; to sow land two years running. 3. Flowing; easy; cursive; as, a running hand. 4. Continuous; keeping along step by step; as, he stated the facts with a running explanation. \"A running conquest.\" Milton. What are art and science if not a running commentary on Nature Hare. 5. (Bot.)  Extending by a slender climbing or trailing stem; as, a running vine. 6. (med.)  Discharging pus; as, a running sore. Running block (Mech.), a block in an arrangement of pulleys which rises or sinks with the weight which is raised or lowered. -- Running board, a narrow platform extending along the side of a locomotive. -- Running bowsprit (Naut.) Same as Reefing bowsprit. -- Running days (Com.), the consecutive days occupied on a voyage under working days. Simmonds. -- Running fire, a constant fire of musketry or cannon. -- Running gear, the wheels and axles of a vehicle, and their attachments, in distinction from the body; all the working parts of a locomotive or other machine, in distinction from the framework. -- Running hand, a style of rapid writing in which the letters are usually slanted and the words formed without lifting the pen; -- distinguished from round hand. -- Running part (Naut.), that part of a rope that is hauled upon, -- in distinction from the standing part. -- Running rigging (Naut.), that part of a ship's rigging or ropes which passes through blocks, etc.; -- is distinction from standing rigging. -- Running title (Print.), the title of a book or chapter continued from page to page on the upper margin.\n\nThe act of one who, or of that which runs; as, the running was slow. 2. That which runs or flows; the quantity of a liquid which flows in a certain time or during a certain operation; as, the first running of a still. 3. The discharge from an ulcer or other sore. At long running, in the long run. [Obs.] Jer. Taylor.
running load |(a) The air pressure supported by each longitudinal foot segment of a wing. (b) Commonly, the whole weight of aëroplane and load divided by the span, or length from tip to tip.
runningly |In a running manner.
runnion |See Ronion.
runology |The science of runes. -- Ru*nol\"o*gist, n.
runround |A felon or whitlow. [Colloq. U.S.]
runt |1. (Zoöl.)  Any animal which is unusually small, as compared with others of its kind; -- applied particulary to domestic animals. 2. (Zoöl.)  A variety of domestic pigeon, related to the barb and carrier. 3. A dwarf; also, a mean, despicable, boorish person; -- used opprobriously. Before I buy a bargain of such runts, I'll buy a college for bears, and live among 'em. Beau. & Fl. 4. The dead stump of a tree; also, the stem of a plant. [Obs. or Prov. Eng.] Halliwell. Neither young poles nor old runts are durable. Holland.
runty |Like a runt; diminutive; mean.
runway |1. The channel of a stream. 2. The beaten path made, by deer or other animals in passing to and from their feeding grounds.
rupee |A silver coin, and money of account, in the East Indies. Note: The valuation of the rupee of sixteen annas, the standard coin of India, by the United States Treasury departament, varies from time to time with the price silver. In 1889 it was rated at about thirty- two cents.
rupellary |Rocky. [Obs.] \"This rupellary nidary.\" Evelyn. RUPERT'S DROP Ru\"pert's drop`.  A kind of glass drop with a long tail, made by dropping melted glass into water. It is remarkable for bursting into fragments when the surface is scratched or the tail broken; -- so called from Prince Rupert, nephew of Charles I., by whom they were first brought to England. Called also Rupert's ball, and glass tear.
rupia |An eruption upon the skin, consisting of vesicles with inflamed base and filled with serous, purulent, or bloody fluid, which dries up, forming a blackish crust.
rupial |Of or pertaining to rupia.
rupicola |A genus of beautiful South American passerine birds, including the cock of the rock. Note: The species are remarkable for having an elevated fan-shaped crest of feathers on the head, and for the beautiful color of their plumage, which is mostly some delicate shade of yellow or orange.
rupicoline |Rock-inhabiting.
ruption |A breaking or bursting open; breach; rupture. \"By ruption or apertion.\" Wiseman.
ruptuary |One not of noble blood; a plebeian; a roturier. [R.] The exclusion of the French ruptuaries (\"roturiers,\" for history must find a word for this class when it speaks of other nations) from the order of nobility. Chenevix.
rupture |1. The act of breaking apart, or separating; the state of being asunder; as, the rupture of the skin; the rupture of a vessel or fiber; the rupture of a lutestring. Arbuthnot. Hatch from the egg, that soon, Bursting with kindly rupture, forth disclosed Their callow young. Milton. 2. Breach of peace or concord between individuals; open hostility or war between nations; interruption of friendly relations; as, the parties came to a rupture. He knew that policy would desincline Napoleon from a rupture with his family. E. Everett. 3. (Med.)  Hernia. See Hernia. 4. A bursting open, as of a steam boiler, in a less sudden manner than by explosion. See Explosion. Modulus of rupture. (Engin.) See under Modulus. Syn. -- Fracture; breach; break; burst; disruption; dissolution. See Fracture.\n\n1. To part by violence; to break; to burst; as, to rupture a blood vessel. 2. To produce a hernia in.\n\nTo suffer a breach or disruption.
ruptured |Having a rupture, or hernia.
rupturewort |(a) Same as Burstwort. (b) A West Indian plant (Alternanthera polygonoides) somewhat resembling burstwort.
rural |1. Of or pertaining to the country, as distinguished from a city or town; living in the country; suitable for, or resembling, the country; rustic; as, rural scenes; a rural prospect. Here is a rural fellow; . . . He brings you figs. Shak. 2. Of or pertaining to agriculture; as, rural economy. Rural dean. (Eccl.) See under Dean. -- Rural deanery (Eccl.), the state, office, or residence, of a rural dean. Syn. -- Rustic. -- Rural, Rustic. Rural refers to the country itself; as, rural scenes, prospects, delights, etc. Rustic refers to the character, condition, taste, etc., of the original inhabitans of the country, who were generally uncultivated and rude; as, rustic manners; a rustic dress; a rustic bridge; rustic architecture, etc. We turn To where the silver Thames first rural grows. Thomson. Lay bashfulness, that rustic virtue, by; To manly confidence thy throughts apply. Dryden.
rurales |The gossamer-winged butterflies; a family of small butterflies, including the hairstreaks, violets, and theclas.
ruralism |1. The quality or state of being rural; ruralness. 2. A rural idiom or expression.
ruralist |One who leads a rural life. Coventry.
rurality |1. The quality or state of being rural. 2. A rural place. \"Leafy ruralities.\" Carlyle.
ruralize |To render rural; to give a rural appearance to.\n\nTo become rural; to go into the country; to rusticate.
rurally |In a rural manner; as in the country.
ruralness |The quality or state of being rural.
ruricolist |An inhabitant of the country. [R.] Bailey.
ruridecanal |Of or pertaining to a rural dean; as, a ruridecanal district; the ruridecanal intellect. [R.]
rurigenous |Born in the country. [Obs.]
ruse |An artifice; trick; stratagem; wile; fraund; deceit. Ruse de guerre ( Etym: [F.], a stratagem of war.
rush |1. (Bot.)  A name given to many aquatic or marsh-growing endogenous plants with soft, slender stems, as the species of Juncus and Scirpus. Note: Some species are used in bottoming chairs and plaiting mats, and the pith is used in some places for wicks to lamps and rushlights. 2. The merest trifle; a straw. John Bull's friendship is not worth a rush. Arbuthnot. Bog rush. See under Bog. -- Club rush, any rush of the genus Scirpus. -- Flowering rush. See under Flowering. -- Nut rush (a) Any plant of the genus Scleria, rushlike plants with hard nutlike fruits. (b) A name for several species of Cyperus having tuberous roots. -- Rush broom, an Australian leguminous plant (Viminaria denudata), having long, slender branches. Also, the Spanish broom. See under Candle. -- Rush grass, any grass of the genus Vilfa, grasses with wiry stems and one-flowered spikelets. -- Rush toad (Zoöl.), the natterjack. -- Scouring rush (Bot.) Same as Dutch rush, under Dutch. -- Spike rush, any rushlike plant of the genus Eleocharis, in which the flowers grow in dense spikes. -- Sweet rush, a sweet-scented grass of Arabia, etc. (Andropogon schoenanthus), used in Oriental medical practice. -- Wood rush, any plant of the genus Luzula, which differs in some technical characters from Juncus.\n\n1. To move forward with impetuosity, violence, and tumultuous rapidity or haste; as, armies rush to battle; waters rush down a precipice. Like to an entered tide, they all rush by. Shak. 2. To enter into something with undue haste and eagerness, or without due deliberation and preparation; as, to rush business or speculation. They . . . never think it to be a part of religion to rush into the office of princes and ministers. Sprat.\n\n1. To push or urge forward with impetuosity or violence; to hurry forward. 2. To recite (a lesson) or pass (an examination) without an error. [College Cant, U.S.]\n\n1. A moving forward with rapidity and force or eagerness; a violent motion or course; as, a rush of troops; a rush of winds; a rush of water. A gentleman of his train spurred up his horse, and, with a violent rush, severed him from the duke. Sir H. Wotton. 2. Great activity with pressure; as, a rush of business. [Colloq.] 3. A perfect recitation. [College Cant, U.S.] 4. (Football) (a) A rusher; as, the center rush, whose place is in the center of the rush line; the end rush. (b) The act of running with the ball. Bunt rush (Football), a combined rush by main strength. -- Rush line (Football), the line composed of rushers.
rush-bearing |A kind of rural festival at the dedication of a church, when the parishioners brought rushes to strew the church. [Eng.] Nares.
rushbuckler |A bullying and violent person; a braggart; a swashbuckler. [Obs.] That flock of stout, bragging rushbucklers. Robynson (More's Utopia).
rushed |Abounding or covered with rushes.
rusher |One who rushes. Whitlock.\n\nOne who strewed rushes on the floor at dances. [Obs.] B. Jonson.
rushiness |The quality or state of abounding with rushes.
rushingly |In a rushing manner.
rushlight |A rush candle, or its light; hence, a small, feeble light.
rushlike |Resembling a rush; weak.
rushy |1. Abounding with rushes. 2. Made of rushes. Me rushy couch and frugal fare. Goldsmith.
rusine |Of, like, or pertaining to, a deer of the genus Rusa, which includes the sambur deer (Rusa Aristotelis) of India. Rusine antler (Zoöl.), an antler with the brow tyne simple, and the beam forked at the tip.
rusk |1. A kind of light, soft bread made with yeast and eggs, often toasted or crisped in an oven; or a kind of sweetened biscuit. 2. A kind of light, hard cake or bread, as for stores Smart. 3. Bread or cake which has been made brown and crisp, and afterwards grated, or pulverized in a mortar.
rusma |A depilatory made of orpiment and quicklime, and used by the Turks. See Rhusma.
russ |1. A Russian, or the Russians. [Rare, except in poetry.] 2. The language of the Russians.\n\nOf or pertaining to the Russians.
russet |1. Of a reddish brown color, or (by some called) a red gray; of the color composed of blue, red, and yellow in equal strength, but unequal proportions, namely, two parts of red to one each of blue and yellow; also, of a yellowish brown color. The morn, in russet mantle clad. Shak. Our summer such a russet livery wears. Dryden. 2. Coarse; homespun; rustic. [R.] Shak.\n\n1. A russet color; a pigment of a russet color. 2. Cloth or clothing of a russet color. 3. A country dress; -- so called because often of a russet color. Dryden. 4. An apple, or a pear, of a russet color; as, the English russet, and the Roxbury russet.
russeting |See Russet, n., 2 and 4.
russety |Of a russet color; russet.
russia |A country of Europe and Asia. Russia iron, a kind of sheet iron made in Russia, having a lustrous blue-black surface. -- Russia leather, a soft kind of leather, made originally in Russia but now elsewhere, having a peculiar odor from being impregnated with an oil obtained from birch bark. It is much used in bookbinding, on account of its not being subject to mold, and being proof against insects. -- Russia matting, matting manufactured in Russia from the inner bark of the linden (Tilia Europæa).
russian |Of or pertaining to Russia, its inhabitants, or language. -- n.  A native or inhabitant of Russia; the language of Russia. Russian bath. See under Bath.
russian church |The established church of the Russian empire. It forms a portion, by far the largest, of the Eastern Church and is governed by the Holy Synod. The czar is the head of the church, but he has never claimed the right of deciding questions of theology and dogma.
russianize |To make Russian, or more or less like the Russians; as, to Russianize the Poles.
russification |The act or process of being Russified.
russify |To Russianize; as, to Russify conquered tribes.
russophile |One who, not being a Russian, favors Russian policy and aggrandizement. -- Rus*soph\"ilism, n. [Chiefly newspaper words.]
russophilist |One who, not being a Russian, favors Russian policy and aggrandizement. -- Rus*soph\"ilism, n. [Chiefly newspaper words.]
russophobe |One who dreads Russia or Russian influence. [Words sometimes found in the newspapers.]
russophobia |Morbid dread of Russia or of Russian influence.
russophobist |One who dreads Russia or Russian influence. [Words sometimes found in the newspapers.]
rust |1. (Chem.)  The reddish yellow coating formed on iron when exposed to moist air, consisting of ferric oxide or hydroxide; hence, by extension, any metallic film of corrosion. 2. (Bot.)  A minute mold or fungus forming reddish or rusty spots on the leaves and stems of cereal and other grasses (Trichobasis Rubigo- vera), now usually believed to be a form or condition of the corn mildew (Puccinia graminis). As rust, it has solitary reddish spores; as corn mildew, the spores are double and blackish. Note: Rust is also applied to many other minute fungi which infest vegetation, such as the species of Ustilago, Uredo, and Lecythea. 3. That which resembles rust in appearance or effects. Specifically: (a) A composition used in making a rust joint. See Rust joint, below. (b) Foul matter arising from degeneration; as, rust on salted meat. (c) Corrosive or injurious accretion or influence. Sacred truths cleared from all rust and dross of human mixtures. Eikon Basilike. Note: Rust is used in the formation of compounds of obvious meaning; as, rust-colored, rust-consumed, rust-eaten, and the like. Rust joint, a joint made between surfaces of iron by filling the space between them with a wet mixture of cast-iron borings, sal ammoniac, and sulphur, which by oxidation becomes hard, and impervious to steam, water, etc. -- Rust mite (Zoöl.), a minute mite (Phytopius oleivorus) which, by puncturing the rind, causes the rust-colored patches on oranges.\n\n1. To contract rust; to be become oxidized. If gold ruste, what shall iron do Chaucer. Our armors now may rust. Dryden. 2. To be affected with the parasitic fungus called rust; also, to acquire a rusty appearance. as plants. 3. Fig.: To degenerate in idleness; to become dull or impaired by inaction. Must I rust in Egypt never more Appear in arms, and be the chief of Greece Dryden.\n\n1. To cause to contract rust; to corrode with rust; to affect with rust of any kind. Keep up your bright swords, for the dew will rust them. Shak. 2. Fig.: To impair by time and inactivity. Johmson.
rustful |Full of rust; resembling rust; causing rust; rusty. \"Rustful sloth.\" Quarles.
rustic |1. Of or pertaining to the country; rural; as, the rustic gods of antiquity. Milton. And many a holy text around she strews, That teach the rustic moralist to die. Gray. She had a rustic, woodland air. Wordsworth. 2. Rude; awkward; rough; unpolished; as, rustic manners. \"A rustic muse.\" Spenser. 3. Coarse; plain; simple; as, a rustic entertainment; rustic dress. 4. Simple; artless; unadorned; unaffected. Pope. Rustic moth (Zoöl.), any moth belonging to Agrotis and allied genera. Their larvæ are called cutworms. See Cutworm. -- Rustic work. (a) (Arch.) Cut stone facing which has the joints worked with grooves or channels, the face of each block projecting beyond the joint, so that the joints are very conspicuous. (b) (Arch. & Woodwork) Summer houses, or furniture for summer houses, etc., made of rough limbs of trees fancifully arranged. Syn. -- Rural; rude; unpolished; inelegant; untaught; artless; honest. See Rural.\n\n1. An inhabitant of the country, especially one who is rude, coarse, or dull; a clown. Hence to your fields, you rustics! hence, away. Pope. 2. A rural person having a natural simplicity of character or manners; an artless, unaffected person. [Poetic]
rustical |Rustic. \"Rustical society.\" Thackeray. -- Rus\"tic*al*ly, adv. -- Rus\"tic*al*ness, n.
rusticate |To go into or reside in the country; to ruralize. Pope.\n\nTo require or compel to reside in the country; to banish or send away temporarily; to impose rustication on. The town is again beginning to be full, and the rusticated beauty sees an end of her banishment. Idler.
rusticated |resembling rustic work. See Rustic work (a), under Rustic.
rustication |1. The act of rusticating, or the state of being rusticated; specifically, the punishment of a student for some offence, by compelling him to leave the institution for a time. 2. (Arch.)  Rustic work.
rusticity |The quality or state of being rustic; rustic manners; rudeness; simplicity; artlessness. The sweetness and rusticity of a pastoral can not be so well expressed in any other tongue as in the Greek, when rightly mixed and qualified with the Doric dialect. Addison. The Saxons were refined from their rusticity. Sir W. Scott.
rusticly |In a rustic manner; rustically. Chapman.
rustily |In a rusty state.
rustiness |The quality or state of being rusty.
rustle |1. To make a quick succession of small sounds, like the rubbing or moving of silk cloth or dry leaves. He is coming; I hear his straw rustle. Shak. Prouder than rustling in unpaid-for silk. Shak. 2. To stir about energetically; to strive to succeed; to bustle about. [Slang, Western U.S.]\n\nTo cause to rustle; as, the wind rustles the leaves.\n\nA quick succession or confusion of small sounds, like those made by shaking leaves or straw, by rubbing silk, or the like; a rustling. When the noise of a torrent, the rustle of a wood, the song of birds, or the play of lambs, had power to fill the attention, and suspend all perception of the course of time. Idler.
rustler |1. One who, or that which, rustles. 2. A bovine animal that can care for itself in any circumstances; also, an alert, energetic, driving person. [Slang, Western U.S.]
rustless |Free from rust.
rusty |1. Covered or affected with rust; as, a rusty knife or sword; rusty wheat. 2. Impaired by inaction, disuse, or neglect. [Hector,] in this dull and long-continued truce, Is rusty grown. Shak. 3. Discolored and rancid; reasty; as, rusty bacon. 4. Surly; morose; crusty; sullen. [Obs. or Prov. Eng.] \"Rusty words.\" Piers Plowman. 5. Rust-colored; dark. \"Rusty blood.\" Spenser. 6. Discolored; stained; not cleanly kept; filthy. The rustly little schooners that bring fire wood from the Brititsh provinces. Hawthorne. 7. (Bot.)  Resembling, or covered with a substance resembling, rust; affected with rust; rubiginous.
rut |1. (Physiol.)  Sexual desire or oestrus of deer, cattle, and various other mammals; heat; also, the period during which the oestrus exists. 2. Roaring, as of waves breaking upon the shore; rote. See Rote.\n\nTo have a strong sexual impulse at the reproductive period; -- said of deer, cattle, etc.\n\nTo cover in copulation. Dryden.\n\nA track worn by a wheel or by habitual passage of anything; a groove in which anything runs. Also used figuratively. in a rut.\n\nTo make a rut or ruts in; -- chiefly used as a past participle or a participial adj; as, a rutted road.
ruta-baga |A kind of turnip commonly with a large and long or ovoid yellowish root; a Swedish turnip. See Turnip.
rutaceous |Of or pertaining to plants of a natural order (Rutacæ) of which the rue is the type, and which includes also the orange, lemon, dittany, and buchu.
rutate |A salt of rutic acid.
ruth |1. Sorrow for the misery of another; pity; tenderness. [Poetic] \"They weep for ruth.\" Chaucer. \"Have ruth of the poor.\" Piers Plowman. To stir up gentle ruth, Both for her noble blood, and for her tender youth. Spenser. 2. That which causes pity or compassion; misery; distress; a pitiful. [Obs.] It had been hard this ruth for to see. Chaucer. With wretched miseries and woeful ruth. Spenser.
ruthenic |Pertaining to, or containing, ruthenium; specifically, designating those compounds in which it has a higher valence as contrasted with ruthenious compounds.
ruthenious |Pertaining to, or containing, ruthenium; designating those compounds in which it has a lower valence as contrasted with ruthenic compounds.
ruthenium |A rare element of the light platinum group, found associated with platinum ores, and isolated as a hard, brittle steel-gray metal which is very infusible. Symbol Ru. Atomic weight 103.5. Specific gravity 12.26. See Platinum metals, under Platinum.
ruthful |Full of ruth; as: (a) Pitiful; tender. (b) Full of sorrow; woeful. (c) Causing sorrow. Shak. -- Ruth\"ful*ly, adv.
ruthless |Having no ruth; cruel; pitiless. Their rage the hostile bands restrain, All but the ruthless monarch of the main. Pope. -- Ruth\"less*ly, adv. -- Ruth\"less*ness, n.
rutic |pertaining to, or obtained from, rue (Ruta); as, rutic acid, now commonly called capric acid.
rutilant |Having a reddish glow; shining. Parchments . . . colored with this rutilant mixture. Evelin.
rutilate |To shine; to emit rays of light. [Obs.] Ure.
rutile |A mineral usually of a reddish brown color, and brilliant metallic adamantine luster, occurring in tetragonal crystals. In composition it is titanium dioxide, like octahedrite and brooklite.
rutilian |Any species of lamellicorn beetles belonging to Rurila and allied genera, as the spotted grapevine beetle (Pelidnota punctata).
rutin |A glucoside resembling, but distinct from, quercitrin. Rutin is found in the leaves of the rue (Ruta graveolens) and other plants, and obtained as a bitter yellow crystalline substance which yields quercitin on decomposition.
rutinose |A disaccharide present in glycosides. Prepared from rutin by hydrolysis with rhamnodiastase. 6-O-a-L-rhamnosyl-D-glucose; C12H22O10.
rutter |A horseman or trooper. [Obs.] Such a regiment of rutters Never defied men braver. Beau. & Fl.\n\nThat which ruts.
rutterkin |An old crafty fox or beguiler -- a word of contempt. [Obs.] Cotgrave.
ruttier |A chart of a course, esp. at sea. [Obs.]
ruttish |Inclined to rut; lustful; libidinous; salacious. Shak. -- Rut\"tish*ness, n.
ruttle |A rattling sound in the throat arising from difficulty of breathing; a rattle. [Obs.]
rutty |Ruttish; lustful.\n\nFull of ruts; as a rutty road.\n\nRooty. [Obs.] Spenser.
rutylene |A liquid hydrocarbon, C10H18, of the acetylene series. It is produced artificially.
ryal |Royal. [Obs.] Chaucer.\n\nSee Rial, and old English coin.
ryder |1. A clause added to a document; a rider. See Rider. [Obs.] 2. Etym: [D. rijder, properly, a rider.]  A gold coin of Zealand [Netherlands] equal to 14 florins, about $ 5.60.
rye |1. (Bot.)  A grain yielded by a hardy cereal grass (Secale cereale), closely allied to wheat; also, the plant itself. Rye constitutes a large portion of the breadstuff used by man. 2. A disease in a hawk. Ainsworth. Rye grass, Italian rye grass, (Bot.) See under Grass. See also Ray grass, and Darnel. -- Wild rye (Bot.), any plant of the genus Elymus, tall grasses with much the appearance of rye.
rynd |A piece of iron crossing the hole in the upper millstone by which the stone is supported on the spindle.
ryot |A peasant or cultivator of the soil. [India] The Indian ryot and the Egyptian fellah work for less pay than any other laborers in the world. The Nation.
rypophagous |Eating, or subsisting on, filth.
rys |A branch. [Obs.] Chaucer.
rysh |Rush, a plant. [Obs.] Chaucer.
rysimeter |See Rhysimeter.
ryth |A ford. [Obs.]
rytina |A genus of large edentulous sirenians, allied to the dugong and manatee, including but one species (R. Stelleri); -- called also Steller's sea cow. [Written also Rhytina.] Note: * It is now extinct, but was formerly abundant at Behring's Island, near Behring's Straits. It was twenty-five feet or more in length, with a thick, blackish, naked skin. The last were killed in 1768 for their oil and flesh.
s |the nineteenth letter of the English alphabet, is a consonanat, and is often called a sibilant, in allusion to its hissing sound. It has two principal sounds; one a more hissing, as in sack, this; the other a vocal hissing (the same as that of z), as in is, wise. Besides these it sometimes has the sounds of sh and zh, as in sure, measure. It generally has its hissing sound at the beginning of words, but in the middle and at the end of words its sound is determined by usage. In a few words it is silent, as in isle, débris. With the letter h it forms the digraph sh. See Guide to pronunciation, t\\'c5 255-261. Note: Both the form and the name of the letter S are derived from the Latin, which got the letter through the Greek from the Phænician. the ultimate origin is Egyptian. S is etymologically most nearly related to c, z, t, and r; as, in ice, OE. is; E. hence, OE. hennes; E. rase, raze; erase, razor; that, G. das; E. reason, F. raison, L. ratio; E. was, were; chair, chaise (see C, Z, T, and R.).
saadh |See Sadh.
saan |Same as Bushmen.
sabadilla |A Mexican liliaceous plant (Schænocaulon officinale); also, its seeds, which contain the alkaloid veratrine. It was formerly used in medicine as an emetic and purgative.
sabaean |Same as Sabianism.
sabaeanism |Same as Sabianism.
sabaeism |See Sabianism.
sabaism |See Sabianism.
sabal |A genus of palm trees including the palmetto of the Southern United States.
sabaoth |1. Armies; hosts. Note: [Used twice in the English Bible, in the phrase \"The Lord of Sabaoth.\"] 2. Incorrectly, the Sabbath.
sabbat |In mediæval demonology, the nocturnal assembly in which demons and sorcerers were thought to celebrate their orgies.
sabbatarian |1. One who regards and keeps the seventh day of the week as holy, aggreeably to the letter of the fourth commandment in the Decalogue. Note: There were Christians in the early church who held this opinion, and certain Christians, esp. the Seventh-day Baptists, hold it now. 2. A strict observer of the Sabbath.\n\nOf or pertaining to the Sabbath, or the tenets of Sabbatarians.
sabbatarianism |The tenets of Sabbatarians. Bp. Ward. (1673).
sabbath |1. A season or day of rest; one day in seven appointed for rest or worship, the observance of which was enjoined upon the Jews in the Decalogue, and has been continued by the Christian church with a transference of the day observed from the last to the first day of the week, which is called also Lord's Day. Remember the sabbath day, to keep it holy. Ex. xx. 8. 2. The seventh year, observed among the Israelites as one of rest and festival. Lev. xxv. 4. 3. Fig.: A time of rest or repose; intermission of pain, effort, sorrow, or the like. Peaceful sleep out the sabbath of the tomb. Pope. Sabbath breaker, one who violates the law of the Sabbath. -- Sabbath breaking, the violation of the law of the Sabbath. -- Sabbath-day's journey, a distance of about a mile, which, under Rabbinical law, the Jews were allowed to travel on the Sabbath. Syn. -- Sabbath, Sunday. Sabbath is not strictly synonymous with Sunday. Sabbath denotes the institution; Sunday is the name of the first day of the week. The Sabbath of the Jews is on Saturday, and the Sabbath of most Christians on Sunday. In New England, the first day of the week has been called \"the Sabbath,\" to mark it as holy time; Sunday is the word more commonly used, at present, in all parts of the United States, as it is in England. \"So if we will be the children of our heavenly Father, we must be careful to keep the Christian Sabbathday, which is the Sunday.\" Homilies.
sabbathless |Without Sabbath, or intermission of labor; hence, without respite or rest. Bacon.
sabbatic |Of or pertaining to the Sabbath; resembling the Sabbath; enjoying or bringing an intermission of labor. Sabbatical year (Jewish Antiq.), every seventh year, in which the Israelites were commanded to suffer their fields and vineyards to rest, or lie without tillage.
sabbatical |Of or pertaining to the Sabbath; resembling the Sabbath; enjoying or bringing an intermission of labor. Sabbatical year (Jewish Antiq.), every seventh year, in which the Israelites were commanded to suffer their fields and vineyards to rest, or lie without tillage.
sabbatism |Intermission of labor, as upon the Sabbath; rest. Dr. H. More.
sabbaton |A round-toed, armed covering for the feet, worn during a part of the sixteenth century in both military and civil dress.
sabean |Same as Sabian.
sabeism |Same as Sabianism.
sabella |A genus of tubiculous annelids having a circle of plumose gills around head.
sabellian |Pertaining to the doctrines or tenets of Sabellius. See Sabellian, n.\n\nA follower of Sabellius, a presbyter of Ptolemais in the third century, who maintained that there is but one person in the Godhead, and that the Son and Holy Spirit are only different powers, operations, or offices of the one God the Father.
sabellianism |The doctrines or tenets of Sabellius. See Sabellian, n.
sabelloid |Like, or related to, the genus Sabella. -- Sa*bel\"loid, n.
saber |A sword with a broad and heavy blade, thick at the back, and usually more or less curved like a scimiter; a cavalry sword. Saber fish, or Sabre fish (Zoöl.), the cutlass fish.\n\nTo strike, cut, or kill with a saber; to cut down, as with a saber. You send troops to saber and bayonet us into submission. Burke.
saberbill |The curlew.
sabian |1. Of or pertaining to Saba in Arabia, celebrated for producing aromatic plants. 2. Relating to the religion of Saba, or to the worship of the heavenly bodies.\n\nAn adherent of the Sabian religion; a worshiper of the heavenly bodies. [Written also Sabæan, and Sabean.]
sabianism |The doctrine of the Sabians; the Sabian religion; that species of idolatry which consists in worshiping the sun, moon, and stars; heliolatry. [Written also Sabæanism.]
sabicu |The very hard wood of a leguminous West Indian tree (Lysilona Sabicu), valued for shipbuilding.
sabine |Of or pertaining to the ancient Sabines, a people of Italy. -- n.  One of the Sabine people.\n\nSee Savin.
sable |1. (Zoöl.)  A carnivorous animal of the Weasel family (Mustela zibellina) native of the northern latitudes of Europe, Asia, and America, -- noted for its fine, soft, and valuable fur. Note: The sable resembles the marten, but has a longer head and ears. Its fur consists of a soft under wool, with a dense coat of hair, overtopped by another still longer. It varies greatly in color and quality according to the locality and the season of the year. The darkest and most valuable furs are taken in autumn and winter in the colder parts of Siberia, Russia, and British North America. Note: The American sable, or marten, was formerly considered a distinct species (Mustela Americana), but it differs very little from the Asiatic sable, and is now considered only a geographical variety. 2. The fur of the sable. 3. A mouring garment; a funeral robe; -- generally in the plural. \"Sables wove by destiny.\" Young. 4. (Her.)  The tincture black; -- represented by vertical and horizontal lines each other.\n\nOf the color of the sable's fur; dark; black; -- used chiefly in poetry. Night, sable goddess! from her ebon throne, In rayless majesty, now stretches forth Her leaden scepter o'er a slumbering world. Young. Sable antelope (Zoöl.), a large South African antelope (Hippotragus niger). Both sexes have long, sharp horns. The adult male is black; the female is dark chestnut above, white beneath. -- Sable iron, a superior quality of Russia iron; -- so called because originally stamped with the figure of a sable. -- Sable mouse (Zoöl.), the lemming.\n\nTo render sable or dark; to drape darkly or in black. Sabled all in black the shady sky. G. Fletcher.
sabot |1. A kind of wooden shoe worn by the peasantry in France, Belgium, Sweden, and some other European countries. 2. (Mil.)  A thick, circular disk of wood, to which the cartridge bag and projectile are attached, in fixed ammunition for cannon; also, a piece of soft metal attached to a projectile to take the groove of the rifling.
sabotage |(a) Scamped work. (b) Malicious waste or destruction of an employer's property or injury to his interests by workmen during labor troubles.
sabotiere |A kind of freezer for ices.
sabre |A sword with a broad and heavy blade, thick at the back, and usually more or less curved like a scimiter; a cavalry sword. Saber fish, or Sabre fish (Zoöl.), the cutlass fish.\n\nTo strike, cut, or kill with a saber; to cut down, as with a saber. You send troops to saber and bayonet us into submission. Burke.\n\nSee Saber.
sabrebill |The curlew.
sabretasche |A leather case or pocket worn by cavalry at the left side, suspended from the sword belt. Campbell (Dict. Mil. Sci. ).
sabrina work |A variety of appliqué work for quilts, table covers, etc. Caulfeild & S. (Dict. of Needlework).
sabulose |Growing in sandy places.
sabulosity |The quality of being sabulous; sandiness; grittiness.
sabulous |Sandy; gritty.
sac |See Sace.\n\nThe privilege formerly enjoyed the lord of a manor, of holding courts, trying causes, and imposing fines. Cowell.\n\n1. See 2d Sack. 2. (Biol.)  A cavity, bag, or receptacle, usually containing fluid, and either closed, or opening into another cavity to the exterior; a sack.
sacalait |A kind of fresh-water bass; the crappie. [Southern U.S.]
sacar |See Saker.
saccade |A sudden, violent check of a horse by drawing or twitching the reins on a sudden and with one pull.
saccate |1. (Biol.)  Having the form of a sack or pouch; furnished with a sack or pouch, as a petal. 2. (Zoöl.)  Of or pertaining to the Saccata, a suborder of ctenophores having two pouches into which the long tentacles can be retracted.
saccharate |(a) A salt of saccharic acid. (b) In a wider sense, a compound of saccharose, or any similar carbohydrate, with such bases as the oxides of calcium, barium, or lead; a sucrate.
saccharic |Of, pertaining to, or obtained from, saccharine substances; specifically, designating an acid obtained, as a white amorphous gummy mass, by the oxidation of mannite, glucose, sucrose, etc.
sacchariferous |Producing sugar; as, sacchariferous canes.
saccharify |Toconvert into, or to impregnate with, sugar.
saccharilla |A kind of muslin.
saccharimeter |An instrument for ascertain the quantity of saccharine matter in any solution, as the juice of a plant, or brewers' and distillers' worts. [Written also saccharometer.] Note: The common saccharimeter of the brewer is an hydrometer adapted by its scale to point out the proportion of saccharine matter in a solution of any specific gravity. The polarizing saccharimeter of the chemist is a complex optical apparatus, in which polarized light is transmitted through the saccharine solution, and the proportion of sugar indicated by the relative deviation of the plane of polarization.
saccharimetrical |Of or pertaining to saccharimetry; obtained saccharimetry.
saccharimetry |The act, process or method of determining the amount and kind of sugar present in sirup, molasses, and the like, especially by the employment of polarizing apparatus.
saccharin |A bitter white crystalline substance obtained from the saccharinates and regarded as the lactone of saccharinic acid; -- so called because formerly supposed to be isomeric with cane sugar (saccharose).
saccharinate |(a) A salt of saccharinic acid. (b) A salt of saccharine.
saccharine |Of or pertaining to sugar; having the qualities of sugar; producing sugar; sweet; as, a saccharine taste; saccharine matter.\n\nA trade name for benzoic sulphinide. [Written also saccharin.] C7H5NO3S.
saccharinic |Of, pertaining to, or derived from, saccharin; specifically, designating a complex acid not known in the free state but well known in its salts, which are obtained by boiling dextrose and levulose (invert sugar) with milk of lime.
saccharize |To convert into, or to impregnate with, sugar.
saccharoid |resembling sugar, as in taste, appearance, consistency, or composition; as, saccharoidal limestone.
saccharoidal |resembling sugar, as in taste, appearance, consistency, or composition; as, saccharoidal limestone.
saccharometer |A saccharimeter.
saccharomyces |A genus of budding fungi, the various species of which have the power, to a greater or less extent, or splitting up sugar into alcohol and carbonic acid. They are the active agents in producing fermentation of wine, beer, etc. Saccharomyces cerevisiæ is the yeast of sedimentary beer. Also called Torula.
saccharomycetes |A family of fungi consisting of the one genus Saccharomyces.
saccharonate |A salt of saccharonic acid.
saccharone |(a) A white crystalline substance, C6H8O6, obtained by the oxidation of saccharin, and regarded as the lactone of saccharonic acid. (b) An oily liquid, C6H10O2, obtained by the reduction of saccharin.
saccharonic |Of, pertaining to, or derived from, saccharone; specifically, designating an unstable acid which is obtained from saccharone (a) by hydration, and forms a well-known series of salts.
saccharose |Cane sugar; sucrose; also, in general, any one of the group of which saccharose, or sucrose proper, is the type. See Sucrose.
saccharous |Saccharine.
saccharum |A genus of tall tropical grasses including the sugar cane.
saccholactate |A salt of saccholactactic acid; -- formerly called also saccholate. [Obs.] See Mucate.
saccholactic |Of, pertaining to, or designating, an acid now called mucic acid; saccholic. [Obs.]
saccholic |Saccholatic. [Obs.]
sacchulmate |A salt of sacchulmic acid.
sacchulmic |Of, pertaining to, or designating, an acid obtained as a dark amorphous substance by the long-continued boiling of sucrose with very dilute sulphuric acid. It resembles humic acid. [Written also sacculmic.]
sacchulmin |An amorphous huminlike substance resembling sacchulmic acid, and produced together with it.
sacciferous |Bearing a sac.
sacciform |Having the general form of a sac.
saccoglossa |Same as Pellibranchiata.
saccular |Like a sac; sacciform.
sacculated |Furnished with little sacs.
saccule |A little sac; specifically, the sacculus of the ear.
sacculo-cochlear |pertaining to the sacculus and cochlea of the ear.
sacculo-utricular |Pertaining to the sacculus and utriculus of the ear.
sacculus |A little sac; esp., a part of the membranous labyrinth of the ear. See the Note under Ear.
saccus |A sac.
sacellum |(a) (Rom. Antiq.) An unroofed space consecrated to a divinity. (b) (Eccl.) A small monumental chapel in a church. Shipley.
sacerdotal |Of or pertaining to priests, or to the order of priests; relating to the priesthood; priesty; as, sacerdotal dignity; sacerdotal functions. The ascendency of the sacerdotal order was long the ascendency which naturally and properly belongs to intellectual superiority. Macaulay.
sacerdotalism |The system, style, spirit, or character, of a priesthood, or sacerdotal order; devotion to the interests of the sacerdotal order.
sacerdotally |In a sacerdotal manner.
sachel |A small bag. See Satchel.
sachem |A chief of a tribe of the American Indians; a sagamore.
sachemdom |The government or jurisdiction of a sachem. Dr. T. Dwight.
sachemship |Office or condition of a sachem.
sachet |A scent bag, or perfume cushion, to be laid among handkerchiefe, garments, etc., to perfume them.
saciety |Satiety. [Obs.] Bacon.
sack |A anme formerly given to various dry Spanish wines. \"Sherris sack.\" Shak. Sack posset, a posset made of sack, and some other ingredients.\n\n1. A bag for holding and carrying goods of any kind; a receptacle made of some kind of pliable material, as cloth, leather, and the like; a large pouch. 2. A measure of varying capacity, according to local usage and the substance. The American sack of salt is 215 pounds; the sack of wheat, two bushels. McElrath. 3. Etym: [Perhaps a different word.]  Originally, a loosely hanging garnment for women, worn like a cloak about the shoulders, and serving as a decorative appendage to the gown; now, an outer garment with sleeves, worn by women; as, a dressing saek. [Written also sacque.] 4. A sack coat; a kind of coat worn by men, and extending from top to bottom without a cross seam. 5. (Biol.)  See 2d Sac, 2. Sack bearer (Zoöl.). See Basket worm, under Basket. -- Sack tree (Bot.), an East Indian tree (Antiaris saccidora) which is cut into lengths, and made into sacks by turning the bark inside out, and leaving a slice of the wood for a bottom. -- To give the sack to or get the sack, to discharge, or be discharged, from employment; to jilt, or be jilted. [Slang]\n\n1. To put in a sack; to bag; as, to sack corn. Bolsters sacked in cloth, blue and crimson. L. Wallace. 2. To bear or carry in a sack upon the back or the shoulders. [Colloq.]\n\nthe pillage or plunder, as of a town or city; the storm and plunder of a town; devastation; ravage. The town was stormed, and delivered up to sack, -- by which phrase is to be understood the perpetration of all those outrages which the ruthless code of war allowed, in that age, on the persons and property of the defenseless inhabitants, without regard to sex or age. Prescott.\n\nTo plunder or pillage, as a town or city; to devastate; to ravage. The Romans lay under the apprehension of seeing their city sacked by a barbarous enemy. Addison.
sack-winged |Having a peculiar pouch developed near the front edge of the wing; -- said of certain bats of the genus Saccopteryx.
sackage |The act of taking by storm and pillaging; sack. [R.] H. Roscoe.
sackbut |A brass wind instrument, like a bass trumpet, so contrived that it can be lengthened or shortened according to the tone required; -- said to be the same as the trombone. [Written also sagbut.] Moore (Encyc. of Music). Note: The sackbut of the Scriptures is supposed to have been a stringed instrument.
sackcloth |Linen or cotton cloth such a sacks are made of; coarse cloth; anciently, a cloth or garment worn in mourning, distress, mortification, or penitence. Gird you with sackcloth, and mourn before Abner. 2 Sam. iii. 31. Thus with sackcloth I invest my woe. Sandys.
sackclothed |Clothed in sackcloth.
sacker |One who sacks; one who takes part in the storm and pillage of a town.
sackful |As much as a sack will hold.\n\nBent on plunder. [Obs.] Chapman.
sacking |Stout, coarse cloth of which sacks, bags, etc., are made.
sackless |Quiet; peaceable; harmless; innocent. [Obs. or Prov. Eng.]
sacque |Same as 2d Sack, 3.
sacral |Of or pertaining to the sacrum; in the region of the sacrum.
sacrament |1. The oath of allegiance taken by Roman soldiers; hence, a sacred ceremony used to impress an obligation; a solemn oath-taking; an oath. [Obs.] I'll take the sacrament on't. Shak. 2. The pledge or token of an oath or solemn cobenant; a sacred thing; a mystery. [Obs.] God sometimes sent a light of fire, and pillar of a cloud . . . and the sacrament of a rainbow, to guide his people through their portion of sorrows. Jer. Taylor. 3. (Theol.)  One of the solemn religious ordinances enjoined by Christ, the head of the Christian church, to be observed by his followers; hence, specifically, the eucharist; the Lord's Supper. Syn. -- Sacrament, Eucharist. -- Protestants apply the term sacrament to baptism and the Lord's Supper, especially the latter. The R. Cath. and Greek churches have five other sacraments, viz., confirmation, penance, holy orders, matrimony, and extreme unction. As sacrament denotes an oath or vow, the word has been applied by way of emphasis to the Lord's Supper, where the most sacred vows are renewed by the Christian in commemorating the death of his Redeemer. Eucharist denotes the giving of thanks; and this term also has been applied to the same ordinance, as expressing the grateful remembrance of Christ's sufferings and death. \"Some receive the sacrament as a means to procure great graces and blessings; others as an eucharist and an office of thanksgiving for what they have received.\" Jer. Taylor.\n\nTo bind by an oath. [Obs.] Laud.
sacramental |1. Of or pertaining to a sacrament or the sacraments; of the nature of a sacrament; sacredly or solemny binding; as, sacramental rites or elements. 2. Bound by a sacrament. The sacramental host of God's elect. Cowper.\n\nThat which relates to a sacrament. Bp. Morton.
sacramentalism |The doctrine and use of sacraments; attashment of excessive importance to sacraments.
sacramentalist |One who holds the doctrine of the real objective presence of Christ;s body and blood in the holy eucharist. Shipley.
sacramentally |In a sacrament manner.
sacramentarian |1. (Eccl.)  A name given in the sixteenth century to those German reformers who rejected both the Roman and the Lutheran doctrine of the holy eucharist. 2. One who holds extreme opinions regarding the efficacy of sacraments.\n\n1. Of or pertaining a sacrament, or to the sacramentals; sacramental. 2. Of or pertaining to the Sacramentarians.
sacramentary |1. Of or pertaining a sacrament or the sacraments; sacramental. 2. Of or pertaining to the Sacramentarians.\n\n1. An ancient book of the Roman Catholic Church, written by Pope Gelasius, and revised, corrected, and abridged by St. Gregory, in which were contained the rites for Mass, the sacraments, the dedication of churches, and other ceremonies. There are several ancient books of the same kind in France and Germany. 2. Same as Sacramentarian, n., 1. Papists, Anabaptists, and Sacramentaries. Jer. Taylor.
sacramentize |To administer the sacraments. [R.] Both to preach and sacramentize. Fuller.
sacrarium |1. A sort of family chapel in the houses of the Romans, devoted to a special divinity. 2. The adytum of a temple. Gwilt. 3. In a Christian church, the sanctuary.
sacrate |To consecrate. [Obs.]
sacration |Consecration. [Obs.]
sacre |See Sakker.\n\nTo consecrate; to make sacred. [Obs.] Holland.
sacred |1. Set apart by solemn religious ceremony; especially, in a good sense, made holy; set apart to religious use; consecrated; not profane or common; as, a sacred place; a sacred day; sacred service. 2. Relating to religion, or to the services of religion; not secular; religious; as, sacred history. Smit with the love of sacred song. Milton. 3. Designated or exalted by a divine sanction; possessing the highest title to obedience, honor, reverence, or veneration; entitled to extreme reverence; venerable. Such neighbor nearness to our sacred [royal] blood Should nothing privilege him. Shak. Poet and saint to thee alone were given, The two most sacred names of earth and heaven. Cowley. 4. Hence, not to be profaned or violated; inviolable. Secrets of marriage still are sacred held. Dryden. 5. Consecrated; dedicated; devoted; -- with to. A temple, sacred to the queen oflove. Dryden. 6. Solemnly devoted, in a bad sense, as to evil, vengeance, curse, or the like; accursed; baleful. [Archaic] But, to destruction sacred and devote. Milton. Society of the Sacred Heart (R.C. Ch.), a religious order of women, founded in France in 1800, and approved in 1826. It was introduced into America in 1817. The members of the order devote themselves to the higher branches of female education. -- Sacred baboon. (Zoöl.) See Hamadryas. -- Sacred bean (Bot.), a seed of the Oriental lotus (Nelumbo speciosa or Nelimbium speciosum), a plant resembling a water lily; also, the plant itself. See Lotus. -- Sacred beetle (Zoöl.) See Scarab. -- Sacred canon. See Canon, n., 3. -- Sacred fish (Zoöl.), any one of fresh-water African fishes of the family Mormyridæ. Several large species inhabit the Nile and were considered sacred by the ancient Egyptians; especially Mormyris oxyrhynchus. -- Sacred ibis. See Ibis. -- Sacred monkey. (Zoöl.) (a) Any Asiatic monkey of the genus Semnopitchecus, regarded as sacred by the Hindoos; especially, the entellus. See Entellus. (b) The sacred baboon. See Hamadryas. (c) The blunder monkey. -- Sacred place (Civil Law), the place where a deceased person is buried. Syn. -- Holy; divine; hallowed; consecrated; dedicated; devoted; religious; venerable; reverend. -- Sa\"cred*ly, adv. -- Sa\"cred*ness, n.
sacrific |Employed in sacrifice. [R.] Johnson.
sacrificable |Capable of being offered in sacrifice. [R.] Sir T. Browne.
sacrifical |Employed in sacrifice. [R.] Johnson.
sacrificant |One who offers a sacrifice. [R.]
sacrificator |A sacrificer; one who offers a sacrifice. [R.] Sir T. Browne.
sacrificatory |Offering sacrifice. [R.] Sherwood.
sacrifice |1. The offering of anything to God, or to a god; consecratory rite. Great pomp, and sacrifice, and praises loud, To Dagon. Milton. 2. Anything consecrated and offered to God, or to a divinity; an immolated victin, or an offering of any kind, laid upon an altar, or otherwise presented in the way of religious thanksgiving, atonement, or conciliation. Moloch, horrid king, besmeared with blood Of human sacrifice. Milton. My life, if thou preserv's my life, Thy sacrifice shall be. Addison. 3. Destruction or surrender of anything for the sake of something else; devotion of some desirable object in behalf of a higher object, or to a claim deemed more pressing; hence, also, the thing so devoted or given up; as, the sacrifice of interest to pleasure, or of pleasure to interest. 4. A sale at a price less than the cost or the actual value. [Tradesmen's Cant] Burnt sacrifice. See Burnt offering, under Burnt. -- Sacrifice hit (Baseball), in batting, a hit of such a kind that the batter loses his chance of tallying, but enables one or more who are on bases to get home or gain a base.\n\n1. To make an offering of; to consecrate or present to a divinity by way of expiation or propitiation, or as a token acknowledgment or thanksgiving; to immolate on the altar of God, in order to atone for sin, to procure favor, or to express thankfulness; as, to sacrifice an ox or a sheep. Oft sacrificing bullock, lamb, or kid. Milton. 2. Hence, to destroy, surrender, or suffer to be lost, for the sake of obtaining something; to give up in favor of a higher or more imperative object or duty; to devote, with loss or suffering. Condemned to sacrifice his childish years To babbling ignorance, and to empty fears. Prior. The Baronet had sacrificed a large sum . . . for the sake of . . . making this boy his heir. G. Eliot. 3. To destroy; to kill. Johnson. 4. To sell at a price less than the cost or the actual value. [Tradesmen's Cant]\n\nTo make offerings to God, or to a deity, of things consumed on the altar; to offer sacrifice. O teacher, some great mischief hath befallen To that meek man, who well had sacrificed. Milton.
sacrificer |One who sacrifices.
sacrificial |Of or pertaining to sacrifice or sacrifices; consisting in sacrifice; performing sacrifice. \"Sacrificial rites.\" Jer. Taylor.
sacrilege |The sin or crime of violating or profaning sacred things; the alienating to laymen, or to common purposes, what has been appropriated or consecrated to religious persons or uses. And the hid treasures in her sacred tomb With sacrilege to dig. Spenser. Families raised upon the ruins of churches, and enriched with the spoils of sacrilege. South.
sacrilegious |Violating sacred things; polluted with sacrilege; involving sacrilege; profane; impious. Above the reach of sacrilegious hands. pope. -- Sac`ri*le\"gious*ly, adv. -- Sac`ri*le\"gious*ness, n.
sacrilegist |One guilty of sacrilege.
sacring |a. & n. from Sacre. Sacring bell. See Sanctus bell, under Sanctus.
sacrist |A sacristan; also, a person retained in a cathedral to copy out music for the choir, and take care of the books.
sacristan |An officer of the church who has the care of the utensils or movables, and of the church in general; a sexton.
sacristy |A apartment in a church where the sacred utensils, vestments, etc., are kept; a vestry.
sacro- |A combining form denoting connection with, or relation to, the sacrum, as in sacro-coccyageal, sacro-iliac, sacrosciatic.
sacrosanct |Sacred; inviolable. [R.] Dr. H. More.
sacrosciatic |Of or pertaining to both the sacrum and the hip; as, the sacrosciatic formina formed by the sacrosciatic ligaments which connect the sacrum and hip bone.
sacrovertebral |Of or pertaining to the sacrum and that part of the vertebral column immediately anterior to it; as, the sacrovertebral angle.
sacrum |That part of the vertebral column which is directly connected with, or forms a part of, the pelvis. Note: It may consist of a single vertebra or of several more or less consolidated. In man it forms the dorsal, or posterior, wall of the pelvis, and consists of five united vertebræ, which diminish in size very rapidly to the posterior extremity, which bears the coccyx.
sacs |A tribe of Indians, which, together with the Foxes, formerly occupied the region about Green Bay, Wisconsin. [Written also Sauks.]
sad |1. Sated; satisfied; weary; tired. [Obs.] Yet of that art they can not waxen sad, For unto them it is a bitter sweet. Chaucer. 2. Heavy; weighty; ponderous; close; hard. [Obs., except in a few phrases; as, sad bread.] His hand, more sad than lump of lead. Spenser. Chalky lands are naturally cold and sad. Mortimer. 3. Dull; grave; dark; somber; -- said of colors. \"Sad-colored clothes.\" Walton. Woad, or wade, is used by the dyers to lay the foundation of all sad colors. Mortimer. 4. Serious; grave; sober; steadfast; not light or frivolous. [Obs.] \"Ripe and sad courage.\" Bacon. Which treaty was wisely handled by sad and discrete counsel of both parties. Ld. Berners. 5. Affected with grief or unhappiness; cast down with affliction; downcast; gloomy; mournful. First were we sad, fearing you would not come; Now sadder, that you come so unprovided. Shak. The angelic guards ascended, mute and sad. Milton. 6. Afflictive; calamitous; causing sorrow; as, a sad accident; a sad misfortune. 7. Hence, bad; naughty; troublesome; wicked. [Colloq.] \"Sad tipsy fellows, both of them.\" I. Taylor. Note: Sad is sometimes used in the formation of self-explaining compounds; as, sad-colored, sad-eyed, sad-hearted, sad-looking, and the like. Sad bread, heavy bread. [Scot. & Local, U.S.] Bartlett. Syn. -- Sorrowful; mournful; gloomy; dejected; depressed; cheerless; downcast; sedate; serious; grave; grievous; afflictive; calamitous.\n\nTo make sorrowful; to sadden. [Obs.] How it sadded the minister's spirits! H. Peters.
sadda |A work in the Persian tongue, being a summary of the Zend- Avesta, or sacred books.
sadden |To make sad. Specifically: (a) To render heavy or cohesive. [Obs.] Marl is binding, and saddening of land is the great prejudice it doth to clay lands. Mortimer. (b) To make dull- or sad-colored, as cloth. (c) To make grave or serious; to make melancholy or sorrowful. Her gloomy presence saddens all the scene. Pope.\n\nTo become, or be made, sad. Tennyson.
sadder |Same as Sadda.
saddle |1. A seat for a rider, -- usually made of leather, padded to span comfortably a horse's back, furnished with stirrups for the rider's feet to rest in, and fastened in place with a girth; also, a seat for the rider on a bicycle or tricycle. 2. A padded part of a harness which is worn on a horse's back, being fastened in place with a girth. It serves various purposes, as to keep the breeching in place, carry guides for the reins, etc. 3. A piece of meat containing a part of the backbone of an animal with the ribs on each side; as, a saddle of mutton, of venison, etc. 4. (Naut.)  A block of wood, usually fastened to some spar, and shaped to receive the end of another spar. 5. (Mach.)  A part, as a flange, which is hollowed out to fit upon a convex surface and serve as a means of attachment or support. 6. (Zoöl.)  The clitellus of an earthworm. 7. (Arch.)  The threshold of a door, when a separate piece from the floor or landing; -- so called because it spans and covers the joint between two floors. Saddle bar (Arch.), one the small iron bars to which the lead panels of a glazed window are secured. Oxf. Gloss. -- Saddle gall (Far.), a sore or gall upon a horse's back, made by the saddle. -- Saddle girth, a band passing round the body of a horse to hold the saddle in its place. -- saddle horse, a horse suitable or trained for riding with a saddle. -- Saddle joint, in sheet-metal roofing, a joint formed by bending up the edge of a sheet and folding it downward over the turned-up edge of the next sheet. -- Saddle roof (Arch.), a roof having two gables and one ridge; -- said of such a roof when used in places where a different form is more common; as, a tower surmounted by a saddle roof. Called also saddleback roof. -- Saddle shell (Zoöl.), any thin plicated bivalve shaell of the genera Placuna and Anomia; -- so called from its shape. Called also saddle oyster.\n\n1. To put a saddle upon; to equip (a beast) for riding. \"saddle my horse.\" Shak. Abraham rose up early saddled his ass. Gen. xxii. 3. 2. Hence: To fix as a charge or burden upon; to load; to encumber; as, to saddle a town with the expense of bridges and highways.
saddle-backed |1. Having the outline of the upper part concave like the seat of a saddle. 2. Having a low back and high neck, as a horse.
saddle-shaped |Shaped like a saddle. Specifically: (a) (Bot.) Bent down at the sides so as to give the upper part a rounded form. Henslow. (b) (Geol.) Bent on each side of a mountain or ridge, without being broken at top; -- said of strata.
saddleback |Same as Saddle-backed. Saddleback roof. (Arch.) See Saddle roof, under Saddle.\n\n1. Anything saddle-backed; esp., a hill or ridge having a concave outline at the top. 2. (Zoöl.) (a) The harp seal. (b) The great blackbacked gull (Larus marinus). (c) The larva of a bombycid moth (Empretia stimulea) which has a large, bright green, saddle-shaped patch of color on the back.
saddlebags |Bags, usually of leather, united by straps or a band, formerly much used by horseback riders to carry small articles, one bag hanging on each side.
saddlebow |The bow or arch in the front part of a saddle, or the pieces which form the front.
saddlecloth |A cloth under a saddle, and extending out behind; a housing.
saddled |Having a broad patch of color across the back, like a saddle; saddle-backed.
saddler |One who makes saddles. 2. (Zoöl.)  A harp seal.
saddlery |1. The materials for making saddles and harnesses; the articles usually offered for sale in a saddler's shop. 2. The trade or employment of a saddler.
saddletree |The frame of a saddle. For saddletree scarce reached had he, His journey to begin. Cowper.
sadducaic |Pertaining to, or like, the Sadducees; as, Sadducaic reasonings.
sadducee |One of a sect among the ancient Jews, who denied the resurrection, a future state, and the existence of angels. -- Sad`du*ce\"an, a.
sadduceeism |The tenets of the Sadducees.
sadducism |The tenets of the Sadducees.
sadducize |To adopt the principles of the Sadducees. Atterbury.
sadh |A member of a monotheistic sect of Hindoos. Sadhs resemble the Quakers in many respects. Balfour (cyc. of India).
sadiron |An iron for smoothing clothes; a flatiron.
sadly |1. Wearily; heavily; firmly. [Obs.] In go the spears full sadly in arest. Chaucer. 2. Seriously; soberly; gravely. [Obs.] To tell thee sadly, shepherd, without blame Or our neglect, we lost her as we came. Milton. 3. Grievously; deeply; sorrowfully; miserably. \"He sadly suffers in their grief.\" Dryden.
sadness |1. Heaviness; firmness. [Obs.] 2. Seriousness; gravity; discretion. [Obs.] Her sadness and her benignity. Chaucer. 3. Quality of being sad, or unhappy; gloominess; sorrowfulness; dejection. Dim sadness did not spare That time celestial visages. Milton. Syn. -- Sorrow; heaviness; dejection. See Grief.
sadr |A plant of the genus Ziziphus (Z. lotus); -- so called by the Arabs of Barbary, who use its berries for food. See Lotus (b).
saengerbund |A singers' union; an association of singers or singing clubs, esp. German.
saengerfest |A festival of singers; a German singing festival.
safe |1. Free from harm, injury, or risk; untouched or unthreatened by danger or injury; unharmed; unhurt; secure; whole; as, safe from disease; safe from storms; safe from foes. \"And ye dwelled safe.\" 1 Sam. xii. 11. They escaped all safe all safe to land. Acts xxvii. 44. Established in a safe, unenvied throne. Milton. 2. Conferring safety; securing from harm; not exposing to danger; confining securely; to be relied upon; not dangerous; as, a safe harbor; a safe bridge, etc. \"The man of safe discretion.\" Shak. The King of heaven hath doomed This place our dungeon, not our safe retreat. Milton. 3. Incapable of doing harm; no longer dangerous; in secure care or custody; as, the prisoner is safe. But Banquo's safe Ay, my good lord, safe in a ditch he bides. Shak. Safe hit (Baseball), a hit which enables the batter to get to first base even if no error is made by the other side. Syn. -- Secure; unendangered; sure.\n\nA place for keeping things in safety. Specifically: (a) A strong and fireproof receptacle (as a movable chest of steel, etc., or a closet or vault of brickwork) for money, valuable papers, or the like. (b) A ventilated or refrigerated chest or closet for securing provisions from noxious animals or insects.\n\nTo render safe; to make right. [Obs.] Shak.
safe-conduct |That which gives a safe, passage; either (a) a convoy or guard to protect a person in an enemy's country or a foreign country, or (b) a writing, pass, or warrant of security, given to a person to enable him to travel with safety. Shak.\n\nTo conduct safely; to give safe-conduct to. [POetic] He him by all the bonds of love besought To safe-conduct his love. Spenser.
safe-keeping |The act of keeping or preserving in safety from injury or from escape; care; custody.
safe-pledge |A surety for the appearance of a person at a given time. Bracton.
safeguard |1. One who, or that which, defends or protects; defense; protection. Shak. Thy sword, the safeguard of thy brother's throne. Granwille. 2. A convoy or guard to protect a traveler or property. 3. A pass; a passport; a safe-conduct. Shak.\n\nTo guard; to protect. Shak.
safely |In a safe manner; danger, injury, loss, or evil consequences.
safeness |The quality or state of being safe; freedom from hazard, danger, harm, or loss; safety; security; as the safeness of an experiment, of a journey, or of a possession.
safety |1. The condition or state of being safe; freedom from danger or hazard; exemption from hurt, injury, or loss. Up led by thee, Into the heaven I have presumed, An earthly guest . . . With like safety guided down, Return me to my native element. Milton. 2. Freedom from whatever exposes one to danger or from libility to cause danger or harm; safeness; hence, the quality of making safe or secure, or of giving confidence, justifying trust, insuring against harm or loss, etc. Would there were any safety in thy sex, That I might put a thousand sorrows off. Beau. & Fl. 3. Preservation from escape; close custody. Imprison him, . . . Deliver him to safety; and return. Shak. 4. (Football)  Same as Safety touchdown, below. Safety arch (Arch.), a discharging arch. See under Discharge, v. t. -- Safety belt, a belt made of some buoyant material, or which is capable of being inflated, so as to enable a person to float in water; a life preserver. -- Safety buoy, a buoy to enable a person to float in water; a safety belt. -- Safety cage (Mach.), a cage for an elevator or mine lift, having appliances to prevent it from dropping if the lifting rope should break. -- Safety lamp. (Mining) See under Lamp. -- Safety match, a match which can be ignited only on a surface specially prepared for the purpose. -- Safety pin, a pin made in the form of a clasp, with a guard covering its point so that it will not prick the wearer. -- safety plug. See Fusible plug, under Fusible. -- Safety switch. See Switch. -- Safety touchdown (Football), the act or result of a player's touching to the ground behind his own goal line a ball which received its last impulse from a man on his own side; -- distinguished from touchback. See Touchdown. -- Safety tube (Chem.), a tube to prevent explosion, or to control delivery of gases by an automatic valvular connection with the outer air; especially, a bent funnel tube with bulbs for adding those reagents which produce unpleasant fumes or violent effervescence. -- Safety valve, a valve which is held shut by a spring or weight and opens automatically to permit the escape of steam, or confined gas, water, etc., from a boiler, or other vessel, when the pressure becomes too great for safety; also, sometimes, a similar valve opening inward to admit air to a vessel in which the pressure is less than that of the atmosphere, to prevent collapse.
safety bicycle |A bicycle with equal or nearly equal wheels, usually 28 inches diameter, driven by pedals connected to the rear (driving) wheel by a multiplying gear.
safety chain |(a) (Railroads) A normally slack chain for preventing excessive movement between a truck and a car body in sluing. (b) An auxiliary watch chain, secured to the clothes, usually out of sight, to prevent stealing of the watch. (c) A chain of sheet metal links with an elongated hole through each broad end, made up by doubling the first link on itself, slipping the next link through and doubling, and so on.
safflow |The safflower. [Obs.]
safflower |1. (Bot.)  An annual composite plant (Carthamus tinctorius), the flowers of which are used as a dyestuff and in making rouge; bastard, or false, saffron. 2. The died flowers of the Carthamus tinctorius. 3. A dyestuff from these flowers. See Safranin (b). Oil of safflower, a purgative oil expressed from the seeds of the safflower.
saffron |1. (Bot.)  A bulbous iridaceous plant (Crocus sativus) having blue flowers with large yellow stigmas. See Crocus. 2. The aromatic, pungent, dried stigmas, usually with part of the stile, of the Crocus sativus. Saffron is used in cookery, and in coloring confectionery, liquors, varnishes, etc., and was formerly much used in medicine. 3. An orange or deep yellow color, like that of the stigmas of the Crocus sativus. Bastard saffron, Dyer's saffron. (Bot.) See Safflower. -- Meadow saffron (Bot.), a bulbous plant (Colchichum autumnate) of Europe, resembling saffron. -- Saffron wood (Bot.), the yellowish wood of a South African tree (Elæodendron croceum); also, the tree itself. -- Saffron yellow, a shade of yellow like that obtained from the stigmas of the true saffron (Crocus sativus).\n\nHaving the color of the stigmas of saffron flowers; deep orange-yellow; as, a saffron face; a saffron streamer.\n\nTo give color and flavor to, as by means of saffron; to spice. [Obs.] And in Latyn I speak a wordes few, To saffron with my predication. Chaucer.
saffrony |Having a color somewhat like saffron; yellowish. Lord (1630).
safranin |(a) An orange-red dyestuff extracted from the saffron. [R.] (b) A red dyestuff extracted from the safflower, and formerly used in dyeing wool, silk, and cotton pink and scarlet; -- called also Spanish red, China lake, and carthamin. (c) An orange-red dyestuff prepared from certain nitro compounds of creosol, and used as a substitute for the safflower dye.
safranine |An orange-red nitrogenous dyestuff produced artificailly by oxidizing certain aniline derivatives, and used in dyeing silk and wool; also, any one of the series of which safranine proper is the type.
sag |1. To sink, in the middle, by its weight or under applied pressure, below a horizontal line or plane; as, a line or cable supported by its ends sags, though tightly drawn; the floor of a room sags; hence, to lean, give way, or settle from a vertical position; as, a building may sag one way or another; a door sags on its hinges. 2. Fig.: To lose firmness or elasticity; to sink; to droop; to flag; to bend; to yield, as the mind or spirits, under the pressure of care, trouble, doubt, or the like; to be unsettled or unbalanced. [R.] the mind I sway by, and the heart I bear, Shall never sag with doubt nor shake with fear. Shak. 3. To loiter in walking; to idle along; to drag or droop heavily. To sag to leeward (Naut.), to make much leeway by reason of the wind, sea, or current; to drift to leeward; -- said of a vessel. Totten.\n\nTo cause to bend or give way; to load.\n\nState of sinking or bending; sagging.
saga |A Scandinavian legend, or heroic or mythic tradition, among the Norsemen and kindred people; a northern European popular historical or religious tale of olden time. And then the blue-eyed Norseman told A saga of the days of old. Longfellow.
sagacious |1. Of quick sense perceptions; keen-scented; skilled in following a trail. Sagacious of his quarry from so far. Milton. 2. Hence, of quick intellectual perceptions; of keen penetration and judgment; discerning and judicious; knowing; far-sighted; shrewd; sage; wise; as, a sagacious man; a sagacious remark. Instinct . . . makes them, many times, sagacious above our apprehension. Dr. H. More. Only sagacious heads light on these observations, and reduce them into general propositions. Locke. Syn. -- See Shrewd. -- Sa*ga\"cious*ly, adv. -- Sa-ga\"cious*ness, n.
sagacity |The quality of being sagacious; quickness or acuteness of sense perceptions; keenness of discernment or penetration with soundness of judgment; shrewdness. Some [brutes] show that nice sagacity of smell. Cowper. Natural sagacity improved by generous education. V. Knox. Syn. -- Penetration; shrewdness; judiciousness. -- Sagacity, Penetration. Penetration enables us to enter into the depths of an abstruse subject, to detect motives, plans, etc. Sagacity adds to penetration a keen, practical judgment, which enables one to guard against the designs of others, and to turn everything to the best possible advantage.
sagamore |1. Etym: [Cf. Sachem.]  The head of a tribe among the American Indians; a chief; -- generally used as synonymous with sachem, but some writters distinguished between them, making the sachem a chief of the first rank, and a sagamore one of the second rank. \"Be it sagamore, sachem, or powwow.\" Longfellow. 2. A juice used in medicine. [Obs.] Johnson.
sagapen |Sagapenum.
sagapenum |A fetid gum resin obtained from a species of Ferula. It has been used in hysteria, etc., but is now seldom met with. U. S. Disp.
sagathy |A mixed woven fabric of silk and cotton; or silk and wool; sayette; also, a light woolen fabric.
sage |(a) A suffriticose labiate plant (Salvia officinalis) with grayish green foliage, much used in flavoring meats, etc. The name is often extended to the whole genus, of which many species are cultivated for ornament, as the scarlet sage, and Mexican red and blue sage. (b) The sagebrush. Meadow sage (Bot.), a blue-flowered species of salvia (S. pratensis) growing in meadows in Europe. -- Sage cheese, cheese flavored with sage, and colored green by the juice of leaves of spanish and other plants which are added to the milk. -- Sage cock (Zoöl.), the male of the sage grouse; in a more general sense, the specific name of the sage grouse. -- Sage green, of a dull grayish green color, like the leaves of garden sage. -- Sage grouse (Zoöl.), a very large American grouse (Centrocercus urophasianus), native of the dry sagebrush plains of Western North America. Called also cock of the plains. The male is called sage cock, and the female sage hen. -- Sage hare, or Sage rabbit (Zoöl.), a species of hare (Lepus Nuttalli, or artemisia) which inhabits the regions of Western North America and lives among sagebrush. By recent writers it is considered to be merely a variety of the common cottontail, or wood rabbit. -- Sage hen (Zoöl.), the female of the sage grouse. Sage sparrow (Zoöl.), a small sparrow (Amphispiza Belli, var Nevadensis) which inhabits the dry plains of the Rocky Mountain region, living among sagebrush. -- Sage thrasher (Zoöl.), a singing bird (Oroscoptes montanus) which inhabits the sagebrush plains of Western North America. -- Sage willow (Bot.), a species of willow (Salix tristis) forming a low bush with nearly sessile grayish green leaves.\n\n1. Having nice discernment and powers of judging; prudent; grave; sagacious. All you sage counselors, hence! Shak. 2. Proceeding from wisdom; well judged; shrewd; well adapted to the purpose. Commanders, who, cloaking their fear under show of sage advice, counseled the general to retreat. Milton. 3. Grave; serious; solemn. [R.] \"[Great bards.] in sage and solemn tunes have sung.\" Milton. Syn. -- Wise; sagacious; sapient; grave; prudent; judicious.\n\nA wise man; a man of gravity and wisdom; especially, a man venerable for years, and of sound judgment and prudence; a grave philosopher. At his birth a star, Unseen before in heaven, proclaims him come, And guides the Eastern sages. Milton.
sagebrush |A low irregular shrub (Artemisia tridentata), of the order Compositæ, covering vast tracts of the dry alkaline regions of the American plains; -- called also sagebush, and wild sage.
sagebrush state |Nevada; -- a nickname.
sagely |In a sage manner; wisely.
sagene |A Russian measure of length equal to about seven English feet.
sageness |The quality or state of being sage; wisdom; sagacity; prudence; gravity. Ascham.
sagenite |Acicular rutile occurring in reticulated forms imbedded in quartz.
sagenitic |Resembling sagenite; -- applied to quartz when containing acicular crystals of other minerals, most commonly rutile, also tourmaline, actinolite, and the like.
sagger |1. A pot or case of fire clay, in which fine stoneware is inclosed while baking in the kiln; a segga. 2. The clay of which such pots or cases are made.
sagging |A bending or sinking between the ends of a thing, in consequence of its own, or an imposed, weight; an arching downward in the middle, as of a ship after straining. Cf. Hogging.
saginate |To make fat; to pamper. [R.] \"Many a saginated boar.\" Cowper.
sagination |The act of fettening or pampering. [R.] Topsell.
sagitta |1. (Astron.)  A small constellation north of Aquila; the Arrow. 2. (Arch.)  The keystone of an arch. [R.] gwitt. 3. (Geom.)  The distance from a point in a curve to the chord; also, the versed sine of an arc; -- so called from its resemblance to an arrow resting on the bow and string. [Obs.] 4. (Anat.)  The larger of the two otoliths, or ear bones, found in most fishes. 5. (Zoöl.)  A genus of transparent, free-swimming marine worms having lateral and caudal fins, and capable of swimming rapidly. It is the type of the class Chætognatha.
sagittal |1. Of or pertaining to an arrow; resembling an arrow; furnished with an arowlike appendage. 2. (Anat.) (a) Of or pertaining to the sagittal suture; in the region of the sagittal suture; rabdoidal; as, the sagittal furrow, or groove, on the inner surface of the roof of the skull. (b) In the mesial plane; as, a sagittal section of an animal. Sagittal suture (Anat.), the suture between the two parietal bones in the top of the skull; -- called also rabdoidal suture, and interparietal suture.
sagittarius |(a) The ninth of the twelve signs of the zodiac, which the sun enters about November 22, marked thus [&sagittarius;] in almanacs; the Archer. (b) A zodiacal constellation, represented on maps and globes as a centaur shooting an arrow.
sagittary |1. (Myth.)  A centaur; a fabulous being, half man, half horse, armed with a bow and quiver. Shak. 2. The Arsenal in Venice; -- so called from having a figure of an archer over the door. Shak.\n\nPertaining to, or resembling, an arrow. Sir T. Browne.
sagittate |Shaped like an arrowhead; triangular, with the two basal angles prolonged downward.
sagittated |Sagittal; sagittate.
sagittocyst |A defensive cell containing a minute rodlike structure which may be expelled. Such cells are found in certain Turbellaria.
sago |A dry granulated starch imported from the East Indies, much used for making puddings and as an article of diet for the sick; also, as starch, for stiffening textile fabrics. It is prepared from the stems of several East Indian and Malayan palm trees, but chiefly from the Metroxylon Sagu; also from several cycadaceous plants (Cycas revoluta, Zamia integrifolia, atc.). Portland sago, a kind of sago prepared from the corms of the cuckoopint (Arum maculatum). -- Sago palm. (Bot.) (a) A palm tree which yields sago. (b) A species of Cycas (Cycas revoluta). -- Sago spleen (Med.), a morbid condition of the spleen, produced by amyloid degeneration of the organ, in which a cross section shows scattered gray translucent bodies looking like grains of sago.
sagoin |A marmoset; -- called also sagouin.
sagum |The military cloak of the Roman soldiers.
sagus |A genus of palms from which sago is obtained.
sagy |Full of sage; seasoned with sage.
saheb |A respectful title or appelation given to Europeans of rank. [India]
sahib |A respectful title or appelation given to Europeans of rank. [India]
sahibah |A lady; mistress. [India]
sahidic |Same as Thebaic.
sahlite |See Salite.
sahui |A marmoset.
sai |See Capuchin, 3 (a).
saibling |A European mountain trout (Salvelinus alpinus); -- called also Bavarian charr.
saic |A kind of ketch very common in the Levant, which has neither topgallant sail nor mizzen topsail.
said |imp. & p. p. of Say.\n\nbefore-mentioned; already spoken of or specified; aforesaid; -- used chiefly in legal style.
saiga |An antelope (Saiga Tartarica) native of the plains of Siberia and Eastern Russia. The male has erect annulated horns, and tufts of long hair beneath the eyes and ears.
saikyr |Same as Saker. [Obs.]
sail |1. An extent of canvas or other fabric by means of which the wind is made serviceable as a power for propelling vessels through the water. Behoves him now both sail and oar. Milton. 2. Anything resembling a sail, or regarded as a sail. 3. A wing; a van. [Poetic] Like an eagle soaring To weather his broad sails. Spenser . 4. the extended surface of the arm of a windmill. 5. A sailing vessel; a vessel of any kind; a craft. Note: In this sense, the plural has usually the same forms as the singular; as, twenty sail were in sight. 6. A passage by a sailing vessel; a journey or excursion upon the water. Note: Sails are of two general kinds, fore-and-aft sails, and square sails. Square sails are always bent to yards, with their foot lying across the line of the vessel. Fore-and-aft sails are set upon stays or gaffs with their foot in line with the keel. A fore-and-aft sail is triangular, or quadrilateral with the after leech longer than the fore leech. Square sails are quardrilateral, but not necessarily square. See Phrases under Fore, a., and Square, a.; also, Bark, Brig, Schooner, Ship, Stay. Sail burton (Naut.), a purchase for hoisting sails aloft for bending. -- Sail fluke (Zoöl.), the whiff. -- Sail hook, a small hook used in making sails, to hold the seams square. -- Sail loft, a loft or room where sails are cut out and made. -- Sail room (Naut.), a room in a vessel where sails are stowed when not in use. -- Sail yard (Naut.), the yard or spar on which a sail is extended. -- Shoulder-of-mutton sail (Naut.), a triangular sail of peculiar form. It is chiefly used to set on a boat's mast. -- To crowd sail. (Naut.) See under Crowd. -- To loose sails (Naut.), to unfurl or spread sails. -- To make sail (Naut.), to extend an additional quantity of sail. -- To set a sail (Naut.), to extend or spread a sail to the wind. -- To set sail (Naut.), to unfurl or spread the sails; hence, to begin a voyage. -- To shorten sail (Naut.), to reduce the extent of sail, or take in a part. -- To strike sail (Naut.), to lower the sails suddenly, as in saluting, or in sudden gusts of wind; hence, to acknowledge inferiority; to abate pretension. -- Under sail, having the sails spread.\n\n1. To be impelled or driven forward by the action of wind upon sails, as a ship on water; to be impelled on a body of water by the action of steam or other power. 2. To move through or on the water; to swim, as a fish or a water fowl. 3. To be conveyed in a vessel on water; to pass by water; as, they sailed from London to Canton. 4. To set sail; to begin a voyage. 5. To move smoothly through the air; to glide through the air without apparent exertion, as a bird. As is a winged messenger of heaven, . . . When he bestrides the lazy pacing clouds, And sails upon the bosom of the air. Shak.\n\n1. To pass or move upon, as in a ship, by means of sails; hence, to move or journey upon(the water) by means of steam or other force. A thousand ships were manned to sail the sea. Dryden. 2. To fly through; to glide or move smoothly through. Sublime she sails The aërial space, and mounts the winged gales. Pope. 3. To direct or manage the motion of, as a vessel; as, to sail one's own ship. Totten.
sailable |Capable of being sailed over; navigable; as, a sailable river.
sailboat |A boat propelled by a sail or sails.
sailcloth |Duck or canvas used in making sails.
sailer |1. A sailor. [R.] Sir P. Sidney. 2. A ship or other vessel; -- with qualifying words descriptive of speed or manner of sailing; as, a heavy sailer; a fast sailer.
sailfish |(a) The banner fish, or spikefish (Histiophorus.) (b) The basking, or liver, shark. (c) The quillback.
sailing |1. The act of one who, or that which, sails; the motion of a vessel on water, impelled by wind or steam; the act of starting on a voyage. 2. (Naut.)  The art of managing a vessel; seamanship; navigation; as, globular sailing; oblique sailing. Note: For the several methods of sailing, see under Circular, Globular, Oblique, Parallel, etc. Sailing master (U. S. Navy), formerly, a warrant officer, ranking next below a lieutenant, whose duties were to navigate the vessel; and under the direction of the executive officer, to attend to the stowage of the hold, to the cables, rigging, etc. The grade was merged in that of master in 1862.
sailless |Destitute of sails. Pollok.
sailmaker |One whose occupation is to make or repair sails. -- Sail\"mak`ing, n.
sailor |One who follows the business of navigating ships or other vessels; one who understands the practical management of ships; one of the crew of a vessel; a mariner; a common seaman. Syn. -- Mariner; seaman; seafarer. Sailor's choice. (Zoöl.) (a) An excellent marine food fish (Diplodus, or Lagodon, rhomboides) of the Southern United States; -- called also porgy, squirrel fish, yellowtail, and salt-water bream. (b) A species of grunt (Orthopristis, or Pomadasys, chrysopterus), an excellent food fish, common on the southern coasts of the United States; -- called also hogfish, and pigfish.
saily |Like a sail. [R.] Drayton.
saim |Lard; grease. [Scot. & Prov. Eng.]
saimir |The squirrel monkey.
sain |Said. Shak.\n\nTo sanctify; to bless so as to protect from evil influence. [R.] Sir W. Scott.
sainfoin |(a) A leguminous plant (Onobrychis sativa) cultivated for fodder. [Written also saintfoin.] (b) A kind of tick trefoil (Desmodium Canadense). [Canada]
saint |1. A person sanctified; a holy or godly person; one eminent for piety and virtue; any true Christian, as being redeemed and consecrated to God. Them that are sanctified in Christ Jesus, called to be saints. 1 Cor. i. 2. 2. One of the blessed in heaven. Then shall thy saints, unmixed, and from the impure Far separate, circling thy holy mount, Unfeigned hallelujahs to thee sing. Milton. 3. (Eccl.)  One canonized by the church. [Abbrev. St.] Saint Andrew's cross (a) A cross shaped like the letter X. See Illust. 4, under Cross. (b) (Bot.) A low North American shrub (Ascyrum Crux-Andræ, the petals of which have the form of a Saint Andrew's cross. Gray. -- Saint Anthony's cross, a T-shaped cross. See Illust. 6, under Cross. -- Saint Anthony's fire, the erysipelas; -- popularly so called because it was supposed to have been cured by the intercession of Saint Anthony. -- Saint Anthony's nut (Bot.), the groundnut (Bunium flexuosum); -- so called because swine feed on it, and St. Anthony was once a swineherd. Dr. Prior. -- Saint Anthony's turnip (Bot.), the bulbous crowfoot, a favorite food of swine. Dr. Prior. -- Saint Barnaby's thistle (Bot.), a kind of knapeweed (Centaurea solstitialis) flowering on St. Barnabas's Day, June 11th. Dr. Prior. -- Saint Bernard (Zoöl.), a breed of large, handsome dogs celebrated for strength and sagacity, formerly bred chiefly at the Hospice of St. Bernard in Switzerland, but now common in Europe and America. There are two races, the smooth-haired and the rough-haired. See Illust. under Dog. -- Saint Catharine's flower (Bot.), the plant love-a-mist. See under Love. -- Saint Cuthbert's beads (Paleon.), the fossil joints of crinoid stems. -- Saint Dabeoc's heath (Bot.), a heatherlike plant (Dabæcia polifolia), named from an Irish saint. -- Saint Distaff's Day. See under Distaff. -- Saint Elmo's fire, a luminious, flamelike appearance, sometimes seen in dark, tempestuous nights, at some prominent point on a ship, particularly at the masthead and the yardams. It has also been observed on land, and is due to the discharge of electricity from elevated or pointed objects. A single flame is called a Helena, or a Corposant; a double, or twin, flame is called a Castor and Pollux, or a double Corposant. It takes its name from St. Elmo, the patron saint of sailors. -- Saint George's cross (Her.), a Greek cross gules upon a field argent, the field being represented by a narrow fimbriation in the ensign, or union jack, of Great Britain. -- Saint George's ensign, a red cross on a white field with a union jack in the upper corner next the mast. It is the distinguishing badge of ships of the royal navy of England; -- called also the white ensign. Brande & C. -- Saint George's flag, a smaller flag resembling the ensign, but without the union jack; used as the sign of the presence and command of an admiral. [Eng.] Brande & C. -- Saint Gobain glass (Chem.), a fine variety of soda-lime plate glass, so called from St.Gobain in France, where it was manufactured. -- Saint Ignatius's bean (Bot.), the seed of a tree of the Philippines (Strychnos Ignatia), of properties similar to the nux vomica. -- Saint Jame's shell (Zoöl.), a pecten (Vola Jacobæus) worn by piligrims to the Holy Land. See Illust. under Scallop. -- Saint Jame's wort (Bot.), a kind of ragwort (Senecio Jacobæa). -- Saint John's bread. (Bot.) See Carob. -- Saint John's-wort (Bot.), any plant of the genus Hypericum, most species of which have yellow flowers; -- called also John's-wort. -- Saint Leger, the name of a race for three-year-old horses run annually in September at Doncaster, England; -- instituted in 1776 by Col. St. Leger. -- Saint Martin's herb (Bot.), a small tropical American violaceous plant (Sauvagesia erecta). It is very mucilaginous and is used in medicine. -- Saint Martin's summer, a season of mild, damp weather frequently prevailing during late autumn in England and the Mediterranean countries; -- so called from St. Martin's Festival, occuring on November 11. It corresponds to the Indian summer in America. Shak. Whitier. -- Saint Patrick's cross. See Illust 4, under Cross. -- Saint Patrick's Day, the 17th of March, anniversary of the death (about 466) of St. Patrick, the apostle and patron saint of Ireland. -- Saint Peter's fish. (Zoöl.) See John Dory, under John. -- Saint Peter's-wort (Bot.), a name of several plants, as Hypericum Ascyron, H. quadrangulum, Ascyrum stans, etc. -- Saint Peter's wreath (Bot.), a shrubby kind of Spiræa (S. hypericifolia), having long slender branches covered with clusters of small white blossoms in spring. -- Saint's bell. See Sanctus bell, under Sanctus. -- Saint Vitus's dance (Med.), chorea; -- so called from the supposed cures wrought on intercession to this saint.\n\nTo make a saint of; to enroll among the saints by an offical act, as of the pope; to canonize; to give the title or reputation of a saint to (some one). A large hospital, erected by a shoemaker who has been beatified, though never sainted. Addison. To saint it, to act as a saint, or with a show of piety. Whether the charmer sinner it or saint it. Shak.\n\nTo act or live as a saint. [R.] Shak.
saint-simonian |A follower of the Count de St. Simon, who died in 1825, and who maintained that the principle of property held in common, and the just division of the fruits of common labor among the members of society, are the true remedy for the social evils which exist. Brande & C.
saint-simonianism |The principles, doctrines, or practice of the Saint-Simonians; -- called also Saint-Simonism.
saint-simonism |A system of socialism in which the state owns all the property and the laborer is entitled to share according to the quality and amount of his work, founded by Saint Simon (1760-1825).
saintdom |The state or character of a saint. [R.] Tennyson.
sainted |1. Consecrated; sacred; holy; pious. \"A most sainted king.\" Shak. Amongst the enthroned gods on sainted seats. Milton. 2. Entered into heaven; -- a euphemism for dead.
saintess |A female saint. [R.] Bp. Fisher.
sainthood |1. The state of being a saint; the condition of a saint. Walpole. 2. The order, or united body, of saints; saints, considered collectively. It was supposed he felt no call to anu expedition that might sainthood. Sir W. Scott.
saintish |Somewhat saintlike; -- used ironically.
saintism |The character or quality of saints; also, hypocritical pretense of holiness. Wood.
saintlike |Resembling a saint; suiting a saint; becoming a saint; saintly. Glossed over only with a saintlike show. Dryden.
saintliness |Quality of being saintly.
saintly |Like a saint; becoming a holy person. So dear to Heaven is saintly chastity. Milton.
saintologist |One who writes the lives of saints. [R.]
saintship |The character or qualities of a saint.
saith |3d pers. sing. pres. of Say. [Archaic]
saithe |The pollock, or coalfish; -- called also sillock. [Scot.]
saiva |One of an important religious sect in India which regards Siva with peculiar veneration.
saivism |The worship of Siva.
sajene |Same as Sagene.
sajou |Same as Sapajou.
sake |Final cause; end; purpose of obtaining; cause; motive; reason; interest; concern; account; regard or respect; -- used chiefly in such phrases as, for the sake, for his sake, for man's sake, for mercy's sake, and the like; as, to commit crime for the sake of gain; to go abroad for the sake of one's health. Moved with wrath and shame and ladies; sake. Spenser. I will not again curse the ground any more for man's sake. Gen. viii. 21. Will he draw out, For anger's sake, finite to infinite Milton. Knowledge is for the sake of man, and not man for the sake of knowledge. Sir W. Hamilton. Note: The -s of the possessive case preceding sake is sometimes omitted for euphony; as, for goodness sake. \"For conscience sake.\" 1 Cor. x. 28. The plural sakes is often used with a possessive plural. \"For both our sakes.\" Shak.
saker |1. (Zo\\'94l.) (a) A falcon (Falco sacer) native of Southern Europe and Asia, closely resembling the lanner. Note: The female is called chargh, and the male charghela, or sakeret. (b) The peregrine falcon. [Prov. Eng.] 2. (Mil.)  A small piece of artillery. Wilhelm. On the bastions were planted culverins and sakers. Macaulay. The culverins and sakers showing their deadly muzzles over the rampart. Hawthorne.
sakeret |The male of the saker (a).
saki |Any one of several species of South American monkeys of the genus Pithecia. They have large ears, and a long hairy tail which is not prehensile. Note: The black saki (Pithecia satanas), the white-headed (P.leucocephala), and the red-backed, or hand-drinking, saki (P.chiropotes), are among the best-known.\n\nThe alcoholic drink of Japan. It is made from rice.sake
sakieh |A kind of water wheel used in Egypt for raising water, from wells or pits, in buckets attached to its periphery or to an endless rope.
sakiyeh |A kind of water wheel used in Egypt for raising water, from wells or pits, in buckets attached to its periphery or to an endless rope.
sakti |The divine energy, personified as the wife of a deity (Brahma, Vishnu, Siva, etc.); the female principle.
