sarsaparilla |(a) Any plant of several tropical American species of Smilax. (b) The bitter mucilaginous roots of such plants, used in medicine and in sirups for soda, etc. Note: The name is also applied to many other plants and their roots, especially to the Aralia nudicaulis, the wild sarsaparilla of the United States.
sarsaparillin |See Parillin.
sarse |A fine sieve; a searce. [Obs.]\n\nTo sift through a sarse. [Obs.]
sarsen |One of the large sandstone blocks scattered over the English chalk downs; -- called also sarsen stone, and Druid stone. [Eng.]
sarsenet |See Sarcenet.
sart |An assart, or clearing. [Obs.] Bailey.
sartorial |1. Of or pertaining to a tailor or his work. Our legs skulked under the table as free from sartorial impertinences as those of the noblest savages. Lowell. 2. (Anat.)  Of or pertaining to thesartorius muscle.
sartorius |A muscle of the thigh, called the tailor's muscle, which arises from the hip bone and is inserted just below the knee. So named because its contraction was supposed to produce the position of the legs assumed by the tailor in sitting.
sarum use |A liturgy, or use, put forth about 1087 by St. Osmund, bishop of Sarum, based on Anglo-Saxon and Norman customs.
sash |A scarf or band worn about the waist, over the shoulder, or otherwise; a belt; a girdle, -- worn by women and children as an ornament; also worn as a badge of distinction by military officers, members of societies, etc.\n\nTo adorn with a sash or scarf. Burke.\n\n1. The framing in which the panes of glass are set in a glazed window or door, including the narrow bars between the panes. 2. In a sawmill, the rectangular frame in which the saw is strained and by which it is carried up and down with a reciprocating motion; - - also called gate. French sash, a casement swinging on hinges; -- in distinction from a vertical sash sliding up and down.\n\nTo furnish with a sash or sashes; as, to sash a door or a window.
sashery |A collection of sashes; ornamentation by means of sashes. [R.] Distinguished by their sasheries and insignia. Carlyle.
sashoon |A kind of pad worn on the leg under the boot. [Obs.] Nares.
sasin |The Indian antelope (Antilope bezoartica, or cervicapra), noted for its beauty and swiftness. It has long, spiral, divergent horns.
sassaby |A large African antelope (Alcelaphus tunata), similar to the hartbeest, but having its horns regularly curved.
sassabye |A large African antelope (Alcelaphus tunata), similar to the hartbeest, but having its horns regularly curved.
sassafras |An American tree of the Laurel family (Sassafras officinale); also, the bark of the roots, which has an aromatic smell and taste. Australian sassafras, a lofty tree (Doryophora Sassafras) with aromatic bark and leaves. -- Chilian sassafras, an aromatic tree (Laurelia sempervirens). -- New Zealand sassafras, a similar tree (Laurelia Novæ Zelandiæ). -- Sassafras nut. See Pichurim bean. -- Swamp sassafras, the sweet bay (Magnolia glauca). See Magnolia.
sassanage |Stones left after sifting. Smart.
sassarara |A word used to emphasize a statement. [Obs.] Out she shall pack, with a sassarara. Goldsmith.
sasse |A sluice or lock, as in a river, to make it more navigable. [Obs.] Pepys.
sassenach |A Saxon; an Englishman; a Lowlander. [Celtic] Sir W. Scott.
sassolin |Native boric acid, found in saline incrustations on the borders of hot springs near Sasso, in the territory of Florence.
sassoline |Native boric acid, found in saline incrustations on the borders of hot springs near Sasso, in the territory of Florence.
sassorol |The rock pigeon. See under Pigeon.
sassorolla |The rock pigeon. See under Pigeon.
sassy bark |The bark of a West African leguminous tree (Erythrophlæum Guineense, used by the natives as an ordeal poison, and also medicinally; -- called also mancona bark.
sastra |Same as Shaster.
sastrugi |Incorrect, but common, var. of Zastrugi.
sat |imp. of Sit. [Written also sate.]
satan |The grand adversary of man; The Devil, or Prince of darkness; the chief of the fallen angels; the archfiend. I beheld Satan as lightning fall from heaven. Luke x. 18.
satanic |Of or pertaining to Satan; having the qualities of Satan; resembling Satan; extremely malicious or wicked; devilish; infernal. \"Satanic strength.\" \"Satanic host.\" Milton. Detest the slander which, with a Satanic smile, exults over the character it has ruined. Dr. T. Dwight. -- Sa*tan\"ic*al*ly, adv. -- Sa*tan\"ic*al*ness, n.
satanical |Of or pertaining to Satan; having the qualities of Satan; resembling Satan; extremely malicious or wicked; devilish; infernal. \"Satanic strength.\" \"Satanic host.\" Milton. Detest the slander which, with a Satanic smile, exults over the character it has ruined. Dr. T. Dwight. -- Sa*tan\"ic*al*ly, adv. -- Sa*tan\"ic*al*ness, n.
satanism |The evil and malicious disposition of Satan; a diabolical sprit. [R.]
satanist |A very wicked-person. [R.] Granger.
satanophany |An incarnation of Satan; a being possessed by a demon. [R.] O. A. Brownson.
satchel |A little sack or bag for carrying papers, books, or small articles of wearing apparel; a hand bag. [Spelled also sachel.] The whining schoolboy with his satchel. Shak.
sate |To satisfy the desire or appetite of; to satiate; to glut; to surfeit. Crowds of wanderers sated with the business and pleasure of great cities. Macaulay.\n\nimp. of Sit. But sate an equal guest at every board. Lowell.
sateen |A kind of dress goods made of cotton or woolen, with a glossy surface resembling satin.
sateless |Insatiable. [R.] Young.
satellite |1. An attendant attached to a prince or other powerful person; hence, an obsequious dependent. \"The satellites of power.\" I. Disraeli. 2. (Astron.)  A secondary planet which revolves about another planet; as, the moon is a satellite of the earth. See Solar system, under Solar. Satellite moth (Zoöl.), a handsome European noctuid moth (Scopelosoma satellitia).\n\nSituated near; accompanying; as, the satellite veins, those which accompany the arteries.
satellitious |Pertaining to, or consisting of, satellites. [R.] Cheyne.
sathanas |Satan. [Obs.] Chaucer. Wyclif.
satiate |Filled to satiety; glutted; sated; -- followed by with or of. \"Satiate of applause.\" Pope.\n\n1. To satisfy the appetite or desire of; tho feed to the full; to furnish enjoyment to, to the extent of desire; to sate; as, to satiate appetite or sense. These [smells] rather woo the sense than satiate it. Bacon. I may yet survive the malice of my enemies, although they should be satiated with my blood. Eikon Basilike. 2. To full beyond matural desire; to gratify to repletion or loathing; to surfeit; to glut. 3. To saturate. [Obs.] Sir I. Newton. Syn. -- To satisfy; sate; suffice; cloy; gorge; overfill; surfeit; glut. -- Satiate, Satisfy, Content. These words differ principally in degree. To Content is to make contented, even though every desire or appetite is not fully gratified. To satisfy is to appease fully the longings of desire. To satiate is to fill so completely that it is not possible to receive or enjoy more; hence, to overfill; to cause disgust in. Content with science in the vale of peace. Pope. His whole felicity is endless strife; No peace, no satisfaction, crowns his life. Beaumont. He may be satiated, but not satisfied. Norris.
satiation |Satiety.
satiety |The state of being satiated or glutted; fullness of gratification, either of the appetite or of any sensual desire; fullness beyond desire; an excess of gratification which excites wearisomeness or loathing; repletion; satiation. In all pleasures there is satiety. Hakewill. But thy words, with grace divine Imbued, bring to their sweetness no satiety. Milton. Syn. -- Repletion; satiation; surfeit; cloyment.
satin |A silk cloth, of a thick, close texture, and overshot woof, which has a glossy surface. Cloths of gold and satins rich of hue. Chaucer. Denmark satin, a kind of lasting; a stout worsted stuff, woven with a satin twill, used for women's shoes. -- Farmer's satin. See under Farmer. -- Satin bird (Zoöl.), an Australian bower bird. Called also satin grackle. -- Satin flower (Bot.) See Honesty, 4. -- Satin spar. (Min.) (a) A fine fibrous variety of calcite, having a pearly luster. (b) A similar variety of gypsum. -- Satin sparrow (Zoöl.), the shining flycatcher (Myiagra nitida) of Tasmania and Australia. The upper surface of the male is rich blackish green with a metallic luster. -- Satin stone, satin spar.
satin weave |A style of weaving producing smooth-faced fabric in which the warp interlaces with the filling at points distributed over the surface.
satinet |1. A thin kind of satin. 2. A kind of cloth made of cotton warp and woolen filling, used chiefly for trousers.
satinette |One of a breed of fancy frilled pigeons allied to the owls and turbits, having the body white, the shoulders tricolored, and the tail bluish black with a large white spot on each feather.
satinwood |The hard, lemon-colored, fragrant wood of an East Indian tree (Chloroxylon Swietnia). It takes a lustrous finish, and is used in cabinetwork. The name is also given to the wood of a species of prickly ash (Xanthoxylum Caribæum) growing in Florida and the West Indies.
satiny |Like or composed of satin; glossy; as, to have a satiny appearance; a satiny texture.
sation |A sowing or planting. [Obs.] Sir T. Browne.
satire |1. A composition, generally poetical, holding up vice or folly to reprobation; a keen or severe exposure of what in public or private morals deserves rebuke; an invective poem; as, the Satires of Juvenal. 2. Keeness and severity of remark; caustic exposure to reprobation; trenchant wit; sarcasm. Syn. -- Lampoon; sarcasm; irony; ridicule; pasquinade; burlesque; wit; humor.
satiric |1. Of or pertaining to satire; of the nature of satire; as, a satiric style. 2. Censorious; severe in language; sarcastic; insulting. \"Satirical rogue.\" Shak. Syn. -- Cutting; caustic; poignant; sarcastic; ironical; bitter; reproachful; abusive. -- Sa*tir\"ic*al*ly, adv. -- Sa*tir\"ic*al*ness, n.
satirical |1. Of or pertaining to satire; of the nature of satire; as, a satiric style. 2. Censorious; severe in language; sarcastic; insulting. \"Satirical rogue.\" Shak. Syn. -- Cutting; caustic; poignant; sarcastic; ironical; bitter; reproachful; abusive. -- Sa*tir\"ic*al*ly, adv. -- Sa*tir\"ic*al*ness, n.
satirist |One who satirizes; especially, one who writes satire. The mighty satirist, who . . . had spread through the Whig ranks. Macaulay.
satirize |To make the object of satire; to attack with satire; to censure with keenness or severe sarcasm. It is as hard to satirize well a man of distinguished vices, as to praise well a man of distinguished virtues. Swift.
satisfaction |1. The act of satisfying, or the state of being satisfied; gratification of desire; contentment in possession and enjoyment; repose of mind resulting from compliance with its desires or demands. The mind having a power to suspend the execution and satisfaction of any of its desires. Locke. 2. Settlement of a claim, due, or demand; payment; indemnification; adequate compensation. We shall make full satisfaction. Shak. 3. That which satisfies or gratifiles; atonement. Die he, or justice must; unless or him Some other, able, and as willing, pay The rigid satisfaction, death for death. Milton. Syn. -- Contentment; content; gratification; pleasure; recompence; compensation; amends; remuneration; indemnification; atonement.
satisfactive |Satisfactory. [Obs.] Satisfactive discernment of fish. Sir T. Browne.
satisfactory |1. Giving or producing satisfaction; yielding content; especially, relieving the mind from doubt or uncertainty, and enabling it to rest with confidence; sufficient; as, a satisfactory account or explanation. 2. Making amends, indemnification, or recompense; causing to cease from claims and to rest content; compensating; atoning; as, to make satisfactory compensation, or a satisfactory apology. A most wise and sufficient means of redemption and salvation, by the satisfactory and meritorius death and obedience of the incarnate Son of God, Jesus Christ. Bp. Sanderson. -- Sat`is*fac\"to*ri*ty, adv. -- Sat`is*fac\"to*ri*ness, n.
satisfiable |That may be satisfied.
satisfier |One who satisfies.
satisfy |1. In general, to fill up the measure of a want of (a person or a thing); hence, to grafity fully the desire of; to make content; to supply to the full, or so far as to give contentment with what is wished for. Death shall . . . with us two Be forced to satisfy his ravenous maw. Milton. 2. To pay to the extent of chaims or deserts; to give what is due to; as, to satisfy a creditor. 3. To answer or discharge, as a claim, debt, legal demand, or the like; to give compensation for; to pay off; to requitte; as, to satisfy a claim or an execution. 4. To free from doubrt, suspense, or uncertainty; to give assurance to; as, to satisfy one's self by inquiry. The standing evidences of the truth of the gospel are in themselves most firm, solid, and satisfying. Atterbury. Syn. -- To satiate; sate; content; grafity; compensate. See Satiate.\n\n1. To give satisfaction; to afford gratification; to leave nothing to be desire. 2. To make payment or atonement; to atone. Milton.
satisfyingly |So as to satisfy; satisfactorily.
sative |Sown; propagated by seed. [Obs.] Evelyn.
satle |To settle. [Obs.] Chaucer.
satrap |The governor of a province in ancient Persia; hence, a petty autocrat despot.
satrapal |Of or pertaining to a satrap, or a satrapy.
satrapess |A female satrap.
satrapical |Satrapal. [R.]
satrapy |The government or jurisdiction of a satrap; a principality. Milton.
satsuma ware |A kind of ornamental hard-glazed pottery made at Satsuma in Kiushu, one of the Japanese islands.
saturable |Capable of being saturated; admitting of saturation. -- Sat`u*ra*bil\"i*ty, n.
saturant |Impregnating to the full; saturating.\n\n1. (Chem.)  A substance used to neutralize or saturate the affinity of another substance. 2. (Med.)  An antacid, as magnesia, used to correct acidity of the stomach.
saturate |1. To cause to become completely penetrated, impregnated, or soaked; to fill fully; to sate. Innumerable flocks and herbs covered that vast expanse of emerald meadow saturated with the moisture of the Atlantic. Macaulay. Fill and saturate each kind With good according to its mind. Emerson. 2. (Chem.)  To satisfy the affinity of; to cause to become inert by chemical combination with all that it can hold; as, to saturate phosphorus with chlorine.\n\nFilled to repletion; saturated; soaked. Dries his feathers saturate with dew. Cowper. The sand beneath our feet is saturate With blood of martyrs. Longfellow.
saturated |1. Filled to repletion; holding by absorption, or in solution, all that is possible; as, saturated garments; a saturated solution of salt. 2. (Chem.)  Having its affinity satisfied; combined with all it can hold; - - said of certain atoms, radicals, or compounds; thus, methane is a saturated compound. Contrasted with unsaturated. Note: A saturated compound may exchange certain ingredients for others, but can not take on more without such exchange. Saturated color (Optics), a color not diluted with white; a pure unmixed color, like those of the spectrum.
saturation |1. The act of saturating, or the state of being saturating; complete penetration or impregnation. 2. (Chem.)  The act, process, or result of saturating a substance, or of combining it to its fullest extent. 3. (Optics)  Freedom from mixture or dilution with white; purity; -- said of colors. Note: The degree of saturation of a color is its relative purity, or freedom from admixture with white.
saturator |One who, or that which, saturates.
saturday |The seventh or last day of the week; the day following Friday and preceding Sunday.
saturity |The state of being saturated; fullness of supply. [Obs.] Warner.
saturn |1. (Roman Myth.)  One of the elder and principal deities, the son of Coelus and Terra (Heaven and Earth), anf the father of Jupiter. The corresponding Greek divinity was Kro`nos, later CHro`nos, Time. 2. (Astron.)  One of the planets of the solar system, next in magnitude to Jupiter, but more remote from the sun. Its diameter is seventy thousand miles, its mean distance from the sun nearly eight hundred and eighty millions of miles, and its year, or periodical revolution round the sun, nearly twenty-nine years and a half. It is surrounded by a remarkable system of rings, and has eight satellites. 3. (Alchem.)  The metal lead. [Archaic]
saturnalia |1. (Rom. Antiq.)  the festival of Saturn, celebrated in December, originally during one day, but afterward during seven days, as a period of unrestrained license and merriment for all classes, extending even to the slaves. 2. Hence: A period or occasion of general licemse, in which the passions or vices have riotous indulgence.
saturnalian |1. Of or pertaining to the Saturnalia. 2. Of unrestrained and intemperate jollity; riotously merry; dissolute. \"Saturnalian amusement.\" Burke.
saturnian |1. (Roman Myth.)  Of or pertaining to Saturn, whose age or reign, from the mildness and wisdom of his government, is called the golden age. 2. Hence: Resembling the golden age; distinguished for peacefulness, happiness, contentment. Augustus, born to bring Saturnian times. Pope. 3. (Astron.)  Of or pertaining to the planet Saturn; as, the Saturnian year. Saturnian verse (Pros.), a meter employed by early Roman satirists, consisting of three iambics and an extra syllable followed by three trochees, as in the line: --Thê queen | wâs isn | thê kistch | ên eatîng | bread ând | honêy.\n\nAny one of numerous species of large handsome moths belonging to Saturnia and allied genera. The Luna moth, polyphemus, and promethea, are examples. They belong to the Silkworn family, and some are raised for their silk. See Polyphemus.
saturnicentric |Appearing as if seen from the center of the planet Saturn; relating or referred to Saturn as a center.
saturnine |1. Born under, or influenced by, the planet Saturn. 2. Heavy; grave; gloomy; dull; -- the opposite of mercurial; as, a saturnine person or temper. Addison. 3. (Old Chem.)  Of or pertaining to lead; characterized by, or resembling, lead, which was formerly called Saturn. [Archaic] Saturnine colic (Med.), lead colic.
saturnism |Plumbum. Quain.
saturnist |A person of a dull, grave, gloomy temperament. W. browne.
satyr |1. (Class. Myth.)  A sylvan deity or demigod, represented as part man and part goat, and characterized by riotous merriment and lasciviousness. Rough Satyrs danced; and Fauns, with cloven heel, From the glad sound would not be absent long. Milton. 2. (Zoöl.)  Any one of many species of butterflies belonging to the family Nymphalidæ. Their colors are commonly brown and gray, often with ocelli on the wings. Called also meadow browns. 3. (Zoöl.)  The orangoutang.
satyriasis |Immoderate venereal appetite in the male. Quain.
satyric |Of or pertaining to satyrs; burlesque; as, satyric tragedy. P. Cyc.
satyrical |Of or pertaining to satyrs; burlesque; as, satyric tragedy. P. Cyc.
satyrion |Any one of several kinds of orchids. [Obs.]
sauba ant |A South American ant (Ecodoma cephalotes) remarkable for having two large kinds of workers besides the ordinary ones, and for the immense size of its formicaries. The sauba ant cuts off leaves of plants and carries them into its subterranean nests, and thus often does great damage by defoliating trees and cultivated plants.
sauce |1. A composition of condiments and appetizing ingredients eaten with food as a relish; especially, a dressing for meat or fish or for puddings; as, mint sauce; sweet sauce, etc. \"Poignant sauce.\" Chaucer. High sauces and rich spices fetched from the Indies. Sir S. Baker. 2. Any garden vegetables eaten with meat. [Prov. Eng. & Colloq. U.S.] Forby. Bartlett. Roots, herbs, vine fruits, and salad flowers . . . they dish up various ways, and find them very delicious sauce to their meats, both roasted and boiled, fresh and salt. Beverly. 3. Stewed or preserved fruit eaten with other food as a relish; as, apple sauce, cranberry sauce, etc. [U.S.] \"Stewed apple sauce.\" Mrs. Lincoln (Cook Book). 4. Sauciness; impertinence. [Low.] Haliwell. To serve one the same sauce, to retaliate in the same kind. [Vulgar]\n\n1. To accompany with something intended to give a higher relish; to supply with appetizing condiments; to season; to flavor. 2. To cause to relish anything, as if with a sauce; to tickle or gratify, as the palate; to please; to stimulate; hence, to cover, mingle, or dress, as if with sauce; to make an application to. [R.] Earth, yield me roots; Who seeks for better of thee, sauce his palate With thy most operant poison! Shak. 3. To make poignant; to give zest, flavor or interest to; to set off; to vary and render attractive. Then fell she to sauce her desires with threatenings. Sir P. Sidney. 4. To treat with bitter, pert, or tart language; to be impudent or sancy to. [Colloq. or Low] I'll sauce her with bitter words. Shak.\n\nA soft crayon for use in stump drawing or in shading with the stump.
sauce aux hatelets |A sauce (such as egg and bread crumbs) used for covering bits of meat, small birds, or fish, strung on skewers for frying.
sauce veloute |A white sauce or stock made by boiling down ham, veal, beef, fowl, bouillon, etc., then adding soup stock, seasoning, vegetables, and thickening, and again boiling and straining.
sauce-alone |Jack-by-the-hedge. See under Jack.
saucebox |A saucy, impudent person; especially, a pert child. Saucebox, go, meddle with your lady's fan, And prate not here! A. Brewer.
saucepan |A small pan with a handle, in which sauce is prepared over a fire; a stewpan.
saucer |1. A small pan or vessel in which sauce was set on a table. [Obs.] Bacon. 2. A small dish, commonly deeper than a plate, in which a cup is set at table. 3. Something resembling a saucer in shape. Specifically: (a) A flat, shallow caisson for raising sunken ships. (b) A shallow socket for the pivot of a capstan. Flying saucer, a type of Unidentified Flying Object, having a biconvex discoid shape; such objects are occasionally reported to have been sighted, but no example of one has been reliably shown to exist. They are believed by ufologists to originate in outer space, but they are generally presumed to be misinterpretations of ordinary phenomena, illusions or imaginary objects. Fraudulent photographs purporting to show flying saucers are published from time to time.
saucily |In a saucy manner; impudently; with impertinent boldness. Addison.
sauciness |The quality or state of being saucy; that which is saucy; impertinent boldness; contempt of superiors; impudence. Your sauciness will jest upon my love. Shak. Syn. -- Impudence; impertinence; rudeness; insolence. see Impudence.
saucisse |1. (Mining or Gun.)  A long and slender pipe or bag, made of cloth well pitched, or of leather, filled with powder, and used to communicate fire to mines, caissons, bomb chests, etc. 2. (Fort.)  A fascine of more than ordinary length.
saucisson |1. (Mining or Gun.)  A long and slender pipe or bag, made of cloth well pitched, or of leather, filled with powder, and used to communicate fire to mines, caissons, bomb chests, etc. 2. (Fort.)  A fascine of more than ordinary length.
saucy |1. Showing impertinent boldness or pertness; transgressing the rules of decorum; treating superiors with contempt; impudent; insolent; as, a saucy fellow. Am I not protector, saucy priest Shak. 2. Expressive of, or characterized by, impudence; impertinent; as, a saucy eye; saucy looks. We then have done you bold and sausy wrongs. Shak. Syn. -- Impudent; insolent; impertinent; rude.
sauerkraut |Cabbage cut fine and allowed to ferment in a brine made of its own juice with salt, -- a German dish.
sauf |Safe. [Obs.] haucer.\n\nSave; except. [Obs.] \"Sauf I myself.\" Chaucer.
saufly |Safely. [Obs.] Chaucer.
sauger |An American fresh-water food fish (Stizostedion Canadense); -- called also gray pike, blue pike, hornfish, land pike, sand pike, pickering, and pickerel.
saugh |imp. sing. of See. Chaucer.
sauh |imp. sing. of See. Chaucer.
sauks |Same as Sacs.
saul |Soul. [Obs.]\n\nSame as Sal, the tree.
saulie |A hired mourner at a funeral. [Scot.] Sir W. Scott.
sault |A rapid in some rivers; as, the Sault Ste. Marie. [U.S.] Bartlett.
saunders |See Sandress.
saunders-blue |A kind of color prepared from calcined lapis lazuli; ultramarine; also, a blue prepared from carbonate of copper. [Written also sanders-blue.]
saunter |To wander or walk about idly and in a leisurely or lazy manner; to lounge; to stroll; to loiter. One could lie under elm trees in a lawn, or saunter in meadows by the side of a stream. Masson. Syn. -- To loiter; linger; stroll; wander.\n\nA sauntering, or a sauntering place. That wheel of fops, that saunter of the town. Young.
saunterer |One who saunters.
saur |Soil; dirt; dirty water; urine from a cowhouse. [Prov. Eng.]
saurel |Any carangoid fish of the genus Trachurus, especially T. trachurus, or T. saurus, of Europe and America, and T. picturatus of California. Called also skipjack, and horse mackarel.
sauria |A division of Reptilia formerly established to include the Lacertilia, Crocodilia, Dinosauria, and other groups. By some writers the name is restricted to the Lacertilia.
saurian |Of or pertaining to, or of the nature of, the Sauria. -- n.  One of the Sauria.
saurioid |Same as Sauroid.
saurobatrachia |The Urodela.
saurognathous |Having the bones of the palate arranged as in saurians, the vomer consisting of two lateral halves, as in the woodpeckers. (Pici).
sauroid |(a) Like or pertaining to the saurians. (b) Resembling a saurian superficially; as, a sauroid fish.
sauroidichnite |The fossil track of a saurian.
sauropoda |An extinct order of herbivorous dinosaurs having the feet of a saurian type, instead of birdlike, as they are in many dinosaurs. It includes the Largest Known land animals, belonging to Brontosaurus, Camarasaurus, and alied genera. See Illustration in Appendix.
sauropsida |A comprehensive group of vertebrates, comprising the reptiles and birds.
sauropterygia |Same as Plesiosauria.
saururae |An extinct order of birds having a long vertebrated tail with quills along each side of it. Archæopteryx is the type. See Archæopteryx, and Odontornithes.
saury |A slender marine fish (Scombresox saurus) of Europe and America. It has long, thin, beaklike jaws. Called also billfish, gowdnook, gawnook, skipper, skipjack, skopster, lizard fish, and Egypt herring.
sausage |1. An article of food consisting of meat (esp. pork) minced and highly seasoned, and inclosed in a cylindrical case or skin usually made of the prepared intestine of some animal. 2. A saucisson. See Saucisson. Wilhelm.
sauseflem |Having a red, pimpled face. [Obs.] [Written also sawceflem.] Chaucer.
saussurite |A tough, compact mineral, of a white, greenish, or grayish color. It is near zoisite in composition, and in part, at least, has been produced by the alteration of feldspar.
saut |An assault. [Obs.]
saute |An assault. [Obs.]\n\np. p. of Sauter. C. Owen.
sauter |To fry lightly and quickly, as meat, by turning ot tossing it over frequently in a hot pan greased with a little fat.\n\nPsalter. [Obs.] Piers Plowman.
sauterelle |An instrument used by masons and others to trace and form angles.
sauterne |A white wine made in the district of sauterne, France.
sautrie |Psaltery. [Obs.] Chaucer.
sauvegarde |The monitor.
savable |capable of, or admitting of, being saved. In the person prayed for there ought to be the great disposition of being in a savable condition. Jer. Taylor.
savableness |Capability of being saved.
savacioun |Salvation. [Obs.]
savage |1. Of or pertaining to the forest; remote from human abodes and cultivation; in a state of nature; nature; wild; as, a savage wilderness. 2. Wild; untamed; uncultivated; as, savage beasts. Cornels, and savage berries of the wood. Dryden. 3. Uncivilized; untaught; unpolished; rude; as, savage life; savage manners. What nation, since the commencement of the Christian era, ever rose from savage to civilized without Christianity E. D. Griffin. 4. Characterized by cruelty; barbarous; fierce; ferocious; inhuman; brutal; as, a savage spirit. Syn. -- Ferocious; wild; uncultivated; untamed; untaught; uncivilized; unpolished; rude; brutish; brutal; heathenish; barbarous; cruel; inhuman; fierce; pitiless; merciless; unmerciful; atrocious. See Ferocious.\n\n1. A human being in his native state of rudeness; one who is untaught; uncivilized, or without cultivation of mind or manners. 2. A man of extreme, unfeeling, brutal cruelty; a barbarian.\n\nTo make savage. [R.] Its bloodhounds, savaged by a cross of wolf. South
savagely |In a savage manner.
savageness |The state or quality of being savage. Wolves and bears, they say, Casting their savageness aside have done Like offices of pity. Shak.
savagery |1. The state of being savage; savageness; savagism. A like work of primeval savagery. C. Kingsley. 2. An act of cruelty; barbarity. The wildest savagery, the vilest stroke, That ever wall-eyed wrath or staring rage Presented to the tears of soft remorse. Shak. 3. Wild growth, as of plants. Shak.
savagism |The state of being savage; the state of rude, uncivilized men, or of men in their native wildness and rudeness.
savanilla |The tarpum. [Local, U.S.]
savanna |A tract of level land covered with the vegetable growth usually found in a damp soil and warm climate, -- as grass or reeds, -- but destitute of trees. [Spelt also savannah.] Savannahs are clear pieces land without woods. Dampier. Savanna flower (Bot.), a West Indian name for several climbing apocyneous plants of the genus Echites. -- Savanna sparrow (Zoöl.), an American sparrow (Ammodramus sandwichensis or Passerculus savanna) of which several varieties are found on grassy plains from Alaska to the Eastern United States. -- Savanna wattle (Bot.), a name of two West Indian trees of the genus Citharexylum.
savant |A man of learning; one versed in literature or science; a person eminent for acquirements.
save |The herb sage, or salvia. [Obs.] Chaucer.\n\n1. To make safe; to procure the safety of; to preserve from injury, destruction, or evil of any kind; to rescue from impending danger; as, to save a house from the flames. God save all this fair company. Chaucer. He cried, saying, Lord, save me. Matt. xiv. 30. Thou hast . . . quitted all to save A world from utter loss. Milton. 2. (Theol.)  Specifically, to deliver from and its penalty; to rescue from a state of condemnation and spiritual death, and bring into a state of spiritual life. Christ Jesus came into the world to save sinners. 1 Tim. i. 15. 3. To keep from being spent or lost; to secure from waste or expenditure; to lay up; to reserve. Now save a nation, and now save a groat. Pope. 4. To rescue from something undesirable or hurtful; to prevent from doing something; to spare. I'll save you That labor, sir. All's now done. Shak. 5. To hinder from doing, suffering, or happening; to obviate the necessity of; to prevent; to spare. Will you not speak to save a lady's blush Dryden. 6. To hold possession or use of; to escape loss of. Just saving the tide, and putting in a stock of merit. Swift. To save appearance, to preserve a decent outside; to avoid exposure of a discreditable state of things. Syn. -- To preserve; rescue; deliver; protect; spare; reserve; prevent.\n\nTo avoid unnecessary expense or expenditure; to prevent waste; to be economical. Brass ordnance saveth in the quantity of the material. Bacon.\n\nExcept; excepting; not including; leaving out; deducting; reserving; saving. Five times received I forty stripes save one. 2 Cor. xi. 24. Syn. -- See Except.\n\nExcept; unless.
save-all |Anything which saves fragments, or prevents waste or loss. Specifically: (a) A device in a candlestick to hold the ends of candles, so that they be burned. (b) (Naut.) A small sail sometimes set under the foot of another sail, to catch the wind that would pass under it. Totten. (c) A trough to prevent waste in a paper-making machine.
saveable |See Savable.
saveloy |A kind of dried sausage. McElrath.
savely |Safely. [Obs.] Chaucer.
savement |The act of saving. [Obs.]
saver |One who saves.
savin |(a) A coniferous shrub (Juniperus Sabina) of Western Asia, occasionally found also in the northern parts of the United States and in British America. It is a compact bush, with dark-colored foliage, and produces small berries having a glaucous bloom. Its bitter, acrid tops are sometimes used in medicine for gout, amenorrhoea, etc. (b) The North American red cedar (Juniperus Virginiana.)
savine |(a) A coniferous shrub (Juniperus Sabina) of Western Asia, occasionally found also in the northern parts of the United States and in British America. It is a compact bush, with dark-colored foliage, and produces small berries having a glaucous bloom. Its bitter, acrid tops are sometimes used in medicine for gout, amenorrhoea, etc. (b) The North American red cedar (Juniperus Virginiana.)
saving |1. Preserving; rescuing. He is the saving strength of his anointed. Ps. xxviii. 8. 2. Avoiding unnecessary expense or waste; frugal; not lavish or wasteful; economical; as, a saving cook. 3. Bringing back in returns or in receipts the sum expended; incurring no loss, though not gainful; as, a saving bargain; the ship has made a saving voyage. 4. Making reservation or exception; as, a saving clause. Note: saving is often used with a noun to form a compound adjective; as, labor-saving, life-saving, etc.\n\nWith the exception of; except; excepting; also, without disrespect to. \"Saving your reverence.\" Shak. \"Saving your presence.\" Burns. None of us put off clothes, saving that every one put them off for washing. Neh. iv. 23. And in the stone a new name written, which no man knoweth saving he that receiveth it. Rev. ii. 17.\n\n1. Something kept from being expended or lost; that which is saved or laid up; as, the savings of years of economy. 2. Exception; reservation. Contend not with those that are too strong for us, but still with a saving to honesty. L'Estrange. Savings bank, a bank in which savings or earnings are deposited and put at interest.
savingly |1. In a saving manner; with frugality or parsimony. 2. So as to be finally saved from eternal death. Savingly born of water and the Spirit. Waterland.
savingness |1. The quality of being saving; carefulness not to expend money uselessly; frugality; parsimony. Mrs. H. H. Jackson. 2. Tendency to promote salvation. Johnson.
savior |1. One who saves, preserves, or delivers from destruction or danger. 2. Specifically: The (or our, your, etc.) Savior, he who brings salvation to men; Jesus Christ, the Redeemer.
savioress |A female savior. [Written also saviouress.] [R.] Bp. Hall.
savor |1. That property of a thing which affects the organs of taste or smell; taste and odor; flavor; relish; scent; as, the savor of an orange or a rose; an ill savor. I smell sweet savors and I feel soft things. Shak. 2. Hence, specific flavor or quality; characteristic property; distinctive temper, tinge, taint, and the like. Why is not my life a continual joy, and the savor of heaven perpetually upon my spirit Baxter. 3. Sense of smell; power to scent, or trace by scent. [R.] \"Beyond my savor.\" Herbert. 4. Pleasure; delight; attractiveness. [Obs.] She shall no savor have therein but lite. Chaucer. Syn. -- Taste; flavor; relish; odor; scent; smell.\n\n1. To have a particular smell or taste; -- with of. 2. To partake of the quality or nature; to indicate the presence or influence; to smack; -- with of. This savors not much of distraction. Shak. I have rejected everything that savors of party. Addison. 3. To use the sense of taste. [Obs.] By sight, hearing, smelling, tasting or savoring, and feeling. Chaucer.\n\n1. To perceive by the smell or the taste; hence, to perceive; to note. [Obs.] B. Jonson. 2. To have the flavor or quality of; to indicate the presence of. [R.] That cuts us off from hope, and savors only Rancor and pride, impatience and despite. Milton. 3. To taste or smell with pleasure; to delight in; to relish; to like; to favor. [R.] Shak.
savorily |In a savory manner.
savoriness |The quality of being savory.
savorless |Having no savor; destitute of smell or of taste; insipid.
savorly |Savory. [Obs.]\n\nIn a savory manner. [Obs.] Barrow.
savorous |Having a savor; savory. [Obs.] Rom. of R.
savory |Pleasing to the organs of taste or smell. [Written also savoury.] The chewing flocks Had ta'en their supper on the savory herb. Milton.\n\nAn aromatic labiate plant (Satireia hortensis), much used in cooking; -- also called summer savory. [Written also savoury.]
savoury |An aromatic labiate plant (Satireia hortensis), much used in cooking; -- also called summer savory. [Written also savoury.]
savoy |A variety of the common cabbage (Brassica oleracea major), having curled leaves, -- much cultivated for winter use.
savoyard |A native or inhabitant of Savoy.
savvey |To understand; to comprehend; know. [Slang, U. S.]\n\nComprehension; knowledge of affairs; mental grasp. [Slang, U. S.]
savvy |To understand; to comprehend; know. [Slang, U. S.]\n\nComprehension; knowledge of affairs; mental grasp. [Slang, U. S.]
saw |imp. of See.\n\n1. Something said; speech; discourse. [Obs.] \"To hearken all his sawe.\" Chaucer. 2. A saying; a proverb; a maxim. His champions are the prophets and apostles, His weapons holy saws of sacred writ. Shak. 3. Dictate; command; decree. [Obs.] [Love] rules the creatures by his powerful saw. Spenser.\n\nAn instrument for cutting or dividing substances, as wood, iron, etc., consisting of a thin blade, or plate, of steel, with a series of sharp teeth on the edge, which remove successive portions of the material by cutting and tearing. Note: Saw is frequently used adjectively, or as the first part of a compound. Band saw, Crosscut saw, etc. See under Band, Crosscut, etc. -- Circular saw, a disk of steel with saw teeth upon its periphery, and revolved on an arbor. -- Saw bench, a bench or table with a flat top for for sawing, especially with a circular saw which projects above the table. -- Saw file, a three-cornered file, such as is used for sharpening saw teeth. -- Saw frame, the frame or sash in a sawmill, in which the saw, or gang of saws, is held. -- Saw gate, a saw frame. -- Saw gin, the form of cotton gin invented by Eli Whitney, in which the cotton fibers are drawn, by the teeth, of a set of revolving circular saws, through a wire grating which is too fine for the seeds to pass. -- Saw grass (Bot.), any one of certain cyperaceous plants having the edges of the leaves set with minute sharp teeth, especially the Cladium effusum of the Southern United States. Cf. Razor grass, under Razor. -- Saw log, a log of suitable size for sawing into lumber. -- Saw mandrel, a mandrel on which a circular saw is fastened for running. -- Saw pit, a pit over which timbor is sawed by two men, one standing below the timber and the other above. Mortimer. -- Saw sharpener (Zoöl.), the great titmouse; -- so named from its harsh call note. [Prov. Eng.] -- Saw whetter (Zoöl.), the marsh titmouse (Parus palustris); -- so named from its call note. [Prov. Eng.] -- Scroll saw, a ribbon of steel with saw teeth upon one edge, stretched in a frame and adapted for sawing curved outlines; also, a machine in which such a saw is worked by foot or power.\n\n1. To cut with a saw; to separate with a saw; as, to saw timber or marble. 2. To form by cutting with a saw; as, to saw boards or planks, that is, to saw logs or timber into boards or planks; to saw shingles; to saw out a panel. 3. Also used figuratively; as, to saw the air.\n\n1. To use a saw; to practice sawing; as, a man saws well. 2. To cut, as a saw; as, the saw or mill saws fast. 3. To be cut with a saw; as, the timber saws smoothly.
saw palmetto |See under Palmetto.
saw-set |An instrument used to set or turn the teeth of a saw a little sidewise, that they may make a kerf somewhat wider than the thickness of the blade, to prevent friction; -- called also saw-wrest.
saw-toothed |Having a tooth or teeth like those of a saw; serrate.
saw-whet |A small North American owl (Nyctale Acadica), destitute of ear tufts and having feathered toes; -- called also Acadian owl.
saw-wort |Any plant of the composite genus Serratula; -- so named from the serrated leaves of most of the species.
saw-wrest |See Saw-set.
sawarra nut |See Souari nut.
sawbelly |The alewife. [Local, U.S.]
sawbill |The merganser. [Prov. Eng.]
sawbones |A nickname for a surgeon.
sawbuck |A sawhorse.
sawceflem |See Sauseflem. [Obs.]
sawder |A corrupt spelling and pronunciation of solder. Soft sawder, seductive praise; flattery; blarney. [Slang]
sawdust |Dust or small fragments of wood 9or of stone, etc.) made by the cutting of a saw.
sawer |One who saws; a sawyer.
sawfish |Any one of several species of elasmobranch fishes of the genus Pristis. They have a sharklike form, but are more nearly allied to the rays. The flattened and much elongated snout has a row of stout toothlike structures inserted along each edge, forming a sawlike organ with which it mutilates or kills its prey.
sawfly |Any one of numerous species of hymenopterous insects belonging to the family Tenthredinidæ. The female usually has an ovipositor containing a pair of sawlike organs with which she makes incisions in the leaves or stems of plants in which to lay the eggs. The larvæ resemble those of Lepidoptera.
sawhorse |A kind of rack, shaped like a double St. Andrew's cross, on which sticks of wood are laid for sawing by hand; -- called also buck, and sawbuck.
sawmill |A mill for sawing, especially one for sawing timber or lumber.
sawneb |A merganser. [Prov. Eng.]
sawtooth |An arctic seal (Lobodon carcinophaga), having the molars serrated; -- called also crabeating seal.
sawtry |A psaltery. [Obs.] Dryden.
sawyer |1. One whose occupation is to saw timber into planks or boards, or to saw wood for fuel; a sawer. 2. A tree which has fallen into a stream so that its branches project above the surface, rising and falling with a rocking or swaying motion in the current. [U.S.] 3. (Zoöl.)  The bowfin. [Local, U.S.]
sax |A kind of chopping instrument for trimming the edges of roofing slates.
sax-tuba |A powerful instrument of brass, curved somewhat like the Roman buccina, or tuba.
saxatile |Of or pertaining to rocks; living among rocks; as, a saxatile plant.
saxhorn |A name given to a numerous family of brass wind instruments with valves, invented by Antoine Joseph Sax (known as Adolphe Sax), of Belgium and Paris, and much used in military bands and in orchestras.
saxicava |Any species of marine bivalve shells of the genus Saxicava. Some of the species are noted for their power of boring holes in limestone and similar rocks.
saxicavid |Of or pertaining to the saxicavas. -- n.  A saxicava.
saxicavous |Boring, or hollowing out, rocks; -- said of certain mollusks which live in holes which they burrow in rocks. See Illust. of Lithodomus.
saxicoline |Stone-inhabiting; pertaining to, or having the characteristics of, the stonechats.
saxicolous |Growing on rocks.
saxifraga |A genus of exogenous polypetalous plants, embracing about one hundred and eighty species. See Saxifrage.
saxifragaceous |Of or pertaining to a natural order of plants (Saxifragaceæ) of which saxifrage is the type. The order includes also the alum root, the hydrangeas, the mock orange, currants and gooseberries, and many other plants.
saxifragant |Breaking or destroying stones; saxifragous. [R.] -- n.  That which breaks or destroys stones. [R.]
saxifrage |Any plant of the genus Saxifraga, mostly perennial herbs growing in crevices of rocks in mountainous regions. Burnet saxifrage, a European umbelliferous plant (Pimpinella Saxifraga). -- Golden saxifrage, a low half-sacculent herb (Chrysosplenium oppositifolium) growing in rivulets in Europe; also, C. Americanum, common in the United States. See also under Golden. -- Meadow saxifrage, or Pepper saxifrage. See under Meadow.
saxifragous |Dissolving stone, especially dissolving stone in the bladder.
saxon |1. (a) One of a nation or people who formerly dwelt in the nothern part of Germany, and who, with other Teutonic tribes, invaded and conquered England in the fifth and sixth centuries. (b) Also used in the sense of Anglo-Saxon. (c) A native or inhabitant of modern Saxony. 2. The language of the Saxons; Anglo-Saxon. old Saxon, the saxon of the continent of Europe in the old form of the language, as shown particularly in the \"Heliand\| a metrical narration of the gospel history preserved in manuscripts of the 9th century.\n\nOf or pertaining to the Saxons| their country| or their language. (b) Anglo-Saxon. (c) Of or pertaining to Saxony or its inhabitants. Saxon blue (Dyeing)| a deep blue liquid used in dyeing| and obtained by dissolving indigo in concentrated sulphuric acid. Brande & C. -- Saxon green (Dyeing)| a green color produced by dyeing with yellow upon a ground of Saxon blue."
saxonic |relating to the saxons or Anglo-Saxons.
saxonism |An idiom of the Saxon or Anglo-Saxon language. T. Warton.
saxonist |One versed in the Saxon language.
saxonite |See Mountain soap, under Mountain.
saxony |1. A kind of glossy woolen cloth formerly much used. 2.  Saxony yarn, or flannel made of it or similar yarn.
saxony yarn |A fine grade of woolen yarn twisted somewhat harder and smoother than zephyr yarn.
saxophone |A wind instrument of brass, containing a reed, and partaking of the qualities both of a brass instrument and of a clarinet.
say |Saw. Chaucer.\n\n1. Trial by sample; assay; sample; specimen; smack. [Obs.] if those principal works of God . . . be but certain tastes and saus, as if were, of that final benefit. Hooker. Thy tongue some say of breeding breathes. Shak. 2. Tried quality; temper; proof. [Obs.] he found a sword of better say. Spenser. 3. Essay; trial; attempt. [Obs.] To give a say at, to attempt. B. Jonson.\n\nTo try; to assay. [Obs.] B. Jonson.\n\n1. A kind of silk or satin. [Obs.] Thou say, thou serge, nay, thou buckram lord! Shak. 2. A delicate kind of serge, or woolen cloth. [Obs.] His garment neither was of silk nor say. Spenser.\n\n1. To utter or express in words; to tell; to speak; to declare; as, he said many wise things. Arise, and say how thou camest here. Shak. 2. To repeat; to rehearse; to recite; to pronounce; as, to say a lesson. Of my instruction hast thou nothing bated In what thou hadst to say Shak. After which shall be said or sung the following hymn. Bk. of Com. Prayer. 3. To announce as a decision or opinion; to state positively; to assert; hence, to form an opinion upon; to be sure about; to be determined in mind as to. But what it is, hard is to say. Milton. 4. To mention or suggest as an estimate, hypothesis, or approximation; hence, to suppose; -- in the imperative, followed sometimes by the subjunctive; as, he had, say fifty thousand dollars; the fox had run, say ten miles. Say, for nonpayment that the debt should double, Is twenty hundred kisses such a trouble Shak. It is said, or They say, it is commonly reported; it is rumored; people assert or maintain. -- That is to say, that is; in other words; otherwise.\n\nTo speak; to express an opinion; to make answer; to reply. You have said; but whether wisely or no, let the forest judge. Shak. To this argument we shall soon have said; for what concerns it us to hear a husband divulge his household privacies Milton.\n\nA speech; something said; an expression of opinion; a current story; a maxim or proverb. [Archaic or Colloq.] He no sooner said out his say, but up rises a cunning snap. L'Estrange. That strange palmer's boding say, That fell so ominous and drear Full on the object of his fear. Sir W. Scott.
sayer |One who says; an utterer. Mr. Curran was something much better than a sayer of smart sayings. Jeffrey.
sayette |A mixed stuff, called also sagathy. See Sagathy.
saying |That which is said; a declaration; a statement, especially a proverbial one; an aphorism; a proverb. Many are the sayings of the wise, In ancient and in modern books enrolled. Milton. Syn. -- Declaration; speech; adage; maxim; aphorism; apothegm; saw; proverb; byword.
sayman |One who assays. [Obs.]
saymaster |A master of assay; one who tries or proves. [Obs.] \"Great saymaster of state.\" D. Jonson.
saynd |obs. p. p. of Senge, to singe. Chaucer. 'SBLOOD 'Sblood, interj.  An abbreviation of God's blood; -- used as an oath. [Obs.] Shak.
scab |1. An incrustation over a sore, wound, vesicle, or pustule, formed by the drying up of the discharge from the diseased part. 2. The itch in man; also, the scurvy. [Colloq. or Obs.] 3. The mange, esp. when it appears on sheep. Chaucer. 4. A disease of potatoes producing pits in their surface, caused by a minute fungus (Tiburcinia Scabies). 5. (Founding)  A slight iregular protuberance which defaces the surface of a casting, caused by the breaking away of a part of the mold. 6. A mean, dirty, paltry fellow. [Low] Shak. 7. A nickname for a workman who engages for lower wages than are fixed by the trades unions; also, for one who takes the place of a workman on a strike. [Cant]\n\nTo become covered with a scab; as, the wound scabbed over.
scabbard |The case in which the blade of a sword, dagger, etc., is kept; a sheath. Nor in thy scabbard sheathe that famous blade. Fairfax. Scabbard fish (Zoöl.), a long, compressed, silver-colored tænioid fish (Lepidopus caudatus, or argyreus), found on the European coasts, and more abundantly about New Zealand, where it is called frostfish and considered an excellent food fish.\n\nTo put in a scabbard.
scabbard plane |See Scaleboard plane, under Scaleboard.
scabbed |1. Abounding with scabs; diseased with scabs. 2. Fig.: Mean; paltry; vile; worthless. Bacon.
scabbedness |Scabbiness.
scabbily |In a scabby manner.
scabbiness |The quality or state of being scabby.
scabble |See Scapple.
scabby |1. Affected with scabs; full of scabs. 2. Diseased with the scab, or mange; mangy. Swift.
scabies |The itch.
scabious |Consisting of scabs; rough; itchy; leprous; as, scabious eruptions. Arbuthnot.\n\nAny plant of the genus Scabiosa, several of the species of which are common in Europe. They resemble the Compositæ, and have similar heads of flowers, but the anthers are not connected. Sweet scabious (a) Mourning bride. (b) A daisylike plant (Erigeron annuus) having a stout branching stem.
scabling |A fragment or chip of stone. [Written also scabline.]
scabredity |Roughness; ruggedness. [Obs.] Burton.
scabrous |1. Rough to the touch, like a file; having small raised dots, scales, or points; scabby; scurfy; scaly. Arbuthnot. 2. Fig.: Harsh; unmusical. [R.] His verse is scabrous and hobbling. Dryden.
scabrousness |The quality of being scabrous.
scabwort |Elecampane.
scad |(a) A small carangoid fish (Trachurus saurus) abundant on the European coast, and less common on the American. The name is applied also to several allied species. (b) The goggler; -- called also big-eyed scad. See Goggler. (c) The friar skate. [Scot.] (d) The cigar fish, or round robin.
scaffold |1. A temporary structure of timber, boards, etc., for various purposes, as for supporting workmen and materials in building, for exhibiting a spectacle upon, for holding the spectators at a show, etc. Pardon, gentles all, The flat, unraised spirits that have dared On this unworthy scaffold to bring forth So great an object. Shak. 2. Specifically, a stage or elevated platform for the execution of a criminal; as, to die on the scaffold. That a scaffold of execution should grow a scaffold of coronation. Sir P. Sidney. 3. (Metal.)  An accumulation of adherent, partly fused material forming a shelf, or dome-shaped obstruction, above the tuyères in a blast furnace.\n\nTo furnish or uphold with a scaffold.
scaffoldage |A scaffold. [R.] Shak.
scaffolding |1. A scaffold; a supporting framework; as, the scaffolding of the body. Pope. 2. Materials for building scaffolds.
scaglia |A reddish variety of limestone.
scagliola |An imitation of any veined and ornamental stone, as marble, formed by a substratum of finely ground gypsum mixed with glue, the surface of which, while soft, is variegated with splinters of marble, spar, granite, etc., and subsequently colored and polished.
scala |1. (Surg.)  A machine formerly employed for reducing dislocations of the humerus. 2. (Anat.)  A term applied to any one of the three canals of the cochlea.
scalable |Capable of being scaled.
scalade |See Escalade. Fairfax.
scalado |See Escalade. Fairfax.
scalar |In the quaternion analysis, a quantity that has magnitude, but not direction; -- distinguished from a vector, which has both magnitude and direction.
scalaria |Any one of numerous species of marine gastropods of the genus Scalaria, or family Scalaridæ, having elongated spiral turreted shells, with rounded whorls, usually crossed by ribs or varices. The color is generally white or pale. Called also ladder shell, and wentletrap. See Ptenoglossa, and Wentletrap.
scalariform |1. Resembling a ladder in form or appearance; having transverse bars or markings like the rounds of a ladder; as, the scalariform cells and scalariform pits in some plants. 2. (Zoöl.)  Like or pertaining to a scalaria.
scalary |Resembling a ladder; formed with steps. [Obs.] Sir T. Browne.
scalawag |A scamp; a scapegrace. [Spelt also scallawag.] [Slang, U.S.] Bartlett.
scald |1. To burn with hot liquid or steam; to pain or injure by contact with, or imersion in, any hot fluid; as, to scald the hand. Mine own tears Do scald like molten lead. Shak. Here the blue flames of scalding brimstone fall. Cowley. 2. To expose to a boiling or violent heat over a fire, or in hot water or other liquor; as, to scald milk or meat.\n\nA burn, or injury to the skin or flesh, by some hot liquid, or by steam.\n\n1. Affected with the scab; scaby. Shak. 2. Scurry; paltry; as, scald rhymers. [Obs.] Shak. Scald crow (Zoöl.), the hooded crow. [Ireland] -- Scald head (Med.), a name popularly given to several diseases of the scalp characterized by pustules (the dried discharge of which forms scales) and by falling out of the hair.\n\nScurf on the head. See Scall. Spenser.\n\nOne of the ancient Scandinavian poets and historiographers; a reciter and singer of heroic poems, etc., among the Norsemen; more rarely, a bard of any of the ancient Teutonic tribes. [Written also skald.] A war song such as was of yore chanted on the field of battle by the scalds of the yet heathen Saxons. Sir W. Scott.
scalder |A Scandinavian poet; a scald.
scaldfish |A European flounder (Arnoglosus laterna, or Psetta arnoglossa); -- called also megrin, and smooth sole.
scaldic |Of or pertaining to the scalds of the Norsemen; as, scaldic poetry.
scale |1. The dish of a balance; hence, the balance itself; an instrument or machine for weighing; as, to turn the scale; -- chiefly used in the plural when applied to the whole instrument or apparatus for weighing. Also used figuratively. Long time in even scale The battle hung. Milton. The scales are turned; her kindness weighs no more Now than my vows. Waller. 2. (Astron.)  The sign or constellation Libra. Platform scale. See under Platform. tip the scales, influence an action so as to change an outcome from one likely result to another.\n\nTo weigh or measure according to a scale; to measure; also, to grade or vary according to a scale or system. Scaling his present bearing with his past. Shak. To scale, or scale down, a debt, wages, etc., to reduce a debt, etc., according to a fixed ratio or scale. [U.S.]\n\n1. (Anat.)  One of the small, thin, membranous, bony or horny pieces which form the covering of many fishes and reptiles, and some mammals, belonging to the dermal part of the skeleton, or dermoskeleton. See Cycloid, Ctenoid, and Ganoid. Fish that, with their fins and shining scales, Glide under the green wave. Milton. 2. Hence, any layer or leaf of metal or other material, resembling in size and thinness the scale of a fish; as, a scale of iron, of bone, etc. 3. (Zoöl.)  One of the small scalelike structures covering parts of some invertebrates, as those on the wings of Lepidoptera and on the body of Thysanura; the elytra of certain annelids. See Lepidoptera. 4. (Zoöl.)  A scale insect. (See below.) 5. (Bot.)  A small appendage like a rudimentary leaf, resembling the scales of a fish in form, and often in arrangement; as, the scale of a bud, of a pine cone, and the like. The name is also given to the chaff on the stems of ferns. 6. The thin metallic side plate of the handle of a pocketknife. See Illust. of Pocketknife. 7. An incrustation deposit on the inside of a vessel in which water is heated, as a steam boiler. 8. (Metal.)  The thin oxide which forms on the surface of iron forgings. It consists esentially of the magnetic oxide, Fe3O4. Also, a similar coating upon other metals. Covering scale (Zoöl.), a hydrophyllium. -- Ganoid scale (Zoöl.) See under Ganoid. -- Scale armor (Mil.), armor made of small metallic scales overlapping, and fastened upon leather or cloth. -- Scale beetle (Zoöl.), the tiger beetle. -- Scale carp (Zoöl.), a carp having normal scales. -- Scale insect (Zoöl.), any one of numerous species of small hemipterous insects belonging to the family Coccidæ, in which the females, when adult, become more or less scalelike in form. They are found upon the leaves and twigs of various trees and shrubs, and often do great damage to fruit trees. See Orange scale,under Orange. -- Scale moss (Bot.), any leafy-stemmed moss of the order Hepaticæ; -- so called from the small imbricated scalelike leaves of most of the species. See Hepatica, 2, and Jungermannia.\n\n1. To strip or clear of scale or scales; as, to scale a fish; to scale the inside of a boiler. 2. To take off in thin layers or scales, as tartar from the teeth; to pare off, as a surface. \"If all the mountaines were scaled, and the earth made even.\" T. Burnet. 3. To scatter; to spread. [Scot. & Prov. Eng.] 4. (Gun.)  To clean, as the inside of a cannon, by the explosion of a small quantity of powder. Totten.\n\n1. To separate and come off in thin layers or laminæ; as, some sandstone scales by exposure. Those that cast their shell are the lobster and crab; the old skins are found, but the old shells never; so it is likely that they scale off. Bacon. 2. To separate; to scatter. [Scot. & Prov. Eng.]\n\n1. A ladder; a series of steps; a means of ascending. [Obs.] 2. Hence, anything graduated, especially when employed as a measure or rule, or marked by lines at regular intervals. Specifically: (a) A mathematical instrument, consisting of a slip of wood, ivory, or metal, with one or more sets of spaces graduated and numbered on its surface, for measuring or laying off distances, etc., as in drawing, plotting, and the like. See Gunter's scale. (b) A series of spaces marked by lines, and representing proportionately larger distances; as, a scale of miles, yards, feet, etc., for a map or plan. (c) A basis for a numeral system; as, the decimal scale; the binary scale, etc. (d) (Mus.) The graduated series of all the tones, ascending or descending, from the keynote to its octave; -- called also the gamut. It may be repeated through any number of octaves. See Chromatic scale, Diatonic scale, Major scale, and Minor scale, under Chromatic, Diatonic, Major, and Minor. 3. Gradation; succession of ascending and descending steps and degrees; progressive series; scheme of comparative rank or order; as, a scale of being. There is a certain scale of duties . . . which for want of studying in right order, all the world is in confusion. Milton. 4. Relative dimensions, without difference in proportion of parts; size or degree of the parts or components in any complex thing, compared with other like things; especially, the relative proportion of the linear dimensions of the parts of a drawing, map, model, etc., to the dimensions of the corresponding parts of the object that is represented; as, a map on a scale of an inch to a mile. Scale of chords, a graduated scale on which are given the lengths of the chords of arcs from 0º to 90º in a circle of given radius, -- used in measuring given angles and in plotting angles of given numbers of degrees.\n\nTo climb by a ladder, or as if by a ladder; to ascend by steps or by climbing; to clamber up; as, to scale the wall of a fort. Oft have I scaled the craggy oak. Spenser.\n\nTo lead up by steps; to ascend. [Obs.] Satan from hence, now on the lower stair, That scaled by steps of gold to heaven-gate, Looks down with wonder. Milton.
scale-winged |Having the wings covered with small scalelike structures, as the lepidoptera; scaly-winged.
scaleback |Any one of numerous species of marine annelids of the family Polynoidæ, and allies, which have two rows of scales, or elytra, along the back. See Illust. under Chætopoda.
scalebeam |1. The lever or beam of a balance; the lever of a platform scale, to which the poise for weighing is applied. 2. A weighing apparatus with a sliding weight, resembling a steelyard.
scaleboard |1. (Print.)  A thin slip of wood used to justify a page. [Obs.] Crabb. 2. A thin veneer of leaf of wood used for covering the surface of articles of firniture, and the like. Scaleboard plane, a plane for cutting from a board a wide shaving forming a scaleboard.
scaled |1. Covered with scales, or scalelike structures; -- said of a fish, a reptile, a moth, etc. 2. Without scales, or with the scales removed; as, scaled herring. 3. (Zoöl.)  Having feathers which in form, color, or arrangement somewhat resemble scales; as, the scaled dove. Scaled dove (Zoöl.), any American dove of the genus Scardafella. Its colored feather tips resemble scales.
scaleless |Destitute of scales.
scalene |1. (Geom.) (a) Having the sides and angles unequal; -- said of a triangle. (b) Having the axis inclined to the base, as a cone. 2. (Anat.) (a) Designating several triangular muscles called scalene muscles. (b) Of or pertaining to the scalene muscles. Scalene muscles (Anat.), a group of muscles, usually three on each side in man, extending from the cervical vertebræ to the first and second ribs.\n\nA triangle having its sides and angles unequal.
scalenohedral |Of or pertaining to a scalenohedron.
scalenohedron |A pyramidal form under the rhombohedral system, inclosed by twelve faces, each a scalene triangle.
scaler |One who, or that which, scales; specifically, a dentist's instrument for removing tartar from the teeth.
scaliness |The state of being scaly; roughness.
scaling |1. Adapted for removing scales, as from a fish; as, a scaling knife; adapted for removing scale, as from the interior of a steam boiler; as, a scaling hammer, bar, etc. 2. Serving as an aid in clambering; as, a scaling ladder, used in assaulting a fortified place.
scaliola |Same as Scagliola.
scall |A scurf or scabby disease, especially of the scalp. It is a dry scall, even a leprosy upon the head. Lev. xiii. 30.\n\nScabby; scurfy. [Obs.] Shak.
scalled |Scabby; scurfy; scall. [Obs.] \"With scalled brows black.\" Chaucer. Scalled head. (Med.) See Scald head, under Scald, a.
scallion |1. (Bot.)  A kind of small onion (Allium Ascalonicum), native of Palestine; the eschalot, or shallot. 2. Any onion which does not \"bottom out,\" but remains with a thick stem like a leek. Amer. Cyc.
scallop |1. (Zoöl.)  Any one of numerous species of marine bivalve mollusks of the genus Pecten and allied genera of the family Pectinidæ. The shell is usually radially ribbed, and the edge is therefore often undulated in a characteristic manner. The large adductor muscle of some the species is much used as food. One species (Vola Jacobæus) occurs on the coast of Palestine, and its shell was formerly worn by pilgrims as a mark that they had been to the Holy Land. Called also fan shell. See Pecten, 2. Note: The common edible scallop of the Eastern United States is Pecten irradians; the large sea scallop, also used as food, is P. Clontonius, or tenuicostastus. 2. One of series of segments of circles joined at their extremities, forming a border like the edge or surface of a scallop shell. 3. One of the shells of a scallop; also, a dish resembling a scallop shell.\n\n1. To mark or cut the edge or border of into segments of circles, like the edge or surface of a scallop shell. See Scallop, n., 2. 2. (Cookery)  To bake in scallop shells or dishes; to prepare with crumbs of bread or cracker, and bake. See Scalloped oysters, below.
scalloped |1. Furnished with a scallop; made or done with or in a scallop. 2. Having the edge or border cut or marked with segments of circles. See Scallop, n., 2. 3. (Cookery)  Baked in a scallop; cooked with crumbs. Scalloped oysters (Cookery), opened oysters baked in a deep dish with alternate layers of bread or cracker crumbs, seasoned with pepper, nutmeg, and butter. This was at first done in scallop shells.
scalloper |One who fishes for scallops.
scalloping |Fishing for scallops.
scalp |A bed of oysters or mussels. [Scot.]\n\n1. That part of the integument of the head which is usually covered with hair. By the bare scalp of Robin Hodd's fat friar, This fellow were a king for our wild faction! Shak. 2. A part of the skin of the head, with the hair attached, cut or torn off from an enemy by the Indian warriors of North America, as a token of victory. 3. Fig.: The top; the summit. Macaulay. Scalp lock, a long tuft of hair left on the crown of the head by the warriors of some tribes of American Indians.\n\n1. To deprive of the scalp; to cut or tear the scalp from the head of. 2. (Surg.)  To remove the skin of. We must scalp the whole lid [of the eye]. J. S. Wells. 3. (Milling.)  To brush the hairs of fuzz from, as wheat grains, in the process of high milling. Knight.\n\nTo make a small, quick profit by slight fluctuations of the market; -- said of brokers who operate in this way on their own account. [Cant]
scalpel |A small knife with a thin, keen blade, -- used by surgeons, and in dissecting.
scalper |1. One who, or that which, scalps. 2. (Surg.)  Same as Scalping iron, under Scalping. 3. A broker who, dealing on his own account, tries to get a small and quick profit from slight fluctuations of the market. [Cant] 4. A person who buys and sells the unused parts of railroad tickets. [Cant]
scalping |a. & n. from Scalp. Scalping iron (Surg.), an instrument used in scraping foul and carious bones; a raspatory. -- Scalping knife, a knife used by north American Indians in scalping.
scalpriform |Shaped like a chisel; as, the scalpriform incisors of rodents.
scaly |1. Covered or abounding with scales; as, a scaly fish. \"Scaly crocodile.\" Milton. 2. Resembling scales, laminæ, or layers. 3. Mean; low; as, a scaly fellow. [Low] 4. (Bot.)  Composed of scales lying over each other; as, a scaly bulb; covered with scales; as, a scaly stem. Scaly ant-eater (Zoöl.), the pangolin.
scaly-winged |Scale-winged.
scamble |1. To move awkwardly; to be shuffling, irregular, or unsteady; to sprawl; to shamble. \"Some scambling shifts.\" Dr. H. More. \"A fine old hall, but a scambling house.\" Evelyn. 2. To move about pushing and jostling; to be rude and turbulent; to scramble. \"The scambling and unquiet time did push it out of . . . question.\" Shak.\n\nTo mangle. [Obs.] Mortimer.
scambler |1. One who scambles. 2. A bold intruder upon the hospitality of others; a mealtime visitor. [Scot.]
scamblingly |In a scambling manner; with turbulence and noise; with bold intrusiveness.
scamell |The female bar-tailed godwit. [Prov. Eng.] Note: Whether this is the scamel mentioned by Shakespeare [\"Tempest,\" ii. 2] is not known.
scamillus |A sort of second plinth or block, below the bases of Ionic and Corinthian columns, generally without moldings, and of smaller size horizontally than the pedestal.
scammel |The female bar-tailed godwit. [Prov. Eng.] Note: Whether this is the scamel mentioned by Shakespeare [\"Tempest,\" ii. 2] is not known.
scammoniate |Made from scammony; as, a scammoniate aperient.
scammony |1. (Bot.)  A species of bindweed or Convolvulus (C. Scammonia). 2. An inspissated sap obtained from the rot of the Convolvulus Scammonia, of a blackish gray color, a nauseous smell like that of old cheese, and a somewhat acrid taste. It is used in medicine as a cathartic.
scamp |A rascal; a swindler; a rogue. De Quincey.\n\nTo perform in a hasty, neglectful, or imperfect manner; to do superficially. [Colloq.] A workman is said to scamp his work when he does it in a superficial, dishonest manner. Wedgwood. Much of the scamping and dawdling complained of is that of men in establishments of good repute. T. Hughes.
scampavia |A long, low war galley used by the Neapolitans and Sicilians in the early part of the nineteenth century.
scamper |To run with speed; to run or move in a quick, hurried manner; to hasten away. Macaulay. The lady, however, . . . could not help scampering about the room after a mouse. S. Sharpe.\n\nA scampering; a hasty flight.
scamperer |One who scampers. Tyndell.
scampish |Of or like a scamp; knavish; as, scampish conduct.
scan |1. To mount by steps; to go through with step by step. [Obs.] Nor stayed till she the highest stage had scand. Spenser. 2. Specifically (Pros.), to go through with, as a verse, marking and distinguishing the feet of which it is composed; to show, in reading, the metrical structure of; to recite metrically. 3. To go over and examine point by point; to examine with care; to look closely at or into; to scrutinize. The actions of men in high stations are all conspicuous, and liable to be scanned and sifted. Atterbury.
scandal |1. Offense caused or experienced; reproach or reprobation called forth by what is regarded as wrong, criminal, heinous, or flagrant: opprobrium or disgrace. O, what a scandal is it to our crown, That two such noble peers as ye should jar! Shak. [I] have brought scandal To Israel, diffidence of God, and doubt In feeble hearts. Milton. 2. Reproachful aspersion; opprobrious censure; defamatory talk, uttered heedlessly or maliciously. You must not put another scandal on him. Shak. My known virtue is from scandal free. Dryden. 3. (Equity)  Anything alleged in pleading which is impertinent, and is reproachful to any person, or which derogates from the dignity of the court, or is contrary to good manners. Daniell. Syn. -- Defamation; detraction; slander; calumny; opprobrium; reproach; shame; disgrace.\n\n1. To treat opprobriously; to defame; to asperse; to traduce; to slander. [R.] I do faws on men and hug them hard And after scandal them. Shak. 2. To scandalize; to offend. [Obs.] Bp. Story. Syn. -- To defame; traduce; reproach; slander; calumniate; asperse; vilify; disgarce.
scandalize |1. To offend the feelings of the conscience of (a person) by some action which is considered immoral or criminal; to bring shame, disgrace, or reproach upon. I demand who they are whom we scandalize by using harmless things. Hooker. the congregation looked on in silence, the better class scandalized, and the lower orders, some laughing, others backing the soldier or the minister, as their fancy dictated. Sir W. Scott. 2. To reproach; to libel; to defame; to slander. To tell his tale might be interpreted into scandalizing the order. Sir W. Scott.
scandalous |1. Giving offense to the conscience or moral feelings; exciting reprobation; calling out condemnation. Nothing scandalous or offensive unto any. Hooker. 2. Disgraceful to reputation; bringing shame or infamy; opprobrious; as, a scandalous crime or vice. 3. Defamatory; libelous; as, a scandalous story.
scandalously |1. In a manner to give offense; shamefully. His discourse at table was scandalously unbecoming the digmity of his station. Swift. 2. With a disposition to impute immorality or wrong. Shun their fault, who, scandalously nice, Will needs mistake an author into vice. Pope.
scandalousness |Quality of being scandalous.
scandalum magnatum |A defamatory speech or writing published to the injury of a person of dignity; -- usually abbreviated scan. mag.
scandent |Climbing. Note: Scandent plants may climb either by twining, as the hop, or by twisted leafstalks, as the clematis, or by tendrils, as the passion flower, or by rootlets, as the ivy.
scandia |A chemical earth, the oxide of scandium.
scandic |Of or pertaining to scandium; derived from, or containing, scandium.
scandinavian |Of or pertaining to Scandinavia, that is, Sweden, Norway, and Denmark. -- n.  A native or inhabitant of Scandinavia.
scandium |A rare metallic element of the boron group, whose existence was predicated under the provisional name ekaboron by means of the periodic law, and subsequently discovered by spectrum analysis in certain rare Scandinavian minerals (euxenite and gadolinite). It has not yet been isolated. Symbol Sc. Atomic weight 44
scansion |The act of scanning; distinguishing the metrical feet of a verse by emphasis, pauses, or otherwise.
scansores |An artifical group of birds formerly regarded as an order. They are distributed among several orders by modern ornithologists. Note: The toes are in pairs, two before and two behind, by which they are enabled to cling to, and climb upon, trees, as the woodpeckers, parrots, cuckoos, and trogons. See Illust. under Aves.
scansorial |(a) Capable of climbing; as, the woodpecker is a scansorial bird; adapted for climbing; as, the scansorial foot. (b) Of or pertaining to the Scansores. See Illust. under Aves. Scansorial tail (Zoöl.), a tail in which the feathers are stiff and sharp at the tip, as in the woodpeckers.
scant |1. Not full, large, or plentiful; scarcely sufficient; less than is wanted for the purpose; scanty; meager; not enough; as, a scant allowance of provisions or water; a scant pattern of cloth for a garment. His sermon was scant, in all, a quarter of an hour. Ridley. 2. Sparing; parsimonious; chary. Be somewhat scanter of your maiden presence. Shak. Syn. -- See under Scanty.\n\n1. To limit; to straiten; to treat illiberally; to stint; as, to scant one in provisions; to scant ourselves in the use of necessaries. Where man hath a great living laid together and where he is scanted. Bacon. I am scanted in the pleasure of dwelling on your actions. Dryden. 2. To cut short; to make small, narrow, or scanty; to curtail. \"Scant not my cups.\" Shak.\n\nTo fail, of become less; to scantle; as, the wind scants.\n\nIn a scant manner; with difficulty; scarcely; hardly. [Obs.] Bacon. So weak that he was scant able to go down the stairs. Fuller.\n\nScantness; scarcity. [R.] T. Carew.
scantily |In a scanty manner; not fully; not plentifully; sparingly; parsimoniously. His mind was very scantily stored with materials. Macaulay.
scantiness |Quality condition of being scanty.
scantle |To be deficient; to fail. [Obs.] Drayton.\n\nTo scant; to be niggard of; to divide into small pieces; to cut short or down. [Obs.] All their pay Must your discretion scantle; keep it back. J. Webster.
scantlet |A small pattern; a small quantity. [Obs.] Sir M. Hale.
scantling |Not plentiful; small; scanty. [Obs.] Jer. Taylor.\n\n1. A fragment; a bit; a little piece. Specifically: (a) A piece or quantity cut for a special purpose; a sample. [Obs.] Such as exceed not this scantling; -- to be solace to the sovereign and harmless to the people. Bacon. A pretty scantling of his knowledge may taken by his deferring to be baptized so many years. Milton. (b) A small quantity; a little bit; not much. [Obs.] Reducing them to narrow scantlings. Jer. Taylor. 2. A piece of timber sawed or cut of a small size, as for studs, rails, etc. 3. The dimensions of a piece of timber with regard to its breadth and thickness; hence, the measure or dimensions of anything. 4. A rough draught; a rude sketch or outline. 5. A frame for casks to lie upon; a trestle. Knight.
scantly |1. In a scant manner; not fully or sufficiently; narrowly; penuriously. Dryden. 2. Scarcely; hardly; barely. Scantly they durst their feeble eyes dispread Upon that town. Fairfax. We hold a tourney here to-morrow morn, And there is scantly time for half the work. Tennyson.
scantness |The quality or condition of being scant; narrowness; smallness; insufficiency; scantiness. \"Scantness of outward things.\" Barrow.
scanty |1. Wanting amplitude or extent; narrow; small; not abundant. his dominions were very narrow and scanty. Locke. Now scantier limits the proud arch confine. Pope. 2. Somewhat less than is needed; insufficient; scant; as, a scanty supply of words; a scanty supply of bread. 3. Sparing; niggardly; parsimonius. In illustrating a point of difficulty, be not too scanty of words. I. Watts. Syn. -- Scant; narrow; small; poor; deficient; meager; scarce; chary; sparing; parsimonious; penurious; niggardly; grudging.
scape |1. (Bot.)  A peduncle rising from the ground or from a subterranean stem, as in the stemless violets, the bloodroot, and the like. 2. (Zoöl.)  The long basal joint of the antennæ of an insect. 3. (Arch.) (a) The shaft of a column. (b) The apophyge of a shaft.\n\nTo escape. [Obs. or Poetic.] Milton. Out of this prison help that we may scape. Chaucer.\n\n1. An escape. [Obs.] I spake of most disastrous chances, . . . Of hairbreadth scapes in the imminent, deadly breach. Shak. 2. Means of escape; evasion. [Obs.] Donne. 3. A freak; a slip; a fault; an escapade. [Obs.] Not pardoning so much as the scapes of error and ignorance. Milton. 4. Loose act of vice or lewdness. [Obs.] Shak.
scape-wheel |the wheel in an escapement (as of a clock or a watch) into the teeth of which the pallets play.
scapegallows |One who has narrowly escaped the gallows for his crimes. [Colloq.] Dickens.
scapegoat |1. (Jewish Antiq.)  A goat upon whose head were symbolically placed the sins of the people, after which he was suffered to escape into the wilderness. Lev. xvi. 10. 2. Hence, a person or thing that is made to bear blame for others. Tennyson.
scapegrace |A graceless, unprincipled person; one who is wild and reckless. Beaconsfield.
scapeless |Destitute of a scape.
scapement |Same as Escapement, 3.
scaphander |The case, or impermeable apparel, in which a diver can work while under water.
scaphism |An ancient mode of punishing criminals among the Persians, by confining the victim in a trough, with his head and limbs smeared with honey or the like, and exposed to the sun and to insects until he died.
scaphite |Any fossil cephalopod shell of the genus Scaphites, belonging to the Ammonite family and having a chambered boat-shaped shell. Scaphites are found in the Cretaceous formation.
scaphocephalic |Of, pertaining to, or affected with, scaphocephaly.
scaphocephaly |A deformed condition of the skull, in which the vault is narrow, clongated, and more or less boat-shaped.
scaphocerite |A flattened plate or scale attached to the second joint of the antennæ of many Crustacea.
scaphognathite |A thin leafike appendage (the exopodite) of the second maxilla of decapod crustaceans. It serves as a pumping organ to draw the water through the gill cavity.
scaphoid |Resembling a boat in form; boat-shaped. -- n.  The scaphoid bone. Scaphoid bone (a) One of the carpal bones, which articulates with the radius; the radiale. (b) One of the tarsal bones; the navicular bone. See under Navicular.
scapholunar |Of or pertaining to the scaphoid and lunar bones of the carpus. -- n.  The scapholunar bone. Scapholunar bone, a bone formed by the coalescence of the scaphoid and lunar in the carpus of carnivora.
scaphopoda |A class of marine cephalate Mollusca having a tubular shell open at both ends, a pointed or spadelike foot for burrowing, and many long, slender, prehensile oral tentacles. It includes Dentalium, or the tooth shells, and other similar shells. Called also Prosopocephala, and Solenoconcha.
scapiform |Resembling scape, or flower stm.
scapolite |A grayish white mineral occuring in tetragonal crystals and in cleavable masses. It is esentially a silicate of aluminia and soda. Note: The scapolite group includes scapolite proper, or wernerite, also meionite, dipyre, etc.
scapple |(a) To work roughly, or shape without finishing, as stone before leaving the quarry. (b) To dress in any way short of fine tooling or rubbing, as stone. Gwilt.
scapula |1. (Anat.)  The principal bone of the shoulder girdle in mammals; the shoulder blade. 2. (Zoöl.)  One of the plates from which the arms of a crinoid arise.
scapular |Of or pertaining to the scapula or the shoulder Scapular arch (Anat.), the pectoral arch. See under pectoral. -- Scapular region, or Scapular tract (Zoöl.), a definite longitudinal area over the shoulder and along each side of the back of a bird, from which the scapular feathers arise.\n\nOne of a special group of feathers which arise from each of the scapular regions and lie along the sides of the back.\n\n1. (R.C.Ch.) (a) A loose sleeveless vestment falling in front and behind, worn by certain religious orders and devout persons. (b) The name given to two pieces of cloth worn under the ordinary garb and over the shoulders as an act of devotion. Addis & Arnold. 2. (Surg.)  A bandage passing over the shoulder to support it, or to retain another bandage in place.
scapulary |1. (R.C.Ch.) (a) A loose sleeveless vestment falling in front and behind, worn by certain religious orders and devout persons. (b) The name given to two pieces of cloth worn under the ordinary garb and over the shoulders as an act of devotion. Addis & Arnold. 2. (Surg.)  A bandage passing over the shoulder to support it, or to retain another bandage in place.\n\nSame as Scapular, a.\n\nSame as 2d and 3d Scapular.
scapulet |A secondary mouth fold developed at the base of each of the armlike lobes of the manubrium of many rhizostome medusæ. See Illustration in Appendix.
scapulo- |A combining form used in anatomy to indicate connection with, or relation to, the scapula or the shoulder; as, the scapulo- clavicular articulation, the articulation between the scapula and clavicle.
scapus |See 1st Scape.
scar |1. A mark in the skin or flesh of an animal, made by a wound or ulcer, and remaining after the wound or ulcer is healed; a cicatrix; a mark left by a previous injury; a blemish; a disfigurement. This earth had the beauty of youth, . . . and not a wrinkle, scar, or fracture on all its body. T. Burnet. 2. (Bot.)  A mark left upon a stem or branch by the fall of a leaf, leaflet, or frond, or upon a seed by the separation of its support. See Illust. under Axillary.\n\nTo mark with a scar or scars. Yet I'll not shed her blood; Nor scar that whiter skin of hers than snow. Shak. His cheeks were deeply scarred. Macaulay.\n\nTo form a scar.\n\nAn isolated or protruding rock; a steep, rocky eminence; a bare place on the side of a mountain or steep bank of earth. [Written also scaur.] O sweet and far, from cliff and scar, The horns of Elfland faintly blowing. Tennyson.\n\nA marine food fish, the scarus, or parrot fish.
scarab |Any one of numerous species of lamellicorn beetles of the genus Scarabæus, or family Scarabæidæ, especially the sacred, or Egyptian, species (Scarabæus sacer, and S. Egyptiorum).
scarabaeus |Same as Scarab.
scarabee |Any one of numerous species of lamellicorn beetles of the genus Scarabæus, or family Scarabæidæ, especially the sacred, or Egyptian, species (Scarabæus sacer, and S. Egyptiorum).
scaraboid |Of or pertaining to the family Scarabæidæ, an extensive group which includes the Egyptian scarab, the tumbleding, and many similar lamellicorn beetles.\n\nA scaraboid beetle.
scaramouch |A personage in the old Italian comedy (derived from Spain) characterized by great boastfulness and poltroonery; hence, a person of like characteristics; a buffoon.
scarce |1. Not plentiful or abundant; in small quantity in proportion to the demand; not easily to be procured; rare; uncommon. You tell him silver is scarcer now in England, and therefore risen one fifth in value. Locke. The scarcest of all is a Pescennius Niger on a medallion well preserved. Addison. 2. Scantily supplied (with); deficient (in); -- with of. [Obs.] \"A region scarce of prey.\" Milton. 3. Sparing; frugal; parsimonious; stingy. [Obs.] \"Too scarce ne too sparing.\" Chaucer. To make one's self scarce, to decamp; to depart. [Slang] Syn. -- Rare; infrequent; deficient. See Rare.\n\n1. With difficulty; hardly; scantly; barely; but just. With a scarce well-lighted flame. Milton. The eldest scarcely five year was of age. Chaucer. Slowly she sails, and scarcely stems the tides. Dryden. He had scarcely finished, when the laborer arrived who had been sent for my ransom. W. Irwing. 2. Frugally; penuriously. [Obs.] haucer.
scarcely |1. With difficulty; hardly; scantly; barely; but just. With a scarce well-lighted flame. Milton. The eldest scarcely five year was of age. Chaucer. Slowly she sails, and scarcely stems the tides. Dryden. He had scarcely finished, when the laborer arrived who had been sent for my ransom. W. Irwing. 2. Frugally; penuriously. [Obs.] haucer.
scarcement |An offset where a wall or bank of earth, etc., retreats, leaving a shelf or footing.
scarceness |The quality or condition of being scarce; smallness of quantity in proportion to the wants or demands; deficiency; lack of plenty; short supply; penury; as, a scarcity of grain; a great scarcity of beauties. Chaucer. A scarcity of snow would raise a mutiny at Naples. Addison. Praise . . . owes its value to its scarcity. Rambler. The value of an advantage is enhanced by its scarceness. Collier. Syn. -- Deficiency; lack; want; penury; dearth; rareness; rarity; infrequency.
scarcity |The quality or condition of being scarce; smallness of quantity in proportion to the wants or demands; deficiency; lack of plenty; short supply; penury; as, a scarcity of grain; a great scarcity of beauties. Chaucer. A scarcity of snow would raise a mutiny at Naples. Addison. Praise . . . owes its value to its scarcity. Rambler. The value of an advantage is enhanced by its scarceness. Collier. Syn. -- Deficiency; lack; want; penury; dearth; rareness; rarity; infrequency.
scard |A shard or fragment. [Obs.]
scare |To frighten; to strike with sudden fear; to alarm. The noise of thy crossbow Will scare the herd, and so my shoot is lost. Shak. To scare away, to drive away by frightening. -- To scare up, to find by search, as if by beating for game. [Slang] Syn. -- To alarm; frighten; startle; affright; terrify.\n\nFright; esp., sudden fright produced by a trifling cause, or originating in mistake. [Colloq.]
scarecrow |1. Anything set up to frighten crows or other birds from cornfields; hence, anything terifying without danger. A scarecrow set to frighten fools away. Dryden. 2. A person clad in rags and tatters. No eye hath seen such scarecrows. I'll not march with them through Coventry, that's flat. Shak. 3. (Zoöl.)  The black tern. [Prov. Eng.]
scarefire |1. An alarm of fire. [Obs.] 2. A fire causing alarm. [Obs.] Fuller.
scarf |A cormorant. [Scot.]\n\nAn article of dress of a light and decorative character, worn loosely over the shoulders or about the neck or the waist; a light shawl or handkerchief for the neck; also, a cravat; a neckcloth. Put on your hood and scarf. Swift. With care about the banners, scarves, and staves. R. Browning.\n\n1. To throw on loosely; to put on like a scarf. \"My sea-gown scarfed about me.\" Shak. 2. To dress with a scarf, or as with a scarf; to cover with a loose wrapping. Shak.\n\n(a) To form a scarf on the end or edge of, as for a joint in timber, metal rods, etc. (b) To unite, as two pieces of timber or metal, by a scarf joint.\n\n(a) In a piece which is to be united to another by a scarf joint, the part of the end or edge that is tapered off, rabbeted, or notched so as to be thinner than the rest of the piece. (b) A scarf joint. Scarf joint (a) A joint made by overlapping and bolting or locking together the ends of two pieces of timber that are halved, notched, or cut away so that they will fit each other and form a lengthened beam of the same size at the junction as elsewhere. (b) A joint formed by welding, riveting, or brazing together the overlapping scarfed ends, or edges, of metal rods, sheets, etc. -- Scarf weld. See under Weld.
scarfskin |See Epidermis.
scarification |The act of scarifying.
scarificator |An instrument, principally used in cupping, containing several lancets moved simultaneously by a spring, for making slight incisions.
scarifier |1. One who scarifies. 2. (Surg.)  The instrument used for scarifying. 3. (Agric.)  An implement for stripping and loosening the soil, without bringing up a fresh surface. You have your scarifiers to make the ground clean. Southey.
scarify |1. To scratch or cut the skin of; esp. (Med.), to make small incisions in, by means of a lancet or scarificator, so as to draw blood from the smaller vessels without opening a large vein. 2. (Agric.)  To stir the surface soil of, as a field.
scariose |Thin, dry, membranous, and not green. Gray.
scarious |Thin, dry, membranous, and not green. Gray.
scarlatina |Scarlet fever. -- Scar`la*ti\"nal, a. -- Scar*lat\"i*nous (# or #), a.
scarless |Free from scar. Drummond.
scarlet |A deep bright red tinged with orange or yellow, -- of many tints and shades; a vivid or bright red color. 2. Cloth of a scarlet color. All her household are clothed with scarlet. Prov. xxxi. 21.\n\nOf the color called scarlet; as, a scarlet cloth or thread. Scarlet admiral (Zoöl.), the red admiral. See under Red. -- Scarlet bean (Bot.), a kind of bean (Phaseolus multiflorus) having scarlet flowers; scarlet runner. -- Scarlet fever (Med.), a contagious febrile disease characterized by inflammation of the fauces and a scarlet rash, appearing usually on the second day, and ending in desquamation about the sixth or seventh day. -- Scarlet fish (Zoöl.), the telescope fish; -- so called from its red color. See under Telescope. -- Scarlet ibis (Zoöl.) See under Ibis. -- Scarlet maple (Bot.), the red maple. See Maple. -- Scarlet mite (Zoöl.), any one of numerous species of bright red carnivorous mites found among grass and moss, especially Thombidium holosericeum and allied species. The young are parasitic upon spiders and insects. -- Scarlet oak (Bot.), a species of oak (Quercus coccinea) of the United States; -- so called from the scarlet color of its leaves in autumn. -- Scarlet runner (Bot.), the scarlet bean. -- Scarlet tanager. (Zoöl.) See under Tanager.\n\nTo dye or tinge with scarlet. [R.] The ashy paleness of my cheek Is scarleted in ruddy flakes of wrath. Ford.
scarmage |A slight contest; a skirmish. See Skirmish. [Obs.] Such cruel game my scarmoges disarms. Spenser.
scarmoge |A slight contest; a skirmish. See Skirmish. [Obs.] Such cruel game my scarmoges disarms. Spenser.
scarn |Dung. [Obs. or Prov. Eng.] Ray. Scarn bee (Zoöl.), a dung beetle.
scaroid |Of or pertaining to the Scaridæ, a family of marine fishes including the parrot fishes.
scarp |A band in the same position as the bend sinister, but only half as broad as the latter.\n\n1. (Fort.)  The slope of the ditch nearest the parapet; the escarp. 2. A steep descent or declivity.\n\nTo cut down perpendicularly, or nearly so; as, to scarp the face of a ditch or a rock. From scarped cliff and quarried stone. Tennyson. Sweep ruins from the scarped mountain. Emerson.
scarring |A scar; a mark. We find upon the limestone rocks the scarrings of the ancient glacier which brought the bowlder here. Tyndall.
scarry |Bearing scars or marks of wounds.\n\nLike a scar, or rocky eminence; containing scars. Holinshed.
scarus |A Mediterranean food fish (Sparisoma scarus) od excellent quality and highly valued by the Romans; -- called also parrot fish.
scary |Barren land having only a thin coat of grass. [Prov. Eng.]\n\n1. Subject to sudden alarm. [Colloq.U.S.] Whittier. 2. Causing fright; alarming. [Colloq.U.S.]
scasely |Scarcely; hardly. [Obs. or Colloq.] Robynson (More's Utopia)
scat |Go away; begone; away; -- chiefly used in driving off a cat.\n\nTribute. [R.] \"Seizing scatt and treasure.\" Longfellow.\n\nA shower of rain. [Prov. Eng.] Wright.
scatch |A kind of bit for the bridle of a horse; -- called also scatchmouth. Bailey.
scatches |Stilts. [Prov. Eng.]
scate |See Skate, for the foot.
scatebrous |Abounding with springs. [Obs.]
scath |Harm; damage; injury; hurt; waste; misfortune. [Written also scathe.] But she was somedeal deaf, and that was skathe. Chaucer. Great mercy, sure, for to enlarge a thrall, Whose freedom shall thee turn to greatest scath. Spenser. Wherein Rome hath done you any scath, Let him make treble satisfaction. Shak.\n\nTo do harm to; to injure; to damage; to waste; to destroy. As when heaven's fire Hath scathed the forest oaks or mountain pines. Milton. Strokes of calamity that scathe and scorch the soul. W. Irwing.
scathe |To do harm to; to injure; to damage; to waste; to destroy. As when heaven's fire Hath scathed the forest oaks or mountain pines. Milton. Strokes of calamity that scathe and scorch the soul. W. Irwing.
scathful |Harmful; doing damage; pernicious. Shak. -- Scath\"ful*ness, n.
scathless |Unharmed. R. L. Stevenson. He, too, . . . is to be dismissed scathless. Sir W. Scott.
scathly |Injurious; scathful. [Obs.]
scatt |Tribute. [R.] \"Seizing scatt and treasure.\" Longfellow.
scatter |1. To strew about; to sprinkle around; to throw down loosely; to deposit or place here and there, esp. in an open or sparse order. And some are scattered all the floor about. Chaucer. Why should my muse enlarge on Libyan swains, Their scattered cottages, and ample plains Dryden. Teach the glad hours to scatter, as they fly, Soft quiet, gentle love, and endless joy. Prior. 2. To cause to separate in different directions; to reduce from a close or compact to a loose or broken order; to dissipate; to disperse. Scatter and disperse the giddy Goths. Shak. 3. Hence, to frustrate, disappoint, and overthrow; as, to scatter hopes, plans, or the like. Syn. -- To disperse; dissipate; spread; strew.\n\nTo be dispersed or dissipated; to disperse or separate; as, clouds scatter after a storm.
scatter-brain |A giddy or thoughtless person; one incapable of concentration or attention. [Written also scatter-brains.]
scatter-brained |Giddy; thoughtless.
scattered |1. Dispersed; dissipated; sprinkled, or loosely spread. 2. (Bot.)  Irregular in position; having no regular order; as, scattered leaves. -- Scat\"tered*ly, adv. -- Scat\"tered*ness, n.
scattergood |One who wastes; a spendthrift.
scattering |Going or falling in various directions; not united or agregated; divided among many; as, scattering votes.\n\nAct of strewing about; something scattered. South.
scatteringly |In a scattering manner; dispersedly.
scatterling |One who has no fixed habitation or residence; a vagabond. [Obs.] \"Foreign scatterlings.\" Spenser.
scaturient |Gushing forth; full to overflowing; effusive. [R.] A pen so scaturient and unretentive. Sir W. Scott.
scaturiginous |Abounding with springs. [Obs.]
scaup |1. A bed or stratum of shellfish; scalp. [Scot.] 2. (Zoöl.)  A scaup duck. See below. Scaup duck (Zoöl.), any one of several species of northern ducks of the genus Aythya, or Fuligula. The adult males are, in large part, black. The three North American species are: the greater scaup duck (Aythya marila, var. nearctica), called also broadbill, bluebill, blackhead, flock duck, flocking fowl, and raft duck; the lesser scaup duck (A. affinis), called also little bluebill, river broadbill, and shuffler; the tufted, or ring-necked, scaup duck (A. collaris), called also black jack, ringneck, ringbill, ringbill shuffler, etc. See Illust. of Ring-necked, under Ring- necked. The common European scaup, or mussel, duck (A.marila), closely resembles the American variety.
scauper |A tool with a semicircular edge, -- used by engravers to clear away the spaces between the lines of an engraving. Fairholt.
scaur |A precipitous bank or rock; a scar.
scavage |A toll duty formerly exacted of merchant strangers by mayors, sheriffs, etc., for goods shown or offered for sale within their precincts. Cowell.
scavenge |To cleanse, as streets, from filth. C. Kingsley.
scavenger |A person whose employment is to clean the streets of a city, by scraping or sweeping, and carrying off the fifth. The name is also applied to any animal which devours refuse, carrion, or anything injurious to health. Scavenger beetle (Zoöl.), any beetle which feeds on decaying substances, as the carrion beetle. -- Scavanger crab (Zoöl.), any crab which feeds on dead animals, as the spider crab. -- Scavenger's daughter Etym: [corrupt. of Skevington's daughter], an instrument of torture invented by Sir W. Skevington, which so compressed the body as to force the blood to flow from nostrils. and sometimes from the hands and feet. Am. Cyc.
scavenging |Act or process of expelling the exhaust gases from the cylinder by some special means, as, in many four-cycle engines, by utilizing the momentum of the exhaust gases in a long exhaust pipe.
scazon |A choliamb.
scelerat |A villian; a criminal. [Obs.] Cheyne.
scelestic |Evil; wicked; atrocious. [Obs.] \"Scelestic villainies.\" Feltham.
scelet |A mummy; a skeleton. [Obs.] olland.
scena |(a) A scene in an opera. (b) An accompanied dramatic recitative, interspersed with passages of melody, or followed by a full aria. Rockstro.
scenario |A preliminary sketch of the plot, or main incidents, of an opera.
scenary |Scenery. [Obs.] Dryden.
scene |1. The structure on which a spectacle or play is exhibited; the part of a theater in which the acting is done, with its adjuncts and decorations; the stage. 2. The decorations and fittings of a stage, representing the place in which the action is supposed to go on; one of the slides, or other devices, used to give an appearance of reality to the action of a play; as, to paint scenes; to shift the scenes; to go behind the scenes. 3. So much of a play as passes without change of locality or time, or important change of character; hence, a subdivision of an act; a separate portion of a play, subordinate to the act, but differently determined in different plays; as, an act of four scenes. My dismal scene I needs must act alone. Shak. 4. The place, time, circumstance, etc., in which anything occurs, or in which the action of a story, play, or the like, is laid; surroundings amid which anything is set before the imagination; place of occurence, exhibition, or action. \"In Troy, there lies the scene.\" Shak. The world is a vast scene of strife. J. M. Mason. 5. An assemblage of objects presented to the view at once; a series of actions and events exhibited in their connection; a spectacle; a show; an exhibition; a view. Through what new scenes and changes must we pass! Addison. 6. A landscape, or part of a landscape; scenery. A sylvan scene with various greens was drawn, Shades on the sides, and in the midst a lawn. Dryden. 7. An exhibition of passionate or strong feeling before others; often, an artifical or affected action, or course of action, done for effect; a theatrical display. Probably no lover of scenes would have had very long to wait De Quincey. Behind the scenes, behind the scenery of a theater; out of the view of the audience, but in sight of the actors, machinery, etc.; hence, conversant with the hidden motives and agencies of what appears to public view.\n\nTo exhibit as a scene; to make a scene of; to display. [Obs.] Abp. Sancroft.
sceneful |Having much scenery. [R.]
sceneman |The man who manages the movable scenes in a theater.
scenery |1. Assemblage of scenes; the scenes of a play; the disposition and arrangement of the scenes in which the action of a play, poem, etc., is laid; representation of place of action or occurence. 2. Sum of scenes or views; general aspect, as regards variety and beauty or the reverse, in a landscape; combination of natural views, as woods, hills, etc. Never need an American look beyond his own country for the sublime and beautiful of natural scenery. W. Irving.
sceneshifter |One who moves the scenes in a theater; a sceneman.
scenic |Of or pertaining to scenery; of the nature of scenery; theatrical. All these situations communicate a scenical animation to the wild romance, if treated dramatically. De Quincey.
scenical |Of or pertaining to scenery; of the nature of scenery; theatrical. All these situations communicate a scenical animation to the wild romance, if treated dramatically. De Quincey.
scenograph |A perspective representation or general view of an object.
scenographic |Of or pertaining to scenography; drawn in perspective. -- Scen`o*graph\"ic*al*ly, adv.
scenographical |Of or pertaining to scenography; drawn in perspective. -- Scen`o*graph\"ic*al*ly, adv.
scenography |The art or act of representing a body on a perspective plane; also, a representation or description of a body, in all its dimensions, as it appears to the eye. Greenhill.
scent |1. To perceive by the olfactory organs; to smell; as, to scent game, as a hound does. Methinks I scent the morning air. Shak. 2. To imbue or fill with odor; to perfume. Balm from a silver box distilled around, Shall all bedew the roots, and scent the sacred ground. Dryden.\n\n1. To have a smell. [Obs.] Thunderbolts . . . do scent strongly of brimstone. Holland. 2. To hunt animals by means of the sense of smell.\n\n1. That which, issuing from a body, affects the olfactory organs of animals; odor; smell; as, the scent of an orange, or of a rose; the scent of musk. With lavish hand diffuses scents ambrosial. prior. 2. Specifically, the odor left by an animal on the ground in passing over it; as, dogs find or lose the scent; hence, course of pursuit; track of discovery. He gained the observations of innumerable ages, and traveled upon the same scent into Ethiopia. Sir W. Temple. 3. The power of smelling; the sense of smell; as, a hound of nice scent; to divert the scent. I. Watts.
scentful |1. Full of scent or odor; odorous. \"A scentful nosegay.\" W. Browne. 2. Of quick or keen smell. The scentful osprey by the rock had fished. W. Browne.
scentingly |By scent. [R.] Fuller.
scentless |Having no scent. The scentless and the scented rose. Cowper.
scepsis |Skepticism; skeptical philosophy. [R.] Among their products were the system of Locke, the scepsis of Hume, the critical philosophy of kant. J. martineau.
scepter |1. A staff or baton borne by a sovereign, as a ceremonial badge or emblem of authority; a royal mace. And the king held out Esther the golden scepter that was in his hand. Esther v. 2. 2. Hence, royal or imperial power or authority; sovereignty; as, to assume the scepter. The scepter shall not depart from Judah, nor a lawgiver from between his feet, until Shilon come. Gen. xlix. 10.\n\nTo endow with the scepter, or emblem of authority; to invest with royal authority. To Britain's queen the sceptered suppliant bends. Tickell.
scepterellate |Having a straight shaft with whorls of spines; -- said of certain sponge spicules. See Illust. under Spicule.
scepterless |Having no scepter; without authority; powerless; as, a scepterless king.
sceptic |etc. See Skeptic, Skeptical, Skepticism, etc.
sceptical |etc. See Skeptic, Skeptical, Skepticism, etc.
scepticism |etc. See Skeptic, Skeptical, Skepticism, etc.
sceptral |Of or pertaining to a scepter; like a scepter.
sceptre |1. A staff or baton borne by a sovereign, as a ceremonial badge or emblem of authority; a royal mace. And the king held out Esther the golden scepter that was in his hand. Esther v. 2. 2. Hence, royal or imperial power or authority; sovereignty; as, to assume the scepter. The scepter shall not depart from Judah, nor a lawgiver from between his feet, until Shilon come. Gen. xlix. 10.\n\nTo endow with the scepter, or emblem of authority; to invest with royal authority. To Britain's queen the sceptered suppliant bends. Tickell.
sceptreless |Having no scepter; without authority; powerless; as, a scepterless king.
scern |To discern; to perceive. [Obs.]
schade |Shade; shadow. [Obs.] Note: English words now beginning with sh, like shade, were formerly often spelled with a c between the s and h; as, schade; schame; schape; schort, etc.
schah |See Shah.
schappe |A silk yarn or fabric made out of carded spun silk.
schatchen |A person whose business is marriage brokage; a marriage broker, esp. among certain Jews.
schediasm |Cursory writing on a loose sheet. [R.]
schedule |A written or printed scroll or sheet of paper; a document; especially, a formal list or inventory; a list or catalogue annexed to a larger document, as to a will, a lease, a statute, etc. Syn. -- Catalogue; list; inventory. see List.\n\nTo form into, or place in, a schedule. SCHEELE'S GREEN Scheele's\" green`. Etym: [See Scheelite.] (Chem.)  See under Green.
scheelin |Scheelium. [Obs.]
scheelite |Calcium tungstate, a mineral of a white or pale yellowish color and of the tetragonal system of crystallization.
scheelium |The metal tungsten. [Obs.]
scheik |See Sheik.
schelly |The powan. [Prov. Eng.]
schema |An outline or image universally applicable to a general conception, under which it is likely to be presented to the mind; as, five dots in a line are a schema of the number five; a preceding and succeeding event are a schema of cause and effect.
schematic |Of or pertaining to a scheme or a schema.
schematism |1. (Astrol.)  Combination of the aspects of heavenly bodies. 2. Particular form or disposition of a thing; an exhibition in outline of any systematic arrangement. [R.]
schematist |One given to forming schemes; a projector; a schemer. Swift.
schematize |To form a scheme or schemes.
scheme |1. A combination of things connected and adjusted by design; a system. The appearance and outward scheme of things. Locke. Such a scheme of things as shall at once take in time and eternity. Atterbury. Arguments . . . sufficient to support and demonstrate a whole scheme of moral philosophy. J. Edwards. The Revolution came and changed his whole scheme of life. Macaulay. 2. A plan or theory something to be done; a design; a project; as, to form a scheme. The stoical scheme of supplying our wants by lopping off our desires, is like cuttig off our feet when we want shoes. Swift. 3. Any lineal or mathematical diagram; an outline. To draw an exact scheme of Constantinople, or a map of France. South. 4. (Astrol.)  A representation of the aspects of the celestial bodies for any moment o at a given event. A blue case, from which was drawn a scheme of nativity. Sir W. Scott. Syn. -- Plan; project; contrivance; purpose; device; plot. -- Scheme, Plan. Scheme and plan are subordinate to design; they propose modes of carrying our designs into effect. Scheme is the least definite of the two, and lies more in speculation. A plan is drawn out into details with a view to being carried into effect. As schemes are speculative, they often prove visionary; hence the opprobrious use of the words schemer and scheming. Plans, being more practical, are more frequently carried into effect. He forms the well-concerted scheme of mischief; 'T is fixed, 't is done, and both are doomed to death. Rowe. Artists and plans relieved my solemn hours; I founded palaces, and planted bowers. prior.\n\nTo make a scheme of; to plan; to design; to project; to plot. That wickedness which schemed, and executed, his destruction. G. Stuart.\n\nTo form a scheme or schemes.
schemeful |Full of schemes or plans.
schemer |One who forms schemes; a projector; esp., a plotter; an intriguer. Schemers and confederates in guilt. Paley.
scheming |Given to forming schemes; artful; intriguing. -- Schem\"ing*ly, adv.
schemist |A schemer. [R.] Waterland.
schene |An Egyptian or Persian measure of length, varying from thirthy- two to sixty stadia.
schenkbeer |A mild German beer.
scherbet |See Sherbet.
scherif |See Sherif.
scherzando |In a playful or sportive manner.
scherzo |A playful, humorous movement, commonly in 3-4 measure, which often takes the place of the old minuet and trio in a sonata or a symphony.
schesis |1. General state or disposition of the body or mind, or of one thing with regard to other things; habitude. [Obs.] Norris. 2. (Rhet.)  A figure of speech whereby the mental habitude of an adversary or opponent is feigned for the purpose of arguing against him. Crabb.
schetic |Of or pertaining to the habit of the body; constitutional. [Obs.] Cudworth.
schetical |Of or pertaining to the habit of the body; constitutional. [Obs.] Cudworth.
schiedam |Holland gin made at Schiedam in the Netherlands.
schiller |The peculiar bronzelike luster observed in certain minerals, as hypersthene, schiller spar, etc. It is due to the presence of minute inclusions in parallel position, and in sometimes of secondary origin. Schiller spar (Min.), an altered variety of enstatite, exhibiting, in certain positions, a bronzelike luster.
schillerization |The act or process of producing schiller in a mineral mass.
schilling |Any one of several small German and Dutch coins, worth from about one and a half cents to about five cents.
schindylesis |A form of articulation in which one bone is received into a groove or slit in another.
schirrhus |See Scirrhus.
schism |Division or separation; specifically (Eccl.), permanent division or separation in the Christian church; breach of unity among people of the same religious faith; the offense of seeking to produce division in a church without justifiable cause. Set bounds to our passions by reason, to our errors by truth, and to our schisms by charity. Eikon Basilike. Greek schism (Eccl.), the separation of the Greek and Roman churches. -- Great schism, or Western schism (Eccl.) a schism in the church in the latter part of the 14th century, on account of rival claimants to the papal throne. -- Schism act (Law), an act of the English Parliament requiring all teachers to conform to the Established Church, -- passed in 1714, repealed in 1719.
schisma |An interval equal to half a comma.
schismatic |Of or pertaining to schism; implying schism; partaking of the nature of schism; tending to schism; as, schismatic opinions or proposals.\n\nOne who creates or takes part in schism; one who separates from an established church or religious communion on account of a difference of opinion. \"They were popularly classed together as canting schismatics.\" Macaulay. Syn. -- Heretic; partisan. See Heretic.
schismatical |Same as Schismatic. -- Schismat\"ic*al*ly, adv. -- Schis*mat\"ic*al*ness, n.
schismatize |To make part in schism; to make a breach of communion in the church.
schismless |Free from schism.
schist |Any crystalline rock having a foliated structure (see Foliation) and hence admitting of ready division into slabs or slates. The common kinds are mica schist, and hornblendic schist, consisting chiefly of quartz with mica or hornblende and often feldspar.
schistaceous |Of a slate color.
schistic |Schistose.
schistose |Of or pertaining to schist; having the structure of a schist.
schistosity |The quality or state of being schistose.
schistous |Of or pertaining to schist; having the structure of a schist.
schizo- |A combining form denoting division or cleavage; as, schizogenesis, reproduction by fission or cell division.
schizocarp |A dry fruit which splits at maturity into several closed one- seeded portions.
schizocoele |See Enterocoele.
schizocoelous |Pertaining to, or of the nature of, a schizocoele.
schizogenesis |reproduction by fission. Haeckel.
schizognath |Any bird with a schizognathous palate.
schizognathae |The schizognathous birds.
schizognathism |the condition of having a schizognathous palate.
