seedcake |A sweet cake or cooky containing aromatic seeds, as caraway. Tusser.
seedcod |A seedlip. [Prov. Eng.]
seeder |One who, or that which, sows or plants seed.
seediness |The quality or state of being seedy, shabby, or worn out; a state of wretchedness or exhaustion. [Colloq.] G. Eliot. What is called seedness, after a debauch, is a plain proof that nature has been outraged. J. S. Blackie.
seedless |Without seed or seeds.
seedling |A plant reared from the seed, as distinguished from one propagated by layers, buds, or the like.
seedlip |A vessel in which a sower carries the seed to be scattered. [Prov. Eng.]
seedlop |A vessel in which a sower carries the seed to be scattered. [Prov. Eng.]
seedman |Seedsman.
seedness |Seedtime. [Obs.] Shak.
seedsman |1. A sower; one who sows or scatters seed. The seedsman Upon the slime and ooze scatters his grain. Shak. 2. A person who deals in seeds.
seedtime |The season proper for sowing. While the earth remaineth, seedtime and harvest, and cold and heat, and summer and winter, and day and night, shall not cease. Gen. viii. 22.
seedy |1. Abounding with seeds; bearing seeds; having run to seeds. 2. Having a peculiar flavor supposed to be derived from the weeds growing among the vines; -- said of certain kinds of FRench brandy. 3. Old and worn out; exhausted; spiritless; also, poor and miserable looking; shabily clothed; shabby looking; as, he looked seedy coat. [Colloq.] Little Flanigan here . . . is a little seedy, as we say among us that practice the law. Goldsmith. Seedy toe, an affection of a horse's foot, in which a cavity filled with horn powder is formed between the lamin√¶ and the wall of the hoof.
seeing |(but originally a present participle). In view of the fact (that); considering; taking into account (that); insmuch as; since; because; -- followed by a dependent clause; as, he did well, seeing that he was so young. Wherefore come ye to me, seeing ye hate me Gen. xxvi. 27.
seek |Sick. [Obs.] Chaucer.\n\n1. To go in search of; to look for; to search for; to try to find. The man saked him, saying, What seekest thou And he said, I seek my brethren. Gen. xxxvii. 15,16. 2. To inquire for; to ask for; to solicit; to bessech. Others, tempting him, sought of him a sign. Luke xi. 16. 3. To try to acquire or gain; to strive after; to aim at; as, to seek wealth or fame; to seek one's life. 4. To try to reach or come to; to go to; to resort to. Seek not Bethel, nor enter into Gilgal. Amos v. 5. Since great Ulysses sought the Phrygian plains. Pope.\n\nTo make search or inquiry: to endeavor to make discovery. Seek ye out of the book of the Lord, and read. Isa. xxxiv. 16. To seek, needing to seek or search; hence, unpreparated. \"Unpracticed, unpreparated, and still to seek.\" Milton. [Obs] -- To seek after, to make pursuit of; to attempt to find or take. -- To seek for, to endeavor to find. -- To seek to, to apply to; to resort to; to court. [Obs.] \"All the earth sought to Solomon, to hear his wisdom.\" 1. Kings x. 24. -- To seek upon, to make strict inquiry after; to follow up; to persecute. [Obs.] To seek Upon a man and do his soul unrest. Chaucer.
seek-no-further |A kind of choice winter apple, having a subacid taste; -- formerly called go-no-further.
seek-sorrow |One who contrives to give himself vexation. [Archaic.] Sir P. Sidney.
seeker |1. One who seeks; that which is used in seeking or searching. 2. (Eccl.)  One of a small heterogeneous sect of the 17th century, in Great Britain, who professed to be seeking the true church, ministry, and sacraments. A skeptic [is] ever seeking and never finds, like our new upstart sect of Seekers. Bullokar.
seel |1. (Falconry)  To close the eyes of (a hawk or other bird) by drawing through the lids threads which were fastened over the head. Bacon. Fools climbs to fall: fond hopes, like seeled doves for want of better light, mount till they end their flight with falling. J. Reading. 2. Hence, to shut or close, as the eyes; to blind. Come, seeling night, Scarf up the tender eye of pitiful day. Shak. Gold death, with a violent fate, his sable eyes did seel. Chapman.\n\nTo incline to one side; to lean; to roll, as a ship at sea. [Obs.] Sir W. Raleigh.\n\nThe rolling or agitation of a ship in a sterm. [Obs.] Sandys.\n\n1. Good fortune; favorable opportunity; prosperity. [Obs.] \"So have I seel\". Chaucer. 2. Time; season; as, hay seel. [Prov. Eng.]
seelily |In a silly manner. [Obs.]
seeling |The rolling or agitation of a ship in a sterm. [Obs.] Sandys.
seely |See Silly. [Obs.] Spenser.
seem |To appear, or to appear to be; to have a show or semblance; to present an appearance; to look; to strike one's apprehension or fancy as being; to be taken as. \"It now seemed probable.\" Macaulay. Thou picture of what thou seem'st. Shak. All seemed well pleased; all seemed, but were not all. Milton. There is a way which seemeth right unto a man; but the end thereof are the ways of death. Prov. xiv. 12. It seems, it appears; it is understood as true; it is said. A prince of Italy, it seems, entertained his misstress on a great lake. Addison. Syn. -- To appear; look. -- Seem, Appear. To appear has reference to a thing's being presented to our view; as, the sun appears; to seem is connected with the idea of semblance, and usually implies an inference of our mind as to the probability of a thing's being so; as, a storm seems to be coming. \"The story appears to be true,\" means that the facts, as presented, go to show its truth; \"the story seems to be true,\" means that it has the semblance of being so, and we infer that it is true. \"His first and principal care being to appear unto his people such as he would have them be, and to be such as he appeared.\" Sir P. Sidney. Ham. Ay, madam, it is common. Queen. If it be, Why seems it so particular with thee Ham. Seems, madam! Nay, it is; I know not \"seems.\" Shak.\n\nTo befit; to beseem. [Obs.] Spenser.
seemer |One who seems; one who carries or assumes an appearance or semblance. Hence shall we see, If power change purpose, what our seemers be. Shak.
seeming |Having a semblance, whether with or without reality; apparent; specious; befitting; as, seeming friendship; seeming truth. My lord, you have lost a friend indeed; And I dare swear you borrow not that face Of seeming sorrow, it is sure your own. Shak.\n\n1. Appearance; show; semblance; fair appearance; speciousness. These keep Seeming and savor all the winter long. Shak. 2. Apprehension; judgment. [Obs.] Chaucer. Nothing more clear unto their seeming. Hooker. His persuasive words, impregned With reason, to her seeming. Milton.
seemingly |In appearance; in show; in semblance; apparently; ostensibly. This the father seemingly complied with. Addison.
seemingness |Semblance; fair appearance; plausibility. Sir K. Digby.
seemless |Unseemly. [Obs.] Spenser.
seemlily |In a seemly manner. [Obs.]
seemliness |The quality or state of being seemly: comeliness; propriety.
seemly |Suited to the object, occasion, purpose, or character; suitable; fit; becoming; comely; decorous. He had a seemly nose. Chaucer. I am a woman, lacking wit To make a seemly answer to such persons. Shak. Suspense of judgment and exercise of charity were safer and seemlier for Christian men than the hot pursuit of these controversies. Hooker. Syn. -- Becoming; fit; suitable; proper; appropriate; congruous; meet; decent; decorous.\n\nIn a decent or suitable manner; becomingly. Suddenly a men before him stood, Not rustic as before, but seemlier clad, As one in city or court or place bred. Milton.
seemlyhed |Comely or decent appearance. [Obs.] Rom. of R. Spenser.
seen |of See.\n\nVersed; skilled; accomplished. [Obs.] Well seen in every science that mote be. Spenser. Noble Boyle, not less in nature seen, Than his great brother read in states and men. Dryden.
seep |To run or soak through fine pores and interstices; to ooze. [Scot. & U. S.] Water seeps up through the sidewalks. G. W. Cable.
seepage |Water that seeped or oozed through a porous soil. [Scot. & U. S.]
seepy |Oozy; -- applied to land under cultivation that is not well drained.
seer |Sore; painful. [Prov. Eng.] Ray.\n\nOne who sees. Addison.\n\nA person who foresees events; a prophet. Milton.
seeress |A female seer; a prophetess.
seerfish |A scombroid food fish of Maderia (Cybium Commersonii).
seerhand |A kind of muslin of a texture between nainsook and mull.
seership |The office or quality of a seer.
seersucker |A light fabric, originally made in the East Indies, of silk and linen, usually having alternating stripes, and a slightly craped or puckered surface; also, a cotton fabric of similar appearance.
seerwood |Dry wood. [Written also searwood.] [Obs.] Dryden.
seesaw |1. A play among children in which they are seated upon the opposite ends of a plank which is balanced in the middle, and move alternately up and down. 2. A plank or board adjusted for this play. 3. A vibratory or reciprocating motion. He has been arguing in a circle; there is thus a seesaw between the hypothesis and fact. Sir W. Hamilton. 4. (Whist.)  Same as Crossruff.\n\nTo move with a reciprocating motion; to move backward and forward, or upward and downward.\n\nTo cause to move backward and forward in seesaw fashion. He seesaws himself to and fro. Ld. Lytton.\n\nMoving up and down, or to and fro; having a reciprocating motion.
seet |Sate; sat. Chaucer.
seeth |imp. of Seethe. Chaucer.
seethe |To decoct or prepare for food in hot liquid; to boil; as, to seethe flesh. [Written also seeth.] Set on the great pot, and seethe pottage for the sons of the prophets. 2 Kings iv. 38.\n\nTo be a state of ebullition or violent commotion; to be hot; to boil. 1 Sam. ii. 13. A long Pointe, round which the Mississippi used to whirl, and seethe, and foam. G. W. Cable.
seether |A pot for boiling things; a boiler. Like burnished gold the little seether shone. Dryden.
seg |1. Sedge. [Obs.] 2. The gladen, and other species of Iris. Prior.\n\nA castrated bull. [Prov. Eng. & Scot.] Halliwell.
segar |See Cigar.
seggar |A case or holder made of fire clay, in which fine pottery is inclosed while baking in the kin. [Written also saggar, sagger, and segger.] Ure.
segge |The hedge sparrow. [Prov. Eng.] Halliwell.
segment |1. One of the parts into which any body naturally separates or is divided; a part divided or cut off; a section; a portion; as, a segment of an orange; a segment of a compound or divided leaf. 2. (Geom.)  A part cut off from a figure by a line or plane; especially, that part of a circle contained between a chord and an arc of that circle, or so much of the circle as is cut off by the chord; as, the segment acb in the Illustration. 3. (Mach.) (a) A piece in the form of the sector of a circle, or part of a ring; as, the segment of a sectional fly wheel or flywheel rim. (b) A segment gear. 4. (Biol.) (a) One of the cells or division formed by segmentation, as in egg cleavage or in fissiparous cell formation. (b) One of the divisions, rings, or joints into which many animal bodies are divided; a somite; a metamere; a somatome. Segment gear, a piece for receiving or communicating reciprocating motion from or to a cogwheel, consisting of a sector of a circular gear, or ring, having cogs on the periphery, or face. -- Segment of a line, the part of a line contained between two points on it. -- Segment of a sphere, the part of a sphere cut off by a plane, or included between two parallel planes. -- Ventral segment. (Acoustics) See Loor, n., 5.\n\nTo divide or separate into parts in growth; to undergo segmentation, or cleavage, as in the segmentation of the ovum.
segmental |1. Relating to, or being, a segment. 2. (Anat. & Zo√∂l.) (a) Of or pertaining to the segments of animals; as, a segmental duct; segmental papill√¶. (b) Of or pertaining to the segmental organs. Segmental duct (Anat.), the primitive duct of the embryonic excretory organs which gives rise to the Wolffian duct and ureter; the pronephric duct. -- Segmental organs. (a) (Anat.) The embryonic excretory organs of vertebrates, consisting primarily of the segmental tubes and segmental ducts. (b) (Zo√∂l.) The tubular excretory organs, a pair of which often occur in each of several segments in annelids. They serve as renal organs, and often, also, as oviducts and sperm ducts. See Illust. under Sipunculacea. -- Segmental tubes (Anat.), the tubes which primarily open into the segmental duct, some of which become the urinary tubules of the adult.
segmentation |The act or process of dividing into segments; specifically (Biol.), a self-division into segments as a result of growth; cell cleavage; cell multiplication; endogenous cell formation. Segmentation cavity (Biol.), the cavity formed by the arrangement of the cells in segmentation or cleavage of the ovum; the cavity of the blastosphere. In the gastrula stage, the segmentation cavity in which the mesoblast is formed lies between the entoblast and ectoblast. See Illust. of Invagination. -- Segmentation nucleus (Biol.), the body formed by fusion of the male and female pronucleus in an impregnated ovum. See the Note under Pronucleus. -- Segmentation of the ovum, or Egg cleavage (Biol.), the process by which the embryos of all the higher plants and animals are derived from the germ cell. In the simplest case, that of small ova destitute of food yolk, the ovum or egg divides into two similar halves or segments (blastomeres), each of these again divides into two, and so on, thus giving rise to a mass of cells (mulberry mass, or morula), all equal and similar, from the growth and development of which the future animal is to be formed. This constitutes regular segmentation. Quite frequently, however, the equality and regularity of cleavage is interfered with by the presence of food yolk, from which results unequal segmentation. See Holoblastic, Meroblastic, Alecithal, Centrolecithal, Ectolecithal, and Ovum. -- Segmentation sphere (Biol.), the blastosphere, or morula. See Morula.
segmented |Divided into segments or joints; articulated.
segnitude |Sluggishness; dullness; inactivity. [Obs.]
segnity |Sluggishness; dullness; inactivity. [Obs.]
segno |A sign. See Al segno, and Dal segno.
sego |A liliaceous plant (Calochortus Nuttallii) of Western North America, and its edible bulb; -- so called by the Ute Indians and the Mormons.
segregate |1. Separate; select. 2. (Bot.)  Separated from others of the same kind.\n\nTo separate from others; to set apart. They are still segregated, Christians from Christians, under odious designations. I. Taylor.\n\nTo separate from a mass, and collect together about centers or along lines of fracture, as in the process of crystallization or solidification.
segregation |1. The act of segregating, or the state of being segregated; separation from others; a parting. 2. (Geol.)  Separation from a mass, and gathering about centers or into cavities at hand through cohesive attraction or the crystallizing process.
seiches |Local oscillations in level observed in the case of some lakes, as Lake Geneva.
seid |A descendant of Mohammed through his daughter Fatima and nephew Ali.
seidlitz |Of or pertaining to Seidlitz, a village in Bohemia. [Written also Sedlitz.] Seidlitz powders, effervescing salts, consisting of two separate powders, one of which contains forty grains of sodium bicarbonate mixed with two drachms of RochellRochelle powders. -- Seidlitz water, a natural water from Seidlitz, containing magnesium, sodium, calcium, and potassium sulphates, with calcium carbonate and a little magnesium chloride. It is used as an aperient.
seigh |obs. imp. sing. of See. Saw. Chaucer.
seigneurial |1. Of or pertaining to the lord of a manor; manorial. Sir W. Temple. 2. Vested with large powers; independent.
seignior |1. A lord; the lord of a manor. 2. A title of honor or of address in the South of Europe, corresponding to Sir or Mr. in English. Grand Seignior, the sultan of Turkey.
seigniorage |1. Something claimed or taken by virtue of sovereign prerogative; specifically, a charge or toll deducted from bullion brought to a mint to be coined; the difference between the cost of a mass of bullion and the value as money of the pieces coined from it. If government, however, throws the expense of coinage, as is reasonable, upon the holders, by making a charge to cover the expense (which is done by giving back rather less in coin than has been received in bullion, and is called \"levying a seigniorage\"), the coin will rise to the extent of the seigniorage above the value of the bullion. J. S. Mill. 2. A share of the receipts of a business taken in payment for the use of a right, as a copyright or a patent.
seignioral |Of or pertaining to a seignior; seigneurial. \"Kingly or seignioral patronage.\" Burke.
seignioralty |The territory or authority of a seignior, or lord. Milman.
seigniorial |Same as Seigneurial.
seigniorize |To lord it over. [Obs.] As proud as he that seigniorizeth hell. Fairfax.
seigniory |1. The power or authority of a lord; dominion. O'Neal never had any seigniory over that country but what by encroachment he got upon the English. Spenser. 2. The territory over which a lord holds jurisdiction; a manor. [Written also seigneury, and seignory.]
seine |A large net, one edge of which is provided with sinkers, and the other with floats. It hangs vertically in the water, and when its ends are brought together or drawn ashore incloses the fish. Seine boat, a boat specially constructed to carry and pay out a seine.
seining |Fishing with a seine.
seint |A girdle. [Obs.] \"Girt with a seint of silk.\" Chaucer.\n\nA saint. [Obs.] Chaucer.
seintuary |Sanctuary. [Obs.]
seirfish |Same as Seerfish.
seirospore |One of several spores arranged in a chain as in certain alg√¶ of the genus Callithamnion.
seise |See Seize. Spenser. Note: This is the common spelling in the law phrase to be seised of (an estate).
seisin |See Seizin. Spenser.
seismal |Of or pertaining to an earthquake; caused by an earthquake. Seismic vertical, the point upon the earth's surface vertically over the center of effort or focal point whence the earthquake's impulse proceeds, or the vertical line connecting these two points.
seismic |Of or pertaining to an earthquake; caused by an earthquake. Seismic vertical, the point upon the earth's surface vertically over the center of effort or focal point whence the earthquake's impulse proceeds, or the vertical line connecting these two points.
seismogram |The trace or record of an earth tremor, made by means of a seismograph.
seismograph |An apparatus for registering the shocks and undulatory motions of earthquakes.
seismographic |Of or pertaining to a seismograph; indicated by a seismograph.
seismography |1. A writing about, or a description of, earthquakes. 2. The art of registering the shocks and undulatory movements of earthquakes.
seismological |Of or pertaining to seismology. -- Seis`mo*log\"ic*al*ly, adv.
seismology |The science of earthquakes.
seismometer |An instrument for measuring the direction, duration, and force of earthquakes and like concussions.
seismometric |Of or pertaining to seismometry, or seismometer; as, seismometric instruments; seismometric measurements.
seismometry |The mensuration of such phenomena of earthquakes as can be expressed in numbers, or by their relation to the co√∂rdinates of space.
seismoscope |A seismometer.
seity |Something peculiar to one's self. [R.] Tatler.
seizable |That may be seized.
seize |1. To fall or rush upon suddenly and lay hold of; to gripe or grasp suddenly; to reach and grasp. For by no means the high bank he could seize. Spenser. Seek you to seize and gripe into your hands The royalties and rights of banished Hereford Shak. 2. To take possession of by force. At last they seize The scepter, and regard not David's sons. Milton. 3. To invade suddenly; to take sudden hold of; to come upon suddenly; as, a fever seizes a patient. Hope and deubt alternate seize her seul. Pope. 4. (law)  To take possession of by virtue of a warrant or other legal authority; as, the sheriff seized the debtor's goods. 5. To fasten; to fix. [Obs.] As when a bear hath seized her cruel claws Upon the carcass of some beast too weak. Spenser. 6. To grap with the mind; to comprehend fully and distinctly; as, to seize an idea. 7. (Naut.)  To bind or fasten together with a lashing of small stuff, as yarn or marline; as, to seize ropes. Note: This word, by writers on law, is commonly written seise, in the phrase to be seised of (an estate), as also, in composition, disseise, disseisin. To be seized of, to have possession, or right of possession; as, A B was seized and possessed of the manor of Dale. \"Whom age might see seized of what youth made prize.\" Chapman. -- To seize on or upon, to fall on and grasp; to take hold on; to take possession of suddenly and forcibly. Syn. -- To catch; grasp; clutch; snatch; apprehend; arrest; take; capture.
seizer |One who, or that which, seizes.
seizin |1. (Law)  Possession; possession of an estate of froehold. It may be either in deed or in law; the former when there is actual possession, the latter when there is a right to such possession by construction of law. In some of the United States seizin means merely ownership. Burrill. 2. The act of taking possession. [Obs.] 3. The thing possessed; property. Sir M. Halle. Note: Commonly spelt by writers on law seisin. Livery of seizin. (Eng. Law) See Note under Livery, 1.
seizing |1. The act of taking or grasping suddenly. 2. (Naut.) (a) The operation of fastening together or lashing. (b) The cord or lashing used for such fastening.
seizor |One who seizes, or takes possession.
seizure |1. The act of seizing, or the state of being seized; sudden and violent grasp or gripe; a taking into possession; as, the seizure of a thief, a property, a throne, etc. 2. Retention within one's grasp or power; hold; possession; ownership. Make o'er thy honor by a deed of trust, And give me seizure of the mighty wealth. Dryden. 3. That which is seized, or taken possession of; a thing laid hold of, or possessed.
sejant |Sitting, as a lion or other beast. Sejant rampant, sitting with the forefeet lifted up. Wright.
sejeant |Sitting, as a lion or other beast. Sejant rampant, sitting with the forefeet lifted up. Wright.
sejein |To separate. [Obs.]
sejunction |The act of disjoining, or the state of being disjoined. [Obs.] Bp. Pearson.
sejungible |Capable of being disjoined. [Obs.] Bp. Pearson.
seke |Sick. [Obs.] Chaucer.\n\nTo seek. [Obs.] Chaucer.
sekes |A place in a pagan temple in which the images of the deities were inclosed.
selachian |One of the Selachii. See Illustration in Appendix.
selachii |An order of elasmobranchs including the sharks and rays; the Plagiostomi. Called also Selacha, Selache, and Selachoidei.
selachoidei |Same as Selachii.
selachostomi |A division of ganoid fishes which includes the paddlefish, in which the mouth is armed with small teeth.
selaginella |A genus of cryptogamous plants resembling Lycopodia, but producing two kinds of spores; also, any plant of this genus. Many species are cultivated in conservatories.
selah |A word of doubtful meaning, occuring frequently in the Psalms; by some, supposed to signify silence or a pause in the musical performance of the song. Beyond the fact that Selach is a musical term, we know absolutely nothing about it. Dr. W. Smith (Bib. Dict.)
selch |A seal. [Scotch]
selcouth |Rarely known; unusual; strange. [Obs.] [She] wondered much at his so selcouth case. Spenser.
seld |Rare; uncommon; unusual. [Obs.] Chaucer. Spenser.\n\nRarely; seldom. [Obs.] Chaucer.
selden |Seldom. [Obs.] Chaucer.
seldom |Rarely; not often; not frequently. Wisdom and youth are seldom joined in one. Hooker.\n\nRare; infrequent. [Archaic.] \"A suppressed and seldom anger.\" Jer. Taylor.
seldomness |Rareness. Hooker.
seldseen |Seldom seen. [Obs.] Drayton.
seldshewn |Rarely shown or exhibited. [Obs.] Shak.
select |Taken from a number by preferance; picked out as more valuable or exellent than others; of special value or exellence; nicely chosen; selected; choice. A few select spirits had separated from the crowd, and formed a fit audience round a far greater teacher. Macaulay.\n\nTo choose and take from a number; to take by preference from among others; to pick out; to cull; as, to select the best authors for perusal. \"One peculiar nation to select.\" Milton. The pious chief . . . A hundred youths from all his train selects. Dryden.
selectedly |With care and selection. [R.]
selection |The act of selecting, or the state of being selected; choice, by preference. 2. That which is selected; a collection of things chosen; as, a choice selection of books. Natural selection. (Biol.) See under Natural.
selective |Selecting; tending to select. This selective providence of the Almighty. Bp. Hall.
selectman |One of a board of town officers chosen annually in the New England States to transact the general public business of the town, and have a kind of executive authority. The number is usually from three to seven in each town. The system of delegated town action was then, perhaps, the same which was defined in an \"order made in 1635 by the inhabitants of Charlestown at a full meeting for the government of the town, by selectmen;\" the name presently extended throughout New England to municipal governors. Palfrey.
selectness |The quality or state of being select.
selector |One who selects.
selenate |A salt of selenic acid; -- formerly called also seleniate.
selenhydric |Of, pertaining to, or designating, hydrogen selenide, H2Se, regarded as an acid analogous to sulphydric acid.
selenic |Of or pertaining to selenium; derived from, or containing, selenium; specifically, designating those compounds in which the element has a higher valence as contrasted with selenious compounds.
selenide |A binary compound of selenium, or a compound regarded as binary; as, ethyl selenide.
seleniferous |Containing, or impregnated with, selenium; as, seleniferous pyrites.
selenio- |A combining form (also used adjectively) denoting the presence of selenium or its compounds; as, selenio-phosphate, a phosphate having selenium in place of all, or a part, of the oxygen.
selenious |Of, pertaining to, or containing, selenium; specifically, designating those compounds in which the element has a lower valence as contrasted with selenic compounds.
selenite |A salt of selenious acid.\n\nA variety of gypsum, occuring in transparent crystals or crystalline masses.
selenitic |Of or pertaining to selenite; resembling or containing selenite.
selenitical |Of or pertaining to selenite; resembling or containing selenite.
selenium |A nonmetallic element of the sulphur group, and analogous to sulphur in its compounds. It is found in small quantities with sulphur and some sulphur ores, and obtained in the free state as a dark reddish powder or crystalline mass, or as a dark metallic- looking substance. It exhibits under the action of light a remarkable variation in electric conductivity, and is used in certain electric apparatus. Symbol Se. Atomic weight 78.9.
seleniuret |A selenide. [Obs.]
seleniureted |Combined with selenium as in a selenide; as, seleniureted hydrogen. [Written also seleniuretted.] [Obsoles.]
selenocentric |As seen or estimated from the center of the moon; with the moon central.
selenograph |, n. A picture or delineation of the moon's surface, or of any part of it.
selenographer |One skilled in selenography. Wright.
selenographic |Of or pertaining to selenography.
selenographical |Of or pertaining to selenography.
selenographist |A selenographer.
selenography |The science that treats of the physical features of the moon; - - corresponding to physical geography in respect to the earth. \"Accurate selenography, or description of the moon.\" Sir T. Browne.
selenology |That branch of astronomy which treats of the moon. -- Sel`e*no*log\"i*cal, a.
selenonium |A hypothetical radical of selenium, analogous to sulphonium. [R.]
self |Same; particular; very; identical. [Obs., except in the compound selfsame.] \"On these self hills.\" Sir. W. Raleigh. To shoot another arrow that self way Which you did shoot the first. Shak. At that self moment enters Palamon. Dryden.\n\n1. The individual as the object of his own reflective consciousness; the man viewed by his own cognition as the subject of all his mental phenomena, the agent in his own activities, the subject of his own feelings, and the possessor of capacities and character; a person as a distinct individual; a being regarded as having personality. \"Those who liked their real selves.\" Addison. A man's self may be the worst fellow to converse with in the world. Pope. The self, the I, is recognized in every act of intelligence as the subject to which that act belongs. It is I that perceive, I that imagine, I that remember, I that attend, I that compare, I that feel, I that will, I that am conscious. Sir W. Hamilton. 2. Hence, personal interest, or love of private interest; selfishness; as, self is his whole aim. 3. Personification; embodiment. [Poetic.] She was beauty's self. Thomson. Note: Self is united to certain personal pronouns and pronominal adjectives to express emphasis or distinction. Thus, for emphasis; I myself will write; I will examine for myself; thou thyself shalt go; thou shalt see for thyself; you yourself shall write; you shall see for yourself; he himself shall write; he shall examine for himself; she herself shall write; she shall examine for herself; the child itself shall be carried; it shall be present itself. It is also used reflexively; as, I abhor myself; thou enrichest thyself; he loves himself; she admires herself; it pleases itself; we walue ourselves; ye hurry yourselves; they see themselves. Himself, herself, themselves, are used in the nominative case, as well as in the objective. \"Jesus himself baptized not, but his disciples.\" John iv. 2. Note: Self is used in the formation of innumerable compounds, usually of obvious signification, in most of which it denotes either the agent or the object of the action expressed by the word with which it is joined, or the person in behalf of whom it is performed, or the person or thing to, for, or towards whom or which a quality, attribute, or feeling expressed by the following word belongs, is directed, or is exerted, or from which it proceeds; or it denotes the subject of, or object affected by, such action, quality, attribute, feeling, or the like; as, self-abandoning, self-abnegation, self- abhorring, self-absorbed, self-accusing, self-adjusting, self- balanced, self-boasting, self-canceled, self-combating, self- commendation, self-condemned, self-conflict, self-conquest, self- constituted, self-consumed, self-contempt, self-controlled, self- deceiving, self-denying, self-destroyed, self-disclosure, self- display, self-dominion, self-doomed, self-elected, self-evolved, self-exalting, self-excusing, self-exile, self-fed, self-fulfillment, self-governed, self-harming, self-helpless, self-humiliation, self- idolized, self-inflicted, self-improvement, self-instruction, self- invited, self-judging, self-justification, self-loathing, self- loving, self-maintenance, self-mastered, self-nourishment, self- perfect, self-perpetuation, self-pleasing, self-praising, self- preserving, self-questioned, self-relying, self-restraining, self- revelation, self-ruined, self-satisfaction, self-support, self- sustained, self-sustaining, self-tormenting, self-troubling, self- trust, self-tuition, self-upbraiding, self-valuing, self-worshiping, and many others.
self-abased |Humbled by consciousness of inferiority, unworthiness, guilt, or shame.
self-abasement |1. Degradation of one's self by one's own act. 2. Humiliation or abasement proceeding from consciousness of inferiority, guilt, or shame.
self-abasing |Lowering or humbling one's self.
self-abhorrence |Abhorrence of one's self.
self-abnegation |Self-denial; self-renunciation; self-sacrifice.
self-abuse |1. The abuse of one's own self, powers, or faculties. 2. Self-deception; delusion. [Obs.] Shak. 3. Masturbation; onanism; self-pollution.
self-accused |Accused by one's self or by one's conscience. \"Die self- accused.\" Cowper.
self-acting |Acting of or by one's self or by itself; -- said especially of a machine or mechanism which is made to perform of or for itself what is usually done by human agency; automatic; as, a self-acting feed apparatus; a self-acting mule; a self-acting press.
self-action |Action by, or originating in, one's self or itself.
self-active |Acting of one's self or of itself; acting without depending on other agents.
self-activity |The quality or state of being self-active; self-action.
self-adjusting |Capable of assuming a desired position or condition with relation to other parts, under varying circumstances, without requiring to be adjusted by hand; -- said of a piece in machinery. Self-adjusting bearing (Shafting), a bearing which is supported in such a manner that it may tip to accomodate flexure or displacement of the shaft.
self-admiration |Admiration of one's self.
self-affairs |One's own affairs; one's private business. [Obs.] Shak.
self-affrighted |Frightened at or by one's self. Shak.
self-aggrandizement |The aggrandizement of one's self.
self-annihilated |Annihilated by one's self.
self-annihilation |Annihilation by one's own acts; annihilation of one's desires. Addison.
self-applause |Applause of one's self.
self-applying |Applying to or by one's self.
self-approving |Approving one's own action or character by one's own judgment. One self-approving hour whole years outweighs Of stupid starers and of loud huzzas. Pope.
self-asserting |asserting one's self, or one's own rights or claims; hence, putting one's self forward in a confident or assuming manner.
self-assertion |The act of asserting one's self, or one's own rights or claims; the quality of being self-asserting.
self-assertive |Disposed to self-assertion; self-asserting.
self-assumed |Assumed by one's own act, or without authority.
self-assured |Assured by or of one's self; self-reliant; complacent.
self-banished |Exiled voluntarily.
self-begotten |Begotten by one's self, or one's own powers.
self-binder |A reaping machine containing mechanism for binding the grain into sheaves.
self-born |Born or produced by one's self.
self-centered |Centered in itself, or in one's self. There hangs the ball of earth and water mixt, Self-centered and unmoved. Dryden.
self-centering |Centering in one's self.
self-centration |The quality or state of being self-centered.
self-centred |Centered in itself, or in one's self. There hangs the ball of earth and water mixt, Self-centered and unmoved. Dryden.
self-centring |Centering in one's self.
self-charity |Self-love. [Obs.] Shak.
self-color |A color not mixed or variegated.
self-colored |Being of a single color; -- applied to flowers, animals, and textile fabrics.
self-command |Control over one's own feelings, temper, etc.; self-control.
self-commune |Self-communion. [R.]
self-communicative |Imparting or communicating by its own powers.
self-communion |Communion with one's self; thoughts about one's self.
self-complacency |The quality of being self-complacent. J. Foster.
self-complacent |Satisfied with one's own character, capacity, and doings; self- satisfied.
self-conceit |Conceit of one's self; an overweening opinion of one's powers or endowments. Syn. -- See Egotism.
self-conceited |Having an overweening opinion of one's own powers, attainments; vain; conceited. -- Self`-con*ceit\"ed*ness, n.
self-concern |Concern for one's self.
self-condemnation |Condemnation of one's self by one's own judgment.
self-confidence |The quality or state of being self-confident; self-reliance. A feeling of self-confidence which supported and sustained him. Beaconsfield.
self-confident |Confident of one's own strength or powers; relying on one's judgment or ability; self-reliant. -- Self`-con\"fi*dent*ly, adv.
self-conjugate |Having the two things that are conjugate parts of the same figure; as, self-conjugate triangles.
self-conscious |1. Conscious of one's acts or state as belonging to, or originating in, one's self. \"My self-conscious worth.\" Dryden. 2. Conscious of one's self as an object of the observation of others; as, the speaker was too self-conscious.
self-consciousness |The quality or state of being self-conscious.
self-considering |Considering in one's own mind; deliberating. Pope.
self-consistency |The quality or state of being self-consistent.
self-consistent |Consistent with one's self or with itself; not deviation from the ordinary standard by which the conduct is guided; logically consistent throughout; having each part consistent with the rest.
self-consuming |Consuming one's self or itself.
self-contained |1. Having self-control; reserved; uncommunicative; wholly engrossed in one's self. 2. (Mach.)  Having all the essential working parts connected by a bedplate or framework, or contained in a case, etc., so that mutual relations of the parts do not depend upon fastening outside of the machine itself. Self-contained steam engine. (a) A steam engine having both bearings for the crank shaft attached to the frame of the engine. (b) A steam engine and boiler combined and fastened together; a portable steam engine.
self-contradiction |The act of contradicting one's self or itself; repugnancy in conceptions or in terms; a proposition consisting of two members, one of which contradicts the other; as, to be and not to be at the same time is a self-contradiction.
self-contradictory |Contradicting one's self or itself.
self-control |Control of one's self; restraint exercised over one's self; self-command.
self-convicted |Convicted by one's own consciousness, knowledge, avowal, or acts.
self-conviction |The act of convicting one's self, or the state of being self- convicted.
self-created |Created by one's self; not formed or constituted by another.
self-culture |Culture, training, or education of one's self by one's own efforts.
self-deceit |The act of deceiving one's self, or the state of being self- deceived; self-deception.
self-deceived |Deceived or misled respecting one's self by one's own mistake or error.
self-deception |Self-deceit.
self-defence |See Self-defense.
self-defense |The act of defending one's own person, property, or reputation. In self-defense (Law), in protection of self, -- it being permitted in law to a party on whom a grave wrong is attempted to resist the wrong, even at the peril of the life of the assailiant. Wharton.
self-defensive |Defending, or tending to defend, one's own person, property, or reputation.
self-degradation |The act of degrading one's self, or the state of being so degraded.
self-delation |Accusation of one's self. [R.] Milman.
self-delusion |The act of deluding one's self, or the state of being thus deluded.
self-denial |The denial of one's self; forbearing to gratify one's own desires; self-sacrifice.
self-denying |Refusing to gratify one's self; self-sacrificing. -- Self`-de*ny\"ing*ly, adv.
self-dependent |Dependent on one's self; self-depending; self-reliant.
self-depending |Depending on one's self.
self-depraved |Corrupted or depraved by one's self. Milton.
self-destroyer |One who destroys himself; a suicide.
self-destruction |The destruction of one's self; self-murder; suicide. Milton.
self-destructive |Destroying, or tending to destroy, one's self or itself; rucidal.
self-determination |Determination by one's self; or, determination of one's acts or states without the necessitating force of motives; -- applied to the voluntary or activity.
self-determining |Capable of self-determination; as, the self-determining power of will.
self-devised |Devised by one's self.
self-devoted |Devoted in person, or by one's own will. Hawthorne.
self-devotement |Self-devotion. [R.]
self-devotion |The act of devoting one's self, or the state of being self- devoted; willingness to sacrifice one's own advantage or happiness for the sake of others; self-sacrifice.
self-devouring |Devouring one's self or itself. Danham.
self-diffusive |Having power to diffuse itself; diffusing itself. Norris.
self-discipline |Correction or government of one's self for the sake of improvement.
self-distrust |Want of confidence in one' self; diffidence.
self-educated |Educated by one's own efforts, without instruction, or without pecuniary assistance from others.
self-elective |Having the right of electing one's self, or, as a body, of electing its own members.
self-enjoyment |Enjoyment of one's self; self-satisfaction.
self-esteem |The holding a good opinion of one's self; self-complacency.
self-estimation |The act of estimating one's self; self-esteem.
self-evidence |The quality or state of being self-evident. Locke.
self-evident |Evident without proof or reasoning; producing certainty or conviction upon a bare presentation to the mind; as, a self-evident proposition or truth. -- Self`-ev\"i*dent*ly, adv.
self-evolution |Evolution of one's self; development by inherent quality or power.
self-exaltation |The act of exalting one's self, or the state of being so exalted.
self-examinant |One who examines himself; one given to self-examination. The humiliated self-examinant feels that there is evil in our nature as well as good. Coleridge.
self-examination |An examination into one's own state, conduct, and motives, particularly in regard to religious feelings and duties.
self-excite |To energize or excite (the field magnets of a dynamo) by induction from the residual magnetism of its cores, leading all or a part of the current thus produced through the field-magnet coils.
self-existence |Inherent existence; existence possessed by virtue of a being's own nature, and independent of any other being or cause; -- an attribute peculiar to God. Blackmore.
self-existent |Existing of or by himself,independent of any other being or cause; -- as, God is the only self-existent being.
self-explaining |Explaining itself; capable of being understood without explanation.
self-exposure |The act of exposing one's self; the state of being so exposed.
self-fertilization |The fertilization of a flower by pollen from the same flower and without outer aid; autogamy.
self-fertilized |Fertilized by pollen from the same flower.
self-glorious |Springing from vainglory or vanity; vain; boastful. Dryden.
self-government |1. The act of governing one's self, or the state of being governed by one's self; self-control; self-command. 2. Hence, government of a community, state, or nation by the joint action of the mass of people constituting such a civil body; also, the state of being so governed; democratic government; democracy. It is to self-government, the great principle of popular representation and administration, -- the system that lets in all to participate in the councels that are to assign the good or evil to all, -- that we may owe what we are and what we hope to be. D. Webster.
self-gratulation |Gratulation of one's self.
self-hardening |Designating, or pert. to, any of various steels that harden when heated to above a red heat and cooled in air, usually in a blast of cold air with moderate rapidity, without quenching. Such steels are alloys of iron and carbon with manganese, tungsten and manganese, chromium, molybdenum and manganese, etc. They are chiefly used as high-speed steels. -- Self`-hard\"en*ed, a.
self-heal |A blue-flowered labiate plant (Brunella vulgaris); the healall.
self-healing |Having the power or property of healing itself.
self-help |The act of aiding one's self, without depending on the aid of others.
self-homicide |The act of killing one's self; suicide. Hakewill.
self-ignorance |Ignorance of one's own character, powers, and limitations.
self-ignorant |Ignorant of one's self.
self-imparting |Imparting by one's own, or by its own, powers and will. Norris.
self-importance |An exaggerated estimate of one's own importance or merit, esp. as manifested by the conduct or manners; self-conceit.
self-important |Having or manifesting an exaggerated idea of one's own importance or merit.
self-imposed |Voluntarily taken on one's self; as, self-imposed tasks.
self-imposture |Imposture practiced on one's self; self-deceit. South.
self-indignation |Indignation at one's own character or actions. Baxter.
self-induction |Induction in a circuit due to the action of one portion of a current upon an adjacent portion during periods of varying current strength. The nature of the induction is such as to oppose the action which produces it.
self-indulgence |Indulgence of one's appetites, desires, or inclinations; -- the opposite of self-restraint, and self-denial.
self-indulgent |Indulging one's appetites, desires, etc., freely.
self-interest |Private interest; the interest or advantage of one's self.
self-interested |Particularly concerned for one's own interest or happiness.
self-involution |Involution in one's self; hence, abstraction of thought; reverie.
self-justifier |One who excuses or justifies himself. J. M. Mason.
self-kindled |Kindled of itself, or without extraneous aid or power. Dryden.
self-knowing |1. Knowing one's self, or one's own character, powers, and limitations. 2. Knowing of itself, without help from another.
self-knowledge |Knowledge of one's self, or of one's own character, powers, limitations, etc.
self-life |Life for one's self; living solely or chiefly for one's own pleasure or good.
self-love |The love of one's self; desire of personal happiness; tendency to seek one's own benefit or advantage. Shak. Self-love, the spring of motion, acts the soul. Pope. Syn. -- Selfishness. -- Self-love, Selfishness. The term self-love is used in a twofold sense: 1. It denotes that longing for good or for well-being which actuates the breasts of all, entering into and characterizing every special desire. In this sense it has no moral quality, being, from the nature of the case, neither good nor evil. 2. It is applied to a voluntary regard for the gratification of special desires. In this sense it is morally good or bad according as these desires are conformed to duty or opposed to it. Selfishness is always voluntary and always wrong, being that regard to our own interests, gratification, etc., which is sought or indulged at the expense, and to the injury, of others. \"So long as self-love does not degenerate into selfishness, it is quite compatible with true benevolence.\" Fleming. \"Not only is the phrase self-love used as synonymous with the desire of happiness, but it is often confounded with the word selfishness, which certainly, in strict propriety, denotes a very different disposition of mind.\" Slewart.
self-luminous |Possessing in itself the property of emitting light. Sir D. Brewster.
self-made |Made by one's self. Self-made man, a man who has risen from poverty or obscurity by means of his own talentss or energies.
self-mettle |Inborn mettle or courage; one's own temper. [Obs.] Shak.
self-motion |Motion given by inherent power, without external impulse; spontaneus or voluntary motion. Matter is not induced with self-motion. Cheyne.
self-moved |Moved by inherent power., without the aid of external impulse.
self-moving |Moving by inherent power, without the aid of external impulse.
self-murder |Suicide.
self-murderer |A suicide.
self-neglecting |A neglecting of one's self, or of one's own interests. Self-love, my liege, is not so vile a sin As self-neglecting. Shak.
self-one |Secret. [Obs.] Marston.
self-opinion |Opinion, especially high opinion, of one's self; an overweening estimate of one's self or of one's own opinion. Collier.
self-opinioned |Having a high opinion of one's self; opinionated; conceited. South.
self-originating |Beginning wwith, or springing from, one's self.
self-partiality |That partiality to himself by which a man overrates his own worth when compared with others. Kames.
self-perplexed |Perplexed by doubts originating in one's own mind.
self-posited |Disposed or arranged by an action originating in one's self or in itself. These molecular blocks of salt are self-posited. Tyndall.
self-positing |The act of disposing or arranging one's self or itself. The self-positing of the molecules. R. Watts.
self-possessed |Composed or tranquill in mind, manner, etc.; undisturbed.
self-possession |The possession of one's powers; calmness; self-command; presence of mind; composure.
self-praise |Praise of one's self.
self-preservation |The preservation of one's self from destruction or injury.
self-propagating |Propagating by one's self or by itself.
self-registering |Registering itself; -- said of any instrument so contrived as to record its own indications of phenomena, whether continuously or at stated times, as at the maxima and minima of variations; as, a self-registering anemometer or barometer.
self-regulated |Regulated by one's self or by itself.
self-regulative |Tending or serving to regulate one's self or itself. Whewell.
self-reliance |Reliance on one's own powers or judgment; self-trust.
self-reliant |Reliant upon one's self; trusting to one's own powers or judgment.
self-renunciation |The act of renouncing, or setting aside, one's own wishes, claims, etc.; self-sacrifice.
self-repellency |The quality or state of being self-repelling.
self-repelling |Made up of parts, as molecules or atoms, which mutually repel each other; as, gases are self-repelling.
self-repetition |Repetition of one's self or of one's acts; the saying or doing what one has already said or done.
self-reproach |The act of reproaching one's self; censure by one's own conscience.
self-reproached |Reproached by one's own conscience or judgment.
self-reproaching |Reproaching one's self. -- Self`-re*proach\"ing*ly, adv.
self-reproof |The act of reproving one's self; censure of one's conduct by one's own judgment.
self-reproved |Reproved by one's own conscience or one's own sense of guilt.
self-reproving |Reproving one's self; reproving by consciousness of guilt.
self-reprovingly |In a self-reproving way.
self-repugnant |Self-contradictory; inconsistent. Brougham.
self-repulsive |Self-repelling.
self-respect |Respect for one's self; regard for one's character; laudable self-esteem.
self-restrained |Restrained by one's self or itself; restrained by one's own power or will.
self-restraint |Restraint over one's self; self-control; self-command.
self-reverence |A reverent respect for one's self. Tennyson.
self-righteous |Righteous in one's own esteem; pharisaic.
self-righteousness |The quality or state of being self-righteous; pharisaism.
self-sacrifice |The act of sacrificing one's self, or one's interest, for others; self-devotion.
self-sacrificing |Yielding up one's own interest, ffeelings, etc; sacrificing one's self.
self-satisfaction |The quality or state of being self-satisfied.
self-satisfied |Satisfied with one's self or one's actions; self-complacent.
self-satisfying |Giving satisfaction to one's self.
self-seeker |One who seeks only his own interest, advantage, or pleasure.
self-seeking |Seeking one's own interest or happiness; selfish. Arbuthnot.\n\nThe act or habit of seeking one's own interest or happiness; selfishness.
self-slaughter |Suicide. Shak.
self-starter |A mechanism (usually one operated by electricity, compressed air, a spring, or an explosive gas), attached to an internal- combustion engine, as on an automobile, and used as a means of starting the engine without cranking it by hand.
self-sufficiency |The quality or state of being self-sufficient.
self-sufficient |1. Sufficient for one's self without external aid or co√∂peration. Neglect of friends can never be proved rational till we prove the person using it omnipotent and self-sufficient, and such as can never need any mortal assistance. South. 2. Having an overweening confidence in one's own abilities or worth; hence, haughty; overbearing. \"A rash and self-sufficient manner.\" I. Watts.
self-sufficing |Sufficing for one's self or for itself, without needing external aid; self-sufficient. -- Self`-suf*fi\"cing*ness, n. J. C. Shairp.
self-suspended |Suspended by one's self or by itself; balanced. Southey.
self-suspicious |Suspicious or distrustful of one's self. Baxter.
self-taught |Taught by one's own efforts.
self-tormentor |One who torments himself.
self-torture |The act of inflicting pain on one's self; pain inflicted on one's self.
self-trust |Faith in one's self; self-reliance.
self-uned |One with itself; separate from others. [Obs.] Sylvester.
self-view |A view if one's self; specifically, carefulness or regard for one's own interests
self-will |One's own will, esp. when opposed to that of others; obstinacy.
self-willed |Governed by one's own will; not yielding to the wishes of others; obstinate.
self-willedness |Obstinacy. Sir W. Scott.
self-worship |The idolizing of one's self; immoderate self-conceit.
self-wrong |Wrong done by a person himself. Shak.
selfhood |Existence as a separate self, or independent person; conscious personality; individuality. Bib. Sacra.
selfish |1. Caring supremely or unduly for one's self; regarding one's own comfort, advantage, etc., in disregard, or at the expense, of those of others. They judge of things according to their own private appetites and selfish passions. Cudworth. In that throng of selfish hearts untrue. Keble. 2. (Ethics)  Believing or teaching that the chief motives of human action are derived from love of self. Hobbes and the selfish school of philosophers. Fleming.
selfishly |In a selfish manner; with regard to private interest only or chiefly.
selfishness |The quality or state of being selfish; exclusive regard to one's own interest or happiness; that supreme self-love or self- preference which leads a person to direct his purposes to the advancement of his own interest, power, or happiness, without regarding those of others. Selfishness,- a vice utterly at variance with the happiness of him who harbors it, and, as such, condemned by self-love. Sir J. Mackintosh. Syn. -- See Self-love.
selfism |Concentration of one's interests on one's self; self-love; selfishness. Emerson.
selfist |A selfish person. [R.] I. Taylor.
selfless |Having no regard to self; unselfish. Lo now, what hearts have men! they never mount As high as woman in her selfless mood. Tennyson.
selflessness |Quality or state of being selfless.
selfness |Selfishness. [Obs.] Sir. P. Sidney.
selfsame |Precisely the same; the very same; identical. His servant was healed in the selfsame hour. Matt. viii. 13.
selion |A short piece of land in arable ridges and furrows, of uncertain quantity; also, a ridge of land lying between two furrows. [Obs. or Prov. Eng.]
seljuckian |A member of the family of Seljuk; an adherent of that family, or subject of its government; (pl.) the dynasty of Turkish sultans sprung from Seljuk.
seljukian |Of or pertaining to Seljuk, a Tartar chief who embraced Mohammedanism, and began the subjection of Western Asia to that faith and rule; of or pertaining to the dynasty founded by him, or the empire maintained by his descendants from the 10th to the 13th century. J. H. Newman.\n\nA member of the family of Seljuk; an adherent of that family, or subject of its government; (pl.) the dynasty of Turkish sultans sprung from Seljuk.
sell |Self. [Obs. or Scot.] B. Jonson.\n\nA sill. [Obs.] Chaucer.\n\nA cell; a house. [Obs.] Chaucer.\n\n1. A saddle for a horse. [Obs.] He left his lofty steed with golden self. Spenser. 2. A throne or lofty seat. [Obs.] Fairfax.\n\n1. To transfer to another for an equivalent; to give up for a valuable consideration; to dispose of in return for something, especially for money. If thou wilt be perfect, go and sell that thou hast, and give to the poor. Matt. xix. 21. I am changed; I'll go sell all my land. Shak. Note: Sell is corellative to buy, as one party buys what the other sells. It is distinguished usually from exchange or barter, in which one commodity is given for another; whereas in selling the consideration is usually money, or its representative in current notes. 2. To make a matter of bargain and sale of; to accept a price or reward for, as for a breach of duty, trust, or the like; to betray. You would have sold your king to slaughter. Shak. 3. To impose upon; to trick; to deceive; to make a fool of; to cheat. [Slang] Dickens. To sell one's life dearly, to cause much loss to those who take one's life, as by killing a number of one's assailants. -- To sell (anything) out, to dispose of it wholly or entirely; as, he had sold out his corn, or his interest in a business.\n\n1. To practice selling commodities. I will buy with you, sell with you; . . . but I will not eat with you. Shak. 2. To be sold; as, corn sells at a good price. To sell out, to sell one's whole stockk in trade or one's entire interest in a property or a business.\n\nAn imposition; a cheat; a hoax. [Colloq.]
sellanders |See Sallenders.
sellenders |See Sallenders.
seller |One who sells. Chaucer.
selters water |A mineral water from Sellers, in the district of Nassan, Germany, containing much free carbonic acid.
seltzer water |See Selters water.
seltzo-gene |A gazogene.
selvage |1. The edge of cloth which is woven in such a manner as to prevent raveling. 2. The edge plate of a lock, through which the bolt passes. Knight. 3. (Mining.)  A layer of clay or decomposed rock along the wall of a vein. See Gouge, n., 4. Raymond.
selvaged |Having a selvage.
selvagee |A skein or hank of rope yarns wound round with yarns or marline, -- used for stoppers, straps, etc.
selvas |Vast woodland plains of South America.
selve |Self; same. [Obs.] Chaucer.
selvedge |1. The edge of cloth which is woven in such a manner as to prevent raveling. 2. The edge plate of a lock, through which the bolt passes. Knight. 3. (Mining.)  A layer of clay or decomposed rock along the wall of a vein. See Gouge, n., 4. Raymond.
selvedged |Having a selvage.
selves |pl. of Self.
sely |Silly. [Obs.] Chaucer. Wyclif.
semaeostomata |A division of Discophora having large free mouth lobes. It includes Aurelia, and Pelagia. Called also Semeostoma. See Illustr. under Discophora, and Medusa.
semaphore |A signal telegraph; an apparatus for giving signals by the disposition of lanterns, flags, oscillating arms, etc.
semaphoric |Of or pertaining to a semaphore, or semaphores; telegraphic.
semaphorical |Of or pertaining to a semaphore, or semaphores; telegraphic.
semaphorically |By means a semaphore.
semaphorist |One who manages or operates a semaphore.
semasiology |The science of meanings or sense development (of words); the explanation of the development and changes of the meanings of words. --Se*ma`si*o*log\"ic*al (#), a.
sematic |Significant; ominous; serving as a warning of danger; --applied esp. to the warning colors or forms of certain animals.
sematology |The doctrine of signs as the expression of thought or reasoning; the science of indicating thought by signs. Smart.
sematrope |An instrument for signaling by reflecting the rays of the sun in different directions. Knight.
semblable |Like; similar; resembling. [Obs.] Chaucer.\n\nLikeness; representation. [Obs.]
semblably |In like manner. [Obs.] Shak.
semblance |1. Seeming; appearance; show; figure; form. Thier semblance kind, and mild their gestures were. Fairfax. 2. Likeness; resemblance, actual or apparent; similitude; as, the semblance of worth; semblance of virtue. Only semblances or imitations of shells. Woodward.
semblant |1. Like; resembling. [Obs.] Prior. 2. Seeming, rather than real; apparent. [R.] Carlyle.\n\n1. Show; appearance; figure; semblance. [Obs.] Spenser. His flatterers made semblant of weeping. Chaucer. 2. The face. [Obs.] Wyclif (Luke xxiv. 5).
semblative |Resembling. [Obs.] And all is semblative a woman's part. Shak.
semble |1. To imitate; to make a representation or likeness. [Obs.] Where sembling art may carve the fair effect. Prior. 2. (Law)  It seems; -- chiefly used impersonally in reports and judgments to express an opinion in reference to the law on some point not necessary to be decided, and not intended to be definitely settled in the cause.\n\nLike; resembling. [Obs.] T. Hudson.
sembling |The practice of attracting the males of Lepidoptera or other insects by exposing the female confined in a cage. Note: It is often adopted by collectors in order to procure specimens of rare species.
seme |Sprinkled or sown; -- said of field, or a charge, when strewed or covered with small charges.
semeiography |A description of the signs of disease.
semeiological |Of or pertaining to the science of signs, or the systematic use of signs; as, a semeiological classification of the signs or symptoms of disease; a semeiological arrangement of signs used as signals.
semeiology |The science or art of signs. Specifically: (a) (Med.) The science of the signs or symptoms of disease; symptomatology. (b) The art of using signs in signaling.
semeiotic |1. Relating to signs or indications; pertaining to the language of signs, or to language generally as indicating thought. 2. (Med.)  Of or pertaining to the signs or symptoms of diseases.
semeiotics |Semeiology.
semele |A daughter of Cadmus, and by Zeus mother of Bacchus.
semen |1. (Bot.)  The seed of plants. 2. (Physiol.)  The seed or fecundating fluid of male animals; sperm. It is a white or whitish viscid fluid secreted by the testes, characterized by the presence of spermatozoids to which it owes its generative power. Semen contra, or Semen cin√¶ or cyn√¶, a strong aromatic, bitter drug, imported from Aleppo and Barbary, said to consist of the leaves, peduncles, and unexpanded flowers of various species of Artemisia; wormseed.
semeniferous |Seminiferous.
semester |A period of six months; especially, a term in a college or uneversity which divides the year into two terms.
semi circumference |Half of a circumference.
semi crustaceous |Half crustaceous; partially crustaceous.
semi pupa |The young of an insect in a stage between the larva and pupa.
semi- |A prefix signifying half, and sometimes partly or imperfectly; as, semiannual, half yearly; semitransparent, imperfectly transparent. Note: The prefix semi is joined to another word either with the hyphen or without it. In this book the hyphen is omitted except before a capital letter; as, semiacid, semiaquatic, semi-Arian, semiaxis, semicalcareous.
semi-arian |A member of a branch of the Arians which did not acknowledge the Son to be consubstantial with the Father, that is, of the same substance, but admitted him to be of a like substance with the Father, not by nature, but by a peculiar privilege.\n\nOf or pertaining to Semi-Arianism.
semi-arianism |The doctrines or tenets of the Semi-Arians.
semi-christianized |Half Christianized.
semi-diesel |Designating an internal-combustion engine of a type resembling the Diesel engine in using as fuel heavy oil which is injected in a spray just before the end of the compression stroke and is fired without electrical ignition. The fuel is sprayed into an iron box (called a hot bulb or hot pot) opening into the combustion chamber, and heated for ignition by a blast-lamp until the engine is running, when it is, ordinarily, kept red hot by the heat of combustion.
semi-pelagian |A follower of John Cassianus, a French monk (died about 448), who modified the doctrines of Pelagius, by denying human merit, and maintaining the necessity of the Spirit's influence, while, on the other hand, he rejected the Augustinian doctrines of election, the inability of man to do good, and the certain perseverance of the saints.\n\nOf or pertaining to the Semi-Pelagians, or their tenets.
semi-pelagianism |The doctrines or tenets of the Semi-Pelagians.
semi-saxon |Half Saxon; -- specifically applied to the language intermediate between Saxon and English, belonging to the period 1150- 1250.
semiacid |Slightly acid; subacid.
semiacidified |Half acidified.
semiadherent |Adherent part way.
semiamplexicaul |Partially amplexicaul; embracing the stem half round, as a leaf.
semiangle |The half of a given, or measuring, angle.
semiannual |Half-yearly.
semiannually |Every half year.
semiannular |Having the figure of a half circle; forming a semicircle. Grew.
semiaxis |One half of the axis of an
semibarbarian |Half barbarous; partially civilized. -- n.  One partly civilized.
semibarbaric |Half barbarous or uncivilized; as, semibarbaric display.
semibarbarism |The quality or state of being half barbarous or uncivilized.
semibarbarous |Half barbarous.
semibreve |A note of half the time or duration of the breve; -- now usually called a whole note. It is the longest note in general use.
semibrief |A semibreve. [R.]
semibull |A bull issued by a pope in the period between his election and coronation.
semicalcareous |Half or partially calcareous; as, a semicalcareous plant.
semicalcined |Half calcined; as, semicalcined iron.
semicastrate |To deprive of one testicle. -- Sem`i*cas*tra\"tion,n.
semicentennial |Of or pertaining to half of a century, or a period of fifty years; as, a semicentennial commemoration.\n\nA fiftieth anniversary.
semichaotic |Partially chaotic.
semichorus |A half chorus; a passage to be sung by a selected portion of the voices, as the female voices only, in contrast with the full choir.
semicircle |1. (a) The half of a circle; the part of a circle bounded by its diameter and half of its circumference. (b) A semicircumference. 2. A body in the form of half of a circle, or half of a circumference. 3. An instrument for measuring angles.
semicircled |Semicircular. Shak.
semicircular |Having the form of half of a circle. Addison. Semicircular canals (Anat.), certain canals of the inner ear. See under Ear.
semicirque |A semicircular hollow or opening among trees or hills. Wordsworth.
semicolon |The punctuation mark [;] indicating a separation between parts or members of a sentence more distinct than that marked by a comma.
semicolumn |A half column; a column bisected longitudinally, or along its axis.
semicolumnar |Like a semicolumn; flat on one side and round on the other; imperfectly columnar.
semicompact |Half compact; imperfectly indurated.
semiconscious |Half conscious; imperfectly conscious. De Quincey.
semicope |A short cope, or an inferier kind of cope. [Obs.] Chaucer.
semicrystalline |Half crystalline; -- said of certain cruptive rocks composed partly of crystalline, partly of amorphous matter.
semicubical |Of or pertaining to the square root of the cube of a quantity. Semicubical parabola, a curve in which the ordinates are proportional to the square roots of the cubes of the abscissas.
semicubium |A half bath, or one that covers only the lewer extremities and the hips; a sitz-bath; a half bath, or hip bath.
semicupium |A half bath, or one that covers only the lewer extremities and the hips; a sitz-bath; a half bath, or hip bath.
semicylindric |Half cylindrical.
semicylyndrical |Half cylindrical.
semideistical |Half deisticsl; bordering on deism. S. Miller.
semidemiquaver |A demisemiquaver; a thirty-second note.
semidetached |Half detached; partly distinct or separate. Semidetached house, one of two tenements under a single roof, but separated by a party wall. [Eng.]
semidiameter |Half of a diameter; a right line, or the length of a right line, drawn from the center of a circle, a sphere, or other curved figure, to its circumference or periphery; a radius.
semidiapason |An imperfect octave.
semidiapente |An imperfect or diminished fifth. Busby.
semidiaphaneity |Half or imperfect transparency; translucency. [R.] Boyle.
semidiaphanous |Half or imperfectly transparent; translucent. Woodward.
semidiatessaron |An imperfect or diminished fourth. [R.]
semiditone |A lesser third, having its terms as 6 to 5; a hemiditone. [R.]
semidiurnal |1. Pertaining to, or accomplished in, half a day, or twelve hours; occurring twice every day. 2. Pertaining to, or traversed in, six hours, or in half the time between the rising and setting of a heavenly body; as, a semidiurnal arc.
semidome |A roof or ceiling covering a semicircular room or recess, or one of nearly that shape, as the apse of a church, a niche, or the like. It is approximately the quarter of a hollow sphere.
semidouble |An office or feast celebrated with less solemnity than the double ones. See Double, n., 8.\n\nHaving the outermost stamens converted into petals, while the inner ones remain perfect; -- said of a flower.
semifable |That which is part fable and part truth; a mixture of truth and fable. De Quincey.
semiflexed |Half bent.
semifloret |See Semifloscule.
semifloscular |Semiflosculous.
semifloscule |A floscule, or florest, with its corolla prolonged into a strap-shaped petal; -- called also semifloret.
semiflosculous |Having all the florets ligulate, as in the dandelion.
semifluid |Imperfectly fluid. -- n.  A semifluid substance.
semiform |A half form; an imperfect form.
semiformed |Half formed; imperfectly formed; as, semiformed crystals.
semiglutin |A peptonelike body, insoluble in alcohol, formed by boiling collagen or gelatin for a long time in water. Hemicollin, a like body, is also formed at the same time, and differs from semiglutin by being partly soluble in alcohol.
semihistorical |Half or party historical. Sir G. C. Lewis.
semihoral |Half-hourly.
semiindurated |Imperfectly indurated or hardened.
semilapidified |Imperfectly changed into stone. Kirwan.
semilens |The half of a lens divided along a plane passing through its axis.
semilenticular |Half lenticular or convex; imperfectly resembling a lens. Kirwan.
semiligneous |Half or partially ligneous, as a stem partly woody and partly herbaceous.
semiliquid |Half liquid; semifluid.
semiliquidity |The quality or state of being semiliquid; partial liquidity.
semilogical |Half logical; partly logical; said of fallacies. Whately.
semilor |A yellowish alloy of copper and zinc. See Simplor.
semilunar |Shaped like a half moon. Semilunar bone (Anat.), a bone of the carpus; the lunar. See Lunar, n. -- Semilunar, or Sigmoid, valves (Anat.), the valves at the beginning of the aorta and of the pulmonary artery which prevent the blood from flowing back into the ventricle.\n\nThe semilunar bone.
semilunary |Semilunar.
semilunate |Semilunar.
semilune |The half of a lune.
semimetal |An element possessing metallic properties in an inferior degree and not malleable, as arsenic, antimony, bismuth, molybdenum, uranium, etc. [Obs.]
semimetallic |Of or pertaining to a semimetal; possessing metallic properties in an inferior degree; resembling metal.
semimonthly |Coming or made twice in a month; as, semimonthly magazine; a semimonthly payment. -- n.  Something done or made every half month; esp., a semimonthly periodical. -- adv.  In a semimonthly manner; at intervals of half a month.
semimute |Having the faculty of speech but imperfectly developed or partially lost.\n\nA semimute person.
seminal |1. Pertaining to, containing, or consisting of, seed or semen; as, the seminal fluid. 2. Contained in seed; holding the relation of seed, source, or first principle; holding the first place in a series of developed results or consequents; germinal; radical; primary; original; as, seminal principles of generation; seminal virtue. The idea of God is, beyond all question or comparison, the one great seminal principle. Hare. Seminal leaf (Bot.), a seed leaf, or cotyleden. -- Seminal receptacle. (Zo√∂l.) Same as Spermatheca.\n\nA seed. [Obs.] Sir T. Browne.
seminality |The quality or state of being seminal. Sir T. Browne.
seminar |A group of students engaged, under the guidance of an instructor, in original research in a particular line of study, and in the exposition of the results by theses, lectures, etc.; -- called also seminary.
