shewer |One who shews. See Shower.
shewn |p. p. of Shew.
shiah |Same as Shiite.\n\nA member of that branch of the Mohammedans to which the Persians belong. They reject the first three caliphs, and consider Ali as being the first and only rightful successor of Mohammed. They do not acknowledge the Sunna, or body of traditions respecting Mohammed, as any part of the law, and on these accounts are treated as heretics by the Sunnites, or orthodox Mohammedans.
shibboleth |1. A word which was made the criterion by which to distinguish the Ephraimites from the Gileadites. The Ephraimites, not being able to pronounce sh, called the word sibboleth. See Judges xii. Without reprieve, adjudged to death, For want of well pronouncing shibboleth. Milton.  Also in an extended sense. The th, with its twofold value, is . . . the shibboleth of foreigners. Earle. 2. Hence, the criterion, test, or watchword of a party; a party cry or pet phrase.
shicer |An unproductive mine; a duffer. [Australia]
shide |A thin board; a billet of wood; a splinter. [Prov. Eng.]
shie |See Shy, to throw.
shied |imp. & p. p. of Shy.
shiel |A sheeling. [Scot.] Burns.
shield |1. A broad piece of defensive armor, carried on the arm, -- formerly in general use in war, for the protection of the body. See Buckler. Now put your shields before your hearts and fight, With hearts more proof than shields. Shak. 2. Anything which protects or defends; defense; shelter; protection. \"My council is my shield.\" Shak. 3. Figuratively, one who protects or defends. Fear not, Abram; I am thy shield, and thy exceeding great reward. Gen. xv. 1. 4. (Bot.)  In lichens, a Hardened cup or disk surrounded by a rim and containing the fructification, or asci. 5. (Her.)  The escutcheon or field on which are placed the bearings in coats of arms. Cf. Lozenge. See Illust. of Escutcheon. 6. (Mining & Tunneling)  A framework used to protect workmen in making an adit under ground, and capable of being pushed along as excavation progresses. 7. A spot resembling, or having the form of, a shield. \"Bespotted as with shields of red and black.\" Spenser. 8. A coin, the old French crown, or écu, having on one side the figure of a shield. [Obs.] Chaucer. Shield fern (Bot.), any fern of the genus Aspidium, in which the fructifications are covered with shield-shaped indusia; -- called also wood fern. See Illust. of Indusium.\n\n1. To cover with, or as with, a shield; to cover from danger; to defend; to protect from assault or injury. Shouts of applause ran ringing through the field, To see the son the vanquished father shield. Dryden. A woman's shape doth shield thee. Shak. 2. To ward off; to keep off or out. They brought with them their usual weeds, fit to shield the cold to which they had been inured. Spenser. 3. To avert, as a misfortune; hence, as a supplicatory exclamation, forbid! [Obs.] God shield that it should so befall. Chaucer. God shield I should disturb devotion! Shak.
shield-bearer |1. One who, or that which, carries a shield. 2. (Zoöl.)  Any small moth of the genus Aspidisca, whose larva makes a shieldlike covering for itself out of bits of leaves.
shielddrake |A sheldrake.
shieldless |Destitute of a shield, or of protection. -- Shield\"less*ly, adv. -- Shield\"less*ness, n.
shieldtail |Any species of small burrowing snakes of the family Uropeltidæ, native of Ceylon and Southern Asia. They have a small mouth which can not be dilated.
shieling |A hut or shelter for shepherds of fishers. See Sheeling. [Scot.]
shift |1. To divide; to distribute; to apportion. [Obs.] To which God of his bounty would shift Crowns two of flowers well smelling. Chaucer. 2. To change the place of; to move or remove from one place to another; as, to shift a burden from one shoulder to another; to shift the blame. Hastily he schifte him[self]. Piers Plowman. Pare saffron between the two St. Mary's days, Or set or go shift it that knowest the ways. Tusser. 3. To change the position of; to alter the bearings of; to turn; as, to shift the helm or sails. Carrying the oar loose, [they] shift it hither and thither at pleasure. Sir W. Raleigh. 4. To exchange for another of the same class; to remove and to put some similar thing in its place; to change; as, to shift the clothes; to shift the scenes. I would advise you to shift a shirt. Shak. 5. To change the clothing of; -- used reflexively. [Obs.] As it were to ride day and night; and . . . not to have patience to shift me. Shak. 6. To put off or out of the way by some expedient. \"I shifted him away.\" Shak. To shift off, to delay; to defer; to put off; to lay aside. -- To shift the scene, to change the locality or the surroundings, as in a play or a story. Shift the scene for half an hour; Time and place are in thy power. Swift.\n\n1. To divide; to distribute. [Obs.] Some this, some that, as that him liketh shift. Chaucer. 2. To make a change or changes; to change position; to move; to veer; to substitute one thing for another; -- used in the various senses of the transitive verb. The sixth age shifts Into the lean and slippered pantaloon. Shak. Here the Baillie shifted and fidgeted about in his seat. Sir W. Scott. 3. To resort to expedients for accomplishing a purpose; to contrive; to manage. Men in distress will look to themselves, and leave their companions to schift as well as they can. L'Estrange. 4. To practice indirect or evasive methods. All those schoolmen, though they were exceeding witty, yet better teach all their followers to shift, than to resolve by their distinctions. Sir W. Raleigh. 5. (Naut.)  To slip to one side of a ship, so as to destroy the equilibrum; -- said of ballast or cargo; as, the cargo shifted.\n\n1. The act of shifting. Specifically: (a) The act of putting one thing in the place of another, or of changing the place of a thing; change; substitution. My going to Oxford was not merely for shift of air. Sir H. Wotton. (b) A turning from one thing to another; hence, an expedient tried in difficalty; often, an evasion; a trick; a fraud. \"Reduced to pitiable shifts.\" Macaulay. I 'll find a thousand shifts to get away. Shak. Little souls on little shifts rely. Dryden. 2. Something frequently shifted; especially, a woman's under-garment; a chemise. 3. The change of one set of workmen for another; hence, a spell, or turn, of work; also, a set of workmen who work in turn with other sets; as, a night shift. 4. In building, the extent, or arrangement, of the overlapping of plank, brick, stones, etc., that are placed in courses so as to break joints. 5. (Mining)  A breaking off and dislocation of a seam; a fault. 6. (Mus.)  A change of the position of the hand on the finger board, in playing the violin. To make shift, to contrive or manage in an exigency. \"I shall make shift to go without him.\" Shak. [They] made a shift to keep their own in Ireland. Milton.
shiftable |Admitting of being shifted.
shifter |1. One who, or that which, shifts; one who plays tricks or practices artifice; a cozener. 'T was such a shifter that, if truth were known, Death was half glad when he had got him down. Milton. 2. (Naut.)  An assistant to the ship's cook in washing, steeping, and shifting the salt provisions. 3. (Mach.) (a) An arrangement for shifting a belt sidewise from one pulley to another. (b) (Knitting Mach.) A wire for changing a loop from one needle to another, as in narrowing, etc.
shiftiness |The quality or state of being shifty. Diplomatic shiftiness and political versatility. J. A. Syminds.
shifting |1. Changing in place, position, or direction; varying; variable; fickle; as, shifting winds; shifting opinions or principles. 2. Adapted or used for shifting anything. Shifting backstays (Naut.), temporary stays that have to be let go whenever the vessel tacks or jibes. -- Shifting ballast, ballast which may be moved from one side of a vessel to another as safety requires. -- Shifting center. See Metacenter. -- Shifting locomotive. See Switching engine, under Switch.
shiftingly |In a shifting manner.
shiftless |Destitute of expedients, or not using successful expedients; characterized by failure, especially by failure to provide for one's own support, through negligence or incapacity; hence, lazy; improvident; thriftless; as, a shiftless fellow; shiftless management. -- Shift\"less*ly, adv. -- Shift\"less*ness, n.
shifty |Full of, or ready with, shifts; fertile in expedients or contrivance. Wright. Shifty and thrifty as old Greek or modern Scot, there were few things he could not invent, and perhaps nothing he could not endure. C. Kingsley.
shiite |A member of that branch of the Mohammedans to which the Persians belong. They reject the first three caliphs, and consider Ali as being the first and only rightful successor of Mohammed. They do not acknowledge the Sunna, or body of traditions respecting Mohammed, as any part of the law, and on these accounts are treated as heretics by the Sunnites, or orthodox Mohammedans.
shikaree |A sportsman; esp., a native hunter. [India]
shikari |A sportsman; esp., a native hunter. [India]
shilf |Straw. [Obs.]
shilfa |The chaffinch; -- so named from its call note. [Prov. Eng.]
shill |To shell. [Obs. or Prov. Eng.]\n\nTo put under cover; to sheal. [Prov.ng.] Brockett.
shill-i-shall-i |In an irresolute, undecided, or hesitating manner. I am somewhat dainty in making a resolution, because when I make it, I keep it; I don't stand shill-I-shall-I then; if I say 't, I'll do 't. Congreve.
shillalah |An oaken sapling or cudgel; any cudgel; -- so called from Shillelagh, a place in Ireland of that name famous for its oaks. [Irish] [Written also shillaly, and shillely.]
shillelah |An oaken sapling or cudgel; any cudgel; -- so called from Shillelagh, a place in Ireland of that name famous for its oaks. [Irish] [Written also shillaly, and shillely.]
shilling |1. A silver coin, and money of account, of Great Britain and its dependencies, equal to twelve pence, or the twentieth part of a pound, equivalent to about twenty-four cents of the United States currency. 2. In the United States, a denomination of money, differing in value in different States. It is not now legally recognized. Note: Many of the States while colonies had issued bills of credit which had depreciated in different degrees in the different colonies. Thus, in New England currency (used also in Virginia, Kentucky, Tennessee, Indiana, Illinois, Missouri, Mississippi, Alabama, and Florida), after the adoption of the decimal system, the pound in paper money was worth only $3.333, and the shilling 16 Am. Cyc. 3. The Spanish real, of the value of one eight of a dollar, or 12 York shilling. Same as Shilling, 3.
shilly-shally |In an irresolute, undecided, or hesitating manner. I am somewhat dainty in making a resolution, because when I make it, I keep it; I don't stand shill-I-shall-I then; if I say 't, I'll do 't. Congreve.\n\nTo hesitate; to act in an irresolute manner; hence, to occupy one's self with trifles.\n\nIrresolution; hesitation; also, occupation with trifles. She lost not one of her forty-five minutes in picking and choosing, - - no shilly-shally in Kate. De Quincey.
shiloh |A word used by Jacob on his deathbed, and interpreted variously, as \"the Messiah,\" or as the city \"Shiloh,\" or as \"Rest.\",
  "polyandric |Pertaining to, or characterized by, polyandry; mating with several males. \"Polyandric societies.\" H. Spencer.
shily |See Shyly.
shim |1. A kind of shallow plow used in tillage to break the ground, and clear it of weeds. 2. (Mach.)  A thin piece of metal placed between two parts to make a fit.
shimmer |To shine with a tremulous or intermittent light; to shine faintly; to gleam; to glisten; to glimmer. The shimmering glimpses of a stream. Tennyson.\n\nA faint, tremulous light; a gleaming; a glimmer. TWo silver lamps, fed with perfumed oil, diffused . . . a trembling twilight-seeming shimmer through the quiet apartment. Sir W. Scott.
shimmering |A gleam or glimmering. \"A little shimmering of a light.\" Chaucer.
shimmy |A chemise. [Colloq.]
shin |1. The front part of the leg below the knee; the front edge of the shin bone; the lower part of the leg; the shank. \"On his shin.\" Chaucer. 2. (Railbroad)  A fish plate for rails. Knight. Shin bone (Anat.), the tibia. -- Shin leaf (Bot.), a perennial ericaceous herb (Pyrola elliptica) with a cluster of radical leaves and a raceme of greenish white flowers.\n\n1. To climb a mast, tree, rope, or the like, by embracing it alternately with the arms and legs, without help of steps, spurs, or the like; -- used with up; as, to shin up a mast. [Slang] 2. To run about borrowing money hastily and temporarily, as for the payment of one's notes at the bank. [Slang, U.S.] Bartlett.\n\nTo climb (a pole, etc.) by shinning up. [Slang]
shin shu |The leading and most progressive Buddhist sect of Japan, resting its faith rather upon Amida than Gautama Buddha. Rites and ceremonies are held useless without uprightness.
shindle |A shingle; also, a slate for roofing. [Obs.] Holland.\n\nTo cover or roof with shindles. [Obs.]
shindy |1. An uproar or disturbance; a spree; a row; a riot. [Slang] Thackeray. 2. Hockey; shinney. Bartlett. 3. A fancy or liking. [Local, U. S.] Bartlett.
shine |1. To emit rays of light; to give light; to beam with steady radiance; to exhibit brightness or splendor; as, the sun shines by day; the moon shines by night. Hyperion's quickening fire doth shine. Shak. God, who commanded the light to shine out of darkness, hath shined in our hearts, to give the light of the knowledge of the glory of God in the face of Jesus Cghrist. 2 Cor. iv. 6. Let thine eyes shine forth in their full luster. Denham. 2. To be bright by reflection of light; to gleam; to be glossy; as, to shine like polished silver. 3. To be effulgent in splendor or beauty. \"So proud she shined in her princely state.\" Spenser. Once brightest shined this child of heat and air. Pope. 4. To be eminent, conspicuous, or distinguished; to exhibit brilliant intellectual powers; as, to shine in courts; to shine in conversation. Few are qualified to shine in company; but it in most men's power to be agreeable. Swift. To make, or cause, the face to shine upon, to be propitious to; to be gracious to. Num. vi. 25.\n\n1. To cause to shine, as a light. [Obs.] He [God] doth not rain wealth, nor shine honor and virtues, upon men equally. Bacon. 2. To make bright; to cause to shine by reflected light; as, in hunting, to shine the eyes of a deer at night by throwing a light on them. [U. S.] Bartlett.\n\n1. The quality or state of shining; brightness; luster, gloss; polish; sheen. Now sits not girt with taper's holy shine. Milton. Fair opening to some court's propitious shine. Pope. The distant shine of the celestial city. Hawthorne. 2. Sunshine; fair weather. Be it fair or foul, or rain or shine. Dryden. 3. A liking for a person; a fancy. [Slang, U.S.] 4. Caper; antic; row. [Slang] To cut up shines, to play pranks. [Slang, U.S.]\n\nShining; sheen. [Obs.] Spenser.
shiner |That which shines. Specifically: (a) A luminary. (b) A bright piece of money. [Slang] Has she the shiners, d' ye think Foote. black eye. (c) (Zoöl.) Any one of numerous species of small freshwater American cyprinoid fishes, belonging to Notropis, or Minnilus, and allied genera; as the redfin (Notropis megalops), and the golden shiner (Notemigonus chrysoleucus) of the Eastern United States; also loosely applied to various other silvery fishes, as the dollar fish, or horsefish, menhaden, moonfish, sailor's choice, and the sparada. (d) (Zoöl.)  The common Lepisma, or furniture bug. Blunt-nosed shiner (Zoöl.), the silver moonfish.
shiness |See Shyness.
shingle |Round, water-worn, and loose gravel and pebbles, or a collection of roundish stones, such as are common on the seashore and elsewhere.\n\n1. A piece of wood sawed or rived thin and small, with one end thinner than the other, -- used in covering buildings, especially roofs, the thick ends of one row overlapping the thin ends of the row below. I reached St. Asaph, . . . where there is a very poor cathedral church covered with shingles or tiles. Ray. 2. A sign for an office or a shop; as, to hang out one's shingle. [Jocose, U. S.] Shingle oak (Bot.), a kind of oak (Quercus imbricaria) used in the Western States for making shingles.\n\n1. To cover with shingles; as, to shingle a roof. They shingle their houses with it. Evelyn. 2. To cut, as hair, so that the ends are evenly exposed all over the head, as shingles on a roof.\n\nTo subject to the process of shindling, as a mass of iron from the pudding furnace.
shingler |1. One who shingles. 2. A machine for shingling puddled iron.
shingles |A kind of herpes (Herpes zoster) which spreads half way around the body like a girdle, and is usually attended with violent neuralgic pain.
shingling |1. The act of covering with shingles; shingles, collectively; a covering made of shingles. 2. (Metal)  The process of expelling scoriæ and other impurities by hammering and squeezing, in the production of wrought iron. Shingling hammer, a ponderous hammer moved by machinery, used in shingling puddled iron. -- Shingling mill, a mill or forge where puddled iron is shingled.
shingly |Abounding with shingle, or gravel.
shinhopple |The hobblebush.
shining |1. Emitting light, esp. in a continuous manner; radiant; as, shining lamps; also, bright by the reflection of light; as, shining armor. \"Fish . . . with their fins and shining scales.\" Milton. 2. Splendid; illustrious; brilliant; distinguished; conspicious; as, a shining example of charity. 3. Having the surface smooth and polished; -- said of leaves, the surfaces of shells, etc. Syn. -- Glistening; bright; radiant; resplendent; effulgent; lustrous; brilliant; glittering; splendid; illustrious. -- Shining, Brilliant, Sparking. Shining describes the steady emission of a strong light, or the steady reflection of light from a clear or polished surface. Brilliant denotes a shining of great brightness, but with gleams or flashes. Sparkling implies a fitful, intense shining from radiant points or sparks, by which the eye is dazzled. The same distinctions obtain when these epithets are figuratively applied. A man of shining talents is made conspicious by possessing them; if they flash upon the mind with a peculiarly striking effect, we call them brilliant; if his brilliancy is marked by great vivacity and occasional intensity, he is sparkling. True paradise . . . inclosed with shining rock. Milton. Some in a brilliant buckle bind her waist, Some round her neck a circling light display. Gay. His sparkling blade about his head he blest. Spenser.\n\nEmission or reflection of light.
shiningness |Brightness. J. Spence.
shinney |The game of hockey; -- so called because of the liability of the players to receive blows on the shin. Halliwell.
shinplaster |Formerly, a jocose term for a bank note greatly depreciated in value; also, for paper money of a denomination less than a dollar. [U. S.]
shintiism |One of the two great systems of religious belief in Japan. Its essence is ancestor worship, and sacrifice to dead heroes. [Written also Sintu, and Sintuism.]
shintiyan |A kind of wide loose drawers or trousers worn by women in Mohammedan countries.
shinto |One of the two great systems of religious belief in Japan. Its essence is ancestor worship, and sacrifice to dead heroes. [Written also Sintu, and Sintuism.]
shintoist |An adherent of Shintoism.
shinty |A Scotch game resembling hockey; also, the club used in the game. Jamieson.
shintyan |A kind of wide loose drawers or trousers worn by women in Mohammedan countries.
shiny |Bright; luminous; clear; unclouded. Like distant thunder on a shiny day. Dryden.
ship |Pay; reward. [Obs.] In withholding or abridging of the ship or the hire or the wages of servants. Chaucer.\n\n1. Any large seagoing vessel. Like a stately ship . . . With all her bravery on, and tackle trim, Sails filled, and streamers waving. Milton. Thou, too, sail on, O Ship of State! Longfellow. 2. Specifically, a vessel furnished with a bowsprit and three masts (a mainmast, a foremast, and a mizzenmast), each of which is composed of a lower mast, a topmast, and a topgallant mast, and square-rigged on all masts. See Illustation in Appendix. l Port or Larboard Side; s Starboard Side; 1 Roundhouse or Deck House; 2 Tiller; 3 Grating; 4 Wheel; 5 Wheel Chains; 6 Binnacle; 7 Mizzenmast; 8 Skylight; 9 Capstan; 10 Mainmast; 11 Pumps; 12 Galley or Caboose; 13 Main Hatchway; 14 Windlass; 15 Foremast; 16 Fore Hatchway; 17 Bitts; 18 Bowsprit; 19 Head Rail; 20 Boomkins; 21 Catheads on Port Bow and Starboard Bow; 22 Fore Chains; 23 Main Chains; 24 Mizzen Chains; 25 Stern. 1 Fore Royal Stay; 2 Flying Jib Stay; 3 Fore Topgallant Stay;4 Jib Stay; 5 Fore Topmast Stays; 6 Fore Tacks; 8 Flying Martingale; 9 Martingale Stay, shackled to Dolphin Striker; 10 Jib Guys; 11 Jumper Guys; 12 Back Ropes; 13 Robstays; 14 Flying Jib Boom; 15 Flying Jib Footropes; 16 Jib Boom; 17 Jib Foottropes; 18 Bowsprit; 19 Fore Truck; 20 Fore Royal Mast; 21 Fore Royal Lift; 22 Fore Royal Yard; 23 Fore Royal Backstays; 24 Fore Royal Braces; 25 Fore Topgallant Mast and Rigging; 26 Fore Topgallant Lift; 27 Fore Topgallant Yard; 28 Fore Topgallant Backstays; 29 Fore Topgallant Braces; 30 Fore Topmast and Rigging; 31 Fore Topsail Lift; 32 Fore Topsail Yard; 33 Fore Topsail Footropes; 34 Fore Topsail Braces; 35 Fore Yard; 36 Fore Brace; 37 Fore Lift; 38 Fore Gaff; 39 Fore Trysail Vangs; 40 Fore Topmast Studding-sail Boom; 41 Foremast and Rigging; 42 Fore Topmast Backstays; 43 Fore Sheets; 44 Main Truck and Pennant; 45 Main Royal Mast and Backstay; 46 Main Royal Stay; 47 Main Royal Lift; 48 Main Royal Yard; 49 Main Royal Braces; 50 Main Topgallant Mast and Rigging; 51 Main Topgallant Lift; 52 Main Topgallant Backstays; 53 Main Topgallant Yard; 54 Main Topgallant Stay; 55 Main Topgallant Braces; 56 Main Topmast and Rigging; 57 Topsail Lift; 58 Topsail Yard; 59 Topsail Footropes; 60 Topsail Braces; 61 Topmast Stays; 62 Main Topgallant Studding-sail Boom; 63 Main Topmast Backstay; 64 Main Yard; 65 Main Footropes; 66 Mainmast and Rigging; 67 Main Lift; 68 Main Braces; 69 Main Tacks; 70 Main Sheets; 71 Main Trysail Gaff; 72 Main Trysail Vangs; 73 Main Stays; 74 Mizzen Truck; 75 Mizzen Royal Mast and Rigging; 76 Mizzen Royal Stay; 77 Mizzen Royal Lift; 78 Mizzen Royal Yard; 79 Mizzen Royal Braces; 80 Mizzen Topgallant Mast and Rigging; 81 Mizzen Topgallant Lift; 82 Mizzen Topgallant Backstays; 83 Mizzen Topgallant Braces; 84 Mizzen Topgallant Yard; 85 Mizzen Topgallant Stay; 86 Mizzen Topmast and Rigging; 87 Mizzen Topmast Stay; 88 Mizzen Topsail Lift; 89 Mizzen Topmast Backstays; 90 Mizzen Topsail Braces; 91 Mizzen Topsail Yard; 92 Mizzen Topsail Footropes; 93 Crossjack Yard; 94 Crossjack Footropes; 95 Crossjack Lift; 96 Crossjack Braces; 97 Mizzenmast and Rigging; 98 Mizzen Stay; 99 Spanker Gaff; 100 Peak Halyards; 101 Spanker Vangs; 102 Spanker Boom; 103 Spanker Boom Topping Lift; 104 Jacob's Ladder, or Stern Ladder; 105 Spanker Sheet; 106 Cutwater; 107 Starboard Bow; 108 Starboard Beam; 109 Water Line; 110 Starboard Quarter; 111 Rudder. 3. A dish or utensil (originally fashioned like the hull of a ship) used to hold incense. [Obs.] Tyndale. Armed ship, a private ship taken into the service of the government in time of war, and armed and equipped like a ship of war. [Eng.] Brande & C. -- General ship. See under General. -- Ship biscuit, hard biscuit prepared for use on shipboard; -- called also ship bread. See Hardtack. -- Ship boy, a boy who serves in a ship. \"Seal up the ship boy's eyes.\" Shak. -- Ship breaker, one who breaks up vessels when unfit for further use. -- Ship broker, a mercantile agent employed in buying and selling ships, procuring cargoes, etc., and generally in transacting the business of a ship or ships when in port. -- Ship canal, a canal suitable for the passage of seagoing vessels. -- Ship carpenter, a carpenter who works at shipbuilding; a shipwright. -- Ship chandler, one who deals in cordage, canvas, and other, furniture of vessels. -- Ship chandlery, the commodities in which a ship chandler deals; also, the business of a ship chandler. -- Ship fever (Med.), a form of typhus fever; -- called also putrid, jail, or hospital fever. -- Ship joiner, a joiner who works upon ships. -- Ship letter, a letter conveyed by a ship not a mail packet. -- Ship money (Eng. Hist.), an imposition formerly charged on the ports, towns, cities, boroughs, and counties, of England, for providing and furnishing certain ships for the king's service. The attempt made by Charles I. to revive and enforce this tax was resisted by John Hampden, and was one of the causes which led to the death of Charles. It was finally abolished. -- Ship of the line. See under Line. -- Ship pendulum, a pendulum hung amidships to show the extent of the rolling and pitching of a vessel. -- Ship railway. (a) An inclined railway with a cradelike car, by means of which a ship may be drawn out of water, as for repairs. (b) A railway arranged for the transportation of vessels overland between two water courses or harbors. -- Ship's company, the crew of a ship or other vessel. -- Ship's days, the days allowed a vessel for loading or unloading. -- Ship's husband. See under Husband. -- Ship's papers (Mar. Law), papers with which a vessel is required by law to be provided, and the production of which may be required on certain occasions. Among these papers are the register, passport or sea letter, charter party, bills of lading, invoice, log book, muster roll, bill of health, etc. Bouvier. Kent. -- To make ship, to embark in a ship or other vessel.\n\n1. To put on board of a ship, or vessel of any kind, for transportation; to send by water. The timber was . . . shipped in the bay of Attalia, from whence it was by sea transported to Pelusium. Knolles. 2. By extension, in commercial usage, to commit to any conveyance for transportation to a distance; as, to ship freight by railroad. 3. Hence, to send away; to get rid of. [Colloq.] 4. To engage or secure for service on board of a ship; as, to ship seamen. 5. To receive on board ship; as, to ship a sea. 6. To put in its place; as, to ship the tiller or rudder.\n\n1. To engage to serve on board of a vessel; as, to ship on a man-of- war. 2. To embark on a ship. Wyclif (Acts xxviii. 11)
ship railway |(a) An inclined railway running into the water with a cradelike car on which a vessel may be drawn out on land, as for repairs. (b) A railway on which to transport vessels overland between bodies of water.
ship-rigged |Rigged like a ship, that is, having three masts, each with square sails.
shipboard |A ship's side; hence, by extension, a ship; -- found chiefly in adverbial phrases; as, on shipboard; a shipboard.
shipbuilder |A person whose occupation is to construct ships and other vessels; a naval architect; a shipwright.
shipbuilding |Naval architecturel the art of constructing ships and other vessels.
shipful |As much or as many as a ship will hold; enough to fill a ship.
shipholder |A shipowner.
shipless |Destitute of ships. Gray.
shiplet |A little ship. [R.] Holinshed.
shipload |The load, or cargo, of a ship.
shipman |A seaman, or sailor. [Obs. or Poetic] Chaucer. R. Browning. About midnight the shipmen deemed that they drew near to some country. Acts xxvii. 27. Shipman's card, the mariner's compass. [Obs.] Shak.
shipmaster |The captain, master, or commander of a ship. Jonah i. 6.
shipmate |One who serves on board of the same ship with another; a fellow sailor.
shipment |1. The act or process of shipping; as, he was engaged in the shipment of coal for London; an active shipment of wheat from the West. 2. That which is shipped. The question is, whether the share of M. in the shipment is exempted from condemnation by reason of his neutral domicle. Story.
shipowner |Owner of a ship or ships.
shippen |A stable; a cowhouse. [Obs. or Prov.Eng.]
shipper |One who sends goods from one place to another not in the same city or town, esp. one who sends goods by water.
shipping |1. Relating to ships, their ownership, transfer, or employment; as, shiping concerns. 2. Relating to, or concerned in, the forwarding of goods; as, a shipping clerk.\n\n1. The act of one who, or of that which, ships; as, the shipping of flour to Liverpool. 2. The collective body of ships in one place, or belonging to one port, country, etc.; vessels, generally; tonnage. 3. Navigation. \"God send 'em good shipping.\" Shak. Shipping articles, articles of agreement between the captain of a vessel and the seamen on board, in respect to the amount of wages, length of time for which they are shipping, etc. Bouvier. -- To take shipping, to embark; to take ship. [Obs.] John vi.24. Shak.
shipping note |A document used in shipping goods by sea. In the case of free goods the shipping notes are the receiving note, addressed by the shipper to the chief officer of the vessel, requesting him to receive on board specified goods, and a receipt for the mate to sign, on receiving whose signature it is called the mate's receipt, and is surrendered by the shipper for the bills of lading.
shippo |Cloisonné enamel on a background of metal or porcelain.
shippon |A cowhouse; a shippen. [Prov. Eng.] Bessy would either do fieldwork, or attend to the cows, the shippon, or churn, or make cheese. Dickens.
shipshape |Arranged in a manner befitting a ship; hence, trim; tidy; orderly. Even then she expressed her scorn for the lubbery executioner's mode of tying a knot, and did it herself in a shipshape orthodox manner. De Quincey. Keep everything shipshape, for I must go Tennyson.\n\nIn a shipshape or seamanlike manner.
shipworm |Any long, slender, worm-shaped bivalve mollusk of Teredo and allied genera. The shipworms burrow in wood, and are destructive to wooden ships, piles of wharves, etc. See Teredo.
shipwreck |1. The breaking in pieces, or shattering, of a ship or other vessel by being cast ashore or driven against rocks, shoals, etc., by the violence of the winds and waves. 2. A ship wrecked or destroyed upon the water, or the parts of such a ship; wreckage. Dryden. 3. Fig.: Destruction; ruin; irretrievable loss. Holding faith and a good conscience, which some having put away concerning faith have made shipwreck. 1 Tim. 1. 19. It was upon an Indian bill that the late ministry had made shipwreck. J. Morley.\n\n1. To destroy, as a ship at sea, by running ashore or on rocks or sandbanks, or by the force of wind and waves in a tempest. Shipwrecking storms and direful thunders break. Shak. 2. To cause to experience shipwreck, as sailors or passengers. Hence, to cause to suffer some disaster or loss; to destroy or ruin, as if by shipwreck; to wreck; as, to shipwreck a business. Addison.
shipwright |One whose occupation is to construct ships; a builder of ships or other vessels.
shipyard |A yard, place, or inclosure where ships are built or repaired.
shiraz |A kind of Persian wine; -- so called from the place whence it is brought.
shire |1. A portion of Great Britain originally under the supervision of an earl; a territorial division, usually identical with a county, but sometimes limited to a smaller district; as, Wiltshire, Yorkshire, Richmondshire, Hallamshire. An indefinite number of these hundreds make up a county or shire. Blackstone. 2. A division of a State, embracing several contiguous townships; a county. [U. S.] Note: Shire is commonly added to the specific designation of a county as a part of its name; as, Yorkshire instead of York shire, or the shire of York; Berkshire instead of Berks shire. Such expressions as the county of Yorkshire, which in a strict sense are tautological, are used in England. In the United States the composite word is sometimes the only name of a county; as, Berkshire county, as it is called in Massachusetts, instead of Berks county, as in Pensylvania. The Tyne, Tees, Humber, Wash, Yare, Stour, and Thames separate the counties of Northumberland, Durham, Yorkshire, Lincolnshire, etc. Encyc. Brit. Knight of the shire. See under Knight. -- Shire clerk, an officer of a county court; also, an under sheriff. [Eng.] -- Shire mote (Old. Eng. Law), the county court; sheriff's turn, or court. [Obs.] Cowell. Blackstone. -- Shire reeve (Old Eng. Law), the reeve, or bailiff, of a shire; a sheriff. Burrill. -- Shire town, the capital town of a county; a county town. -- Shire wick, a county; a shire. [Obs.] Holland.
shire horse |One of an English breed of heavy draft horses believed to be descended largely from the horses used in war in the days of heavy armor. They are the  largest of the British draft breeds, and have long hair on the back of the cannons and fetlocks. Brown or bay with white on the face and legs is now the commonest color.
shirk |1. To procure by petty fraud and trickery; to obtain by mean solicitation. You that never heard the call of any vocation, . . . that shirk living from others, but time from Yourselves. Bp. Rainbow. 2. To avoid; to escape; to neglect; -- implying unfaithfulness or fraud; as, to shirk duty. The usual makeshift by which they try to shirk difficulties. Hare.\n\n1. To live by shifts and fraud; to shark. 2. To evade an obligation; to avoid the performance of duty, as by running away. One of the cities shirked from the league. Byron.\n\nOne who lives by shifts and tricks; one who avoids the performance of duty or labor.
shirker |One who shirks. Macaulay.
shirky |Disposed to shirk. [Colloq.]
shirl |Shrill. [Prov. Eng.] Halliwell.\n\nSee Schorl.
shirley |The bullfinch.
shirr |A series of close parallel runnings which are drawn up so as to make the material between them set full by gatherings; -- called also shirring, and gauging.
shirred |1. (Sewing)  Made or gathered into a shirr; as, a shirred bonnet. 2. (Cookery)  Broken into an earthen dish and baked over the fire; -- said of eggs.
shirt |A loose under-garment for the upper part of the body, made of cotton, linen, or other material; -- formerly used of the under- garment of either sex, now commonly restricted to that worn by men and boys. Several persons in December had nothing over their shoulders but their shirts. Addison. She had her shirts and girdles of hair. Bp. Fisher.\n\nTo cover or clothe with a shirt, or as with a shirt. Dryden.
shirt waist |A belted waist resembling a shirt in plainness of cut and style, worn by women or children; -- in England called a blouse.
shirt-waist suit |A costume consisting of a plain belted waist and skirt of the same material.
shirting |Cloth, specifically cotton cloth, suitable for making shirts.
shirtless |Not having or wearing a shirt. Pope. -- Shirt\"less*ness, n.
shist |See Shist, Schistose.
shistose |See Shist, Schistose.
shittah |A tree that furnished the precious wood of which the ark, tables, altars, boards, etc., of the Jewish tabernacle were made; -- now believed to have been the wood of the Acacia Seyal, which is hard, fine grained, and yellowish brown in color.
shittah tree |A tree that furnished the precious wood of which the ark, tables, altars, boards, etc., of the Jewish tabernacle were made; -- now believed to have been the wood of the Acacia Seyal, which is hard, fine grained, and yellowish brown in color.
shittim |The wood of the shittah tree.
shittim wood |The wood of the shittah tree.
shittle |A shuttle. [Obs.] Chapman.\n\nWavering; unsettled; inconstant. [Obs.] Holland.
shittlecock |A shuttlecock. [Obs.]
shittleness |Instability; inconstancy. [Obs.] The vain shittlenesse of an unconstant head. Baret.
shive |1. A slice; as, a shive of bread. [Obs. or Prov. Eng.] Shak. 2. A thin piece or fragment; specifically, one of the scales or pieces of the woody part of flax removed by the operation of breaking. 3. A thin, flat cork used for stopping a wide-mouthed bottle; also, a thin wooden bung for casks.
shiver |1. One of the small pieces, or splinters, into which a brittle thing is broken by sudden violence; -- generally used in the plural. \"All to shivers dashed.\" Milton. 2. A thin slice; a shive. [Obs. or Prov. Eng.] \"A shiver of their own loaf.\" Fuller. Of your soft bread, not but a shiver. Chaucer. 3. (Geol.)  A variety of blue slate. 4. (Naut.)  A sheave or small wheel in a pulley. 5. A small wedge, as for fastening the bolt of a window shutter. 6. A spindle. [Obs. or Prov. Eng.]\n\nTo break into many small pieces, or splinters; to shatter; to dash to pieces by a blow; as, to shiver a glass goblet. All the ground With shivered armor strown. Milton.\n\nTo separate suddenly into many small pieces or parts; to be shattered. There shiver shafts upon shields thick. Chaucer The natural world, should gravity once cease, . . . would instantly shiver into millions of atoms. Woodward.\n\nTo tremble; to vibrate; to quiver; to shake, as from cold or fear. Prometheus is laid On icy Caucasus to shiver. Swift. The man that shivered on the brink of sin, Thus steeled and hardened, ventures boldly in. Creech.\n\nTo cause to shake or tremble, as a sail, by steering close to the wind.\n\nThe act of shivering or trembling.
shiver-spar |A variety of calcite, so called from its slaty structure; -- called also slate spar.
shiveringly |In a shivering manner.
shivery |1. Tremulous; shivering. Mallet. 2. Easily broken; brittle; shattery.
shizoku |The Japanese warrior gentry or middle class, formerly called samurai; also, any member of this class.
shoad |A train of vein material mixed with rubbish; fragments of ore which have become separated by the action of water or the weather, and serve to direct in the discovery of mines. [Written also shode.]
shoading |The tracing of veins of metal by shoads. [Written also shoding.] Pryce.
shoal |A great multitude assembled; a crowd; a throng; -- said especially of fish; as, a shoal of bass. \"Great shoals of people.\" Bacon. Beneath, a shoal of silver fishes glides. Waller.\n\nTo assemble in a multitude; to throng; as, the fishes shoaled about the place. Chapman.\n\nHaving little depth; shallow; as, shoal water.\n\n1. A place where the water of a sea, lake, river, pond, etc., is shallow; a shallow. The depth of your pond should be six feet; and on the sides some shoals for the fish to lay their span. Mortimer. Wolsey, that once trod the ways of glory, And sounded all the depths and shoals of honor. Shak. 2. A sandbank or bar which makes the water shoal. The god himself with ready trident stands, And opes the deep, and spreads the moving sands, Then heaves them off the shoals. Dryden.\n\nTo become shallow; as, the color of the water shows where it shoals.\n\nTo cause to become more shallow; to come to a more shallow part of; as, a ship shoals her water by advancing into that which is less deep. Marryat.
shoaliness |The quality or state of being shoaly; little depth of water; shallowness.
shoaling |Becoming shallow gradually. \"A shoaling estuary.\" Lyell.
shoaly |Full of shoals, or shallow places. The tossing vessel sailed on shoaly ground. Dryden.
shoar |A prop. See 3d Shore.
shoat |A young hog. Same as Shote.
shock |1. A pile or assemblage of sheaves of grain, as wheat, rye, or the like, set up in a field, the sheaves varying in number from twelve to sixteen; a stook. And cause it on shocks to be by and by set. Tusser. Behind the master walks, builds up the shocks. Thomson. 2. Etym: [G. schock.] (Com.)  A lot consisting of sixty pieces; -- a term applied in some Baltic ports to loose goods.\n\nTo collect, or make up, into a shock or shocks; to stook; as, to shock rye.\n\nTo be occupied with making shocks. Reap well, scatter not, gather clean that is shorn, Bind fast, shock apace. Tusser.\n\n1. A quivering or shaking which is the effect of a blow, collision, or violent impulse; a blow, impact, or collision; a concussion; a sudden violent impulse or onset. These strong, unshaken mounds resist the shocks Of tides and seas tempestuous. Blackmore. He stood the shock of a whole host of foes. Addison. 2. A sudden agitation of the mind or feelings; a sensation of pleasure or pain caused by something unexpected or overpowering; also, a sudden agitating or overpowering event. \"A shock of pleasure.\" Talfourd. 3. (Med.)  A sudden depression of the vital forces of the entire body, or of a port of it, marking some profound impression produced upon the nervous system, as by severe injury, overpowering emotion, or the like. 4. (Elec.)  The sudden convulsion or contraction of the muscles, with the feeling of a concussion, caused by the discharge, through the animal system, of electricity from a charged body. Syn. -- Concussion, Shock. Both words signify a sudden violent shaking caused by impact or colision; but concussion is restricted in use to matter, while shock is used also of mental states.\n\n1. To give a shock to; to cause to shake or waver; hence, to strike against suddenly; to encounter with violence. Come the three corners of the world in arms, And we shall shock them. Shak. A shall never forget the force with which he shocked De Vipont. Sir W. Scott. 2. To strike with surprise, terror, horror, or disgust; to cause to recoil; as, his violence shocked his associates. Advise him not to shock a father's will. Dryden.\n\nTo meet with a shock; to meet in violent encounter. \"They saw the moment approach when the two parties would shock together.\" De Quincey.\n\n1. (Zoöl.)  A dog with long hair or shag; -- called also shockdog. 2. A thick mass of bushy hair; as, a head covered with a shock of sandy hair.\n\nBushy; shaggy; as, a shock hair. His red shock peruke . . . was laid aside. Sir W. Scott.
shock-head |Shock-headed. Tennyson.
shock-headed |Having a thick and bushy head of hair.
shockdog |See 7th Shock, 1.
shocking |Causing to shake or tremble, as by a blow; especially, causing to recoil with horror or disgust; extremely offensive or disgusting. The grossest and most shocking villainies. Secker. -- Shock\"ing*ly, adv. -- Shock\"ing*ness, n.
shod |f Shoe.
shoddy |1. A fibrous material obtained by \"deviling,\" or tearing into fibers, refuse woolen goods, old stockings, rags, druggets, etc. See Mungo. 2. A fabric of inferior quality made of, or containing a large amount of, shoddy. Note: The great quantity of shoddy goods furnished as army supplies in the late Civil War in the United States gave wide currency to the word, and it came to be applied to persons who pretend to a higher position in society than that to which their breeding or worth entitles them.\n\nMade wholly or in part of shoddy; containing shoddy; as, shoddy cloth; shoddy blankets; hence, colloquially, not genuine; sham; pretentious; as, shoddy aristocracy. Shoddy inventions designed to bolster up a factitious pride. Compton Reade.
shoddy fever |A febrile disease characterized by dyspnoa and bronchitis caused by inhaling dust.
shoddyism |The quality or state of being shoddy. [Colloq.] See the Note under Shoddy, n.
shode |1. The parting of the hair on the head. [Obs.] Full straight and even lay his jolly shode. Chaucer. 2. The top of the head; the head. [Obs.] Chaucer.\n\nSee Shoad, Shoading.
shoder |A package of gold beater's skins in which gold is subjected to the second process of beating.
shoding |See Shoad, Shoading.
shoe |1. A covering for the human foot, usually made of leather, having a thick and somewhat stiff sole and a lighter top. It differs from a boot on not extending so far up the leg. Your hose should be ungartered, . . . yourshoe untied. Shak. Spare none but such as go in clouted shoon. Shak. 2. Anything resembling a shoe in form, position, or use. Specifically: (a) A plate or rim of iron nailed to the hoof of an animal to defend it from injury. (b) A band of iron or steel, or a ship of wood, fastened to the bottom of the runner of a sleigh, or any vehicle which slides on the snow. (c) A drag, or sliding piece of wood or iron, placed under the wheel of a loaded vehicle, to retard its motion in going down a hill. (d) The part of a railroad car brake which presses upon the wheel to retard its motion. (e) (Arch.) A trough-shaped or spout-shaped member, put at the bottom of the water leader coming from the eaves gutter, so as to throw the water off from the building. (f) (Milling.) The trough or spout for conveying the grain from the hopper to the eye of the millstone. (g) An inclined trough in an ore-crushing mill. (h) An iron socket or plate to take the thrust of a strut or rafter. (i) An iron socket to protect the point of a wooden pile. (j) (Mach.) A plate, or notched piece, interposed between a moving part and the stationary part on which it bears, to take the wear and afford means of adjustment; -- called also slipper, and gib. Note: Shoe is often used adjectively, or in composition; as, shoe buckle, or shoe-buckle; shoe latchet, or shoe-latchet; shoe leathet, or shoe-leather; shoe string, shoe-string, or shoestring. Shoe of an anchor. (Naut.) (a) A small block of wood, convex on the back, with a hole to receive the point of the anchor fluke, -- used to prevent the anchor from tearing the planks of the vessel when raised or lowered. (b) A broad, triangular piece of plank placed upon the fluke to give it a better hold in soft ground. -- Shoe block (Naut.), a block with two sheaves, one above the other, and at right angles to each other. -- Shoe bolt, a bolt with a flaring head, for fastening shoes on sleigh runners. -- Shoe pac, a kind of moccasin. See Pac. -- Shoe stone, a sharpening stone used by shoemakers and other workers in leather.\n\n1. To furnish with a shoe or shoes; to put a shoe or shoes on; as, to shoe a horse, a sled, an anchor. 2. To protect or ornament with something which serves the purpose of a shoe; to tip. The sharp and small end of the billiard stick, which is shod with brass or silver. Evelyn.
shoebill |A large African wading bird (Balæniceps rex) allied to the storks and herons, and remarkable for its enormous broad swollen bill. It inhabits the valley of the White Nile. See Illust. (l.) of Beak.
shoeblack |One who polishes shoes.
shoefly |1. (Railroading) A contrivance for throwing the track temporarily to one side for  convenience in filling washouts or effecting other repairs. [Cant, U. S.] 2.  (Print.) In some cylinder presses, a device with long fingers for freeing the sheet from the cylinder.
shoehorn |1. A curved piece of polished horn, wood, or metal used to facilitate the entrance of the foot into a shoe. 2. Figuratively: (a) Anything by which a transaction is facilitated; a medium; -- by way of contempt. Spectator. (b) Anything which draws on or allures; an inducement. [Low] Beau & Fl.
shoeing-horn |1. A curved piece of polished horn, wood, or metal used to facilitate the entrance of the foot into a shoe. 2. Figuratively: (a) Anything by which a transaction is facilitated; a medium; -- by way of contempt. Spectator. (b) Anything which draws on or allures; an inducement. [Low] Beau & Fl.
shoeless |Destitute of shoes. Addison.
shoemaker |1. One whose occupation it is to make shoes and boots. 2. (Zoöl.) (a) The threadfish. (b) The runner, 12.
shoemaking |The business of a shoemaker.
shoer |One who fits shoes to the feet; one who furnishes or puts on shoes; as, a shoer of horses.
shog |A shock; a jog; a violent concussion or impulse. [R. or Scot.]\n\nTo shake; to shock. [R. or Scot.]\n\nTo jog; to move on. [R. or Scot.] Beau & Fl.
shoggle |To joggle. [Obs. or Prov. Eng. & Scot.] Pegge.
shogun |A title originally conferred by the Mikado on the military governor of the eastern provinces of Japan. By gradual usurpation of power the Shoguns (known to foreigners as Tycoons) became finally the virtual rulers of Japan. The title was abolished in 1867. [Written variously, Shiogun, Shiogoon, etc.]
shogunate |The office or dignity of a Shogun. [Written also Siogoonate.]
shola |See Sola.
shole |A plank fixed beneath an object, as beneath the rudder of a vessel, to protect it from injury; a plank on the ground under the end of a shore or the like.\n\nSee Shoal. [Obs.]
shonde |Harm; disgrace; shame. [Obs.] Chaucer.
shone |imp. & p. p. of Shine.
shoo |Begone; away; -- an expression used in frightening away animals, especially fowls.
shooi |The Richardson's skua (Stercorarius parasiticus);- so called from its cry. [Prov. Eng.]
shook |imp. & obs. or poet. p. p. of Shake.\n\n(a) A set of staves and headings sufficient in number for one hogshead, cask, barrel, or the like, trimmed, and bound together in compact form. (b) A set of boards for a sugar box. (c) The parts of a piece of house furniture, as a bedstead, packed together.\n\nTo pack, as staves, in a shook.
shoon |pl. of Shoe. [Archaic] Chaucer. They shook the snow from hats and shoon. Emerson.
shoop |imp. of Shape. Shaped. Chaucer.
shoot |An inclined plane, either artificial or natural, down which timber, coal, etc., are caused to slide; also, a narrow passage, either natural or artificial, in a stream, where the water rushes rapidly; esp., a channel, having a swift current, connecting the ends of a bend in the stream, so as to shorten the course. [Written also chute, and shute.] [U. S.] To take a shoot, to pass through a shoot instead of the main channel; to take the most direct course. [U.S.]\n\n1. To let fly, or cause to be driven, with force, as an arrow or a bullet; -- followed by a word denoting the missile, as an object. If you please To shoot an arrow that self way. Shak. 2. To discharge, causing a missile to be driven forth; -- followed by a word denoting the weapon or instrument, as an object; -- often with off; as, to shoot a gun. The two ends od a bow, shot off, fly from one another. Boyle. 3. To strike with anything shot; to hit with a missile; often, to kill or wound with a firearm; -- followed by a word denoting the person or thing hit, as an object. When Roger shot the hawk hovering over his master's dove house. A. Tucker. 4. To send out or forth, especially with a rapid or sudden motion; to cast with the hand; to hurl; to discharge; to emit. An honest weaver as ever shot shuttle. Beau & Fl. A pit into which the dead carts had nightly shot corpses by scores. Macaulay. 5. To push or thrust forward; to project; to protrude; -- often with out; as, a plant shoots out a bud. They shoot out the lip, they shake the head. Ps. xxii. 7. Beware the secret snake that shoots a sting. Dryden. 6. (Carp.)  To plane straight; to fit by planing. Two pieces of wood that are shot, that is, planed or else pared with a paring chisel. Moxon. 7. To pass rapidly through, over, or under; as, to shoot a rapid or a bridge; to shoot a sand bar. She . . . shoots the Stygian sound. Dryden. 8. To variegate as if by sprinkling or intermingling; to color in spots or patches. The tangled water courses slept, Shot over with purple, and green, and yellow. Tennyson. To be shot of, to be discharged, cleared, or rid of. [Colloq.] \"Are you not glad to be shot of him\" Sir W. Scott.\n\n1. To cause an engine or weapon to discharge a missile; -- said of a person or an agent; as, they shot at a target; he shoots better than he rides. The archers have . . . shot at him. Gen. xlix. 23. 2. To discharge a missile; -- said of an engine or instrument; as, the gun shoots well. 3. To be shot or propelled forcibly; -- said of a missile; to be emitted or driven; to move or extend swiftly, as if propelled; as, a shooting star. There shot a streaming lamp along the sky. Dryden. 4. To penetrate, as a missile; to dart with a piercing sensation; as, shooting pains. Thy words shoot through my heart. Addison. 5. To feel a quick, darting pain; to throb in pain. These preachers make His head to shoot and ache. Herbert. 6. To germinate; to bud; to sprout. Onions, as they hang, will shoot forth. Bacon. But the wild olive shoots, and shades the ungrateful plain. Dryden. 7. To grow; to advance; as, to shoot up rapidly. Well shot in years he seemed. Spenser. Delightful task! to rear the tender thought, To teach the young idea how to shoot. Thomson. 8. To change form suddenly; especially, to solidify. If the menstruum be overcharged, metals will shoot into crystals. Bacon. 9. To protrude; to jut; to project; to extend; as, the land shoots into a promontory. There shot up against the dark sky, tall, gaunt, straggling houses. Dickens. 10. (Naut.)  To move ahead by force of momentum, as a sailing vessel when the helm is put hard alee. To shoot ahead, to pass or move quickly forward; to outstrip others.\n\n1. The act of shooting; the discharge of a missile; a shot; as, the shoot of a shuttle. The Turkish bow giveth a very forcible shoot. Bacon. One underneath his horse to get a shoot doth stalk. Drayton. 2. A young branch or growth. Superfluous branches and shoots of this second spring. Evelyn. 3. A rush of water; a rapid. 4. (Min.)  A vein of ore running in the same general direction as the lode. Knight. 5. (Weaving)  A weft thread shot through the shed by the shuttle; a pick. 6. Etym: [Perh. a different word.]  A shoat; a young hog.
shooter |1. One who shoots, as an archer or a gunner. 2. That which shoots. Specifically: (a) A firearm; as, a five-shooter. [Colloq. U.S.] (b) A shooting star. [R.]
shooting |1. The act of one who, or that which, shoots; as, the shooting of an archery club; the shooting of rays of light. 2. A wounding or killing with a firearm; specifically (Sporting), the killing of game; as, a week of shooting. 3. A sensation of darting pain; as, a shooting in one's head.\n\nOf or pertaining to shooting; for shooting; darting. Shooting board (Joinery), a fixture used in planing or shooting the edge of a board, by means of which the plane is guided and the board held true. -- Shooting box, a small house in the country for use in the shooting season. Prof. Wilson. -- Shooting gallery, a range, usually covered, with targets for practice with firearms. -- Shooting iron, a firearm. [Slang, U.S.] -- Shooting star. (a) (Astron.) A starlike, luminous meteor, that, appearing suddenly, darts quickly across some portion of the sky, and then as suddenly disappears, leaving sometimes, for a few seconds, a luminous train, - - called also falling star. Shooting stars are small cosmical bodies which encounter the earth in its annual revolution, and which become visible by coming with planetary velocity into the upper regions of the atmosphere. At certain periods, as on the 13th of November and 10th of August, they appear for a few hours in great numbers, apparently diverging from some point in the heavens, such displays being known as meteoric showers, or star showers. These bodies, before encountering the earth, were moving in orbits closely allied to the orbits of comets. See Leonids, Perseids. (b) (Bot.) The American cowslip (Dodecatheon Meadia). See under Cowslip. -- Shooting stick (Print.), a tapering piece of wood or iron, used by printers to drive up the quoins in the chase. Hansard.
shooty |Sprouting or coming up freely and regularly. [Prev. Eng.] Grose.
shop |imp. of Shape. Shaped. Chaucer.\n\n1. A building or an apartment in which goods, wares, drugs, etc., are sold by retail. From shop to shop Wandering, and littering with unfolded silks The polished counter. Cowper. 2. A building in which mechanics or artisans work; as, a shoe shop; a car shop. A tailor called me in his shop. Shak. Note: Shop is often used adjectively or in composition; as, shop rent, or shop-rent; shop thief, or shop-thief; shop window, or shop- window, etc. To smell of the shop, to indicate too distinctively one's occupation or profession. -- To talk shop, to make one's business the topic of social conversation; also, to use the phrases peculiar to one's employment. [Colloq.] Syn. -- Store; warehouse. See Store.\n\nTo visit shops for the purpose of purchasing goods. He was engaged with his mother and some ladies to go shopping. Byron.
shopboard |A bench or board on which work is performed; a workbench. South.
shopbook |A book in which a tradesman keeps his accounts. Locke.
shopboy |A boy employed in a shop.
shopen |p. p. of Shape. Chaucer.
shopgirl |A girl employed in a shop.
shopkeeper |A trader who sells goods in a shop, or by retail; -- in distinction from one who sells by wholesale. Addison.
shoplifter |One who steals anything in a shop, or takes goods privately from a shop; one who, under pretense of buying goods, takes occasion to steal.
shoplifting |Larceny committed in a shop; the stealing of anything from a shop.
shoplike |Suiting a shop; vulgar. B. Jonson.
shopmaid |A shopgirl.
shopman |1. A shopkeeper; a retailer. Dryden. 2. One who serves in a shop; a salesman. 3. One who works in a shop or a factory.
shopper |One who shops.
shoppish |Having the appearance or qualities of a shopkeeper, or shopman.
shoppy |1. Abounding with shops. [Colloq.] 2. Of or pertaining to shops, or one's own shop or business; as, shoppy talk. [Colloq.] Mrs. Gaskell.
shopshift |The trick of a shopkeeper; deception. [Obs.] B. Jonson.
shopwalker |One who walks about in a shop as an overseer and director. Cf. Floorwalker.
shopwoman |A woman employed in a shop.
shopworn |Somewhat worn or damaged by having been kept for a time in a shop.
shorage |Duty paid for goods brought on shore. Grabb.
shore |imp. of Shear. Chaucer.\n\nA sewer. [Obs. or Prov. Eng.]\n\nA prop, as a timber, placed as a brace or support against the side of a building or other structure; a prop placed beneath anything, as a beam, to prevent it from sinking or sagging. [Written also shoar.]\n\nTo support by a shore or shores; to prop; -- usually with up; as, to shore up a building.\n\nThe coast or land adjacent to a large body of water, as an ocean, lake, or large river. Michael Cassio, Lieutenant to the warlike Moor Othello, Is come shore. Shak. The fruitful shore of muddy Nile. Spenser. In shore, near the shore. Marryat. -- On shore. See under On. -- Shore birds (Zoöl.), a collective name for the various limicoline birds found on the seashore. -- Shore crab (Zoöl.), any crab found on the beaches, or between tides, especially any one of various species of grapsoid crabs, as Heterograpsus nudus of California. -- Shore lark (Zoöl.), a small American lark (Otocoris alpestris) found in winter, both on the seacoast and on the Western plains. Its upper parts are varied with dark brown and light brown. It has a yellow throat, yellow local streaks, a black crescent on its breast, a black streak below each eye, and two small black erectile ear tufts. Called also horned lark. -- Shore plover (Zoöl.), a large-billed Australian plover (Esacus magnirostris). It lives on the seashore, and feeds on crustaceans, etc. -- Shore teetan (Zoöl.), the rock pipit (Anthus obscurus). [Prov. Eng.]\n\nTo set on shore. [Obs.] Shak.
shoreless |Having no shore or coast; of indefinite or unlimited extent; as, a shoreless ocean. Young.
shoreling |See Shorling.
shorer |One who, or that which, shores or props; a prop; a shore.
shoreward |Toward the shore.
shoring |1. The act of supporting or strengthening with a prop or shore. 2. A system of props; props, collectively.
shorl |See Schorl, Schorlaceous.
shorlaceous |See Schorl, Schorlaceous.
shorling |1. The skin of a sheen after the fleece is shorn off, as distinct from the morling, or skin taken from the dead sheep; also, a sheep of the first year's shearing. [Prov. Eng.] 2. A person who is shorn; a shaveling; hence, in contempt, a priest. [Obs.] Halliwell.
shorn |p. p. of Shear.
short |1. Not long; having brief length or linear extension; as, a short distance; a short piece of timber; a short flight. The bed is shorter than that a man can stretch himself on it. Isa. xxviii. 20. 2. Not extended in time; having very limited duration; not protracted; as, short breath. The life so short, the craft so long to learn. Chaucer. To short absense I could yield. Milton. 3. Limited in quantity; inadequate; insufficient; scanty; as, a short supply of provisions, or of water. 4. Insufficiently provided; inadequately supplied; scantily furnished; lacking; not coming up to a resonable, or the ordinary, standard; -- usually with of; as, to be short of money. We shall be short in our provision. Shak. 5. Deficient; defective; imperfect; not coming up, as to a measure or standard; as, an account which is short of the trith. 6. Not distant in time; near at hand. Marinell was sore offended That his departure thence should be so short. Spenser. He commanded those who were appointed to attend him to be ready by a short day. Clarendon. 7. Limited in intellectual power or grasp; not comprehensive; narrow; not tenacious, as memory. Their own short understandings reach No farther than the present. Rowe. 8. Less important, efficaceous, or powerful; not equal or equivalent; less (than); -- with of. Hardly anything short of an invasion could rouse them again to war. Landor. 9. Abrupt; brief; pointed; petulant; as, he gave a short answer to the question. 10. (Cookery)  Breaking or crumbling readily in the mouth; crisp; as, short pastry. 11. (Metal)  Brittle. Note: Metals that are brittle when hot are called ; as, cast iron may be hot-short, owing to the presence of sulphur. Those that are brittle when cold are called cold-short; as, cast iron may be cold- short, on account of the presence of phosphorus. 12. (Stock Exchange)  Engaging or engaged to deliver what is not possessed; as, short contracts; to be short of stock. See The shorts, under Short, n., and To sell short, under Short, adv. Note: In mercantile transactions, a note or bill is sometimes made payable at short sight, that is, in a little time after being presented to the payer. 13. (Phon.)  Not prolonged, or relatively less prolonged, in utterance; -- opposed to long, and applied to vowels or to syllables. In English, the long and short of the same letter are not, in most cases, the long and short of the same sound; thus, the i in ill is the short sound, not of i in isle, but of ee in eel, and the e in pet is the short sound of a in pate, etc. See Quantity, and Guide to Pronunciation, §§22, 30. Note: Short is much used with participles to form numerous self- explaining compounds; as, short-armed, short-billed, short-fingered, short-haired, short-necked, short-sleeved, short-tailed, short- winged, short-wooled, etc. At short notice, in a brief time; promptly. -- Short rib (Anat.), one of the false ribs. -- Short suit (Whist), any suit having only three cards, or less than three. R. A. Proctor. -- To come short, To cut short, To fall short, etc. See under Come, Cut, etc.\n\n1. A summary account. The short and the long is, our play is preferred. Shak. 2. pl.  The part of milled grain sifted out which is next finer than the bran. The first remove above bran is shorts. Halliwell. 3. pl.  Short, inferior hemp. 4. pl.  Breeches; shortclothes. [Slang] Dickens. 5. (Phonetics)  A short sound, syllable, or vowel. If we compare the nearest conventional shorts and longs in English, as in \"bit\" and \"beat,\" \"not\" and \"naught,\" we find that the short vowels are generally wide, the long narrow, besides being generally diphthongic as well. Hence, originally short vowels can be lengthened and yet kept quite distinct from the original longs. H. Sweet. In short, in few words; in brief; briefly. -- The long and the short, the whole; a brief summing up. -- The shorts (Stock Exchange), those who are unsupplied with stocks which they contracted to deliver.\n\nIn a short manner; briefly; limitedly; abruptly; quickly; as, to stop short in one's course; to turn short. He was taken up very short, and adjudged corrigible for such presumptuous language. Howell. To sell short (Stock Exchange), to sell, for future delivery, what the party selling does not own, but hopes to buy at a lower rate.\n\nTo shorten. [Obs.]\n\nTo fail; to decrease. [Obs.]
short circuit |A circuit formed or closed by a conductor of relatively low resistance because shorter or of relatively great conductivity.
short-breathed |1. Having short-breath, or quick respiration. 2. Having short life.
short-circuit |To join, as the electrodes of a battery or dynamo or any two points of a circuit, by a conductor of low resistance.
short-dated |Having little time to run from the date. \"Thy short-dated life.\" Sandys.
short-handed |Short of, or lacking the regular number of, servants or helpers.
short-jointed |Having short intervals between the joints; -- said of a plant or an animal, especially of a horse whose pastern is too short.
short-lived |Not living or lasting long; being of short continuance; as, a short-lived race of beings; short-lived pleasure; short-lived passion.
short-spoken |Speaking in a quick or short manner; hence, gruff; curt. [Colloq.]
short-waisted |Having a short waist.
short-winded |Affected with shortness of breath; having a quick, difficult respiration, as dyspnoic and asthmatic persons. May.
short-wited |Having little wit; not wise; having scanty intellect or judgment.
shortage |Amount or extent of deficiency, as determined by some requirement or standard; as, a shortage in money accounts.
shortcake |An unsweetened breakfast cake shortened with butter or lard, rolled thin, and baked.
shortclothes |Coverings for the legs of men or boys, consisting of trousers which reach only to the knees, -- worn with long stockings.
shortcoming |The act of falling, or coming short; as: (a) The failure of a crop, or the like. (b) Neglect of, or failure in, performance of duty.
shorten |1. To make short or shorter in measure, extent, or time; as, to shorten distance; to shorten a road; to shorten days of calamity. 2. To reduce or diminish in amount, quantity, or extent; to lessen; to abridge; to curtail; to contract; as, to shorten work, an allowance of food, etc. Here, where the subject is so fruitful, I am shortened by my chain. Dryden. 3. To make deficient (as to); to deprive; -- with of. Spoiled of his nose, and shortened of his ears. Dryden. 4. To make short or friable, as pastry, with butter, lard, pot liquor, or the like. To shorten a rope (Naut.), to take in the slack of it. -- To shorten sail (Naut.), to reduce sail by taking it in.\n\nTo become short or shorter; as, the day shortens in northern latitudes from June to December; a metallic rod shortens by cold.
shortener |One who, or that which, shortens.
shortening |1. The act of making or becoming short or shorter. 2. (Cookery)  That which renders pastry short or friable, as butter, lard, etc.
shorthand |A compendious and rapid method or writing by substituting characters, abbreviations, or symbols, for letters, words, etc.; short writing; stenography. See Illust. under Phonography.
shorthead |A sucking whale less than one year old; -- so called by sailors.
shorthorn |One of a breed of large, heavy domestic cattle having short horns. The breed was developed in England.
shortly |1. In a short or brief time or manner; soon; quickly. Chaucer. I shall grow jealous of you shortly. Shak. The armies came shortly in view of each other. Clarendon. 2. In few words; briefly; abruptly; curtly; as, to express ideas more shortly in verse than in prose.
shortness |The quality or state of being short; want of reach or extension; brevity; deficiency; as, the shortness of a journey; the shortness of the days in winter; the shortness of an essay; the shortness of the memory; a shortness of provisions; shortness of breath.
shortsighted |1. Not able to see far; nearsighted; myopic. See Myopic, and Myopia. 2. Fig.: Not able to look far into futurity; unable to understand things deep; of limited intellect. 3. Having little regard for the future; heedless. -- Short\"sight`ed*ly, adv. -- Short\"sight`ed*ness, n. Cunning is a kind of shortsightedness. Addison.
shortstop |The player stationed in the field bewtween the second and third bases.
shortwing |Any one of several species of small wrenlike Asiatic birds having short wings and a short tail. They belong to Brachypterix, Callene, and allied genera.
shory |Lying near the shore. [Obs.]
shoshones |A linguistic family or stock of North American Indians, comprising many tribes, which extends from Montana and Idaho into Mexico. In a restricted sense the name is applied especially to the Snakes, the most northern of the tribes.
shot |imp. & p. p. Shoot.\n\nWoven in such a way as to produce an effect of variegation, of changeable tints, or of being figured; as, shot silks. See Shoot, v. t., 8.\n\nA share or proportion; a reckoning; a scot. Here no shots are where all shares be. Chapman. A man is never . . . welcome to a place till some certain shot be paid and the hostess say \"Welcome.\" Shak.\n\n1. The act of shooting; discharge of a firearm or other weapon which throws a missile. He caused twenty shot of his greatest cannon to be made at the king's army. Clarendon. 2. A missile weapon, particularly a ball or bullet; specifically, whatever is discharged as a projectile from firearms or cannon by the force of an explosive. Note: Shot used in war is of various kinds, classified according to the material of which it is composed, into lead, wrought-iron, and cast-iron; according to form, into spherical and oblong; according to structure and modes of operation, into solid, hollow, and case. See Bar shot, Chain shot, etc., under Bar, Chain, etc. 3. Small globular masses of lead, of various sizes, -- used chiefly for killing game; as, bird shot; buckshot. 4. The flight of a missile, or the distance which it is, or can be, thrown; as, the vessel was distant more than a cannon shot. 5. A marksman; one who practices shooting; as, an exellent shot. Shot belt, a belt having a pouch or compartment for carrying shot. -- Shot cartridge, a cartridge containing powder and small shot, forming a charge for a shotgun. -- Shot garland (Naut.), a wooden frame to contain shot, secured to the coamings and ledges round the hatchways of a ship. -- Shot gauge, an instrument for measuring the diameter of round shot. Totten. -- shot hole, a hole made by a shot or bullet discharged. -- Shot locker (Naut.), a strongly framed compartment in the hold of a vessel, for containing shot. -- Shot of a cable (Naut.), the splicing of two or more cables together, or the whole length of the cables thus united. -- Shot prop (Naut.), a wooden prop covered with tarred hemp, to stop a hole made by the shot of an enemy in a ship's side. -- Shot tower, a lofty tower for making shot, by dropping from its summit melted lead in slender streams. The lead forms spherical drops which cool in the descent, and are received in water or other liquid. -- Shot window, a window projecting from the wall. Ritson, quoted by Halliwell, explains it as a window that opens and shuts; and Wodrow describes it as a window of shutters made of timber and a few inches of glass above them.\n\nTo load with shot, as a gun. Totten.
shot samples |Samples taken for assay from  a molten metallic mass pouring a portion into water, to granulate it.
shot-clog |A person tolerated only because he pays the shot, or reckoning, for the rest of the company, otherwise a mere clog on them. [Old Slang] Thou common shot-clog, gull of all companies. Chapman.
shot-free |Not to be injured by shot; shot-proof. [Obs.] Feltham.\n\nFree from charge or expense; hence, unpunished; scot-free. [Obs.] Shak.
shot-proof |Impenetrable by shot.
shote |1. (Zoöl.)  A fish resembling the trout. [Obs. or Prov. Eng.] Garew. 2. Etym: [Perh. a different word.]  A young hog; a shoat.
shotgun |A light, smooth-bored gun, often double-barreled, especially designed for firing small shot at short range, and killing small game.
shots |The refuse of cattle taken from a drove. [Prov. Eng.] Halliwell.
shotted |1. Loaded with shot. 2. (Med.)  Having a shot attached; as, a shotten suture.
shotten |1. Having ejected the spawn; as, a shotten herring. Shak. 2. Shot out of its socket; dislocated, as a bone.
shough |A shockdog.\n\nSee Shoo. Beau & Fl.
should |Used as an auxiliary verb, to express a conditional or contingent act or state, or as a supposition of an actual fact; also, to express moral obligation (see Shall); e. g.: they should have come last week; if I should go; I should think you could go. \"You have done that you should be sorry for.\" Shak. Syn. -- See Ought.
shoulder |1. (Anat.)  The joint, or the region of the joint, by which the fore limb is connected with the body or with the shoulder girdle; the projection formed by the bones and muscles about that joint. 2. The flesh and muscles connected with the shoulder joint; the upper part of the back; that part of the human frame on which it is most easy to carry a heavy burden; -- often used in the plural. Then by main force pulled up, and on his shoulders bore The gates of Azza. Milton. Adown her shoulders fell her length of hair. Dryden. 3. Fig.: That which supports or sustains; support. In thy shoulder do I build my seat. Shak. 4. That which resembles a human shoulder, as any protuberance or projection from the body of a thing. The north western shoulder of the mountain. Sir W. Scott. 5. The upper joint of the fore leg and adjacent parts of an animal, dressed for market; as, a shoulder of mutton. 6. (Fort.)  The angle of a bastion included between the face and flank. See Illust. of Bastion. 7. An abrupt projection which forms an abutment on an object, or limits motion, etc., as the projection around a tenon at the end of a piece of timber, the part of the top of a type which projects beyond the base of the raised character, etc. Shoulder belt, a belt that passes across the shoulder. -- Shoulder blade (Anat.), the flat bone of the shoulder, to which the humerus is articulated; the scapula. -- Shoulder block (Naut.), a block with a projection, or shoulder, near the upper end, so that it can rest against a spar without jamming the rope. -- Shoulder clapper, one who claps another on the shoulder, or who uses great familiarity. [Obs.] Shak. -- Shoulder girdle. (Anat.) See Pectoral girdle, under Pectoral. -- Shoulder knot, an ornamental knot of ribbon or lace worn on the shoulder; a kind of epaulet or braided ornament worn as part of a military uniform. -- Shoulder-of-mutton sail (Naut.), a triangular sail carried on a boat's mast; -- so called from its shape. -- Shoulder slip, dislocation of the shoulder, or of the humerous. Swift. -- Shoulder strap, a strap worn on or over the shoulder. Specifically (Mil. & Naval), a narrow strap worn on the shoulder of a commissioned officer, indicating, by a suitable device, the rank he holds in the service. See Illust. in App.\n\n1. To push or thrust with the shoulder; to push with violence; to jostle. As they the earth would shoulder from her seat. Spenser. Around her numberless the rabble flowed, Shouldering each other, crowding for a view. Rowe. 2. To take upon the shoulder or shoulders; as, to shoulder a basket; hence, to assume the burden or responsibility of; as, to shoulder blame; to shoulder a debt. As if Hercules Or burly Atlas shouldered up their state. Marston. Right shoulder arms (Mil.), a position in the Manual of Arms which the piece is placed on the right shoulder, with the lock plate up, and the muzzle elevated and inclined to the left, and held as in the illustration.
shoulder-shotten |Sprained in the shoulder, as a horse. Shak.
shouldered |Having shoulders; -- used in composition; as, a broad- shouldered man. \"He was short-shouldered.\" Chaucer.
shout |To utter a sudden and loud outcry, as in joy, triumph, or exultation, or to attract attention, to animate soldiers, etc. Shouting of the men and women eke. Chaucer. They shouted thrice: what was the last cry for Shak. To shout at, to utter shouts at; to deride or revile with shouts.\n\n1. To utter with a shout; to cry; -- sometimes with out; as, to shout, or to shout out, a man's name. 2. To treat with shouts or clamor. Bp. Hall.\n\nA loud burst of voice or voices; a vehement and sudden outcry, especially of a multitudes expressing joy, triumph, exultation, or animated courage. The Rhodians, seeing the enemy turn their backs, gave a great shout in derision. Knolles.
shouter |One who shouts.
shove |1. To drive along by the direct and continuous application of strength; to push; especially, to push (a body) so as to make it move along the surface of another body; as, to shove a boat on the water; to shove a table across the floor. 2. To push along, aside, or away, in a careless or rude manner; to jostle. And shove away the worthy bidden guest. Milton. He used to shove and elbow his fellow servants. Arbuthnot.\n\n1. To push or drive forward; to move onward by pushing or jostling. 2. To move off or along by an act pushing, as with an oar a pole used by one in a boat; sometimes with off. He grasped the oar,shoved from shore. Garth.\n\nThe act of shoving; a forcible push. I rested . . . and then gave the boat another shove. Swift. Syn. -- See Thrust.\n\np. p. of Shove. Chaucer.
shoveboard |The same as Shovelboard.
shovegroat |The same as Shovelboard.
shovel |An implement consisting of a broad scoop, or more or less hollow blade, with a handle, used for lifting and throwing earth, coal, grain, or other loose substances. Shovel hat, a broad-brimmed hat, turned up at the sides, and projecting in front like a shovel, - - worn by some clergy of the English Church. [Colloq.] -- Shovelspur (Zoöl.), a flat, horny process on the tarsus of some toads, -- used in burrowing. -- Steam shovel, a machine with a scoop or scoops, operated by a steam engine, for excavating earth, as in making railway cuttings.\n\n1. To take up and throw with a shovel; as, to shovel earth into a heap, or into a cart, or out of a pit. 2. To gather up as with a shovel.
shovel-nosed |Having a broad, flat nose; as, the shovel-nosed duck, or shoveler.
shovelard |Shoveler. [Prov. Eng.]
shovelbill |The shoveler.
shovelboard |1. A board on which a game is played, by pushing or driving pieces of metal or money to reach certain marks; also, the game itself. Called also shuffleboard, shoveboard, shovegroat, shovelpenny. 2. A game played on board ship in which the aim is to shove or drive with a cue wooden disks into divisions chalked on the deck; -- called also shuffleboard.
shoveler |1. One who, or that which, shovels. 2. (Zoöl.)  A river duck (Spatula clypeata), native of Europe and America. It has a large bill, broadest towards the tip. The male is handsomely variegated with green, blue, brown, black, and white on the body; the head and neck are dark green. Called also broadbill, spoonbill, shovelbill, and maiden duck. The Australian shoveler, or shovel-nosed duck (S. rhynchotis), is a similar species.
shovelful |As much as a shovel will hold; enough to fill a shovel.
shovelhead |A shark (Sphryna tiburio) allied to the hammerhead, and native of the warmer parts of the Atlantic and Pacific oceans; -- called also bonnet shark.
shovelnose |(a) The common sand shark. See under Snad. (b) A small California shark (Heptranchias maculatus), which is taken for its oil. (c) A Pacific Ocean shark (Hexanchus corinus). (d) A ganoid fish of the Sturgeon family (Scaphirhynchus platyrhynchus) of the Mississippi and Ohio rivers; -- called also white sturgeon.
shoven |p. p. of Shove. Chaucer.
show |1. To exhibit or present to view; to place in sight; to display; -- the thing exhibited being the object, and often with an indirect object denoting the person or thing seeing or beholding; as, to show a house; show your colors; shopkeepers show customers goods (show goods to customers). Go thy way, shew thyself to the priest. Matt. viii. 4. Nor want we skill or art from whence to raise Magnificence; and what can heaven show more Milton. 2. To exhibit to the mental view; to tell; to disclose; to reveal; to make known; as, to show one's designs. Shew them the way wherein they must walk. Ex. xviii. 20. If it please my father to do thee evil, then I will shew it thee, and send thee away. 1 Sam. xx. 13. 3. Specifically, to make known the way to (a person); hence, to direct; to guide; to asher; to conduct; as, to show a person into a parlor; to show one to the door. 4. To make apparent or clear, as by evidence, testimony, or reasoning; to prove; to explain; also, to manifest; to evince; as, to show the truth of a statement; to show the causes of an event. I 'll show my duty by my timely care. Dryden. 5. To bestow; to confer; to afford; as, to show favor. Shewing mercy unto thousands of them that love me. Ex. xx. 6. To show forth, to manifest; to publish; to proclaim. -- To show his paces, to exhibit the gait, speed, or the like; -- said especially of a horse. -- To show off, to exhibit ostentatiously. -- To show up, to expose. [Colloq.]\n\n1. To exhibit or manifest one's self or itself; to appear; to look; to be in appearance; to seem. Just such she shows before a rising storm. Dryden. All round a hedge upshoots, and shows At distance like a little wood. Tennyson. 2. To have a certain appearance, as well or ill, fit or unfit; to become or suit; to appear. My lord of York, it better showed with you. Shak. To show off, to make a show; to display one's self.\n\n1. The act of showing, or bringing to view; exposure to sight; exhibition. 2. That which os shown, or brought to view; that which is arranged to be seen; a spectacle; an exhibition; as, a traveling show; a cattle show. As for triumphs, masks, feasts, and such shows. Bacon. 3. Proud or ostentatious display; parade; pomp. I envy none their pageantry and show. Young. 4. Semblance; likeness; appearance. He through the midst unmarked, In show plebeian angel militant Of lowest order, passed. Milton. 5. False semblance; deceitful appearance; pretense. Beware of the scribes, . . . which devour widows' houses, and for a shew make long prayers. Luke xx. 46. 47. 6. (Med.)  A discharge, from the vagina, of mucus streaked with blood, occuring a short time before labor. 7. (Mining)  A pale blue flame, at the top of a candle flame, indicating the presence of fire damp. Raymond. Show bill, a broad sheet containing an advertisement in large letters. -- Show box, a box xontaining some object of curiosity carried round as a show. -- Show card, an advertising placard; also, a card for displaying samples. -- Show case, a gla -- Show glass, a glass which displays objects; a mirror. -- Show of hands, a raising of hands to indicate judgment; as, the vote was taken by a show of hands. -- Show stone, a piece of glass or crystal supposed to have the property of exhibiting images of persons or things not present, indicating in that way future events.
showbread |Bread of exhibition; loaves to set before God; -- the term used in translating the various phrases used in the Hebrew and Greek to designate the loaves of bread which the priest of the week placed before the Lord on the golden table in the sanctuary. They were made of fine flour unleavened, and were changed every Sabbath. The loaves, twelve in number, represented the twelve tribes of Israel. They were to be eaten by the priests only, and in the Holy Place. [Written also shewbread.] Mark ii. 26.
shower |1. One who shows or exhibits. 2. That which shows; a mirror. [Obs.] Wyclif.\n\n1. A fall or rain or hail of short duration; sometimes, but rarely, a like fall of snow. In drought or else showers. Chaucer. Or wet the thirsty earth with falling showers. Milton. 2. That which resembles a shower in falling or passing through the air copiously and rapidly. With showers of stones he drives them far away. Pope. 3. A copious supply bestowed. [R.] He and myself Have travail'd in the great shower of your gifts. Shak. Shower bath, a bath in which water is showered from above, and sometimes from the sides also.\n\n1. To water with a shower; to Lest it again dissolve and shower the earth. Milton. 2. To bestow liberally; to destribute or scatter in Shak. Cshowers down greatness on his friends. Addison.\n\nTo rain in showers; to fall, as in a hower or showers. Shak.
showerful |Full of showers. Tennyson.
showeriness |Quality of being showery.
showerless |Rainless; freo from showers.
showery |1. Raining in showers; abounding with frequent showers of rain. 2. Of or pertaining to a shower or showers. \"Colors of the showery arch.\" Milton.
showily |In a showy manner; pompously; with parade.
showiness |The quality or state of being showy; pompousness; great parade; ostentation.
showing |1. Appearance; display; exhibition. 2. Presentation of facts; statement. J. S. Mill.
showish |Showy; ostentatious. Swift.
showman |One who exhibits a show; a proprietor of a show.
shown |p. p. of Show.
showroom |A room or apartment where a show is exhibited. 2. A room where merchandise is exposed for sale, or where samples are displayed.
showy |, a. Etym: [Compar. Showier (; superl. Showiest.]  Making a show; attracting attention; presenting a marked appearance; ostentatious; gay; gaudy. A present of everything that was rich and showy. Addison. Syn. -- Splendid; gay; gaudy; gorgeous; fine; magnificent; grand; stately; sumptuous; pompous.
shrag |A twig of a tree cut off. [Obs.]\n\nTo trim, as trees; to lop. [Obs.]
shragger |One who lops; one who trims trees. [Obs.] Huloet.
shram |To cause to shrink or shrivel with cold; to benumb. [Prov. Eng.]
shrank |imp. of Shrink.
shrap |A place baited with chaff to entice birds. [Written also scrap.] [Obs.] Bp. Bedell.
shrape |A place baited with chaff to entice birds. [Written also scrap.] [Obs.] Bp. Bedell.
shrapnel |Applied as an appellation to a kind of shell invented by Gen. H. Shrapnel of the British army. -- n.  A shrapnel shell; shrapnel shells, collectively. Shrapnel shell (Gunnery), a projectile for a cannon, consisting of a shell filled with bullets and a small bursting charge to scatter them at any given point while in flight. See the Note under Case shot.
shred |1. A long, narrow piece cut or torn off; a strip. \"Shreds of tanned leather.\" Bacon. 2. In general, a fragment; a piece; a particle. Shak.\n\n1. To cut or tear into small pieces, particularly narrow and long pieces, as of cloth or leather. Chaucer. 2. To lop; to prune; to trim. [Obs.]
shredcook |The fieldfare; -- so called from its harsh cry before rain. [Prov. Eng.]
shredding |1. The act of cutting or tearing into shreds. 2. That which is cut or torn off; a piece. Hooker.
shreddy |Consisting of shreds.
shredless |Having no shreds; without a shred. And those which waved are shredless dust ere now. Byron.
shrew |Wicked; malicious. [Obs.] Chaucer.\n\n1. Originally, a brawling, turbulent, vexatious person of either sex, but now restricted in use to females; a brawler; a scold. A man . . . grudgeth that shrews [i. e., bad men] have prosperity, or else that good men have adversity. Chaucer. A man had got a shrew to his wife, and there could be no quiet in the house for her. L'Estrange. 2. Etym: [AS. screáwa; -- so called because supposed to be venomous. ] (Zoöl.)  Any small insectivore of the genus Sorex and several allied genera of the family Sorecidæ. In form and color they resemble mice, but they have a longer and more pointed nose. Some of them are the smallest of all mammals. Note: The common European species are the house shrew (Crocidura araneus), and the erd shrew (Sorex vulgaris) (see under Erd.). In the United States several species of Sorex and Blarina are common, as the broadnosed shrew (S. platyrhinus), Cooper's shrew (S. Cooperi), and the short-tailed, or mole, shrew (Blarina brevicauda). Th American water, or marsh, shrew (Neosorex palustris), with fringed feet, is less common. The common European water shrews are Crossopus fodiens, and the oared shrew (see under Oared). Earth shrew, any shrewlike burrowing animal of the family Centetidæ, as the tendrac. -- Elephant shrew, Jumping shrew, Mole shrew. See under Elephant, Jumping, etc. -- Musk shrew. See Desman. -- River shrew, an aquatic West African insectivore (Potamogale velox) resembling a weasel in form and size, but having a large flattened and crested tail adapted for rapid swimming. It feeds on fishes. -- Shrew mole, a common large North American mole (Scalops aquaticus). Its fine, soft fur is gray with iridescent purple tints.\n\nTo beshrew; to curse. [Obs.] \"I shrew myself.\" Chaucer.
shrewd |1. Inclining to shrew; disposing to curse or scold; hence, vicious; malicious; evil; wicked; mischievous; vexatious; rough; unfair; shrewish. [Obs.] Chaucer. [Egypt] hath many shrewd havens, because of the great rocks that ben strong and dangerous to pass by. Sir J. Mandeville. Every of this happy number That have endured shrewd days and nights with us. Shak. 2. Artful; wily; cunning; arch. These women are shrewd tempters with their tongues. Shak. 3. Able or clever in practical affairs; sharp in business; astute; sharp-witted; sagacious; keen; as, a shrewd observer; a shrewd design; a shrewd reply. Professing to despise the ill opinion of mankind creates a shrewd suspicion that we have deserved it. Secker. Syn. -- Keen; critical; subtle; artful; astute; sagacious; discerning; acute; penetrating. -- Shrewd, Sagacious. One who is shrewd is keen to detect errors, to penetrate disguises, to foresee and guard against the selfishness of others. Shrewd is a word of less dignity than sagacious, which implies a comprehensive as well as penetrating mind, whereas shrewd does not. -- Shrewd\"ly, adv. -- Shrewd\"ness, n.
shrewish |having the qualities of a shrew; having a scolding disposition; froward; peevish. My wife is shrewish when I keep not hours. Shak. -- Shrew\"ish*ly, adv. -- Shrew\"ish*ness, n.
shrewmouse |A shrew; especially, the erd shrew.
shriek |To utter a loud, sharp, shrill sound or cry, as do some birds and beasts; to scream, as in a sudden fright, in horror or anguish. It was the owl that shrieked. Shak. At this she shrieked aloud; the mournful train Echoed her grief. Dryden.\n\nTo utter sharply and shrilly; to utter in or with a shriek or shrieks. On top whereof aye dwelt the ghostly owl, Shrieking his baleful note. Spenser. She shrieked his name To the dark woods. Moore.\n\nA sharp, shrill outcry or scream; a shrill wild cry such as is caused by sudden or extreme terror, pain, or the like. Shrieks, clamors, murmurs, fill the frighted town. Dryden. Shriek owl. (Zoöl.) (a) The screech owl. (b) The swift; -- so called from its cry.
shrieker |One who utters a shriek.
shrieval |Of or pertaining to a sheriff.
shrievalty |The office, or sphere of jurisdiction, of a sheriff; sheriffalty. It was ordained by 28 Edward I that the people shall have election of sheriff in every shire where the shrievalty is not of inheritance. Blackstone.
shrieve |A sheriff. [Obs.] Shak.\n\nTo shrive; to question. [Obs.] \"She gan him soft to shrieve.\" Spenser.
shrift |1. The act of shriving. In shrift and preaching is my diligence. Chaucer. 2. Confession made to a priest, and the absolution consequent upon it. Chaucer. Have you got leave to go to shrift to-day Shak. Therefore, my lord, address you to your shrift, And be yourself; for you must die this instant. Rowe. Shrift father, a priest to whom confession is made.
shright |imp. & p. p. of Shriek. She cried alway and shright. Chaucer.\n\nA shriek; shrieking. [Obs] Spenser. \"All hoarse for shright.\" Chaucer.
shrike |Any one of numerous species of oscinine birds of the family Laniidæ, having a strong hooked bill, toothed at the tip. Most shrikes are insectivorous, but the common European gray shrike (Lanius excubitor), the great northern shrike (L. borealis), and several others, kill mice, small birds, etc., and often impale them on thorns, and are, on that account called also butcher birds. See under Butcher. Note: The ant shrikes, or bush shrikes, are clamatorial birds of the family Formicaridæ. The cuckoo shrikes of the East Indies and Australia are Oscines of the family Campephagidæ. The drongo shrikes of the same regions belong to the related family Dicruridæ. See Drongo. Crow shrike. See under Crow. -- Shrike thrush. (a) Any one of several species of Asiatic timaline birds of the genera Thamnocataphus, Gampsorhynchus, and allies. (b) Any one of several species of shrikelike Australian singing birds of the genus Colluricincla. -- Shrike tit. (a) Any one of several Australian birds of the genus Falcunculus, having a strong toothed bill and sharp claws. They creep over the bark of trees, like titmice, in search of insects. (b) Any one of several species of small Asiatic birds belonging to Allotrius, Pteruthius, Cutia, Leioptila, and allied genera, related to the true tits. Called also hill tit. -- Swallow shrike. See under Swallow.
shrill |Acute; sharp; piercing; having or emitting a sharp, piercing tone or sound; -- said a sound, or of that which produces a sound. Hear the shrill whistle which doth order give To sounds confused. Shak. Let winds be shrill, let waves roll high. Byron.\n\nA shrill sound. [Obs.] Spenser.\n\nTo utter an acute, piercing sound; to sound with a sharp, shrill tone; to become shrill. Break we our pipes, that shrilledloud as lark. Spenser. No sounds were heard but of the shrilling cock. Goldsmith. His voice shrilled with passion. L. Wallace.\n\nTo utter or express in a shrill tone; to cause to make a shrill sound. How poor Andromache shrills her dolors forth. Shak.
shrill-gorged |Having a throat which produces a shrill note. [R.] Shak.
shrill-tongued |Having a shrill voice. \"When shrill-tongued Fulvia scolds.\" Shak.
shrillness |The quality or state of being shrill.
shrilly |In a shrill manner; acutely; with a sharp sound or voice.\n\nSomewhat shrill. [Poetic] Sir W. Scott. Some kept up a shrilly mellow sound. Keats.
shrimp |To contract; to shrink. [Obs.]\n\n1. (Zoöl.) (a) Any one of numerous species of macruran Crustacea belonging to Crangon and various allied genera, having a slender body and long legs. Many of them are used as food. The larger kinds are called also prawns. See Illust. of Decapoda. (b) In a more general sense, any species of the macruran tribe Caridea, or any species of the order Schizopoda, having a similar form. (c) In a loose sense, any small crustacean, including some amphipods and even certain entomostracans; as, the fairy shrimp, and brine shrimp. See under Fairy, and Brine. 2. Figuratively, a little wrinkled man; a dwarf; -- in contempt. This weak and writhled shrimp. Shak. Opossum shrimp. (Zoöl.) See under Opossum. -- Spector shrimp, or Skeleton shrimp (Zoöl.), any slender amphipod crustacean of the genus Caprella and allied genera. See Illust. under Læmodopoda. -- Shrimp catcher (Zoöl.), the little tern (Sterna minuta). -- Shrimp net, a dredge net fixed upon a pole, or a sweep net dragged over the fishing ground.
shrimper |One who fishes for shrimps.
shrine |1. A case, box, or receptacle, especially one in which are deposited sacred relics, as the bones of a saint. 2. Any sacred place, as an altar, tromb, or the like. Too weak the sacred shrine guard. Byron. 3. A place or object hallowed from its history or associations; as, a shrine of art.\n\nTo enshrine; to place reverently, as in a shrine. \"Shrined in his sanctuary.\" Milton.
shrink |1. To wrinkle, bend, or curl; to shrivel; hence, to contract into a less extent or compass; to gather together; to become compacted. And on a broken reed he still did stay His feeble steps, which shrunk when hard thereon he lay. Spenser. I have not found that water, by mixture of ashes, will shrink or draw into less room. Bacon. Against this fire do I shrink up. Shak. And shrink like parchment in consuming fire. Dryden. All the boards did shrink. Coleridge. 2. To withdraw or retire, as from danger; to decline action from fear; to recoil, as in fear, horror, or distress. What happier natures shrink at with affright, The hard inhabitant contends is right. Pope. They assisted us against the Thebans when you shrank from the task. Jowett (Thucyd.) 3. To express fear, horror, or pain by contracting the body, or part of it; to shudder; to quake. [R.] Shak.\n\n1. To cause to contract or shrink; as, to shrink finnel by imersing it in boiling water. 2. To draw back; to withdraw. [Obs.] The Libyc Hammon shrinks his horn. Milton. To shrink on (Mach.), to fix (one piece or part) firmly around (another) by natural contraction in cooling, as a tire on a wheel, or a hoop upon a cannon, which is made slightly smaller than the part it is to fit, and expanded by heat till it can be slipped into place.\n\nThe act shrinking; shrinkage; contraction; also, recoil; withdrawal. Yet almost wish, with sudden shrink, That I had less to praise. Leigh Hunt.
shrinkage |1. The act of shrinking; a contraction into less bulk or measurement. 2. The amount of such contraction; the bulk or dimension lost by shrinking, as of grain, castings, etc. 3. Decrease in value; depreciation. [Colloq.]
shrinker |One who shrinks; one who withdraws from danger.
shrinking |from Shrink. Shrinking head (Founding), a body of molten metal connected with a mold for the purpose of supplying metal to compensate for the shrinkage of the casting; -- called also sinking head, and riser.
shrinkingly |In a shrinking manner.
shrivalty |Shrievalty. Johnson.
shrive |1. To hear or receive the confession of; to administer confession and absolution to; -- said of a priest as the agent. That they should shrive their parishioners. Piers Plowman. Doubtless he shrives this woman, . . . Else ne'er could he so long protract his speech. Shak. Till my guilty soul be shriven. Longfellow. 2. To confess, and receive absolution; -- used reflexively. Get you to the church and shrive yourself. Beau & Fl.\n\nTo receive confessions, as a priest; to administer confession and absolution. Spenser.
shrivel |To draw, or be drawn, into wrinkles; to shrink, and form corrugations; as, a leaf shriveles in the hot sun; the skin shrivels with age; -- often with up.\n\nTo cause to shrivel or contract; to cause to shrink onto corruptions.
shriven |p. p. of Shrive.
shriver |One who shrives; a confessor.
shriving |Shrift; confession. Spenser.
shroff |A banker, or changer of money. [East Indies]
shroffage |The examination of coins, and the separation of the good from the debased. [East Indies]
shrood |To trim; to lop. [Prov. Eng.]
shropshire |An English breed of black-faced hornless sheep similar to the Southdown, but larger, now extensively raised in many parts of the world.
shroud |1. That which clothes, covers, conceals, or protects; a garment. Piers Plowman. Swaddled, as new born, in sable shrouds. Sandys. 2. Especially, the dress for the dead; a winding sheet. \"A dead man in his shroud.\" Shak. 3. That which covers or shelters like a shroud. Jura answers through her misty shroud. Byron. 4. A covered place used as a retreat or shelter, as a cave or den; also, a vault or crypt. [Obs.] The shroud to which he won His fair-eyed oxen. Chapman. A vault, or shroud, as under a church. Withals. 5. The branching top of a tree; foliage. [R.] The Assyrian wad a cedar in Lebanon, with fair branches and with a shadowing shroad. Ezek. xxxi. 3. 6. pl. (Naut.)  A set of ropes serving as stays to support the masts. The lower shrouds are secured to the sides of vessels by heavy iron bolts and are passed around the head of the lower masts. 7. (Mach.)  One of the two annular plates at the periphery of a water wheel, which form the sides of the buckets; a shroud plate. Bowsprit shrouds (Naut.), ropes extending from the head of the bowsprit to the sides of the vessel. -- Futtock shrouds (Naut.), iron rods connecting the topmast rigging with the lower rigging, passing over the edge of the top. -- Shroud plate. (a) (Naut.) An iron plate extending from the dead- eyes to the ship's side. Ham. Nav. Encyc. (b) (Mach.) A shroud. See def. 7, above.\n\n1. To cover with a shroud; especially, to inclose in a winding sheet; to dress for the grave. The ancient Egyptian mummies were shrouded in a number of folds of linen besmeared with gums. Bacon. 2. To cover, as with a shroud; to protect completely; to cover so as to conceal; to hide; to veil. One of these trees, with all his young ones, may shroud four hundred horsemen. Sir W. Raleigh. Some tempest rise, And blow out all the stars that light the skies, To shroud my shame. Dryden.\n\nTo take shelter or harbor. [Obs.] If your stray attendance be yet lodged, Or shroud within these limits. Milton.\n\nTo lop. See Shrood. [Prov. Eng.]
shroud-laid |Composed of four strands, and laid right-handed with a heart, or center; -- said of rope. See Illust. under Cordage.
shrouded |Provided with a shroud or shrouds. Shrouded gear (Mach.), a cogwheel or pinion having flanges which form closed ends to the spaces between the teeth and thus strengthen the teeth by tying them together.
shrouding |The shrouds. See Shroud, n., 7.
shroudless |Without a shroud.
shroudy |Affording shelter. [R.] Milton.
shrove |imp. of Shrive. Shrove Sunday, Quinguagesima Sunday. -- Shrove Tuesday, the Tuesday following Quinguagesima Sunday, and preceding the first day of Lent, or Ash Wednesday. Note: It was formerly customary in England, on this day, for the people to confess their sins to their parish priests, after which they dined on pancakes, or fritters, and the occasion became one of merriment. The bell rung on this day is popularly called Pancake Bell, and the day itself Pancake Tuesday. P. Cyc.\n\nTo join in the festivities of Shrovetide; hence, to make merry. [Obs.] J. Fletcher.
shrovetide |The days immediately preceding Ash Widnesday, especially the period between the evening before Quinguagesima Sunday and the morning of Ash Wednesday.
shroving |The festivity of Shrovetide. [Obs.]
shrow |A shrew. [Obs.] Shak.
shrowd |See Shrood. [Prov. Eng.]
shrub |A liquor composed of vegetable acid, especially lemon juice, and sugar, with spirit to preserve it.\n\nA woody plant of less size than a tree, and usually with several stems from the same root.\n\nTo lop; to prune. [Obs.] Anderson (1573).
shrubbery |1. A collection of shrubs. 2. A place where shrubs are planted. Macaulay.
shrubbiness |Quality of being shrubby.
shrubby |1. Full of shrubs. 2. Of the nature of a shrub; resembling a shrub. \"Shrubby browse.\" J. Philips.
shrubless |having no shrubs. Byron.
shruff |Rubbish. Specifically: (a) Dross or refuse of metals. [Obs.] (b) Light, dry wood, or stuff used for fuel. [Prov. Eng.]
shrug |To draw up or contract (the shoulders), especially by way of expressing dislike, dread, doubt, or the like. He shrugs his shoulders when you talk of securities. Addison.\n\nTo raise or draw up the shoulders, as in expressing dislike, dread, doubt, or the like. They grin, they shrug. They bow, they snarl, they snatch, they hug. Swift.\n\nA drawing up of the shoulders, -- a motion usually expressing dislike, dread, or doubt. The Spaniards talk in dialogues Of heads and shoulders, nods and shrugs. Hudibras.
shrunken |from Shrink.
shuck |A shock of grain. [Prev.Eng.]\n\n1. A shell, husk, or pod; especially, the outer covering of such nuts as the hickory nut, butternut, peanut, and chestnut. 2. The shell of an oyster or clam. [U. S.]\n\nTo deprive of the shucks or husks; as, to shuck walnuts, Indian corn, oysters, etc.
shucker |One who shucks oysters or clams
shudder |To tremble or shake with fear, horrer, or aversion; to shiver with cold; to quake. \"With shuddering horror pale.\" Milton. The shuddering tennant of the frigid zone. Goldsmith.\n\nThe act of shuddering, as with fear. Shak.
shudderingly |In a shuddering manner.
shude |The husks and other refuse of rice mills, used to adulterate oil cake, or linseed cake.
shuffle |1. To shove one way and the other; to push from one to another; as, to shuffle money from hand to hand. 2. To mix by pushing or shoving; to confuse; to throw into disorder; especially, to change the relative positions of, as of the cards in a pack. A man may shuffle cards or rattle dice from noon to midnight without tracing a new idea in his mind. Rombler. 3. To remove or introduce by artificial confusion. It was contrived by your enemies, and shuffled into the papers that were seizen. Dryden. To shuffe off, to push off; to rid one's self of. -- To shuffe up, to throw together in hastel to make up or form in confusion or with fraudulent disorder; as, he shuffled up a peace.\n\n1. To change the relative position of cards in a pack; as, to shuffle and cut. 2. To change one's position; to shift ground; to evade questions; to resort to equivocation; to prevaricate. I muself, . . . hiding mine honor in my necessity, am fain to shuffle. Shak. 3. To use arts or expedients; to make shift. Your life, good master, Must shuffle for itself. Shak. 4. To move in a slovenly, dragging manner; to drag or scrape the feet in walking or dancing. The aged creature came Shuffling along with ivory-headed wand. Keats. Syn. -- To equivicate; prevaricate; quibble; cavil; shift; siphisticate; juggle.\n\n1. The act of shuffling; a mixing confusedly; a slovenly, dragging motion. The unguided agitation and rude shuffles of matter. Bentley. 2. A trick; an artifice; an evasion. The gifts of nature are beyond all shame and shuffles. L'Estrange.
shuffleboard |See Shovelboard.
shufflecap |,.A play performed by shaking money in a hat or cap. [R.] Arbuthnot.
shuffler |1. One who shuffles. 2. (Zoöl.)  Either one of the three common American scaup ducks. See Scaup duck, under Scaup.
shufflewing |The hedg sparrow. [Prov. Eng.]
shuffling |1. Moving with a dragging, scraping step. \"A shuffling nag.\" Shak. 2. Evasive; as, a shuffling excuse. T. Burnet.\n\nIn a shuffling manner.
shug |1. To writhe the body so as to produce friction against one's clothes, as do those who have the itch. [Prov. Eng.] Halliwell. 2. Hence, to crawl; to sneak. [Obs.] There I 'll shug in and get a noble countenance. Ford.
shumac |Sumac.
shun |To avoid; to keep clear of; to get out of the way of; to escape from; to eschew; as, to shun rocks, shoals, vice. I am pure from the blood of all men. For I have not shunned to declare unto you all the counsel of God. Acts xx. 26,27. Scarcity and want shall shun you. Shak. Syn. -- See Avoid.
shunless |Not to be shunned; inevitable; unavoidable. [R.] \"Shunless destiny.\" Shak.
shunt |1. To shun; to move from. [Obs. or Prov. Eng.] 2. To cause to move suddenly; to give a sudden start to; to shove. [Obs. or Prov.Eng.] Ash. 3. To turn off to one side; especially, to turn off, as a grain or a car upon a side track; to switch off; to shift. For shunting your late partner on to me. T. Hughes. 4. (Elec.)  To provide with a shunt; as, to shunt a galvanometer.\n\nTo go aside; to turn off.\n\n1. (Railroad)  A turning off to a side or short track, that the principal track may be left free. 2. (Elec.)  A conducting circuit joining two points in a conductor, or the terminals of a galvanometer or dynamo, so as to form a parallel or derived circuit through which a portion of the current may pass, for the purpose of regulating the amount passing in the main circuit. 3. (Gunnery)  The shifting of the studs on a projectile from the deep to the shallow sides of the grooves in its discharge from a shunt gun. Shunt dynamo (Elec.), a dynamo in which the field circuit is connected with the main circuit so as to form a shunt to the letter, thus employing a portion of the current from the armature to maintain the field. -- Shunt gun, a firearm having shunt rifling. See under Rifling.
shunt valve |A valve permitting a fluid under pressure an easier avenue of escape than normally; specif., a valve, actuated by the governor, used in one system of marine-engine governing to connect both ends of the low-pressure cylinder as a supplementary control.
shunt winding |A winding so arranged as to divide the armature current and lead a portion of it around the field-magnet coils; -- opposed to series winding. --Shunt\"-wound` (#), a.
shunter |A person employed to shunt cars from one track to another.
shunting |(a) (Railroads) Switching; as, shunting engine, yard, etc. [British] (b) (Finance) Arbitrage conducted between certain local markets without the necessity of the exchange involved in foreign arbitrage. [Great Britain]
shut |1. To close so as to hinder ingress or egress; as, to shut a door or a gate; to shut one's eyes or mouth. 2. To forbid entrance into; to prohibit; to bar; as, to shut the ports of a country by a blockade. Shall that be shut to man which to the beast Is open Milton. 3. To preclude; to exclude; to bar out. \"Shut from every shore.\" Dryden. 4. To fold together; to close over, as the fingers; to close by bringing the parts together; as, to shut the hand; to shut a book. To shut in. (a) To inclose; to confine. \"The Lord shut him in.\" Cen. vii. 16. (b) To cover or intercept the view of; as, one point shuts in another. -- To shut off. (a) To exclude. (b) To prevent the passage of, as steam through a pipe, or water through a flume, by closing a cock, valve, or gate. -- To shut out, to preclude from entering; to deny admission to; to exclude; as, to shut out rain by a tight roof. -- To shut together, to unite; to close, especially to close by welding. -- To shut up. (a) To close; to make fast the entrances into; as, to shut up a house. (b) To obstruct. \"Dangerous rocks shut up the passage.\" Sir W. Raleigh. (c) To inclose; to confine; to imprison; to fasten in; as, to shut up a prisoner. Before faith came, we were kept under the law, shut up unto the faith which should afterwards be revealed. Gal. iii. 23. (d) To end; to terminate; to conclude. When the scene of life is shut up, the slave will be above his master if he has acted better. Collier. (e) To unite, as two pieces of metal by welding. (f) To cause to become silent by authority, argument, or force.\n\nTo close itself; to become closed; as, the door shuts; it shuts hard. To shut up, to cease speaking. [Colloq.] T. Hughes.\n\n1. Closed or fastened; as, a shut door. 2. Rid; clear; free; as, to get shut of a person. [Now dialectical or local, Eng. & U.S.] L'Estrange. 3. (Phon.) (a) Formed by complete closure of the mouth passage, and with the nose passage remaining closed; stopped, as are the mute consonants, p, t, k, b, d, and hard g. H. Sweet. (b) Cut off sharply and abruptly by a following consonant in the same syllable, as the English short vowels, â, ê, î, ô, û, always are.\n\nThe act or time of shutting; close; as, the shut of a door. Just then returned at shut of evening flowers. Milton. 2. A door or cover; a shutter. [Obs.] Sir I. Newton. 3. The line or place where two pieces of metal are united by welding. Cold shut, the imperfection in a casting caused by the flowing of liquid metal upon partially chilled metal; also, the imperfect weld in a forging caused by the inadequate heat of one surface under working.
shute |Same as Chute, or Shoot.
shutter |1. One who shuts or closes. 2. A movable cover or screen for a window, designed to shut out the light, to obstruct the view, or to be of some strength as a defense; a blind. 3. A removable cover, or a gate, for closing an aperture of any kind, as for closing the passageway for molten iron from a ladle.
shuttered |Furnished with shutters.
shuttle |1. An instrument used in weaving for passing or shooting the thread of the woof from one side of the cloth to the other between the threads of the warp. Like shuttles through the loom, so swiftly glide My feathered hours. Sandys. 2. The sliding thread holder in a sewing machine, which carries the lower thread through a loop of the upper thread, to make a lock stitch. 3. A shutter, as for a channel for molten metal. [R.] Shuttle box (Weaving), a case at the end of a shuttle race, to receive the shuttle after it has passed the thread of the warp; also, one of a set of compartments containing shuttles with different colored threads, which are passed back and forth in a certain order, according to the pattern of the cloth woven. -- Shutten race, a sort of shelf in a loom, beneath the warp, along which the shuttle passes; a channel or guide along which the shuttle passes in a sewing machine. -- Shuttle shell (Zoöl.), any one of numerous species of marine gastropods of the genus Volva, or Radius, having a smooth, spindle- shaped shell prolonged into a channel at each end.\n\nTo move backwards and forwards, like a shuttle. I had to fly far and wide, shutting athwart the big Babel, wherever his calls and pauses had to be. Carlyle.
shuttlecock |A cork stuck with feathers, which is to be struck by a battledoor in play; also, the play itself.\n\nTo send or toss to and fro; to bandy; as, to shuttlecock words. Thackeray.
shuttlecork |See Shuttlecock.
shuttlewise |Back and forth, like the movement of a shuttle.
shwan-pan |See Schwan-pan.
shy |1. Easily frightened; timid; as, a shy bird. The horses of the army . . . were no longer shy, but would come up to my very feet without starting. Swift. 2. Reserved; coy; disinclined to familiar approach. What makes you so shy, my good friend There's nobody loves you better than I. Arbuthnot. The embarrassed look of shy distress And maidenly shamefacedness. Wordsworth. 3. Cautious; wary; suspicious. I am very shy of using corrosive liquors in the preparation of medicines. Boyle. Princes are, by wisdom of state, somewhat shy of thier successors. Sir H. Wotton. To fight shy. See under Fight, v. i.\n\nTo start suddenly aside through fright or suspicion; -- said especially of horses.\n\nTo throw sidewise with a jerk; to fling; as, to shy a stone; to shy a slipper. T. Hughes.\n\n1. A sudden start aside, as by a horse. 2. A side throw; a throw; a fling. Thackeray. If Lord Brougham gets a stone in his hand, he must, it seems, have a shy at somebody. Punch.
shyly |In a shy or timid manner; not familiarly; with reserve. [Written also shily.]
shyness |The quality or state of being shy. [Written also shiness.] Frequency in heavenly contemplation is particularly important to prevent a shyness bewtween God and thy soul. Baxter. Syn. -- Bashfulness; reserve; coyness; timidity; diffidence. See Bashfulness.
shyster |A trickish knave; one who carries on any business, especially legal business, in a mean and dishonest way. [Slang, U.S.]
si |A syllable applied, in solmization, to the note B; more recently, to the seventh tone of any major diatonic scale. It was added to Guido's scale by Le Maire about the end of the 17th century.
si quis |A notification by a candidate for orders of his intention to inquire whether any impediment may be alleged against him.
siaga |The ahu, or jairou.
sialogogue |An agent which promotes the flow of saliva.
siamang |A gibbon (Hylobates syndactylus), native of Sumatra. It has the second and third toes partially united by a web.
siamese |Of or pertaining to Siam, its native people, or their language.\n\n1. A native or inhabitant of Siam; pl., the people of Siam. 2. sing.  The language of the Siamese.
sib |A blood relation. [Obs.] Nash.\n\nRelated by blood; akin. [Obs. or Prov. Eng. & Scot.] Sir W. Scott. Your kindred is but . . . little sib to you. Chaucer. [He] is no fairy birn, ne sib at all To elfs, but sprung of seed terrestrial. Spenser.
sibbens |A contagious disease, endemic in Scotland, resembling the yaws. It is marked by ulceration of the throat and nose and by pustules and soft fungous excrescences upon the surface of the body. In the Orkneys the name is applied to the itch. [Written also sivvens.]
siberian |Of or pertaining to Siberia, a region comprising all northern Asia and belonging to Russia; as, a Siberian winter. -- n.  A native or inhabitant of Siberia. Siberian crab (Bot.), the Siberian crab apple. See Crab apple, under Crab. -- Siberian dog (Zoöl.), one of a large breed of dogs having erect ears and the hair of the body and tail very long. It is distinguished for endurance of fatigue when used for the purpose of draught. -- Siberian pea tree (Bot.), a small leguminous tree (Cragana arborescens) with yellow flowers. It is a native of Siberia.
sibilance |The quality or state of being sibilant; sibilation. Milton would not have avoided them for their sibilancy, he who wrote . . . verses that hiss like Medusa's head in wrath. Lowell.
sibilancy |The quality or state of being sibilant; sibilation. Milton would not have avoided them for their sibilancy, he who wrote . . . verses that hiss like Medusa's head in wrath. Lowell.
sibilant |Making a hissing sound; uttered with a hissing sound; hissing; as, s, z, sh, and zh, are sibilant elementary sounds. -- n.  A sibiliant letter.
sibilate |To pronounce with a hissing sound, like that of the letter s; to mark with a character indicating such pronunciation.
sibilation |Utterance with a hissing sound; also, the sound itself; a hiss. He, with a long, low sibilation, stared. Tennyson.
sibilatory |Hissing; sibilant.
sibilous |Having a hissing sound; hissing; sibilant. [R.] Pennant.
sibyl |1. (Class. Antiq.)  A woman supposed to be endowed with a spirit of prophecy. Note: The number of the sibyls is variously stated by different authors; but the opinion of Varro, that there were ten, is generally adopted. They dwelt in various parts of Persia, Greece, and Italy. 2. A female fortune teller; a pythoness; a prophetess. \"An old highland sibyl.\" Sir W. Scott.
sibylist |One who believes in a sibyl or the sibylline prophecies. Cudworth.
sibylline |Pertaining to the sibyls; uttered, written, or composed by sibyls; like the productions of sibyls. Sibylline books. (a) (Rom. Antiq.) Books or documents of prophecies in verse concerning the fate of the Roman empire, said to have been purchased by Tarquin the Proud from a sibyl. (b) Certain Jewish and early Christian writings purporting to have been prophetic and of sibylline origin. They date from 100 b. c. to a. d. 500.
sic |Such. [Scot.]\n\nThus. Note: This word is sometimes inserted in a quotation [sic], to call attention to the fact that some remarkable or inaccurate expression, misspelling, or the like, is literally reproduced.
sicamore |See Sycamore.
sicca |A seal; a coining die; -- used adjectively to designate the silver currency of the Mogul emperors, or the Indian rupee of 192 grains. Sicca rupee, an East Indian coin, valued nominally at about two shillings sterling, or fifty cents.
siccate |To dry. [R.]
siccation |The act or process of drying. [R.] Bailey.
siccative |Drying; causing to dry. -- n.  That which promotes drying.
siccific |Causing dryness.
siccity |Dryness; aridity; destitution of moisture. [Obs.] The siccity and dryness of its flesh. Sir T. Browne.
sice |The number six at dice.
sicer |A strong drink; cider. [Obs.] Chaucer.
sich |Such. [Obs. or Colloq.] Spenser.
sicilian |Of or pertaining to Sicily or its inhabitants. Sicilian vespers, the great massacre of the French in Sicily, in the year 1282, on the evening of Easter Monday, at the hour of vespers.\n\nA native or inhabitant of Sicily.
siciliano |A Sicilian dance, resembling the pastorale, set to a rather slow and graceful melody in 12-8 or 6-8 measure; also, the music to the dance.
sicilienne |A kind of rich poplin.
sick |1. Affected with disease of any kind; ill; indisposed; not in health. See the Synonym under Illness. Simon's wife's mother lay sick of a fever. Mark i. 30. Behold them that are sick with famine. Jer. xiv. 18. 2. Affected with, or attended by, nausea; inclined to vomit; as, sick at the stomach; a sick headache. 3. Having a strong dislike; disgusted; surfeited; -- with of; as, to be sick of flattery. He was not so sick of his master as of his work. L'Estrange. 4. Corrupted; imperfect; impaired; weakned. So great is his antipathy against episcopacy, that, if a seraphim himself should be a bishop, he would either find or make some sick feathers in his wings. Fuller. Sick bay (Naut.), an apartment in a vessel, used as the ship's hospital. -- Sick bed, the bed upon which a person lies sick. -- Sick berth, an apartment for the sick in a ship of war. -- Sick headache (Med.), a variety of headache attended with disorder of the stomach and nausea. -- Sick list, a list containing the names of the sick. -- Sick room, a room in which a person lies sick, or to which he is confined by sickness. Note: [These terms, sick bed, sick berth, etc., are also written both hyphened and solid.] Syn. -- Diseased; ill; disordered; distempered; indisposed; weak; ailing; feeble; morbid.\n\nSickness. [Obs.] Chaucer.\n\nTo fall sick; to sicken. [Obs.] Shak.
sick-brained |Disordered in the brain.
sicken |1. To make sick; to disease. Raise this strength, and sicken that to death. Prior. 2. To make qualmish; to nauseate; to disgust; as, to sicken the stomach. 3. To impair; to weaken. [Obs.] Shak.\n\n1. To become sick; to fall into disease. The judges that sat upon the jail, and those that attended, sickened upon it and died. Bacon. 2. To be filled to disgust; to be disgusted or nauseated; to be filled with abhorrence or aversion; to be surfeited or satiated. Mine eyes did sicken at the sight. Shak. 3. To become disgusting or tedious. The toiling pleasure sickens into pain. Goldsmith. 4. To become weak; to decay; to languish. All pleasures sicken, and all glories sink. Pope.
sickening |Causing sickness; specif., causing surfeit or disgust; nauseating. -- Sick\"en*ing*ly, adv.
sicker |To percolate, trickle, or ooze, as water through a crack. [Also written sigger, zigger, and zifhyr.] [Prov. Eng.]\n\nSure; certain; trusty. [Obs. or Prov. Eng. & Scot.] Burns. When he is siker of his good name. Chaucer.\n\nSurely; certainly. [Obs.] Believe this as siker as your creed. Chaucer. Sicker, Willye, thou warnest well. Spenser.
sickerly |Surely; securely. [Obs.] But sikerly, withouten any fable. Chaucer.
sickerness |The quality or state of being sicker, or certain. [Obs.] Chaucer. Spenser.
sickish |1. Somewhat sick or diseased. 2. Somewhat sickening; as, a sickish taste. -- Sick\"ish*ly, adv. -- Sick\"ish*ness, n.
sickle |1. A reaping instrument consisting of a steel blade curved into the form of a hook, and having a handle fitted on a tang. The sickle has one side of the blade notched, so as always to sharpen with a serrated edge. Cf. Reaping hook, under Reap. When corn has once felt the sickle, it has no more benefit from the sunshine. Shak. 2. (Astron.)  A group of stars in the constellation Leo. See Illust. of Leo. Sickle pod (Bot.), a kind of rock cress (Arabis Canadensis) having very long curved pods.
sicklebill |(a) Any one of three species of humming birds of the genus Eutoxeres, native of Central and South America. They have a long and strongly curved bill. Called also the sickle-billed hummer. (b) A curlew. (c) A bird of the genus Epimachus and allied genera.
sickled |Furnished with a sickle.
sickleman |One who uses a sickle; a reaper. You sunburned sicklemen, of August weary. Shak.
sickler |One who uses a sickle; a sickleman; a reaper.
sickless |Free from sickness. [R.] Give me long breath, young beds, and sickless ease. Marston.
sicklewort |(a) A plant of the genus Coronilla (C. scorpioides); -- so named from its curved pods. (b) The healall (Brunella vulgaris).
sicklied |Made sickly. See Sickly, v.
sickliness |The quality or state of being sickly.
sickly |1. Somewhat sick; disposed to illness; attended with disease; as, a sickly body. This physic but prolongs thy sickly days. Shak. 2. Producing, or tending to, disease; as, a sickly autumn; a sickly climate. Cowper. 3. Appearing as if sick; weak; languid; pale. The moon grows sickly at the sight of day. Dryden. Nor torrid summer's sickly smile. Keble. 4. Tending to produce nausea; sickening; as, a sickly smell; sickly sentimentality. Syn. -- Diseased; ailing; infirm; weakly; unhealthy; healthless; weak; feeble; languid; faint.\n\nIn a sick manner or condition; ill. My people sickly [with ill will] beareth our marriage. Chaucer.\n\nTo make sick or sickly; -- with over, and probably only in the past participle. [R.] Sicklied o'er with the pale cast of thought. Shak. Sentiments sicklied over . . . with that cloying heaviness into which unvaried sweetness is too apt to subside. Jeffrey.
sickness |1. The quality or state of being sick or diseased; illness; sisease or malady. I do lament the sickness of the king. Shak. Trust not too much your now resistless charms; Those, age or sickness soon or late disarms. Pope. 2. Nausea; qualmishness; as, sickness of stomach. Syn. -- Illness; disease; malady. See Illness.
sicle |A shekel. [Obs.] The holy mother brought five sicles and a pair of turtledoves to redeem the Lamb of God. Jer. Taylor.
sida |A genus of malvaceous plants common in the tropics. All the species are mucilaginous, and some have tough ligneous fibers which are used as a substitute for hemp and flax. Balfour (Cyc. of India).
siddow |Soft; pulpy. [Obs. or Prov. Eng.]
side |1. The margin, edge, verge, or border of a surface; especially (when the thing spoken of is somewhat oblong in shape), one of the longer edges as distinguished from the shorter edges, called ends; a bounding line of a geometrical figure; as, the side of a field, of a square or triangle, of a river, of a road, etc. 3. Any outer portion of a thing considered apart from, and yet in relation to, the rest; as, the upper side of a sphere; also, any part or position viewed as opposite to or contrasted with another; as, this or that side. Looking round on every side beheld A pathless desert. Milton. 4. (a) One of the halves of the body, of an animals or man, on either side of the mesial plane; or that which pertains to such a half; as, a side of beef; a side of sole leather. (b) The right or left part of the wall or trunk of the body; as, a pain in the side. One of the soldiers with a spear pierced his side. John xix. 34. 5. A slope or declivity, as of a hill, considered as opposed to another slope over the ridge. Along the side of yon small hill. Milton. 6. The position of a person or party regarded as opposed to another person or party, whether as a rival or a foe; a body of advocates or partisans; a party; hence, the interest or cause which one maintains against another; a doctrine or view opposed to another. God on our side, doubt not of victory. Shak. We have not always been of the . . . same side in politics. Landor. Sets the passions on the side of truth. Pope. 7. A line of descent traced through one parent as distinguished from that traced through another. To sit upon thy father David's throne, By mother's side thy father. Milton. 8. Fig.: Aspect or part regarded as contrasted with some other; as, the bright side of poverty. By the side of, close at hand; near to. -- Exterior side. (Fort.) See Exterior, and Illust. of Ravelin. -- Interior side (Fort.), the line drawn from the center of one bastion to that of the next, or the line curtain produced to the two oblique radii in front. H. L. Scott. -- Side by side, close together and abreast; in company or along with. -- To choose sides, to select those who shall compete, as in a game, on either side. -- To take sides, to attach one's self to, or give assistance to, one of two opposing sides or parties.\n\n1. Of or pertaining to a side, or the sides; being on the side, or toward the side; lateral. One mighty squadron with a side wind sped. Dryden. 2. Hence, indirect; oblique; collateral; incidental; as, a side issue; a side view or remark. The law hath no side respect to their persons. Hooker. 3. Etym: [AS. sid. Cf Side, n.]  Long; large; extensive. [Obs. or Scot.] Shak. His gown had side sleeves down to mid leg. Laneham. Side action, in breech-loading firearms, a mechanism for operating the breech block, which is moved by a lever that turns sidewise. -- Side arms, weapons worn at the side, as sword, bayonet, pistols, etc. -- Side ax, an ax of which the handle is bent to one side. -- Side-bar rule (Eng. Law.), a rule authorized by the courts to be granted by their officers as a matter of course, without formal application being made to them in open court; -- so called because anciently moved for by the attorneys at side bar, that is, informally. Burril. -- Side box, a box or inclosed seat on the side of a theater. To insure a side-box station at half price. Cowper. -- Side chain, one of two safety chains connecting a tender with a locomotive, at the sides. -- Side cut, a canal or road branching out from the main one. [U.S.] -- Side dish, one of the dishes subordinate to the main course. -- Side glance, a glance or brief look to one side. -- Side hook (Carp.), a notched piece of wood for clamping a board to something, as a bench. -- Side lever, a working beam of a side-lever engine. -- Side-lever engine, a marine steam engine having a working beam of each side of the cylinder, near the bottom of the engine, communicating motion to a crank that is above them. -- Side pipe (Steam Engine), a steam or exhaust pipe connecting the upper and lower steam chests of the cylinder of a beam engine. -- Side plane, a plane in which the cutting edge of the iron is at the side of the stock. -- Side posts (Carp.), posts in a truss, usually placed in pairs, each post set at the same distance from the middle of the truss, for supporting the principal rafters, hanging the tiebeam, etc. -- Side rod. (a) One of the rods which connect the piston-rod crosshead with the side levers, in a side-lever engine. (b) See Parallel rod, under Parallel. -- Side screw (Firearms), one of the screws by which the lock is secured to the side of a firearm stock. -- Side table, a table placed either against the wall or aside from the principal table. -- Side tool (Mach.), a cutting tool, used in a lathe or planer, having the cutting edge at the side instead of at the point. -- Side wind, a wind from one side; hence, an indirect attack, or indirect means. Wright.\n\n1. To lean on one side. [Obs.] Bacon. 2. To embrace the opinions of one party, or engage in its interest, in opposition to another party; to take sides; as, to side with the ministerial party. All side in parties, and begin the attack. Pope.\n\n1. To be or stand at the side of; to be on the side toward. [Obs.] His blind eye that sided Paridell. Spenser. 2. To suit; to pair; to match. [Obs.] Clarendon. 3. (Shipbuilding)  To work (a timber or rib) to a certain thickness by trimming the sides. 4. To furnish with a siding; as, to side a house.
side line |1. (a) A line pert. or attached to the side of a thing. (b) Specif., a line for hobbling an animal by connecting the fore and the hind feet of the same side. 2. (a) A line of goods sold in addition to one's principal articles of trade; a course of business pursued aside from one's regular occupation. (b) A secondary road; esp., a byroad at right angles to a main road. [Canada]
side slip |See Skid, below.
side-chain theory |A theory proposed by Ehrlich as a chemical explanation of immunity phenomena. In brief outline it is as follows: Animal cells and bacteria are complex aggregations of molecules, which are themselves complex. Complex molecules react with one another through certain of their side chains, but only when these side chains have a definite correspondence in structure (this account for the specific action of antitoxins).
side-slip |See Skid, below.
side-taking |A taking sides, as with a party, sect, or faction. Bp. Hall.
side-wheel |Having a paddle wheel on each side; -- said of steam vessels; as, a side-wheel steamer.
sideboard |A piece of dining-room furniture having compartments and shelves for keeping or displaying articles of table service. At a stately sideboard, by the wine, That fragrant smell diffused. Milton.
sidebone |A morbid growth or deposit of bony matter and at the sides of the coronet and coffin bone of a horse. J. H. Walsh.
sided |Having (such or so many) sides; -- used in composition; as, one-sided; many-sided.
sideflash |A disruptive discharge between a conductor traversed by an oscillatory current of high frequency (as lightning) and neighboring masses of metal, or between different parts of the same conductor.
sidehill |The side or slope of a hill; sloping ground; a descent. [U. S.]
sideling |Sidelong; on the side; laterally; also, obliquely; askew. A fellow nailed up maps . . . some sideling, and others upside down. Swift.\n\nInclining to one sidel directed toward one side; sloping; inclined; as, sideling ground.
sidelong |1. Laterally; obliquely; in the direction of the side. 2. On the side; as, to lay a thing sidelong. Note: [See Sideling, adv. ] Evelyn.\n\nLateral; oblique; not being directly in front; as, a sidelong glance. The bashful virgin's sidelong looks of love. Goldsmith.
sidepiece |The jamb, or cheek, of an opening in a wall, as of door or window.
sider |One who takes a side.\n\nCider. [Obs.]
sideral |1. Relating to the stars. 2. (Astrol.)  Affecting unfavorably by the supposed influence of the stars; baleful. \"Sideral blast.\" Milton.
siderated |Planet-struck; blasted. [Obs.]
sideration |The state of being siderated, or planet-struck; esp., blast in plants; also, a sudden and apparently causeless stroke of disease, as in apoplexy or paralysis. [Obs.] Ray.
sidereal |1. Relating to the stars; starry; astral; as, sidereal astronomy. 2. (Astron.)  Measuring by the apparent motion of the stars; designated, marked out, or accompanied, by a return to the same position in respect to the stars; as, the sidereal revolution of a planet; a sidereal day. Sidereal clock, day, month, year. See under Clock, Day, etc. -- Sideral time, time as reckoned by sideral days, or, taking the sidereal day as the unit, the time elapsed since a transit of the vernal equinox, reckoned in parts of a sidereal day. This is, strictly, apparent sidereal time, mean sidereal time being reckoned from the transit, not of the true, but of the mean, equinoctial point.
siderealize |To elevate to the stars, or to the region of the stars; to etherealize. German literature transformed, siderealized, as we see it in Goethe, reckons Winckelmann among its initiators. W. Pater.
sidereous |Sidereal. [Obs.]
siderite |1. (Min.) (a) Carbonate of iron, an important ore of iron occuring generally in cleavable masses, but also in rhombohedral crystals. It is of a light yellowish brown color. Called also sparry iron, spathic iron. (b) A meteorite consisting solely of metallic iron. (c) An indigo-blue variety of quartz. (d) Formerly, magnetic iron ore, or loadstone. 2. (Bot.)  Any plant of the genus Sideritis; ironwort.
siderographic |Of or pertaining to siderography; executed by engraved plates of steel; as, siderographic art; siderographic impressions.
siderographical |Of or pertaining to siderography; executed by engraved plates of steel; as, siderographic art; siderographic impressions.
siderographist |One skilled in siderography.
siderography |The art or practice of steel engraving; especially, the process, invented by Perkins, of multiplying facsimiles of an engraved steel plate by first rolling over it, when hardened, a soft steel cylinder, and then rolling the cylinder, when hardened, over a soft steel plate, which thus becomes a facsimile of the original. The process has been superseded by electrotypy.
siderolite |A kind of meteorite. See under Meteorite.
sideromancy |Divination by burning straws on red-hot iron, and noting the manner of their burning. Craig.
sideroscope |An instrument for detecting small quantities of iron in any substance by means of a very delicate combination of magnetic needles.
siderosis |A sort of pneumonia occuring in iron workers, produced by the inhalation of particles of iron.
siderostat |An apparatus consisting essentially of a mirror moved by clockwork so as to throw the rays of the sun or a star in a fixed direction; -- a more general term for heliostat.
sideroxylon |A genus of tropical sapotaceous trees noted for their very hard wood; ironwood.
sidesaddle |A saddle for women, in which the rider sits with both feet on one side of the animal mounted. Sidesaddle flower (Bot.), a plant with hollow leaves and curiously shaped flowers; -- called also huntsman's cup. See Sarracenia.
sidesman |1. A party man; a partisan. Milton. 2. An assistant to the churchwarden; a questman.
sidetrack |1. (Railroads) To transfer to a siding from a main line of track. 2.  Hence, fig., to divert or reduce to a position or condition that is relatively secondary or subordinate in activity, importance, effectiveness, or the like; to switch off; to turn aside, as from a purpose. [Colloq.] Such a project was, in fact, sidetracked in favor of the census of school children. Pop. Sci. Monthly.
sidewalk |A walk for foot passengers at the side of a street or road; a foot pavement. [U.S.]
sideways |Toward the side; sidewise. A second refraction made sideways. Sir I. Newton. His beard, a good palm's length, at least, . . . Shot sideways, like a swallow's wings. Longfellow.
sidewinder |1. (Zoöl.) See Horned rattler, under Horned. 2. A heavy swinging blow from the side, which disables an adversary. [Slang.]
sidewise |On or toward one side; laterally; sideways. I saw them mask their awful glance Sidewise meek in gossamer lids. Emerson.
siding |1. Attaching one's self to a party. 2. A side track, as a railroad; a turnout. 3. (Carp.)  The covering of the outside wall of a frame house, whether made of weatherboards, vertical boarding with cleats, shingles, or the like. 4. (Shipbuilding)  The thickness of a rib or timber, measured, at right angles with its side, across the curved edge; as, a timber having a siding of ten inches.
sidle |To go or move with one side foremost; to move sidewise; as, to sidle through a crowd or narrow opening. Swift. He . . . then sidled close to the astonished girl. Sir W. Scott.
siege |1. A seat; especially, a royal seat; a throne. [Obs.] \"Upon the very siege of justice.\" Shak. A stately siege of sovereign majesty, And thereon sat a woman gorgeous gay. Spenser. In our great hall there stood a vacant chair . . . And Merlin called it \"The siege perilous.\" Tennyson. 2. Hence, place or situation; seat. [Obs.] Ah! traitorous eyes, come out of your shameless siege forever. Painter (Palace of Pleasure). 3. Rank; grade; station; estimation. [Obs.] I fetch my life and being From men of royal siege. Shak. 4. Passage of excrements; stool; fecal matter. [Obs.] The siege of this mooncalf. Shak. 5. The sitting of an army around or before a fortified place for the purpose of compelling the garrison to surrender; the surrounding or investing of a place by an army, and approaching it by passages and advanced works, which cover the besiegers from the enemy's fire. See the Note under Blockade. 6. Hence, a continued attempt to gain possession. Love stood the siege, and would not yield his breast. Dryden. 7. The floor of a glass-furnace. 8. A workman's bench. Knught. Siege gun, a heavy gun for siege operations. -- Siege train, artillery adapted for attacking fortified places.\n\nTo besiege; to beset. [R.] Through all the dangers that can siege The life of man. Buron.
siegework |A temporary fort or parallel where siege guns are mounted.
siemens-martin process |See Open-hearth process, etc., under Open.
siemens-martin steel |See Open-hearth steel, under Open.
sienite |See Syenite.
sienitic |See Syenitic.
sienna |Clay that is colored red or brown by the oxides of iron or manganese, and used as a pigment. It is used either in the raw state or burnt. Burnt sienna, sienna made of a much redder color by the action of fire. -- Raw sienna, sienna in its natural state, of a transparent yellowish brown color.
siennese |Of or pertaining to Sienna, a city of Italy.
sierra |A ridge of mountain and craggy rocks, with a serrated or irregular outline; as, the Sierra Nevada. The wild sierra overhead. Whitter.
siesta |A short sleep taken about the middle of the day, or after dinner; a midday nap.
sieur |Sir; -- a title of respect used by the French.
sieva |A small variety of the Lima bean (Phaseolus lunatus).
sieve |1. A utensil for separating the finer and coarser parts of a pulverized or granulated substance from each other. It consist of a vessel, usually shallow, with the bottom perforated, or made of hair, wire, or the like, woven in meshes. \"In a sieve thrown and sifted.\" Chaucer. 2. A kind of coarse basket. Simmonds. Sieve cells (Bot.), cribriform cells. See under Cribriform.
sifac |The white indris of Madagascar. It is regarded by the natives as sacred.
sifflement |The act of whistling or hissing; a whistling sound; sibilation. [Obs.] A. Brewer.
sifilet |The six-shafted bird of paradise. See Paradise bird, under Paradise.
sift |1. To separate with a sieve, as the fine part of a substance from the coarse; as, to sift meal or flour; to sift powder; to sift sand or lime. 2. To separate or part as if with a sieve. When yellow sands are sifted from below, The glittering billows give a golden show. Dryden. 3. To examine critically or minutely; to scrutinize. Sifting the very utmost sentence and syllable. Hooker. Opportunity I here have had To try thee, sift thee. Milton. Let him but narrowly sift his ideas. I. Taylor. To sift out, to search out with care, as if by sifting.
sifter |1. One who, or that which, sifts. 2. (Zoöl.)  Any lamellirostral bird, as a duck or goose; -- so called because it sifts or strains its food from the water and mud by means of the lamell
sig |Urine. [Prov. Eng.]
sigaultian |Pertaining to Sigault, a French physician. See Symphyseotomy.
sigger |Same as Sicker. [Prov. Eng.]
sigh |1. To inhale a larger quantity of air than usual, and immediately expel it; to make a deep single audible respiration, especially as the result or involuntary expression of fatigue, exhaustion, grief, sorrow, or the like. 2. Hence, to lament; to grieve. He sighed deeply in his spirit. Mark viii. 12. 3. To make a sound like sighing. And the coming wind did roar more loud, And the sails did sigh like sedge. Coleridge. The winter winds are wearily sighing. Tennyson. Note: An extraordinary pronunciation of this word as sith is still heard in England and among the illiterate in the United States.\n\n1. To exhale (the breath) in sighs. Never man sighed truer breath. Shak. 2. To utter sighs over; to lament or mourn over. Ages to come, and men unborn, Shall bless her name, and sigh her fate. Pior. 3. To express by sighs; to utter in or with sighs. They . . . sighed forth proverbs. Shak. The gentle swain . . . sighs back her grief. Hoole.\n\n1. A deep and prolonged audible inspiration or respiration of air, as when fatigued or grieved; the act of sighing. I could drive the boat with my sighs. Shak. 2. Figuratively, a manifestation of grief; a lan With their sighs the air Frequenting, sent from hearts contrite. Milton.
sigh-born |Sorrowful; mournful. [R.] \"Sigh-born thoughts.\" De Quincey.
sigher |One who sighs.
sighing |Uttering sighs; grieving; lamenting. \"Sighing millions.\" Cowper. -- Sigh\"ing*ly, adv.
sight |1. The act of seeing; perception of objects by the eye; view; as, to gain sight of land. A cloud received him out of their sight. Acts. i. 9. 2. The power of seeing; the faculty of vision, or of perceiving objects by the instrumentality of the eyes. Thy sight is young, And thou shalt read when mine begin to dazzle. Shak. O loss of sight, of thee I most complain! Milton. 3. The state of admitting unobstructed vision; visibility; open view; region which the eye at one time surveys; space through which the power of vision extends; as, an object within sight. 4. A spectacle; a view; a show; something worth seeing. Moses said, I will now turn aside and see this great sight, why the bush is not burnt. Ex. iii. 3. They never saw a sight so fair. Spenser. 5. The instrument of seeing; the eye. Why cloud they not their sights Shak. 6. Inspection; examination; as, a letter intended for the sight of only one person. 7. Mental view; opinion; judgment; as, in their sight it was harmless. Wake. That which is highly esteemed among men is abomination in the sight of God. Luke xvi. 15. 8. A small aperture through which objects are to be seen, and by which their direction is settled or ascertained; as, the sight of a quadrant. Thier eyes of fire sparking through sights of steel. Shak. 9. A small piece of metal, fixed or movable, on the breech, muzzle, center, or trunnion of a gun, or on the breech and the muzzle of a rifle, pistol, etc., by means of which the eye is guided in aiming. Farrow. 10. In a drawing, picture, etc., that part of the surface, as of paper or canvas, which is within the frame or the border or margin. In a frame or the like, the open space, the opening. 11. A great number, quantity, or sum; as, a sight of money. [Now colloquial] Note: Sight in this last sense was formerly employed in the best usage. \"A sight of lawyers.\" Latimer. A wonder sight of flowers. Gower. At sight, as soon as seen, or presented to sight; as, a draft payable at sight: to read Greek at sight; to shoot a person at sight. -- Front sight (Firearms), the sight nearest the muzzle. -- Open sight. (Firearms) (a) A front sight through which the objects aimed at may be seen, in distinction from one that hides the object. (b) A rear sight having an open notch instead of an aperture. -- Peep sight, Rear sight. See under Peep, and Rear. -- Sight draft, an order, or bill of exchange, directing the payment of money at sight. -- To take sight, to take aim; to look for the purpose of directing a piece of artillery, or the like. Syn. -- Vision; view; show; spectacle; representation; exhibition.\n\n1. To get sight of; to see; as, to sight land; to sight a wreck. Kane. 2. To look at through a sight; to see accurately; as, to sight an object, as a star. 3. To apply sights to; to adjust the sights of; also, to give the proper elevation and direction to by means of a sight; as, to sight a rifle or a cannon.\n\nTo take aim by a sight.
sight-hole |A hole for looking through; a peephole. \"Stop all sight-holes.\" Shak.
sight-seeing |Engaged in, or given to, seeing sights; eager for novelties or curiosities.\n\nThe act of seeing sights; eagerness for novelties or curiosities.
sight-seer |One given to seeing sights or noted things, or eager for novelties or curiosities.
sight-shot |Distance to which the sight can reach or be thrown. [R.] Cowley.
sighted |Having sight, or seeing, in a particular manner; -- used in composition; as, long-sighted, short-sighted, quick-sighted, sharp- sighted, and the like.
sightful |Easily or clearly seen; distinctly visible; perspicuous. [Obs.] Testament of Love.
sightfulness |The state of being sightful; perspicuity. [Obs.] Sir P. Sidney.
sighting |from Sight, v. t. Sighting shot, a shot made to ascertain whether the sights of a firearm are properly adjusted; a trial shot.
sightless |1. Wanting sight; without sight; blind. Of all who blindly creep or sightless soar. Pope. 2. That can not be seen; invisible. [Obs.] The sightless couriers of the air. Shak. 3. Offensive or unpleasing to the eye; unsightly; as, sightless stains. [R.] Shak. -- Sight\"less*ly, adv.- Sight\"less*ness, n.
sightliness |The state of being sightly; comeliness; conspicuousness.
sightly |1. Pleasing to the sight; comely. \"Many brave, sightly horses.\" L'Estrange. 2. Open to sight; conspicuous; as, a house stands in a sightly place.
sightproof |Undiscoverable to sight. Hidden in their own sightproof bush. Lowell.
sightsman |One who reads or performs music readily at first sight. [R.] Busby.
sigil |A seal; a signature. Dryden. Of talismans and sigils knew the power. Pope.
sigillaria |Little images or figures of earthenware exposed for sale, or given as presents, on the last two days of the Saturnalia; hence, the last two, or the sixth and seventh, days of the Saturnalia.\n\nA genus of fossil trees principally found in the coal formation; -- so named from the seallike leaf scars in vertical rows on the surface.
sigillarid |One of an extinct family of cryptagamous trees, including the genus Sigillaria and its allies.
sigillated |Decorated by means of stamps; -- said of pottery.
