sigillative |Fit to seal; belonging to a seal; composed of wax. [R.]
sigillum |A seal.
sigla |The signs, abbreviations, letters, or characters standing for words, shorthand, etc., in ancient manuscripts, or on coins, medals, etc. W. Savage.
sigma |The Greek letter S, or s). It originally had the form of the English C.
sigmodont |Any one of a tribe (Sigmodontes) of rodents which includes all the indigenous rats and mice of America. So called from the form of the ridges of enamel on the crowns of the worn molars. Also used adjectively.
sigmoid |Curved in two directions, like the letter S, or the Greek s. Sigmoid flexure (Anat.), the last curve of the colon before it terminates in the rectum. See Illust. under Digestive. -- Sigmoid valves. (Anat.) See Semilunar valves, under Semilunar.
sigmoidal |Curved in two directions, like the letter S, or the Greek s. Sigmoid flexure (Anat.), the last curve of the colon before it terminates in the rectum. See Illust. under Digestive. -- Sigmoid valves. (Anat.) See Semilunar valves, under Semilunar.
sigmoidally |In a sigmoidal manner.
sign |That by which anything is made known or represented; that which furnishes evidence; a mark; a token; an indication; a proof. Specifically: (a) A remarkable event, considered by the ancients as indicating the will of some deity; a prodigy; an omen. (b) An event considered by the Jews as indicating the divine will, or as manifesting an interposition of the divine power for some special end; a miracle; a wonder. Through mighty signs and wonders, by the power of the Spirit of God. Rom. xv. 19. It shall come to pass, if they will not believe thee, neither hearken to the voice of the first sign, that they will believe the voice of the latter sign. Ex. iv. 8. (c) Something serving to indicate the existence, or preserve the memory, of a thing; a token; a memorial; a monument. What time the fire devoured two hundred and fifty men, and they became a sign. Num. xxvi. 10. (d) Any symbol or emblem which prefigures, typifles, or represents, an idea; a type; hence, sometimes, a picture. The holy symbols, or signs, are not barely significative; but what they represent is as certainly delivered to us as the symbols themselves. Brerewood. Saint George of Merry England, the sign of victory. Spenser. (e) A word or a character regarded as the outward manifestation of thought; as, words are the sign of ideas. (f) A motion, an action, or a gesture by which a thought is expressed, or a command or a wish made known. They made signs to his father, how he would have him called. Luke i. 62. (g) Hence, one of the gestures of pantomime, or of a language of a signs such as those used by the North American Indians, or those used by the deaf and dumb. Note: Educaters of the deaf distinguish between natural signs, which serve for communicating ideas, and methodical, or systematic, signs, adapted for the dictation, or the rendering, of written language, word by word; and thus the signs are to be distinguished from the manual alphabet, by which words are spelled on the fingers. (h) A military emblem carried on a banner or a standard. Milton. (i) A lettered board, or other conspicuous notice, placed upon or before a building, room, shop, or office to advertise the business there transacted, or the name of the person or firm carrying it on; a publicly displayed token or notice. The shops were, therefore, distinguished by painted signs, which gave a gay and grotesque aspect to the streets. Macaulay. (j) (Astron.)  The twelfth part of the ecliptic or zodiac. Note: The signs are reckoned from the point of intersection of the ecliptic and equator at the vernal equinox, and are named, respectively, Aries (Taurus (Gemini (II), Cancer (Leo (Virgo (Libra (Scorpio (Sagittarius (Capricornus (Aquarius (Pisces ( (k) (Alg.) A character indicating the relation of quantities, or an operation performed upon them; as, the sign + (plus); the sign -- (minus); the sign of division ÷, and the like. (l) (Med.) An objective evidence of disease; that is, one appreciable by some one other than the patient. Note: The terms symptom and and sign are often used synonymously; but they may be discriminated. A sign differs from a symptom in that the latter is perceived only by the patient himself. The term sign is often further restricted to the purely local evidences of disease afforded by direct examination of the organs involved, as distinguished from those evidence of general disturbance afforded by observation of the temperature, pulse, etc. In this sense it is often called physical sign. (m) (Mus.) Any character, as a flat, sharp, dot, etc. (n) (Theol.) That which, being external, stands for, or signifies, something internal or spiritual; -- a term used in the Church of England in speaking of an ordinance considered with reference to that which it represents. An outward and visible sign of an inward and spiritual grace. Bk. of Common Prayer. Note: See the Table of Arbitrary Signs, p. 1924. Sign manual. (a) (Eng. Law) The royal signature superscribed at the top of bills of grants and letter patent, which are then sealed with the privy signet or great seal, as the case may be, to complete their validity. (b) The signature of one's name in one's own handwriting. Craig. Tomlins. Wharton. Syn. -- Token; mark; note; symptom; indication; signal; symbol; type; omen; prognostic; presage; manifestation. See Emblem.\n\n1. To represent by a sign; to make known in a typical or emblematic manner, in distinction from speech; to signify. I signed to Browne to make his retreat. Sir W. Scott. 2. To make a sign upon; to mark with a sign. We receive this child into the congregation of Christ's flock, and do sign him with the sign of the cross. Bk. of Com Prayer. 3. To affix a signature to; to ratify by hand or seal; to subscribe in one's own handwriting. Inquire the Jew's house out, give him this deed, And let him sign it. Shak. 4. To assign or convey formally; -- used with away. 5. To mark; to make distinguishable. Shak.\n\n1. To be a sign or omen. [Obs.] Shak. 2. To make a sign or signal; to communicate directions or intelligence by signs. 3. To write one's name, esp. as a token of assent, responsibility, or obligation.
signable |Suitable to be signed; requiring signature; as, a legal document signable by a particular person.
signal |1. A sign made for the purpose of giving notice to a person of some occurence, command, or danger; also, a sign, event, or watchword, which has been agreed upon as the occasion of concerted action. All obeyed The wonted signal and superior voice Of this great potentate. Milton. 2. A token; an indication; a foreshadowing; a sign. The weary sun . . . Gives signal of a goodly day to-morrow. Shak. There was not the least signal of the calamity to be seen. De Foc.\n\n1. Noticeable; distinguished from what is ordinary; eminent; remarkable; memorable; as, a signal exploit; a signal service; a signal act of benevolence. As signal now in low, dejected state As erst in highest, behold him where he lies. Milton. 2. Of or pertaining to signals, or the use of signals in conveying information; as, a signal flag or officer. The signal service, a bureau of the government (in the United States connected with the War Department) organized to collect from the whole country simultaneous raports of local meteorological conditions, upon comparison of which at the central office, predictions concerning the weather are telegraphed to various sections, where they are made known by signals publicly displayed. -- Signal station, the place where a signal is displayed; specifically, an observation office of the signal service. Syn. -- Eminent; remarkable; memorable; extraordinary; notable; conspicuous.\n\n1. To communicate by signals; as, to signal orders. 2. To notify by a signals; to make a signal or signals to; as, to signal a fleet to anchor. M. Arnold.
signalist |One who makes signals; one who communicates intelligence by means of signals.
signality |The quality or state of being signal or remarkable. [Obs.] Sir T. Browne.
signalize |1. To make signal or eminent; to render distinguished from what is common; to distinguish. It is this passion which drives men to all the ways we see in use of signalizing themselves. Burke. 2. To communicate with by means of a signal; as, a ship signalizes its consort. 3. To indicate the existence, presence, or fact of, by a signal; as, to signalize the arrival of a steamer.
signally |In a signal manner; eminently.
signalman |A man whose business is to manage or display signals; especially, one employed in setting the signals by which railroad trains are run or warned.
signalment |The act of signaling, or of signalizing; hence, description by peculiar, appropriate, or characteristic marks. Mrs. Browning.
signate |Having definite color markings.
signation |Sign given; marking. [Obs.] Sir T. Browne.
signatory |1. Relating to a seal; used in sealing. [Obs.] Bailey. 2. Signing; joining or sharing in a signature; as, signatory powers.\n\nA signer; one who signs or subscribes; as, a conference of signatories.
signature |1. A sign, stamp, or mark impressed, as by a seal. The brain, being well furnished with various traces, signatures, and images. I. Watts. The natural and indelible signature of God, which human souls . . . are supposed to be stamped with. Bentley. 2. Especially, the name of any person, written with his own hand, employed to signify that the writing which precedes accords with his wishes or intentions; a sign manual; an autograph. 3. (Physiol.)  An outward mark by which internal characteristics were supposed to be indicated. Some plants bear a very evident signature of their nature and use. Dr. H. More. 4. (Old Med.)  A resemblance between the external characters of a disease and those of some physical agent, for instance, that existing between the red skin of scarlet fever and a red cloth; -- supposed to indicate this agent in the treatment of the disease. 5. (Mus.)  The designation of the key (when not C major, or its relative, A minor) by means of one or more sharps or flats at the beginning of the staff, immediately after the clef, affecting all notes of the same letter throughout the piece or movement. Each minor key has the same signature as its relative major. 6. (Print.) (a) A letter or figure placed at the bottom of the first page of each sheet of a book or pamphlet, as a direction to the binder in arranging and folding the sheets. (b) The printed sheet so marked, or the form from which it is printed; as, to reprint one or more signatures. Note: Star signatures (as A*, 1*) are the same characters, with the addition of asterisks, used on the first pages of offcuts, as in 12mo sheets. 7. (Pharm.)  That part of a prescription which contains the directions to the patient. It is usually prefaced by S or Sig. (an abbreviation for the Latin signa, imperative of signare to sign or mark).\n\nTo mark with, or as with, a signature or signatures.
signaturist |One who holds to the doctrine of signatures impressed upon objects, indicative of character or qualities. [Obs.] Sir T. Browne.
signboard |A board, placed on or before a shop, office, etc., on which ssome notice is given, as the name of a firm, of a business, or the like.
signer |One who signs or subscribes his name; as, a memorial with a hundred signers.
signet |A seal; especially, in England, the seal used by the sovereign in sealing private letters and grants that pass by bill under the sign manual; -- called also privy signet. I had my father's signet in my purse. Shak. Signet ring, a ring containing a signet or private seal. -- Writer to the signet (Scots Law), a judicial officer who prepares warrants, writs, etc.; originally, a clerk in the office of the secretary of state.
signeted |Stamped or marked with a signet.
signifer |Bearing signs. [Obs.] \"The signifer sphere, or zodiac.\" Holland.
significance |1. The quality or state of being significant. 2. That which is signified; meaning; import; as, the significance of a nod, of a motion of the hand, or of a word or expression. 3. Importance; moment; weight; consequence. With this brain I must work, in order to give significancy and value to the few facts which I possess. De Quincey.
significancy |1. The quality or state of being significant. 2. That which is signified; meaning; import; as, the significance of a nod, of a motion of the hand, or of a word or expression. 3. Importance; moment; weight; consequence. With this brain I must work, in order to give significancy and value to the few facts which I possess. De Quincey.
significant |1. Fitted or designed to signify or make known somethingl having a meaning; standing as a sign or token; expressive or suggestive; as, a significant word or sound; a significant look. It was well said of Plotinus, that the stars were significant, but not efficient. Sir W. Raleigh. 2. Deserving to be considered; important; momentous; as, a significant event. Significant figures (Arith.), the figures which remain to any number, or decimal fraction, after the ciphers at the right or left are canceled. Thus, the significant figures of 25,000, or of .0025, are 25.\n\nThat which has significance; a sign; a token; a symbol. Wordsworth. In dumb significants proclaim your thoughts. Shak.
significantly |In a significant manner.
significate |One of several things signified by a common term. Whately.
signification |1. The act of signifying; a making known by signs or other means. A signification of being pleased. Landor. All speaking or signification of one's mind implies an act or addres of one man to another. South. 2. That which is signified or made known; that meaning which a sign, character, or token is intended to convey; as, the signification of words.
significative |1. Betokening or representing by an external sign. The holy symbols or signs are not barely significative. Brerewood. 2. Having signification or meaning; expressive of a meaning or purpose; significant. Neither in the degrees of kindred they were destitute of significative words. Camden. -- Sig*nif\"i*ca*tive*ly, adv. -- Sig*nif\"i*ca*tive*ness, n.
significator |One who, or that which, signifies. In this diagram there was one significator which pressed remarkably upon our astrologer's attention. Sir W. Scott.
significatory |Significant. -- n.  That which is significatory.
significavit |Formerly, a writ issuing out of chancery, upon certificate given by the ordinary, of a man's standing excommunicate by the space of forty days, for the laying him up in prison till he submit himself to the authority of the church. Crabb.
signify |1. To show by a sign; to communicate by any conventional token, as words, gestures, signals, or the like; to announce; to make known; to declare; to express; as, a signified his desire to be present. I 'll to the king; and signify to him That thus I have resign'd my charge to you. Shak. The government should signify to the Protestants of Ireland that want of silver is not to be remedied. Swift. 2. To mean; to import; to denote; to betoken. He bade her tell him what it signified. Chaucer. A tale Told by an idiot, full of sound and fury, Signifying nothing. Shak. Note: Signify is often used impersonally; as, it signifies nothing, it does not signify, that is, it is of no importance. Syn. -- To express; manifest; declare; utter; intimate; betoken; denote; imply; mean.
signior |Sir; Mr. The English form and pronunciation for the Italian Signor and the Spanish Señor.
signiorize |To exercise dominion over; to lord it over. [Obs.] Shelton.\n\nTo exercise dominion; to signiorize. [Obs.] Hewyt.
signiorship |State or position of a signior.
signiory |Same as Seigniory.
signor |Sir; Mr; -- a title of address or respect among the Italians. Before a noun the form is Signor.
signora |Madam; Mrs; -- a title of address or respect among the Italians.
signore |Sir; Mr; -- a title of address or respect among the Italians. Before a noun the form is Signor.
signorina |Miss; -- a title of address among the Italians.
signpost |A post on which a sign hangs, or on which papers are placed to give public notice of anything.
sik |Such. See Such. [Obs.] \"Sike fancies weren foolerie.\" Spenser.
sike |Such. See Such. [Obs.] \"Sike fancies weren foolerie.\" Spenser.\n\nA gutter; a stream, such as is usually dry in summer. [Prov. Eng. & Scot.]\n\nA sick person. [Prov. Eng.]\n\nTo sigh. [Obs.] That for his wife weepeth and siketh sore. Chaucer.\n\nA sigh. [Obs.] Chaucer.
siker |Sure; certain; trusty. [Obs. or Prov. Eng. & Scot.] Burns. When he is siker of his good name. Chaucer.\n\nSurely; certainly. [Obs.] Believe this as siker as your creed. Chaucer. Sicker, Willye, thou warnest well. Spenser.\n\nSee 2d Sicker, Sickerly, etc. [Obs.]
sikerly |Surely; securely. [Obs.] But sikerly, withouten any fable. Chaucer.\n\nSee 2d Sicker, Sickerly, etc. [Obs.]
sikerness |The quality or state of being sicker, or certain. [Obs.] Chaucer. Spenser.\n\nSee 2d Sicker, Sickerly, etc. [Obs.]
sikhs |A religious sect noted for warlike traits, founded in the Punjab at the end of the 15th century.
silage |Short for Ensilage.
sile |To strain, as fresh milk. [Prov. Eng.]\n\nTo drop; to flow; to fall. [Prov. Eng.]\n\n1. A sieve with fine meshes. [Prov. Eng.] 2. Filth; sediment. [Prov. Eng.] Halliwell.\n\nA young or small herring. [Eng.] Pennant.
silence |1. The state of being silent; entire absence of sound or noise; absolute stillness. I saw and heared; for such a numerous host Fled not in silence through the frighted deep. Milton. 2. Forbearance from, or absence of, speech; taciturnity; muteness. 3. Secrecy; as, these things were transacted in silence. The administration itself keeps a profound silence. D. Webster. 4. The cessation of rage, agitation, or tumilt; calmness; quiest; as, the elements were reduced to silence. 5. Absence of mention; oblivion. And what most merits fame, in silence hid. Milton.\n\nBe silent; -- used elliptically for let there be silence, or keep silence. Shak.\n\n1. To compel to silence; to cause to be still; to still; to hush. Silence that dreadful bell; it frights the isle. Shak. 2. To put to rest; to quiet. This would silence all further opposition. Clarendon. These would have silenced their scruples. Rogers. 3. To restrain from the exercise of any function, privilege of instruction, or the like, especially from the act of preaching; as, to silence a minister of the gospel. The Rev. Thomas Hooker of Chelmsford, in Essex, was silenced for nonconformity. B. Trumbull. 4. To cause to cease firing, as by a vigorous cannonade; as, to silence the batteries of an enemy.
silencer |(a) The muffler of an internal-combustion engine. (b) Any of various devices to silence the humming noise of telegraph wires. (c) A device for silencing the report of a firearm shooting its projectiles singly, as a tubular attachment for the muzzle having circular plates that permit the passage of the projectile but impart a rotary motion to, and thus retard, the exploding gases.
silene |A genus of caryophyllaceous plants, usually covered with a viscid secretion by which insects are caught; catchfly. Bon Silène. See Silène, in the Vocabulary.
silent |1. Free from sound or noise; absolutely still; perfectly quiet. How silent is this town! Shak. 2. Not speaking; indisposed to talk; speechless; mute; taciturn; not loquacious; not talkative. Ulysses, adds he, was the most eloquent and most silent of men. Broome. This new-created world, whereof in hell Fame is not silent. Milton. 3. Keeping at rest; inactive; calm; undisturbed; as, the wind is silent. Parnell. Sir W. Raleigh. 4. (Pron.)  Not pronounced; having no sound; quiescent; as, e is silent in \"fable.\" 5. Having no effect; not operating; inefficient. [R.] Cause . . . silent, virtueless, and dead. Sir W. Raleigh. Silent partner. See Dormant partner, under Dormant. Syn. -- Mute; taciturn; dumb; speechless; quiet; still. See Mute, and Taciturn.\n\nThat which is silent; a time of silence. [R.] \"The silent of the night.\" Shak.
silentiary |One appointed to keep silence and order in court; also, one sworn not to divulge secre
silentious |Habitually silent; taciturn; reticent. [R.]
silently |In a silent manner.
silentness |State of being silent; silence.
silenus |See Wanderoo.
silesia |1. A kind of linen cloth, originally made in Silesia, a province of Prussia. 2. A twilled cotton fabric, used for dress linings.
silesian |Of or pertaining to Silesia. -- n.  A native or inhabitant of Silesia.
silex |Silica, SiO2 as found in nature, constituting quarz, and most sands and sandstones. See Silica, and Silicic.
silhouette |A representation of the outlines of an object filled in with a black color; a profile portrait in black, such as a shadow appears to be.\n\nTo represent by a silhouette; to project upon a background, so as to be like a silhouette. [Recent] A flock of roasting vultures silhouetted on the sky. The Century.
silica |Silicon dioxide, SiO
silicate |A salt of silicic acid. Note: In mineralogical chemistry the silicates include; the unisilicates or orthosilicates, salts of orthosilicic acid; the bisilicates or metasilicates, salts of metasilicic acid; the polysilicates or acid silicates, salts of the polysilicic acids; the basic silicates or subsilicates, in which the equivalent of base is greater than would be required to neutralize the acid; and the hydrous silicates, including the zeolites and many hydrated decomposition products.
silicated |Combined or impregnated with silicon or silica; as, silicated hydrogen; silicated rocks. Silicated soap, a hard soap containing silicate of soda.
silicatization |Silicification.
silicea |Same as Silicoidea.
siliceous |Of or pertaining to silica; containing silica, or partaking of its nature. [Written also silisious.]
silicic |Pertaining to, derived from, or resembling, silica; specifically, designating compounds of silicon; as, silicic acid. Silicic acid (Chem.), an amorphous gelatinous substance, Si(HO)4, very unstable and easily dried to silica, but forming many stable salts; -- called also orthosilicic, or normal silicic, acid.
silicicalcareous |Consisting of silica and calcareous matter.
silicide |A binary compound of silicon, or one regarded as binary. [R.] Hydrogen silicide (Chem.), a colorless, spontaneously inflammable gas, SiH4, produced artifically from silicon, and analogous to methane; -- called also silico-methane, silicon hydride, and formerly siliciureted hydrogen.
siliciferous |Producing silica; united with silica.
silicification |Thae act or process of combining or impregnating with silicon or silica; the state of being so combined or impregnated; as, the silicification of wood.
silicified |Combined or impregnated with silicon or silica, especially the latter; as, silicified wood.
silicify |To convert into, or to impregnate with, silica, or with the compounds of silicon. The specimens found . . . are completely silicified. Say. Note: The silica may take the form of agate, chalcedony, flint, hornstone, or crystalline quartz.\n\nTo become converted into silica, or to be impregnated with silica.
silicioidea |Same as Silicoidea.
silicious |See Siliceous.
silicispongiae |Same as Silicoidea.
silicited |Silicified. [Obs.]
silicium |See Silicon.
siliciureted |Combined or impregnated with silicon. [Obsoles.] Siliciureted hydrogen. (Chem.) Hydrogen silicide. [Obs.]
silicle |A seed vessel resembling a silique, but about as broad as it is long. See Silique.
silico- |A combining form (also used adjectively) denoting the presence of silicon or its compounds; as, silicobenzoic, silicofluoride, etc.
silicofluoric |Containing, or composed of, silicon and fluorine; especially, denoting the compounds called silicofluorides. Silicofluoric acid (Chem.), a compound of hydrofluoric acid and silicon fluoride, known only in watery solution. It is produced by the action of silicon fluoride on water, and is regarded as an acid, H2SiF6, and the type and origin of the silicofluorides.
silicofluoride |A fluosilicate; a salt of silicofluoric acid.
silicoidea |An extensive order of Porifera, which includes those that have the skeleton composed mainly of siliceous fibers or spicules.
silicon |A nonmetalic element analogous to carbon. It always occurs combined in nature, and is artificially obtained in the free state, usually as a dark brown amorphous powder, or as a dark crystalline substance with a meetallic luster. Its oxide is silica, or common quartz, and in this form, or as silicates, it is, next to oxygen, the most abundant element of the earth's crust. Silicon is characteristically the element of the mineral kingdom, as carbon is of the organic world. Symbol Si. Atomic weight 28. Called also silicium.
silicotungstic |Of, pertaining to, or designating, any one of a series of double acids of silicon and tungsten, known in the free state, and also in their salts (called silicotungstates).
silicula |A silicle.
silicule |A silicle.
siliculose |1. (Bot.)  Bearing silicles; pertaining to, or resembling, silicles. 2. Full of, or consisting of, husks; husky. [Obs.]
siliginose |Made of fine wheat. [Obs.] Bailey.
siling |from Sile to strain. [Obs. or Prov.Eng.] Siling dish, a colander. [Obs. or Prov. Eng.]
siliqua |1. (Bot.)  Same as Silique. 2. A weight of four grains; a carat; -- a term used by jewelers, and refiners of gold.
silique |An oblong or elongated seed vessel, consisting of two valves with a dissepiment between, and opening by sutures at either margin. The seeds are attached to both edges of the dissepiment, alternately upon each side of it.
siliquiform |Having the form of a silique.
siliquosa |A Linnæan order of plants including those which bear siliques.
siliquose |Bearing siliques; as, siliquose plants; pertaining to, or resembling, siliques; as, siliquose capsules.
siliquous |Bearing siliques; as, siliquose plants; pertaining to, or resembling, siliques; as, siliquose capsules.
silk |1. The fine, soft thread produced by various species of caterpillars in forming the cocoons within which the worm is inclosed during the pupa state, especially that produced by the larvæ of Bombyx mori. 2. Hence, thread spun, or cloth woven, from the above-named material. 3. That which resembles silk, as the filiform styles of the female flower of maize. Raw silk, silk as it is wound off from the cocoons, and before it is manufactured. -- Silk cotton, a cottony substance enveloping the seeds of the silk-cotton tree. -- Silk-cotton tree (Bot.), a name for several tropical trees of the genera Bombax and Eriodendron, and belonging to the order Bombaceæ. The trees grow to an immense size, and have their seeds enveloped in a cottony substance, which is used for stuffing cushions, but can not be spun. -- Silk flower. (Bot.) (a) The silk tree. (b) A similar tree (Calliandra trinervia) of Peru. -- Silk fowl (Zoöl.), a breed of domestic fowls having silky plumage. -- Silk gland (Zoöl.), a gland which secretes the material of silk, as in spider or a silkworm; a sericterium. -- Silk gown, the distinctive robe of a barrister who has been appointed king's or queen's counsel; hence, the counsel himself. Such a one has precedence over mere barristers, who wear stuff gowns. [Eng.] -- Silk grass (Bot.), a kind of grass (Stipa comata) of the Western United States, which has very long silky awns. The name is also sometimes given to various species of the genera Aqave and Yucca. -- Silk moth (Zoöl.), the adult moth of any silkworm. See Silkworm. -- Silk shag, a coarse, rough-woven silk, like plush, but with a stiffer nap. -- Silk spider (Zoöl.), a large spider (Nephila plumipes), native of the Southern United States, remarkable for the large quantity of strong silk it produces and for the great disparity in the sizes of the sexes. -- Silk thrower, Silk throwster, one who twists or spins silk, and prepares it for weaving. Brande & C. -- Silk tree (Bot.), an Asiatic leguminous tree (Albizzia Julibrissin) with finely bipinnate leaves, and large flat pods; -- so called because of the abundant long silky stamens of its blossoms. Also called silk flower. -- Silk vessel. (Zoöl.) Same as Silk gland, above. -- Virginia silk (Bot.), a climbing plant (Periploca Græca) of the Milkweed family, having a silky tuft on the seeds. It is native in Southern Europe.
silk-stocking |Wearing silk stockings (which among men were formerly worn chiefly by the luxurious or aristocratic); hence, elegantly dressed; aristocratic; luxurious; -- chiefly applied to men, often by way of reproach. [They] will find their levees crowded with silk-stocking gentry, but no yeomanry; an army of officers without soldiers. Jefferson.
silken |1. Of or pertaining to silk; made of, or resembling, silk; as, silken cloth; a silken veil. 2. Fig.: Soft; delicate; tender; smooth; as, silken language. \"Silken terms precise.\" Shak. 3. Dressed in silk. \"A . . . silken wanton.\" Shak.\n\nTo render silken or silklike. Dyer.
silkiness |1. The quality or state of being silky or silken; softness and smoothness. 2. Fig.: Effeminacy; weakness. [R.] B. Jonson.
silkman |A dealer in silks; a silk mercer. Shak.
silkness |Silkiness. [Obs.] B. Jonson.
silkweed |Any plant of the genera Asclepias and Acerates whose seed vessels contain a long, silky down; milkweed.
silkworm |The larva of any one of numerous species of bombycid moths, which spins a large amount of strong silk in constructing its cocoon before changing to a pupa. Note: The common species (Bombyx mori) feeds onm the leaves of the white mulberry tree. It is native of China, but has long been introduced into other countries of Asia and Europe, and is reared on a large scale. In America it is reared only to small extent. The Ailanthus silkworm (Philosamia cynthia) is a much larger species, of considerable importance, which has been introduced into Europe and America from China. The most useful American species is the Polyphemus. See Polyphemus. Pernyi silkworm, the larva of the Pernyi moth. See Pernyi moth. -- Silkworm gut, a substance prepared from the contents of the silk glands of silkworms and used in making lines for angling. See Gut. -- Silkworm rot, a disease of silkworms; muscardine.
silky |1. Of or pertaining to silk; made of, or resembling, silk; silken; silklike; as, a silky luster. 2. Hence, soft and smooth; as, silky wine. 3. Covered with soft hairs pressed close to the surface, as a leaf; sericeous. Silky oak (Bot.), a lofty Australian tree (Grevillea robusta) with silky tomentose lobed or incised leaves. It furnishes a valuable timber.
sill |The basis or foundation of a thing; especially, a horizontal piece, as a timber, which forms the lower member of a frame, or supports a structure; as, the sills of a house, of a bridge, of a loom, and the like. Hence: (a) The timber or stone at the foot of a door; the threshold. (b) The timber or stone on which a window frame stands; or, the lowest piece in a window frame. (c) The floor of a gallery or passage in a mine. (d) A piece of timber across the bottom of a canal lock for the gates to shut against. Sill course (Arch.), a horizontal course of stone, terra cotta, or the like, built into a wall at the level of one or more window sills, these sills often forming part of it.\n\nThe shaft or thill of a carriage. [Prov. Eng.]\n\nA young herring. [Eng.]
sillabub |A dish made by mixing wine or cider with milk, and thus forming a soft curd; also, sweetened cream, flavored with wine and beaten to a stiff froth. [Written also syllabub.]
siller |Silver. [Scot.]
sillily |In a silly manner; foolishly. Dryden.
sillimanite |Same as Fibrolite.
silliness |The quality or state of being silly.
sillock |The pollock, or coalfish.
sillon |A work raised in the middle of a wide ditch, to defend it. Crabb.
sillyhow |A caul. See Caul, n., 3. [Obs. or Prov. Eng. & Scot.]
silo |A pit or vat for packing away green fodder for winter use so as to exclude air and outside moisture. See Ensilage.
silt |Mud or fine earth deposited from running or standing water.\n\nTo choke, fill, or obstruct with silt or mud.\n\nTo flow through crevices; to percolate.
silty |Full of silt; resembling silt.
silundum |A form of silicon carbide, produced in the electric furnace, possessing great hardness, and high electrical resistance, and not subject to oxidation below 2880º F., or 1600º C.
silure |A fish of the genus Silurus, as the sheatfish; a siluroid.
silurian |Of or pertaining to the country of the ancient Silures; -- a term applied to the earliest of the Paleozoic eras, and also to the strata of the era, because most plainly developed in that country. Note: The Silurian formation, so named by Murchison, is divided into the Upper Silurian and Lower Silurian. The lower part of the Lower Silurian, with some underlying beds, is now separated under the name Cambrian, first given by Sedwick. Recently the term Ordovician has been proposed for the Lower Silurian, leawing the original word to apply only to the Upper Silurian.\n\nThe Silurian age.
siluridan |Any fish of the family Silurid or of the order Siluroidei.
siluroid |Belonging to the Siluroidei, or Nematognathi, an order of fishes including numerous species, among which are the American catfishes and numerous allied fresh-water species of the Old World, as the sheatfish (Silurus glanis) of Europe. -- n.  A siluroid fish.
siluroidei |An order of fishes, the Nematognathi.
silurus |A genus of large malacopterygious fishes of the order Siluroidei. They inhabit the inland waters of Europe and Asia.
silva |(a) The forest trees of a region or country, considered collectively. (b) A description or history of the forest trees of a country.
silvan |Of or pertaining to woods; composed of woods or groves; woody. [Written also sylvan.] Betwixt two rows of rocks, a silvan scene Appears above, and groves forever green. Dryden.\n\nSee Sylvanium. [Obs.]
silvanite |See Sylvanite.
silvas |Vast woodland plains of South America.
silvate |Same as Sylvate.
silver |1. (Chem.)  A soft white metallic element, sonorous, ductile, very malleable, and capable of a high degree of polish. It is found native, and also combined with sulphur, arsenic, antimony, chlorine, etc., in the minerals argentite, proustite, pyrargyrite, ceragyrite, etc. Silver is one of the \"noble\" metals, so-called, not being easily oxidized, and is used for coin, jewelry, plate, and a great variety of articles. Symbol Ag (Argentum). Atomic weight 107.7. Specific gravity 10.5. Note: Silver was known under the name of luna to the ancients and also to the alchemists. Some of its compounds, as the halogen salts, are remarkable for the effect of light upon them, and are used in photography. 2. Coin made of silver; silver money. 3. Anything having the luster or appearance of silver. 4. The color of silver. Note: Silver is used in the formation of many compounds of obvious meaning; as, silver-armed, silver-bright, silver-buskined, silver- coated, silver-footed, silver-haired, silver-headed, silver-mantled, silver-plated, silver-slippered, silver-sounding, silver-studded, silver-tongued, silver-white. See Silver, a. Black silver (Min.), stephanite; -- called also brittle silver ore, or brittle silver glance. -- Fulminating silver. (Chem.) (a) A black crystalline substance, Ag2O.(NH3)2, obtained by dissolving silver oxide in aqua ammonia. When dry it explodes violently on the slightest percussion. (b) Silver fulminate, a white crystalline substance, Ag2C2N2O2, obtained by adding alcohol to a solution of silver nitrate. When dry it is violently explosive. -- German silver. (Chem.) See under German. -- Gray silver. (Min.) See Freieslebenite. -- Horn silver. (Min.) See Cerargyrite. -- King's silver. (O. Eng. Law) See Postfine. -- Red silver, or Ruby silver. (Min.) See Proustite, and Pyrargyrite. -- Silver beater, one who beats silver into silver leaf or silver foil. -- Silver glance, or Vitreous silver. (Min.) See Argentine.\n\n1. Of or pertaining to silver; made of silver; as, silver leaf; a silver cup. 2. Resembling silver. Specifically: (a) Bright; resplendent; white. \"Silver hair.\" Shak. Others, on silver lakes and rivers, bathed Their downy breast. Milton. (b) Precious; costly. (c) Giving a clear, ringing sound soft and clear. \"Silver voices.\" Spenser. (d) Sweet; gentle; peaceful. \"Silver slumber.\" Spenser. American silver fir (Bot.), the balsam fir. See under Balsam. -- Silver age (Roman Lit.), the latter part (a. d. 14-180) of the classical period of Latinity, -- the time of writers of inferior purity of language, as compared with those of the previous golden age, so-called. -- Silver-bell tree (Bot.), an American shrub or small tree (Halesia tetraptera) with white bell-shaped flowers in clusters or racemes; the snowdrop tree. -- Silver bush (Bot.), a shrubby leguminous plant (Anthyllis Barba- Jovis) of Southern Europe, having silvery foliage. -- Silver chub (Zoöl.), the fallfish. -- Silver eel. (Zoöl.) (a) The cutlass fish. (b) A pale variety of the common eel. -- Silver fir (Bot.), a coniferous tree (Abies pectinata) found in mountainous districts in the middle and south of Europe, where it often grows to the height of 100 or 150 feet. It yields Burgundy pitch and Strasburg turpentine. -- Silver foil, foil made of silver. -- Silver fox (Zoöl.), a variety of the common fox (Vulpes vulpes, variety argenteus) found in the northern parts of Asia, Europe, and America. Its fur is nearly black, with silvery tips, and is highly valued. Called also black fox, and silver-gray fox. -- Silver gar. (Zoöl.) See Billfish (a) -- Silver grain (Bot.), the lines or narrow plates of cellular tissue which pass from the pith to the bark of an exogenous stem; the medullary rays. In the wood of the oak they are much larger than in that of the beech, maple, pine, cherry, etc. -- Silver grebe (Zoöl.), the red-throated diver. See Illust. under Diver. -- Silver hake (Zoöl.), the American whiting. -- Silver leaf, leaves or sheets made of silver beaten very thin. -- Silver lunge (Zoöl.), the namaycush. -- Silver moonfish.(Zoöl.) See Moonfish (b). -- Silver moth (Zoöl.), a lepisma. -- Silver owl (Zoöl.), the barn owl. -- Silver perch (Zoöl.), the mademoiselle, 2. -- Silver pheasant (Zoöl.), any one of several species of beautiful crested and long-tailed Asiatic pheasants, of the genus Euplocamus. They have the tail and more or less of the upper parts silvery white. The most common species (E. nychtemerus) is native of China. -- Silver plate, domestic utensils made of silver. -- Silver plover (Zoöl.), the knot. -- Silver salmon (Zoöl.), a salmon (Oncorhynchus kisutch) native of both coasts of the North Pacific. It ascends all the American rivers as far south as the Sacramento. Called also kisutch, whitefish, and white salmon. -- Silver shell (Zoöl.), a marine bivalve of the genus Anomia. See Anomia. -- Silver steel, an alloy of steel with a very small proportion of silver. -- Silver stick, a title given to the title field officer of the Life Guards when on duty at the palace. [Eng.] Thackeray. -- Silver tree (Bot.), a South African tree (Leucadendron argenteum) with long, silvery, silky leaves. -- Silver trout, (Zoöl.) See Trout. -- Silver wedding. See under Wedding. -- Silver whiting (Zoöl.), a marine sciænoid food fish (Menticirrus littoralis) native of the Southern United States; -- called also surf whiting. -- Silver witch (Zoöl.), A lepisma.\n\n1. To cover with silver; to give a silvery appearance to by applying a metal of a silvery color; as, to silver a pin; to silver a glass mirror plate with an amalgam of tin and mercury. 2. To polish like silver; to impart a brightness to, like that of silver. And smiling calmness silvered o'er the deep. Pope. 3. To make hoary, or white, like silver. His head was silvered o'er with age. Gay.\n\nTo acquire a silvery color. [R.] The eastern sky began to silver and shine. L. Wallace.
silver certificate |A certificate issued by a government that there has been deposited with it silver to a specified amount, payable to the bearer on demand. In the United States and its possessions, it is issued against the deposit of silver coin, and is not legal tender, but is receivable for customs, taxes, and all public dues.
silver state |Nevada; -- a nickname alluding to its silver mines.
silver-gray |Having a gray color with a silvery luster; as, silver-gray hair.
silverback |The knot.
silverberry |A tree or shrub (Elæagnus argentea) with silvery foliage and fruit. Gray.
silverbill |An Old World finch of the genus Minia, as the M. Malabarica of India, and M. cantans of Africa.
silverboom |See Leucadendron.
silverfin |A small North American fresh-water cyprinoid fish (Notropis Whipplei).
silverfish |(a) The tarpum. (b) A white variety of the goldfish. Lepisma saccharina, which may infest houses, and eats starched clothing and sized papers. See Lepisma.
silveriness |The state of being silvery.
silvering |The art or process of covering metals, wood, paper, glass, etc., with a thin film of metallic silver, or a substance resembling silver; also, the firm do laid on; as, the silvering of a glass speculum.
silverite |One who favors the use or establishment of silver as a monetary standard; -- so called by those who favor the gold standard. [Colloq. or Cant]
silverize |To cover with silver.
silverless |Having no silcver; hence, without money; impecunious. Piers Plowman.
silverling |A small silver coin. [Obs.] A thousand vines at a thousand silverings. Isa. vii. 23.
silverly |Like silver in appearance or in sound. Let me wipe off this honorable dew, That silverly doth progress on thy cheeks. Shak.
silvern |Made of silver. [Archaic.] Wyclif (Acts xix. 24). Speech is silvern; silence is golden. Old Proverb.
silversides |Any one of several species of small fishes of the family Atherinidæ, having a silvery stripe along each side of the body. The common species of the American coast (Menidia notata) is very abundant. Called also silverside, sand smelt, friar, tailor, and tinker. Brook silversides (Zoöl.), a small fresh-water North American fish (Labadesthes sicculus) related to the marine silversides.
silversmith |One whose occupation is to manufacture utensils, ornaments, etc., of silver; a worker in silver.
silverspot |Any one of numerous species of butterflies of the genus Argynnis and allied genera, having silvery spots on the under side of the wings. See Illust. under Aphrodite.
silverware |Dishes, vases, ornaments, and utensils of various sorts, made of silver.
silverweed |A perennial rosaceous herb (Potentilla Anserina) having the leaves silvery white beneath.
silvery |1. Resembling, or having the luster of, silver; grayish white and lustrous; of a mild luster; bright. All the enameled race, whose silvery wing Waves to the tepid zephyrs of the spring. Pope. 2. Besprinkled or covered with silver. 3. Having the clear, musical tone of silver; soft and clear in sound; as, silvery voices; a silvery laugh. Silvery iron (Metal.), a peculiar light-gray fine-grained cast iron, usually obtained from clay iron ore.
silvics |1. The science treating of the life of trees in the forest. 2.  Habit or behavior of a forest tree.
silviculture |See Sylviculture.
sima |A cyma.
simagre |A grimace. [Obs.] Dryden.
simar |A woman's long dress or robe; also light covering; a scarf. [Written also cimar, cymar, samare, simare.]
simarre |See Simar. Sir W. Scott.
simblot |The harness of a drawloom.
simia |A Linnæan genus of Quadrumana which included the types of numerous modern genera. By modern writers it is usually restricted to the genus which includes the orang-outang.
simial |Simian; apelike.
simian |Of or pertaining to the family Simiadæ, which, in its widest sense, includes all the Old World apes and monkeys; also, apelike. -- n.  Any Old World monkey or ape.
similar |1. Exactly corresponding; resembling in all respects; precisely like. 2. Nearly corresponding; resembling in many respects; somewhat like; having a general likeness. 3. Homogenous; uniform. [R.] Boyle. Similar figures (Geom.), figures which differ from each other only in magnitude, being made up of the same number of like parts similarly situated. -- Similar rectilineal figures, such as have their several angles respectively equal, each to each, and their sides about the equal angles proportional. -- Similar solids, such as are contained by the same number of similar planes, similarly situated, and having like inclination to one another.\n\nThat which is similar to, or resembles, something else, as in quality, form, etc.
similarity |The quality or state of being similar; likeness; resemblance; as, a similarity of features. Hardly is there a similarity detected between two or three facts, than men hasten to extend it to all. Sir W. Hamilton.
similarly |In a similar manner.
similary |Similar. [Obs.] Rhyming cadences of similarly words. South.
similative |Implying or indicating likeness or resemblance. [R.] In similative or instrumental relation to a pa. pple. [past participle], as almond-leaved, -scented, etc. New English Dict.
simile |A word or phrase by which anything is likened, in one or more of its aspects, to something else; a similitude; a poetical or imaginative comparison. A good swift simile, but something currish. Shak.
similiter |The technical name of the form by which either party, in pleading, accepts the issue tendered by his opponent; -- called sometimes a joinder in issue.
similitude |1. The quality or state of being similar or like; resemblance; likeness; similarity; as, similitude of substance. Chaucer. Let us make now man in our image, man In our similitude. Milton. If fate some future bard shall join In sad similitude of griefs to mine. Pope. 2. The act of likening, or that which likens, one thing to another; fanciful or imaginative comparison; a simile. Tasso, in his similitudes, never departed from the woods; that is, all his comparisons were taken from the country. Dryden. 3. That which is like or similar; a representation, semblance, or copy; a facsimile. Man should wed his similitude. Chaucer.
similitudinary |Involving or expressing similitude. [Obs.] Coke.
similize |To liken; to compare; as, to similize a person, thing, or act. Lowell.
similor |An alloy of copper and zinc, resembling brass, but of a golden color. Ure.
simious |Of or pertaining to the Simian. That strange simious, schoolboy passion of giving pain to others. Sydney Smith.
simitar |See Scimiter.
simmer |To boil gently, or with a gentle hissing; to begin to boil. I simmer as liquor doth on the fire before it beginneth to boil. Palsgrave.\n\nTo cause to boil gently; to cook in liquid heated almost or just to the boiling point.
simnel |1. A kind of cake made of fine flour; a cracknel. [Obs.] Not common bread, but vastel bread, or simnels. Fuller. 2. A kind of rich plum cake, eaten especially on Mid-Lent Sunday. [Eng.] Herrick.
simon-pure |Genuine; true; real; authentic; -- a term alluding to the comedy character Simon Pure, who is impersonated by another and is obliged to prove himself to be the \"real Simon Pure.\",
  "fractionate |To separate into different portions or fractions, as in the distillation of liquids.
simoniac |One who practices simony, or who buys or sells preferment in the church. Ayliffe.
simoniacal |Of or pertaining to simony; guilty of simony; consisting of simony. -- Sim\"o*ni`a*cal*ly, adv. The flagitious profligacy of their lives, and the simoniacal arts by which they grasped at the popedom. J. S. Harford.
simonial |Simoniacal. [Obs.]
simonian |One of the followers of Simon Magus; also, an adherent of certain heretical sects in the early Christian church.
simonious |Simoniacal. [Obs.] Milton.
simonist |One who practices simony.
simony |The crime of buying or selling ecclesiastical preferment; the corrupt presentation of any one to an ecclesiastical benefice for money or reward. Piers Plowman.
simoom |A hot, dry, suffocating, dust-laden wind, that blows occasionally in Arabia, Syria, and neighboring countries, generated by the extreme heat of the parched deserts or sandy plains.
simoon |A hot, dry, suffocating, dust-laden wind, that blows occasionally in Arabia, Syria, and neighboring countries, generated by the extreme heat of the parched deserts or sandy plains.
simous |Having a very flat or snub nose, with the end turned up.
simpai |A long-tailed monkey (Semnopitchecus melalophus) native of Sumatra. It has a crest of black hair. The forehead and cheeks are fawn color, the upper parts tawny and red, the under parts white. Called also black-crested monkey, and sinpæ.
simper |1. To smile in a silly, affected, or conceited manner. Behold yond simpering dame. Shak. With a made countenance about her mouth, between simpering and smiling. ir. P. Sidney. 2. To glimmer; to twinkle. [Obs.] Yet can I mark how stars above Simper and shine. Herbert.\n\nA constrained, self-conscious smile; an affected, silly smile; a smirk. The conscious simper, and the jealous leer. Pope.
simperer |One who simpers. Sir W. Scott. A simperer that a court affords. T. Nevile.
simpering |from Simper, v.
simperingly |In a simpering manner.
simple |1. Single; not complex; not infolded or entangled; uncombined; not compounded; not blended with something else; not complicated; as, a simple substance; a simple idea; a simple sound; a simple machine; a simple problem; simple tasks. 2. Plain; unadorned; as, simple dress. \"Simple truth.\" Spenser. \"His simple story.\" Burns. 3. Mere; not other than; being only. A medicine . . . whose simple touch Is powerful to araise King Pepin. Shak. 4. Not given to artifice, stratagem, or duplicity; undesigning; sincere; true. Full many fine men go upon my score, as simple as I stand here, and I trust them. Marston. Must thou trust Tradition's simple tongue Byron. To be simple is to be great. Emerson. 5. Artless in manner; unaffected; unconstrained; natural; inartificial;; straightforward. In simple manners all the secret lies. Young. 6. Direct; clear; intelligible; not abstruse or enigmatical; as, a simple statement; simple language. 7. Weak in intellect; not wise or sagacious; of but moderate understanding or attainments; hence, foolish; silly. \"You have simple wits.\" Shak. The simple believeth every word; but the prudent man looketh well to his going. Prov. xiv. 15. 8. Not luxurious; without much variety; plain; as, a simple diet; a simple way of living. Thy simple fare and all thy plain delights. Cowper. 9. Humble; lowly; undistinguished. A simple husbandman in garments gray. Spenser. Clergy and laity, male and female, gentle and simple made the fuel of the same fire. Fuller. 10. (BOt.)  Without subdivisions; entire; as, a simple stem; a simple leaf. 11. (Chem.)  Not capable of being decomposed into anything more simple or ultimate by any means at present known; elementary; thus, atoms are regarded as simple bodies. Cf. Ultimate, a. Note: A simple body is one that has not as yet been decomposed. There are indications that many of our simple elements are still compound bodies, though their actual decomposition into anything simpler may never be accomplished.fundamental particle 12. (Min.)  Homogenous. 13. (Zoöl.)  Consisting of a single individual or zooid; as, a simple ascidian; -- opposed to compound. Simple contract (Law), any contract, whether verbal or written, which is not of record or under seal. J. W. Smith. Chitty. -- Simple equation (Alg.), an eqyation containing but one unknown quantity, and that quantity only in the first degree. -- Simple eye (Zoöl.), an eye having a single lens; -- opposed to Ant: compound eye. -- Simple interest. See under Interest. -- Simple larceny. (Law) See under Larceny. -- Simple obligation (Rom. Law), an obligation which does not depend for its execution upon any event provided for by the parties, or is not to become void on the happening of any such event. Burrill. Syn. -- Single; uncompounded; unmingled; unmixed; mere; uncombined; elementary; plain; artless; sincere; harmless; undesigning; frank; open; unaffected; inartificial; unadorned; credulous; silly; foolish; shallow; unwise. -- Simple, Silly. One who is simple is sincere, unaffected, and inexperienced in duplicity, -- hence liable to be duped. A silly person is one who is ignorant or weak and also self-confident; hence, one who shows in speech and act a lack of good sense. Simplicity is incompatible with duplicity, artfulness, or vanity, while silliness is consistent with all three. Simplicity denotes lack of knowledge or of guile; silliness denotes want of judgment or right purpose, a defect of character as well as of education. I am a simple woman, much too weak To oppose your cunning. Shak. He is the companion of the silliest people in their most silly pleasure; he is ready for every impertinent entertainment and diversion. Law.\n\n1. Something not mixed or compounded. \"Compounded of many simples.\" Shak. 2. (Med.)  A medicinal plant; -- so called because each vegetable was supposed to possess its particular virtue, and therefore to constitute a simple remedy. What virtue is in this remedy lies in the naked simple itself as it comes over from the Indies. Sir W. Temple. 3. (Weaving) (a) A drawloom. (b) A part of the apparatus for raising the heddles of a drawloom. 4. (R. C. Ch.)  A feast which is not a double or a semidouble.\n\nTo gather simples, or medicinal plants. As simpling on the flowery hills she [Circe] strayed. Garth.
simple-hearted |Sincere; inguenuous; guileless. Sir W. Scott.
simple-minded |Artless; guileless; simple-hearted; undesigning; unsuspecting; devoid of duplicity. Blackstone. -- Sim\"ple-mind`ed*ness, n.
simpleness |The quality or state of being simple; simplicity. Shak.
simpler |One who collects simples, or medicinal plants; a herbalist; a simplist. Simpler's joy. (Bot.) Vervain.
simpless |Simplicity; silliness. [Obs.] Spenser.
simpleton |A person of weak intellect; a silly person.
simplician |One who is simple. [Obs.] Arnway.
simplicity |1. The quality or state of being simple, unmixed, or uncompounded; as, the simplicity of metals or of earths. 2. The quality or state of being not complex, or of consisting of few parts; as, the simplicity of a machine. 3. Artlessness of mind; freedom from cunning or duplicity; lack of acuteness and sagacity. Marquis Dorset, a man, for his harmless simplicity neither misliked nor much regarded. Hayward. In wit a man; simplicity a child. Pope. 4. Freedom from artificial ornament, pretentious style, or luxury; plainness; as, simplicity of dress, of style, or of language; simplicity of diet; simplicity of life. 5. Freedom from subtlety or abstruseness; clearness; as, the simplicity of a doctrine; the simplicity of an explanation or a demonstration. 6. Weakness of intellect; silliness; folly. How long, ye simple ones, will ye love simplicity and the scorners delight in their scorning Prov. i. 22.
simplification |The act of simplifying. A. Smith.
simplify |To make simple; to make less complex; to make clear by giving the explanation for; to show an easier or shorter process for doing or making. The collection of duties is drawn to a point, and so far simplified. A. Hamilton. It is important, in scientific pursuits, to be caitious in simplifying our deductions. W. Nicholson.
simplist |One skilled in simples, or medicinal plants; a simpler. Sir T. Browne.
simplistic |Of or pertaining to simples, or a simplist. [R.] Wilkinson.
simplity |Simplicity. [Obs.]
simploce |See Symploce.
simply |1. In a simple manner or state; considered in or by itself; without addition; along; merely; solely; barely. [They] make that now good or evil, . . . which otherwise of itself were not simply the one or the other. Hooker. Simply the thing I am Shall make me live. Shak. 2. Plainly; without art or subtlety. Subverting worldly strong and worldly wise By simply meek. Milton. 3. Weakly; foolishly. Johnson.
simulacher |See Simulacrum. [Obs.]
simulachre |See Simulacrum. [Obs.]
simulacrum |A likeness; a semblance; a mock appearance; a sham; -- now usually in a derogatory sense. Beneath it nothing but a great simulacrum. Thackeray.
simular |One who pretends to be what he is not; one who, or that which, simulates or counterfeits something; a pretender. [Obs.] Shak. Christ calleth the Pharisees hypocrites, that is to say, simulars, and painted sepulchers. Tyndale.\n\nFalse; specious; counterfeit. [R. & Obs.] \"Thou simular man of virtue.\" Shak.
simulate |Feigned; pretended. Bale.\n\nTo assume the mere appearance of, without the reality; to assume the signs or indications of, falsely; to counterfeit; to feign. The Puritans, even in the depths of the dungeons to which she had sent them, prayed, and with no simulated fervor, that she might be kept from the dagger of the assassin. Macaulay.
simulation |The act of simulating, or assuming an appearance which is feigned, or not true; -- distinguished from dissimulation, which disguises or conceals what is true. Syn. -- Counterfeiting; feint; pretense.
simulator |One who simulates, or feigns. De Quincey.
simulatory |Simulated, or capable of being simulated. Bp. Hall.
simultaneity |The quality or state of being simultaneous; simultaneousness.
simultaneous |Existing, happening, or done, at the same time; as, simultaneous events. -- Si`mul*ta\"ne*ous*ly, adv. -- Si`mul*ta\"ne*ous*ness, n. Simultaneous equations (Alg.), two or more equations in which the values of the unknown quantities entering them are the same at the same time in both or in all.
simulty |Private grudge or quarrel; as, domestic simulties. [Obs.] B. Jonson.
sin |Old form of Since. [Obs. or Prov.Eng. & Scot.] Sin that his lord was twenty year of age. Chaucer.\n\n1. Transgression of the law of God; disobedience of the divine command; any violation of God's will, either in purpose or conduct; moral deficiency in the character; iniquity; as, sins of omission and sins of commission. Whosoever committeth sin is the servant of sin. John viii. 34. Sin is the transgression of the law. 1 John iii. 4. I think 't no sin. To cozen him that would unjustly win. Shak. Enthralled By sin to foul, exorbitant desires. Milton. 2. An offense, in general; a violation of propriety; a misdemeanor; as, a sin against good manners. I grant that poetry's a crying sin. Pope. 3. A sin offering; a sacrifice for sin. He hath made him to be sin for us, who knew no sin. 2 Cor. v. 21. 4. An embodiment of sin; a very wicked person. [R.] Thy ambition, Thou scarlet sin, robbed this bewailing land Of noble Buckingham. Shak. Note: Sin is used in the formation of some compound words of obvious signification; as, sin-born; sin-bred, sin-oppressed, sin-polluted, and the like. Actual sin, Canonical sins, Original sin, Venial sin. See under Actual, Canonical, etc. -- Deadly, or Mortal, sins (R. C. Ch.), willful and deliberate transgressions, which take away divine grace; -- in distinction from vental sins. The seven deadly sins are pride, covetousness, lust, wrath, gluttony, envy, and sloth. -- Sin eater, a man who (according to a former practice in England) for a small gratuity ate a piece of bread laid on the chest of a dead person, whereby he was supposed to have taken the sins of the dead person upon himself. -- Sin offering, a sacrifice for sin; something offered as an expiation for sin. Syn. -- Iniquity; wickedness; wrong. See Crime.\n\n1. To depart voluntarily from the path of duty prescribed by God to man; to violate the divine law in any particular, by actual transgression or by the neglect or nonobservance of its injunctions; to violate any known rule of duty; -- often followed by against. Against thee, thee only, have I sinned. Ps. li. 4. All have sinned, and come short of the glory of God. Rom. iii. 23. 2. To violate human rights, law, or propriety; to commit an offense; to trespass; to transgress. I am a man More sinned against than sinning. Shak. Who but wishes to invert the laws Of order, sins against the eternal cause. Pope.
sinaic |Of or pertaining to Mount Sinai; given or made at Mount Sinai; as, the Sinaitic law. Sinaitic manuscript, a fourth century Greek manuscript of the part Bible, discovered at Mount Sinai (the greater part of it in 1859) by Tisschendorf, a German Biblical critic; -- called also Codex Sinaiticus.
sinaitic |Of or pertaining to Mount Sinai; given or made at Mount Sinai; as, the Sinaitic law. Sinaitic manuscript, a fourth century Greek manuscript of the part Bible, discovered at Mount Sinai (the greater part of it in 1859) by Tisschendorf, a German Biblical critic; -- called also Codex Sinaiticus.
sinalbin |A glucoside found in the seeds of white mustard (Brassica alba, formerly Sinapis alba), and extracted as a white crystalline substance.
sinamine |A bitter white crystalline nitrogenous substance, obtained indirectly from oil of mustard and ammonia; -- called also allyl melamine.
sinapate |A salt of sinapic acid.
sinapic |Of or pertaining to sinapine; specifically, designating an acid (C11H12O5) related to gallic acid, and obtained by the decomposition of sinapine, as a white crystalline substance.
sinapine |An alkaloid occuring in the seeds of mustard. It is extracted, in combination with sulphocyanic acid, as a white crystalline substance, having a hot, bitter taste. When sinapine is isolated it is unstable and undergoes decomposition.
sinapis |A disused generic name for mustard; -- now called Brassica.
sinapisin |A substance extracted from mustard seed and probably identical with sinalbin. [Obs.]
sinapism |A plaster or poultice composed principally of powdered mustard seed, or containing the volatile oil of mustard seed. It is a powerful irritant.
sinapoleic |Of or pertaining to mustard oil; specifically, designating an acid of the oleic acid series said to occur in mistard oil.
sinapoline |A nitrogenous base, CO.(NH.C3H5)2, related to urea, extracted from mustard oil, and also produced artifically, as a white crystalline substance; -- called also diallyl urea.
sincaline |Choline. [Written also sinkaline.]
since |1. From a definite past time until now; as, he went a month ago, and I have not seen him since. We since become the slaves to one man's lust. B. Jonson. 2. In the time past, counting backward from the present; before this or now; ago. w many ages since has Virgil writ Roscommon. About two years since, it so fell out, that he was brought to a great lady's house. Sir P. Sidney. 3. When or that. [Obs.] Do you remember since we lay all night in the windmill in St. George's field Shak.\n\nFrom the time of; in or during the time subsequent to; subsequently to; after; -- usually with a past event or time for the object. The Lord hath blessed thee, since my coming. Gen. xxx. 30. I have a model by which he build a nobler poem than any extant since the ancients. Dryden.\n\nSeeing that; because; considering; -- formerly followed by that. Since that my penitence comes after all, Imploring pardon. Shak. Since truth and constancy are vain, Since neither love, nor sense of pain, Nor force of reason, can persuade, Then let example be obeyed. Granville. Syn. -- Because; for; as; inasmuch as; considering. See Because.
sincere |1. Pure; unmixed; unadulterated. There is no sincere acid in any animal juice. Arbuthnot. A joy which never was sincere till now. Dryden. 2. Whole; perfect; unhurt; uninjured. [Obs.] The inviolable body stood sincere. Dryden. 3. Being in reality what it appears to be; having a character which corresponds with the appearance; not falsely assumed; genuine; true; real; as, a sincere desire for knowledge; a sincere contempt for meanness. A sincere intention of pleasing God in all our actions. Law. 4. Honest; free from hypocrisy or dissimulation; as, a sincere friend; a sincere person. The more sincere you are, the better it will fare with you at the great day of account. Waterland. Syn. -- Honest; unfeigned; unvarnished; real; true; unaffected; inartificial; frank; upright. See Hearty.
sincerely |In a sincere manner. Specifically: (a) Purely; without alloy. Milton. (b) Honestly; unfeignedly; without dissimulation; as, to speak one's mind sincerely; to love virtue sincerely.
sincereness |Same as Sincerity. Beau & Fl.
sincerity |The quality or state of being sincere; honesty of mind or intention; freedom from simulation, hypocrisy, disguise, or false pretense; sincereness. I protest, in the sincerity of love. Shak. Sincerity is a duty no less plain than important. Knox.
sinch |A saddle girth made of leather, canvas, woven horsehair, or woven grass. [Western U.S.]\n\nTo gird with a sinch; to tighten the sinch or girth of (a saddle); as, to sinch up a sadle. [Western U.S.]
sincipital |Of or pertaining to the sinciput; being in the region of the sinciput.
sinciput |1. (Anat.)  The fore part of the head. 2. (Zoöl.)  The part of the head of a bird between the base of the bill and the vertex.
sindi |A native of Sind, India, esp. one of the native Hindoo stock.
sindon |1. A wrapper. [Obs.] \"Wrapped in sindons of linen.\" Bacon. 2. (Surg.)  A small rag or pledget introduced into the hole in the cranium made by a trephine. Dunglison.
sine |(a) The length of a perpendicular drawn from one extremity of an arc of a circle to the diameter drawn through the other extremity. (b) The perpendicular itself. See Sine of angle, below. Artificial sines, logarithms of the natural sines, or logarithmic sines. -- Curve of sines. See Sinusoid. -- Natural sines, the decimals expressing the values of the sines, the radius being unity. -- Sine of an angle, in a circle whose radius is unity, the sine of the arc that measures the angle; in a right-angled triangle, the side opposite the given angle divided by the hypotenuse. See Trigonometrical function, under Function. -- Versed sine, that part of the diameter between the sine and the arc.\n\nWithout.
sinecural |Of or pertaining to a sinecure; being in the nature of a sinecure.
sinecure |1. An ecclesiastical benefice without the care of souls. Ayliffe. 2. Any office or position which requires or involves little or no responsibility, labor, or active service. A lucrative sinecure in the Excise. Macaulay.\n\nTo put or place in a sinecure.
sinecurism |The state of having a sinecure.
sinecurist |One who has a sinecure.
sinew |1. (Anat.)  A tendon or tendonous tissue. See Tendon. 2. Muscle; nerve. [R.] Sir J. Davies. 3. Fig.: That which supplies strength or power. The portion and sinew of her fortune, her marriage dowry. Shak. The bodies of men, munition, and money, may justly be called the sinews of war. Sir W. Raleigh. Note: Money alone is often called the sinews of war.\n\nTo knit together, or make strong with, or as with, sinews. Shak. Wretches, now stuck up for long tortures . . . might, if properly treated, serve to sinew the state in time of danger. Goldsmith.
sinew-shrunk |Having the sinews under the belly shrunk by excessive fatigue.
sinewed |1. Furnished with sinews; as, a strong-sinewed youth. 2. Fig.: Equipped; strengthened. When he sees Ourselves well sinewed to our defense. Shak.
sinewiness |Quality of being sinewy.
sinewish |Sinewy. [Obs.] Holinshed.
sinewless |Having no sinews; hence, having no strength or vigor.
sinewous |Sinewy. [Obs.] Holinshed.
sinewy |1. Pertaining to, consisting of, or resembling, a sinew or sinews. The sinewy thread my brain lets fall. Donne. 2. Well braced with, or as if with, sinews; nervous; vigorous; strong; firm; tough; as, the sinewy Ajax. A man whose words . . . were so close and sinewy. Hare.
sinful |Tainted with, or full of, sin; wicked; iniquitous; criminal; unholy; as, sinful men; sinful thoughts. Piers Plowman. Ah sinful nation, a people laden with iniquity. Isa. i. 4. -- Sin\"ful*ly, adv. -- Sin\"ful*ness, n.
sing |1. To utter sounds with musical inflections or melodious modulations of voice, as fancy may dictate, or according to the notes of a song or tune, or of a given part (as alto, tenor, etc.) in a chorus or concerted piece. The noise of them that sing do I hear. Ex. xxxii. 18. 2. To utter sweet melodious sounds, as birds do. On every bough the briddes heard I sing. Chaucer. Singing birds, in silver cages hung. Dryden. 3. To make a small, shrill sound; as, the air sings in passing through a crevice. O'er his head the flying spear Sang innocent, and spent its force in air. Pope. 4. To tell or relate something in numbers or verse; to celebrate something in poetry. Milton. Bid her . . . sing Of human hope by cross event destroyed. Prior. 5. Ti cry out; to complain. [Obs.] They should sing if thet they were bent. Chaucer.\n\n1. To utter with musical infections or modulations of voice. And they sing the song of Moses, the servant of God, and the song of the Lamb. Rev. xv. 3. And in the darkness sing your carol of high praise. Keble. 2. To celebrate is song; to give praises to in verse; to relate or rehearse in numbers, verse, or poetry. Milton. Arms and the man I sing. Dryden. The last, the happiest British king, Whom thou shalt paint or I shall sing. Addison. 3. To influence by singing; to lull by singing; as, to sing a child to sleep. 4. To accompany, or attend on, with singing. I heard them singing home the bride. Longfellow.
sing-sing |The kob.
singe |1. To burn slightly or superficially; to burn the surface of; to burn the ends or outside of; as, to singe the hair or the skin. You sulphurous and thought-executing fires, . . . Singe my white head! Shak. I singed the toes of an ape through a burning glass. L'Estrange. 2. (a) To remove the nap of (cloth), by passing it rapidly over a red- hot bar, or over a flame, preliminary to dyeing it. (b) To remove the hair or down from (a plucked chicken or the like) by passing it over a flame.\n\nA burning of the surface; a slight burn.
singer |One who, or that which, singes. Specifically: (a) One employed to singe cloth. (b) A machine for singeing cloth.\n\nOne who sings; especially, one whose profession is to sing.
singeress |A songstress. [Obs.] Wyclif.
singhalese |Same as Cingalese.
singing |from Sing, v. Singing bird. (Zoöl.) (a) Popularly, any bird that sings; a song bird. (b) Specifically, any one of the Oscines. -- Singing book, a book containing music for singing; a book of tunes. -- Singing falcon or hawk. (Zoöl.) See Chanting falcon, under Chanting. -- Singing fish (Zoöl.), a California toadfish (Porichthys porosissimus). -- Singing flame (Acoustics), a flame, as of hydrogen or coal gas, burning within a tube and so adjusted as to set the air within the tube in vibration, causing sound. The apparatus is called also chemical harmonicon. -- Singing master, a man who teaches vocal music. -- Singing school, a school in which persons are instructed in singing.
singingly |With sounds like singing; with a kind of tune; in a singing tone. G. North (1575).
single |1. One only, as distinguished from more than one; consisting of one alone; individual; separate; as, a single star. No single man is born with a right of controlling the opinions of all the rest. Pope. 2. Alone; having no companion. Who single hast maintained, Against revolted multitudes, the cause Of truth. Milton. 3. Hence, unmarried; as, a single man or woman. Grows, lives, and dies in single blessedness. Shak. Single chose to live, and shunned to wed. Dryden. 4. Not doubled, twisted together, or combined with others; as, a single thread; a single strand of a rope. 5. Performed by one person, or one on each side; as, a single combat. These shifts refuted, answer thy appellant, . . . Who now defles thee thrice ti single fight. Milton. 6. Uncompounded; pure; unmixed. Simple ideas are opposed to complex, and single to compound. I. Watts. 7. Not deceitful or artful; honest; sincere. I speak it with a single heart. Shak. 8. Simple; not wise; weak; silly. [Obs.] He utters such single matter in so infantly a voice. Beau & Fl. Single ale, beer, or drink, small ale, etc., as contrasted with double ale, etc., which is stronger. [Obs.] Nares. -- Single bill (Law), a written engagement, generally under seal, for the payment of money, without a penalty. Burril. -- Single court (Lawn Tennis), a court laid out for only two players. -- Single-cut file. See the Note under 4th File. -- Single entry. See under Bookkeeping. -- Single file. See under 1st File. -- Single flower (Bot.), a flower with but one set of petals, as a wild rose. -- Single knot. See Illust. under Knot. -- Single whip (Naut.), a single rope running through a fixed block.\n\n1. To select, as an individual person or thing, from among a number; to choose out from others; to separate. Dogs who hereby can single out their master in the dark. Bacon. His blood! she faintly screamed her mind Still singling one from all mankind. More. 2. To sequester; to withdraw; to retire. [Obs.] An agent singling itself from consorts. Hooker. 3. To take alone, or one by one. Men . . . commendable when they are singled. Hooker.\n\nTo take the irrregular gait called single-foot;- said of a horse. See Single-foot. Many very fleet horses, when overdriven, adopt a disagreeable gait, which seems to be a cross between a pace and a trot, in which the two legs of one side are raised almost but not quite, simultaneously. Such horses are said to single, or to be single-footed. W. S. Clark.\n\n1. A unit; one; as, to score a single. 2. pl.  The reeled filaments of silk, twisted without doubling to give them firmness. 3. A handful of gleaned grain. [Prov. Eng. & Scot.] 4. (Law Tennis)  A game with but one player on each side; -- usually in the plural. 5. (Baseball)  A hit by a batter which enables him to reach first base only.
single tax |A tax levied upon land alone, irrespective of improvements, -- advocated by certain economists as the sole source of public revenue. Whatever may be thought of Henry George's single-tax theory as a whole, there can be little question that a relatively higher assessment of ground rent, with corresponding relief for those who have made improvements, is a much-needed reform. A. T. Hadley.
single-acting |Having simplicity of action; especially (Mach.), acting or exerting force during strokes in one direction only; -- said of a reciprocating engine, pump, etc.
single-breasted |Lapping over the breast only far enough to permit of buttoning, and having buttons on one edge only; as, a single-breasted coast.
single-foot |An irregular gait of a horse; -- called also single-footed pace. See Single, v. i. Single-foot is an irregular pace, rather rare, distinguished by the posterior extremities moving in the order of a fast walk, and the anterior extremities in that of a slow trot. Stillman (The Horse in Motion.)
single-handed |Having but one hand, or one workman; also, alone; unassisted.
single-hearted |Having an honest heart; free from duplicity. -- Sin\"gle-heart\"ed*ly, adv.
single-minded |Having a single purpose; hence, artless; guileless; single- hearted.
single-surfaced |Having one surface; -- said specif. of aëroplanes or aërocurves that are covered with fabric, etc., on only one side.
singleness |1. The quality or state of being single, or separate from all others; the opposite of doubleness, complication, or multiplicity. 2. Freedom from duplicity, or secondary and selfish ends; purity of mind or purpose; simplicity; sincerity; as, singleness of purpose; singleness of heart.
singles |See Single, n., 2.
singlestick |(a) In England and Scotland, a cudgel used in fencing or fighting; a backsword. (b) The game played with singlesticks, in which he who first brings blood from his adversary's head is pronounced victor; backsword; cudgeling.
singlet |An unlined or undyed waistcoat; a single garment; -- opposed to doublet. [Prov. Eng.]
singleton |In certain games at cards, as whist, a single card of any suit held at the deal by a player; as, to lead a singleton.
singletree |The pivoted or swinging bar to which the traces of a harnessed horse are fixed; a whiffletree. Note: When two horses draw abreast, a singletree is fixed at each end of another crosspiece, called the doubletree.
singly |1. Individually; particularly; severally; as, to make men singly and personally good. 2. Only; by one's self; alone. Look thee, 't is so! Thou singly honest man. Shak. 3. Without partners, companions, or associates; single-handed; as, to attack another singly. At omber singly to decide their doom. Pope. 4. Honestly; sincerely; simply. [R.] Johnson. 5. Singularly; peculiarly. [Obs.] Milton.
singsong |1. Bad singing or poetry. 2. A drawling or monotonous tone, as of a badly executed song.\n\nDrawling; monotonous.\n\nTo write poor poetry. [R.] Tennyson.
singspiel |A dramatic work, partly in dialogue and partly in song, of a kind popular in Germany in the latter part of the 18th century. It was often comic, had modern characters, and patterned its music on folk song with strictly subordinated accompaniment.
singster |A songstress. [Obs.] Wyclif.
singular |1. Separate or apart from others; single; distinct. [Obs.] Bacon. And God forbid that all a company Should rue a singular man's folly. Chaucer. 2. Engaged in by only one on a side; single. [Obs.] To try the matter thus together in a singular combat. Holinshed. 3. (Logic)  Existing by itself; single; individual. The idea which represents one . . . determinate thing, is called a singular idea, whether simple, complex, or compound. I. Watts. 4. (Law)  Each; individual; as, to convey several parcels of land, all and singular. 5. (Gram.)  Denoting one person or thing; as, the singular number; -- opposed to dual and Ant: plural. 6. Standing by itself; out of the ordinary course; unusual; uncommon; strange; as, a singular phenomenon. So singular a sadness Must have a cause as strange as the effect. Denham. 7. Distinguished as existing in a very high degree; rarely equaled; eminent; extraordinary; exceptional; as, a man of singular gravity or attainments. 8. Departing from general usage or expectations; odd; whimsical; -- often implying disapproval or consure. His zeal None seconded, as out of season judged, Or singular and rash. Milton. To be singular in anything that is wise and worthy, is not a disparagement, but a praise. Tillotson. 9. Being alone; belonging to, or being, that of which there is but one; unique. These busts of the emperors and empresses are all very scarce, and some of them almost singular in their kind. Addison. Singular point in a curve (Math.), a point at which the curve possesses some peculiar properties not possessed by other points of the curve, as a cusp point, or a multiple point. -- Singular proposition (Logic), a proposition having as its subject a singular term, or a common term limited to an individual by means of a singular sign. Whately. -- Singular succession (Civil Law), division among individual successors, as distinguished from universal succession, by which an estate descended in intestacy to the heirs in mass. -- Singular term (Logic), a term which represents or stands for a single individual. Syn. -- Unexampled; unprecedented; eminent; extraordinary; remarkable; uncommon; rare; unusual; peculiar; strange; odd; eccentric; fantastic.\n\n1. An individual instance; a particular. [Obs.] Dr. H. More. 2. (Gram)  The singular number, or the number denoting one person or thing; a word in the singular number.
singularist |One who affects singularity. [Obs.] A clownish singularist, or nonconformist to ordinary usage. Borrow.
singularity |1. The quality or state of being singular; some character or quality of a thing by which it is distinguished from all, or from most, others; peculiarity. Pliny addeth this singularity to that soil, that the second year the very falling down of the seeds yieldeth corn. Sir. W. Raleigh. I took notice of this little figure for the singularity of the instrument. Addison. 2. Anything singular, rare, or curious. Your gallery Have we passed through, not without much content In many singularities. Shak. 3. Possession of a particular or exclusive privilege, prerogative, or distinction. No bishop of Rome ever took upon him this name of singularity [universal bishop]. Hooker. Catholicism . . . must be understood in opposition to the legal singularity of the Jewish nation. Bp. Pearson. 4. Celibacy. [Obs.] Jer. Taylor.
singularize |To make singular or single; to distinguish. [R.]
singularly |1. In a singular manner; in a manner, or to a degree, not common to others; extraordinarily; as, to be singularly exact in one's statements; singularly considerate of others. \"Singularly handsome.\" Milman. 2. Strangely; oddly; as, to behave singularly. 3. So as to express one, or the singular number.
singult |A sigh or sobbing; also, a hiccough. [Obs.] Spenser. W. Browne.
singultous |Relating to, or affected with, hiccough. Dunglison.
singultus |Hiccough.
sinic |Of or pertaining to the Chinese and allied races; Chinese.
sinical |Of or pertaining to a sine; employing, or founded upon, sines; as, a sinical quadrant.
sinicism |Anything peculiar to the Chinese; esp., a Chinese peculiarity in manners or customs.
sinigrin |A glucoside found in the seeds of black mustard (Brassica nigra, formerly Sinapis nigra) It resembles sinalbin, and consists of a potassium salt of myronic acid.
sinister |1. On the left hand, or the side of the left hand; left; -- opposed to dexter, or right. \"Here on his sinister cheek.\" Shak. My mother's blood Runs on the dexter cheek, and this sinister Bounds in my father's Shak. Note: In heraldy the sinister side of an escutcheon is the side which would be on the left of the bearer of the shield, and opposite the right hand of the beholder. 2. Unlucky; inauspicious; disastrous; injurious; evil; -- the left being usually regarded as the unlucky side; as, sinister influences. All the several ills that visit earth, Brought forth by night, with a sinister birth. B. Jonson. 3. Wrong, as springing from indirection or obliquity; perverse; dishonest; corrupt; as, sinister aims. Nimble and sinister tricks and shifts. Bacon. He scorns to undermine another's interest by any sinister or inferior arts. South. He read in their looks . . . sinister intentions directed particularly toward himself. Sir W. Scott. 4. Indicative of lurking evil or harm; boding covert danger; as, a sinister countenance. Bar sinister. (Her.) See under Bar, n. -- Sinister aspect (Astrol.), an appearance of two planets happening according to the succession of the signs, as Saturn in Aries, and Mars in the same degree of Gemini. -- Sinister base, Sinister chief. See under Escutcheon.
sinister-handed |Left-handed; hence, unlucky. [Obs.] Lovelace.
sinisterly |In a sinister manner. Wood.
sinistrad |Toward the left side; sinistrally.
sinistral |1. Of or pertaining to the left, inclining to the left; sinistrous; - - opposed to dextral. 2. (Zoöl.)  Having the whorls of the spire revolving or rising to the left; reversed; -- said of certain spiral shells.
sinistrality |The quality or state of being sinistral.
sinistrally |Toward the left; in a sinistral manner. J. Le Conte.
sinistrin |A mucilaginous carbohydrate, resembling achroödextrin, extracted from squill as a colorless amorphous substance; -- so called because it is levorotatory.
sinistrorsal |Rising spirally from right to left (of the spectator); sinistrorse.
sinistrorse |Turning to the left (of the spectator) in the ascending line; - - the opposite of dextrorse. See Dextrorse.
sinistrous |1. Being on the left side; inclined to the left; sinistral. \"Sinistrous gravity.\" Sir T. Browne. 2. Wrong; absurd; perverse. A knave or fool can do no harm, even by the most sinistrous and absurd choice. Bentley.
sinistrously |1. In a sinistrous manner; perversely; wrongly; unluckily. 2. With a tendency to use the left hand. Many, in their infancy, are sinistrously disposed, and divers continue all their life left-handed. Sir T. Browne.
sink |1. To fall by, or as by, the force of gravity; to descend lower and lower; to decline gradually; to subside; as, a stone sinks in water; waves rise and sink; the sun sinks in the west. I sink in deep mire. Ps. lxix. 2. 2. To enter deeply; to fall or retire beneath or below the surface; to penetrate. The stone sunk into his forehead. 1 San. xvii. 49. 3. Hence, to enter so as to make an abiding impression; to enter completely. Let these sayings sink down into your ears. Luke ix. 44. 4. To be overwhelmed or depressed; to fall slowly, as so the ground, from weakness or from an overburden; to fail in strength; to decline; to decay; to decrease. I think our country sinks beneath the yoke. Shak. He sunk down in his chariot. 2 Kings ix. 24. Let not the fire sink or slacken. Mortimer. 5. To decrease in volume, as a river; to subside; to become diminished in volume or in apparent height. The Alps and Pyreneans sink before him. Addison. Syn. -- To fall; subside; drop; droop; lower; decline; decay; decrease; lessen.\n\n1. To cause to sink; to put under water; to immerse or submerge in a fluid; as, to sink a ship. [The Athenians] fell upon the wings and sank a single ship. Jowett (Thucyd.). 2. Figuratively: To cause to decline; to depress; to degrade; hence, to ruin irretrievably; to destroy, as by drowping; as, to sink one's reputation. I raise of sink, imprison or set free. Prior. If I have a conscience, let it sink me. Shak. Thy cruel and unnatural lust of power Has sunk thy father more than all his years. Rowe. 3. To make (a depression) by digging, delving, or cutting, etc.; as, to sink a pit or a well; to sink a die. 4. To bring low; to reduce in quantity; to waste. You sunk the river repeated draughts. Addison. 5. To conseal and appropriate. [Slang] If sent with ready money to buy anything, and you happen to be out of pocket, sink the money, and take up the goods on account. Swift. 6. To keep out of sight; to suppress; to ignore. A courtly willingness to sink obnoxious truths. Robertson. 7. To reduce or extinguish by payment; as, to sink the national debt.\n\n1. A drain to carry off filthy water; a jakes. 2. A shallow box or vessel of wood, stone, iron, or other material, connected with a drain, and used for receiving filthy water, etc., as in a kitchen. 3. A hole or low place in land or rock, where waters sink and are lost; -- called also sink hole. [U. S.] Sink hole. (a) The opening to a sink drain. (b) A cesspool. (c) Same as Sink, n., 3.
sinker |One who, or that which, sinks. Specifically: (a) A weight on something, as on a fish line, to sink it. (b) In knitting machines, one of the thin plates, blades, or other devices, that depress the loops upon or between the needles. Dividing sinker, in knitting machines, a sinker between two jack sinkers and acting alternately with them. -- Jack sinker. See under Jack, n. -- Sinker bar. (a) In knitting machines, a bar to which one set of the sinkers is attached. (b) In deep well boring, a heavy bar forming a connection between the lifting rope and the boring tools, above the jars.
sinking |from Sink. Sinking fund. See under Fund. -- Sinking head (Founding), a riser from which the mold is fed as the casting shrinks. See Riser, n., 4. -- Sinking pump, a pump which can be lowered in a well or a mine shaft as the level of the water sinks.
sinless |Free from sin. Piers Plowman. -- Sin\"less*ly, adv. -- Sin\"less*ness, n.
sinner |One who has sinned; especially, one who has sinned without repenting; hence, a persistent and incorrigible transgressor; one condemned by the law of God.\n\nTo act as a sinner. [Humorous] Whether the charmer sinner it or saint it. Pope.
sinneress |A woman who sins. [Obs.]
sinnet |See Sennit .
sinological |Relating to the Chinese language or literature.
sinologist |A sinilogue.
sinologue |A student of Chinese; one versed in the Chinese language, literature, and history.
sinology |That branch of systemized knowledge which treats of the Chinese, their language, literature, etc.
sinoper |Sinople.
sinopia |A red pigment made from sinopite.
sinopis |A red pigment made from sinopite.
sinopite |A brickred ferruginous clay used by the ancients for red paint.
sinople |Ferruginous quartz, of a blood-red or brownish red color, sometimes with a tinge of yellow.\n\nThe tincture vert; green.
sinque |See Cinque. [Obs.] Beau & Fl.
sinsring |Same as Banxring.
sinter |Dross, as of iron; the scale which files from iron when hammered; -- applied as a name to various minerals. Calcareous sinter, a loose banded variety of calcite formed by deposition from lime-bearing waters; calcareous tufa; travertine. -- Ceraunian sinter, fulgurite. -- Siliceous sinter, a light cellular or fibrous opal; especially, geyserite (see Geyserite). It has often a pearly luster, and is then called pearl sinter.
sinto |See Shinto, etc.
sintoc |A kind of spice used in the East Indies, consisting of the bark of a species of Cinnamomum. [Written also sindoc.]
sintoism |See Shinto, etc.
sintoist |See Shinto, etc.
sintu |See Shinto, etc.
sinuate |Having the margin alternately curved inward and outward; having rounded lobes separated by rounded sinuses; sinuous; wavy.\n\nTo bend or curve in and out; to wind; to turn; to be sinusous. Woodward.
sinuated |Same as Sinuate.
sinuation |A winding or bending in and out.
sinuose |Sinuous. Loudon.
sinuosity |1. Quality or state of being sinuous. 2. A bend, or a series of bends and turns; a winding, or a series of windings; a wave line; a curve. A line of coast certainly amounting, with its sinuosities, to more than 700 miles. Sydney Smith.
sinuous |Bending in and out; of a serpentine or undulating form; winding; crooked. -- Sin\"u*ous*ly, adv. Streaking the ground with sinuous trace. Milton. Gardens bright with sinuous rills. Coleridge.
sinupalliate |Having a pallial sinus. See under Sinus.
sinus |1. An opening; a hollow; a bending. 2. A bay of the sea; a recess in the shore. 3. (Anat. & Zoöl.)  A cavity; a depression. Specifically: (a) A cavity in a bone or other part, either closed or with a narrow opening. (b) A dilated vessel or canal. 4. (Med.)  A narrow, elongated cavity, in which pus is collected; an elongated abscess with only a small orifice. 5. (Bot.)  A depression between adjoining lobes. Note: A sinus may be rounded, as in the leaf of the white oak, or acute, as in that of the red maple. Pallial sinus. (Zoöl.) See under Pallial. -- Sinus venosus. Etym: [L., venous dilatation.] (Anat.) (a) The main part of the cavity of the right auricle of the heart in the higher vertebrates. (b) In the lower vertebrates, a distinct chamber of the heart formed by the union of the large systematic veins and opening into the auricle.
sinusoid |The curve whose ordinates are proportional to the sines of the abscissas, the equation of the curve being y = a sin x. It is also called the curve of sines.
sinusoidal |Of or pertaining to a sinusoid; like a sinusoid.
siogoon |See Shogun.
siogoonate |See Shogunate.
sioux |See Dakotas.
sioux state |North Dakota; -- a nickname.
sip |1. To drink or imbibe in small quantities; especially, to take in with the lips in small quantities, as a liquid; as, to sip tea. \"Every herb that sips the dew.\" Milton. 2. To draw into the mouth; to suck up; as, a bee sips nectar from the flowers. 3. To taste the liquor of; to drink out of. [Poetic] They skim the floods, and sip the purple flowers. Dryden.\n\nTo drink a small quantity; to take a fluid with the lips; to take a sip or sips of something. [She] raised it to her mouth with sober grace; Then, sipping, offered to the next in place. Dryden.\n\n1. The act of sipping; the taking of a liquid with the lips. 2. A small draught taken with the lips; a slight taste. One sip of this Will bathe the drooping spirits in delight Beyond the bliss of dreams. Milton. A sip is all that the public ever care to take from reservoirs of abstract philosophy. De Quincey.
sipage |Water that seeped or oozed through a porous soil. [Scot. & U. S.]\n\nSee Seepage. [Scot. & U.S.]
sipe |To run or soak through fine pores and interstices; to ooze. [Scot. & U. S.] Water seeps up through the sidewalks. G. W. Cable.\n\nSee Seep. [Scot. & U.S.]
siphilis |Syphilis.
siphoid |A siphon bottle. See under Siphon, n.
siphon |1. A device, consisting of a pipe or tube bent so as to form two branches or legs of unequal length, by which a liquid can be transferred to a lower level, as from one vessel to another, over an intermediate elevation, by the action of the pressure of the atmosphere in forcing the liquid up the shorter branch of the pipe immersed in it, while the continued excess of weight of the liquid in the longer branch (when once filled) causes a continuous flow. The flow takes place only when the discharging extremity of the pipe ia lower than the higher liquid surface, and when no part of the pipe is higher above the surface than the same liquid will rise by atmospheric pressure; that is, about 33 feet for water, and 30 inches for mercury, near the sea level. 2. (Zoöl.) (a) One of the tubes or folds of the mantle border of a bivalve or gastropod mollusk by which water is conducted into the gill cavity. See Illust. under Mya, and Lamellibranchiata. (b) The anterior prolongation of the margin of any gastropod shell for the protection of the soft siphon. (c) The tubular organ through which water is ejected from the gill cavity of a cephaloid. It serves as a locomotive organ, by guiding and confining the jet of water. Called also siphuncle. See Illust. under Loligo, and Dibranchiata. (d) The siphuncle of a cephalopod shell. (e) The sucking proboscis of certain parasitic insects and crustaceans. (f) A sproutlike prolongation in front of the mouth of many gephyreans. (g) A tubular organ connected both with the esophagus and the intestine of certain sea urchins and annelids. 3. A siphon bottle. Inverted siphon, a tube bent like a siphon, but having the branches turned upward; specifically (Hydraulic Engineering), a pipe for conducting water beneath a depressed place, as from one hill to another across an intervening valley, following the depression of the ground. -- Siphon barometer. See under Barometer. -- Siphon bottle, a bottle for holding aërated water, which is driven out through a bent tube in the neck by the gas within the bottle when a valve in the tube is opened; -- called also gazogene, and siphoid. -- Siphon condenser, a condenser for a steam engine, in which the vacuum is maintained by the downward flow of water through a vertical pipe of great height. -- Siphon cup, a cup with a siphon attached for carrying off any liquid in it; specifically (Mach.), an oil cup in which oil is carried over the edge of a tube in a cotton wick, and so reaches the surface to be lubricated. -- Siphon gauge. See under Gauge. -- Siphon pump, a jet pump. See under Jet, n.\n\nTo convey, or draw off, by means of a siphon, as a liquid from one vessel to another at a lower level.
siphonage |The action of a siphon.
siphonal |Of or pertaining to a siphon; resembling a siphon. Siphonal stomach (Zoöl.), a stomach which is tubular and bent back upon itself, like a siphon, as in the salmon.
siphonarid |Any one of numerous species of limpet-shaped pulmonate gastropods of the genus Siphonaria. They cling to rocks between high and low water marks and have both lunglike organs and gills. -- Si`pho*na\"rid, a.
siphonata |A tribe of bivalve mollusks in which the posterior mantle border is prolonged into two tubes or siphons. Called also Siphoniata. See Siphon, 2 (a), and Quahaug.
siphonate |1. Having a siphon or siphons. 2. (Zoöl.)  Belonging to the Siphonata.
siphonet |One of the two dorsal tubular organs on the hinder part of the abdomen of aphids. They give exit to the honeydew. See Illust. under Aphis.
siphonia |A former name for a euphorbiaceous genus (Hevea) of South American trees, the principal source of caoutchouc.
siphoniata |Same as Siphonata.
siphonic |Of or pertaining to a siphon.
siphonifer |Any cephalopod having a siphonate shell.
siphoniferous |Siphon-bearing, as the shell of the nautilus and other cephalopods.
siphonium |A bony tube which, in some birds, connects the tympanium with the air chambers of the articular piece of the mandible.
siphonobranchiata |A tribe of gastropods having the mantle border, on one or both sides, prolonged in the form of a spout through which water enters the gill cavity. The shell itself is not always siphonostomatous in this group.
siphonobranchiate |Having a siphon, or siphons, to convey water to the gills; belonging or pertaining to the Siphonobranchiata. -- n.  One of the Siphonobranchiata.
siphonoglyphe |A gonidium.
siphonophora |An order of pelagic Hydrozoa including species which form complex free-swimming communities composed of numerous zooids of various kinds, some of which act as floats or as swimming organs, others as feeding or nutritive zooids, and others as reproductive zooids. See Illust. under Physallia, and Porpita.
siphonophoran |Belonging to the Siphonophora. -- n.  One of the Siphonophora.
siphonophore |One of the Siphonophora.
siphonopoda |A division of Scaphopoda including those in which the foot terminates in a circular disk.
siphonostomata |(a) A tribe of parasitic copepod Crustacea including a large number of species that are parasites of fishes, as the lerneans. They have a mouth adapted to suck blood. (b) An artificial division of gastropods including those that have siphonostomatous shells.
siphonostomatous |(a) Having the front edge of the aperture of the shell prolonged in the shape of a channel for the protection of the siphon; -- said of certain gastropods. (b) Pertaining to the Siphonostomata.
siphonostome |(a) Any parasitic entomostracan of the tribe Siphonostomata. (b) A siphonostomatous shell.
siphorhinal |Having tubular nostrils, as the petrels.
siphorhinian |A siphorhinal bird.
siphuncle |The tube which runs through the partitions of chambered cephalopod shells.
siphuncled |Having a siphuncle; siphunculated.
siphuncular |Of or pertaining to the siphuncle.
siphunculated |Having a siphuncle. Huxley.
sipid |Having a taste or flavorl savory; sapid. [Obs.] Cockeram.
sipper |One whi sips.
sippet |A small sop; a small, thin piece of toasted bread soaked in milk, broth, or the like; a small piece of toasted or fried bread cut into some special shape and used for garnishing. Your sweet sippets in widows' houses. Milton.
sipple |To sip often. [Obs. or Scot.]
sippling |Sipping often. [Obs.] \"Taken after a sippling sort.\" Holland.
sipunculacea |A suborder of Gephyrea, including those which have the body unarmed and the intestine opening anteriorly.
sipunculoid |Pertaining to the Sipunculoidea. -- n.  One of the Sipunculoidea.
sipunculoidea |(a) Same as Gephyrea. (b) In a restricted sense, same as Sipunculacea.
sipy |Oozy; -- applied to land under cultivation that is not well drained.
sir |1. A man of social authority and dignity; a lord; a master; a gentleman; -- in this sense usually spelled sire. [Obs.] He was crowned lord and sire. Gower. In the election of a sir so rare. Shak. 2. A title prefixed to the Christian name of a knight or a baronet. Sir Horace Vere, his brother, was the principal in the active part. Bacon. 3. An English rendering of the LAtin Dominus, the academical title of a bachelor of arts; -- formerly colloquially, and sometimes contemptuously, applied to the clergy. Nares. Instead of a faithful and painful teacher, they hire a Sir John, which hath better skill in playing at tables, or in keeping of a garden, than in God's word. Latimer. 4. A respectful title, used in addressing a man, without being prefixed to his name; -- used especially in speaking to elders or superiors; sometimes, also, used in the way of emphatic formality. \"What's that to you, sir\" Sheridan. Note: Anciently, this title, was often used when a person was addressed as a man holding a certain office, or following a certain business. \"Sir man of law.\" \"Sir parish priest.\" Chaucer. Sir reverance. See under Reverence, n.
siraskier |See Seraskier.
siraskierate |See Seraskierate.
sirbonian |See Serbonian.
sircar |1. A Hindoo clerk or accountant. [India] 2. A district or province; a circar. [India] 3. The government; the supreme authority of the state. [India]
sirdar |A native chief in Hindostan; a headman. Malcom.
sire |1. A lord, master, or other person in authority. See Sir. [Obs.] Pain and distress, sickness and ire, And melancholy that angry sire, Be of her palace senators. Rom. of R. 2. A tittle of respect formerly used in speaking to elders and superiors, but now only in addressing a sovereign. 3. A father; the head of a family; the husband. Jankin thet was our sire [i.e., husband]. Chaucer. And raise his issue, like a loving sire. Shak. 4. A creator; a maker; an author; an originator. [He] was the sire of an immortal strain. Shelley. 5. The male parent of a beast; -- applied especially to horses; as, the horse had a good sire. Note: Sire is often used in composition; as in grandsire, grandfather; great-grandsire, great-grandfather.\n\nTo beget; to procreate; -- used of beasts, and especially of stallions.
siredon |The larval form of any salamander while it still has external gills; especially, one of those which, like the axolotl (Amblystoma Mexicanum), sometimes lay eggs while in this larval state, but which under more favorable conditions lose their gills and become normal salamanders. See also Axolotl.
siren |1. (Class. Myth.)  One of three sea nymphs, -- or, according to some writers, of two, -- said to frequent an island near the coast of Italy, and to sing with such sweetness that they lured mariners to destruction. Next where the sirens dwell you plow the seas; Their song is death, and makes destruction please. Pope. 2. An enticing, dangerous woman. Shak. 3. Something which is insidious or deceptive. Consumption is a siren. W. Irving. 4. A mermaid. [Obs.] Shak. 5. (Zoöl.)  Any long, slender amphibian of the genus Siren or family Sirenidæ, destitute of hind legs and pelvis, and having permanent external gills as well as lungs. They inhabit the swamps, lagoons, and ditches of the Southern United States. The more common species (Siren lacertina) is dull lead-gray in color, and becames two feet long. 6. Etym: [F. sirène, properly, a siren in sense 1.] (Acoustics)  An instrument for producing musical tones and for ascertaining the number of sound waves or vibrations per second which produce a note of a given pitch. The sounds are produced by a perforated rotating disk or disks. A form with two disks operated by steam or highly compressed air is used sounding an alarm to vessels in fog. [Written also sirene, and syren.]\n\nOf or pertaining to a siren; bewitching, like a siren; fascinating; alluring; as, a siren song.
sirene |See Siren, 6.
sirenia |An order of large aquatic herbivorous mammals, including the manatee, dugong, rytina, and several fossil genera. Note: The hind limbs are either rudimentary or wanting, and the front ones are changed to paddles. They have horny plates on the front part of the jaws, and usually flat-crowned molar teeth. The stomach is complex and the intestine long, as in other herbivorous mammals. See Cetacea (b).
sirenian |Any species of Sirenia.
sirenical |Like, or appropriate to, a siren; fascinating; deceptive. Here's couple of sirenical rascals shall enchant ye. Marton.
sirenize |To use the enticements of a siren; to act as a siren; to fascinate.
siriasis |(a) A sunstroke. (b) The act of exposing to a sun bath. [Obs.] Cf. Insolation.
sirius |The Dog Star. See Dog Star.
sirkeer |Any one of several species of Asiatic cuckoos of the genus Taccocua, as the Bengal sirkeer (T. sirkee).
sirloin |A loin of beef, or a part of a loin. [Written also surloin.]
sirname |See Surname.
siroc |See Sirocco. [Poetic] Emerson.
sirocco |An oppressive, relaxing wind from the Libyan deserts, chiefly experienced in Italy, Malta, and Sicily.
sirrah |A term of address implying inferiority and used in anger, contempt, reproach, or disrespectful familiarity, addressed to a man or boy, but sometimes to a woman. In sililoquies often preceded by ah. Not used in the plural. \"Ah, sirrah mistress.\" Beau & Fl. Go, sirrah, to my cell. Shak.
sirt |A quicksand. [Obs.]
sirup |1. A thick and viscid liquid made from the juice of fruits, herbs, etc., boiled with sugar. 2. A thick and viscid saccharine solution of superior quality (as sugarhouse sirup or molasses, maple sirup); specifically, in pharmacy and often in cookery, a saturated solution of sugar and water (simple sirup), or such a solution flavored or medicated. Lucent sirups tinct with cinnamon. Keats. Mixing sirup. See the Note under Dextrose.
siruped |Moistened, covered, or sweetened with sirup, or sweet juice.
sirupy |Like sirup, or partaking of its qualities. Mortimer.
sirvente |A peculiar species of poetry, for the most part devoted to moral and religious topics, and commonly satirical, -- often used by the troubadours of the Middle Ages.
sis |A colloquial abbreviation of Sister.\n\nSix. See Sise. [Obs.] Chaucer.
sisal grass |The prepared fiber of the Agave Americana, or American aloe, used for cordage; -- so called from Sisal, a port in Yucatan. See Sisal hemp, under Hemp.
sisal hemp |The prepared fiber of the Agave Americana, or American aloe, used for cordage; -- so called from Sisal, a port in Yucatan. See Sisal hemp, under Hemp.
siscowet |A large, fat variety of the namaycusa found in Lake Superior; - - called also siskawet, siskiwit.
sise |An assize. [Obs.]\n\nSix; the highest number on a die; the cast of six in throwing dice. In the new casting of a die, when ace is on the top, sise must needs be at the bottom. Fuller.
sisel |The suslik.
siser |Cider. See Sicer. [Obs.] Chaucer.
siserara |A hard blow. [Prov. Eng.] Halliwell.
siserary |A hard blow. [Prov. Eng.] Halliwell.
siskin |(a) A small green and yellow European finch (Spinus spinus, or Carduelis spinus); -- called also aberdevine. (b) The American pinefinch (S. pinus); -- called also pine siskin. See Pinefinch. Note: The name is applied also to several other related species found in Asia and South America. Siskin green, a delicate shade of yellowish green, as in the mineral torbernite.
siskiwit |The siscowet.
sismograph |See Seismograph.
sismometer |See Seismometer.
siss |To make a hissing sound; as, a flatiron hot enough to siss when touched with a wet finger. [Colloq. U. S.; Local, Eng.]\n\nA hissing noise. [Colloq. U. S.]
sissoo |A leguminous tree (Dalbergia Sissoo) of the northern parts of India; also, the dark brown compact and durable timber obtained from it. It is used in shipbuilding and for gun carriages, railway ties, etc.
sist |1. (Scots Law)  To stay, as judicial proceedings; to delay or suspend; to stop. 2. To cause to take a place, as at the bar of a court; hence, to cite; to summon; to bring into court. [Scot.] Some, however, have preposterously sisted nature as the first or generative principle. Sir W. Hamilton.\n\nA stay or suspension of proceedings; an order for a stay of proceedings. Burril.
sister |1. A female who has the same parents with another person, or who has one of them only. In the latter case, she is more definitely called a half sister. The correlative of brother. I am the sister of one Claudio. Shak. 2. A woman who is closely allied to, or assocciated with, another person, as in the sdame faith, society, order, or community. James ii. 15. 3. One of the same kind, or of the same condition; -- generally used adjectively; as, sister fruits. Pope. Sister Block (Naut.), a tackle block having two sheaves, one above the other. -- Sister hooks, a pair of hooks fitted together, the shank of one forming a mousing for the other; -- called also match hook. -- Sister of charity, Sister of mercy. (R. C. Ch.) See under Charity, and Mercy.\n\nTo be sister to; to resemble closely. [Obs.] Shak.
sister-in-law |The sister of one's husband or wife; also, the wife of one's brother; sometimes, the wife of one's husband's or wife's brother.
sisterhood |1. The state or relation of being a sister; the office or duty of a sister. She . . . abhorr'd Her proper blood, and left to do the part Of sisterhood, to do that of a wife. Daniel. 2. A society of sisters; a society of women united in one faith or order; sisters, collectively. \"A sisterhood of holy nuns.\" Shak. The fair young flowers . . . a beauteous sisterhood. Bryant.
sistering |Contiguous. [Obs.] Shak.
sisterly |Like a sister; becoming a sister, affectionate; as, sisterly kindness; sisterly remorse. Shak.
sistine |Of or pertaining to Pope Sixtus. Sistine chapel, a chapel in the Vatican at Rome, built by Pope Sixtus IV., and decorated with frescoes by Michael Angelo and others.
sistren |Sisters. [Obs.] Chaucer.
sistrum |An instrument consisting of a thin metal frame, through which passed a number of metal rods, and furnished with a handle by which it was shaken and made to rattle. It was peculiarly Egyptian, and used especially in the worship of Isis. It is still used in Nubia.
sisyphean |Relating to Sisyphus; incessantly recurring; as, Sisyphean labors.
sisyphus |A king of Corinth, son of Æolus, famed for his cunning. He was killed by Theseus, and in the lower world was condemned by Pluto to roll to the top of a hill a huge stone, which constantly rolled back again, making his task incessant.
sit |obs. 3d pers. sing. pres. of Sit, for sitteth.\n\n1. To rest upon the haunches, or the lower extremity of the trunk of the body; -- said of human beings, and sometimes of other animals; as, to sit on a sofa, on a chair, or on the ground. And he came and took the book put of the right hand of him that sate upon the seat. Bible (1551) (Rev. v. 7.) I pray you, jest, sir, as you sit at dinner. Shak. 2. To perch; to rest with the feet drawn up, as birds do on a branch, pole, etc. 3. To remain in a state of repose; to rest; to abide; to rest in any position or condition. And Moses said to . . . the children of Reuben, Shall your brothren go to war, and shall ye sit here Num. xxxii. 6. Like a demigod here sit I in the sky. Shak. 4. To lie, rest, or bear; to press or weigh; -- with on; as, a weight or burden sits lightly upon him. The calamity sits heavy on us. Jer. Taylor. 5. To be adjusted; to fit; as, a coat sts well or ill. This new and gorgeous garment, majesty, Sits not so easy on me as you think. Shak. 6. To suit one well or ill, as an act; to become; to befit; -- used impersonally. [Obs.] Chaucer. 7. To cover and warm eggs for hatching, as a fowl; to brood; to incubate. As the partridge sitteth on eggs, and hatcheth them not. Jer. xvii. 11. 8. To have position, as at the point blown from; to hold a relative position; to have direction. Like a good miller that knows how to grind, which way soever the wind sits. Selden. Sits the wind in that quarter Sir W. Scott. 9. To occupy a place or seat as a member of an official body; as, to sit in Congress. 10. To hold a session; to be in session for official business; -- said of legislative assemblies, courts, etc.; as, the court sits in January; the aldermen sit to-night. 11. To take a position for the purpose of having some artistic representation of one's self made, as a picture or a bust; as, to sit to a painter. To sit at, to rest under; to be subject to. [Obs.] \"A farmer can not husband his ground so well if he sit at a great rent\". Bacon. -- To sit at meat or at table, to be at table for eating. -- To sit down. (a) To place one's self on a chair or other seat; as, to sit down when tired. (b) To begin a siege; as, the enemy sat down before the town. (c) To settle; to fix a permanent abode. Spenser. (d) To rest; to cease as satisfied. \"Here we can not sit down, but still proceed in our search.\" Rogers. -- To sit for a fellowship, to offer one's self for examination with a view to obtaining a fellowship. [Eng. Univ.] -- To sit out. (a) To be without engagement or employment. [Obs.] Bp. Sanderson. (b) To outstay. -- To sit under, to be under the instruction or ministrations of; as, to sit under a preacher; to sit under good preaching. -- To sit up, to rise from, or refrain from, a recumbent posture or from sleep; to sit with the body upright; as, to sit up late at night; also, to watch; as, to sit up with a sick person. \"He that was dead sat up, and began to speak.\" Luke vii. 15.\n\n1. To sit upon; to keep one's seat upon; as, he sits a horse well. Hardly the muse can sit the headstrong horse. Prior. 2. To cause to be seated or in a sitting posture; to furnish a seat to; -- used reflexively. They sat them down to weep. Milton. Sit you down, father; rest you. Shak. 3. To suit (well or ill); to become. [Obs. or R.]
site |1. The place where anything is fixed; situation; local position; as, the site of a city or of a house. Chaucer. 2. A place fitted or chosen for any certain permanent use or occupation; as, a site for a church. 3. The posture or position of a thing. [R.] The semblance of a lover fixed In melancholy site. Thomson.
sited |Having a site; situated. [Obs.] [The garden] sited was in fruitful soil. Chaucer.
sitfast |Fixed; stationary; immovable. [R.] 'T is good, when you have crossed the sea and back, To find the sitfast acres where you left them. Emerson.\n\nA callosity with inflamed edges, on the back of a horse, under the saddle.
sith |Since; afterwards; seeing that. [Obs.] We need not fear them, sith Christ is with us. Latimer. Sith thou art rightful judge. Chaucer.\n\nTime. [Obs.] Chaucer. And humbly thanked him a thousand sithes. Spenser.
sithe |Time. [Obs.] Chaucer. And humbly thanked him a thousand sithes. Spenser.\n\nTo sigh. Note: [A spelling of a corrupt and provincial pronunciation.]\n\nA scythe. [Obs.] Milton.\n\nTo cut with a scythe; to scythe. [Obs.]
sithed |Scythed. [Obs.] T. Warton.
sitheman |A mower. [Obs.] Marston.
sithen |Since; afterwards. See 1st Sith. [Obs.] Fortune was first friend and sithen foe. Chaucer.
sithence |Since. See Sith, and Sithen. [Obs.] Piers Plowman.
sithens |Since. See Sith, and Sithen. [Obs.] Piers Plowman.
siththen |See Sithen. [Obs.] Siththen that the world began. Chaucer.
sitology |A treatise on the regulation of the diet; dietetics. [Written also sitiology.]
sitophobia |A version to food; refusal to take nourishment. [Written also sitiophobia.]
sitten |p. p. of Sit, for sat.
sitter |1. One who sits; esp., one who sits for a portrait or a bust. 2. A bird that sits or incubates.
sittine |Of or pertaining to the family Sittidæ, or nuthatches.
sitting |Being in the state, or the position, of one who, or that which, sits.\n\n1. The state or act of one who sits; the posture of one who occupies a seat. 2. A seat, or the space occupied by or allotted for a person, in a church, theater, etc.; as, the hall has 800 sittings. 3. The act or time of sitting, as to a portrait painter, photographer, etc. 4. The actual presence or meeting of any body of men in their seats, clothed with authority to transact business; a session; as, a sitting of the judges of the King's Bench, or of a commission. The sitting closed in great agitation. Macaulay. 5. The time during which one sits while doing something, as reading a book, playing a game, etc. For the understanding of any one of St. Paul's Epistles I read it all through at one sitting. Locke. 6. A brooding over eggs for hatching, as by fowls. The male bird . . . amuses her [the female] with his songs during the whole time of her sitting. Addison. Sitting room, an apartment where the members of a family usually sit, as distinguished from a drawing-room, parlor, chamber, or kitchen.
situate |1. Having a site, situation, or location; being in a relative position; permanently fixed; placed; located; as, a town situated, or situate, on a hill or on the seashore. 2. Placed; residing. Pleasure situate in hill and dale. Milton. Note: Situate is now less used than situated, but both are well authorized.\n\nTo place. [R.] Landor.
situated |1. Having a site, situation, or location; being in a relative position; permanently fixed; placed; located; as, a town situated, or situate, on a hill or on the seashore. 2. Placed; residing. Pleasure situate in hill and dale. Milton. Note: Situate is now less used than situated, but both are well authorized.
situation |1. Manner in which an object is placed; location, esp. as related to something else; position; locality site; as, a house in a pleasant situation. 2. Position, as regards the conditions and circumstances of the case. A situation of the greatest ease and tranquillity. Rogers. 3. Relative position; circumstances; temporary state or relation at a moment of action which excites interest, as of persons in a dramatic scene. There's situation for you! there's an heroic group! Sheridan. 4. Permanent position or employment; place; office; as, a situation in a store; a situation under government. Syn. -- State; position; seat; site; station; post; place; office; condition; case; plight. See State.
situs |The method in which the parts of a plant are arranged; also, the position of the parts. Henslow.
sitz bath |A tub in which one bathes in a sitting posture; also, a bath so taken; a hip bath.
siva |One of the triad of Hindoo gods. He is the avenger or destroyer, and in modern worship symbolizes the reproductive power of nature.
sivan |The third month of the Jewish ecclesiastical year; -- supposed to correspond nearly with our month of June.
sivatherium |A genus of very large extinct ruminants found in the Tertiary formation of India. The snout was prolonged in the form of a proboscis. The male had four horns, the posterior pair being large and branched. It was allied to the antelopes, but very much larger than any exsisting species.
siver |To simmer. [Obs.] Holland.
sivvens |See Sibbens.
siwin |Same as Sewen.
six |One more than five; twice three; as, six yards. Six Nations (Ethnol.), a confederation of North American Indians formed by the union of the Tuscaroras and the Five Nations. -- Six points circle. (Geom.) See Nine points circle, under Nine.\n\n1. The number greater by a unit than five; the sum of three and three; six units or objects. 2. A symbol representing six units, as 6, vi., or VI. To be at six and seven or at sixes and sevens, to be in disorder. Bacon. Shak. Swift.
six-footer |One who is six feet tall. [Colloq. U.S.]
six-shooter |A pistol or other firearm which can be fired six times without reloading especially, a six-chambered revolver. [Colloq. U.S.]
sixfold |Six times repeated; six times as much or as many.
sixpence |An English silver coin of the value of six pennies; half a shilling, or about twelve cents.
sixpenny |Of the value of, or costing, sixpence; as, a sixpenny loaf.
sixscore |Six times twenty; one hundred and twenty.
sixteen |Six and ten; consisting of six and ten; fifteen and one more.\n\n1. The number greater by a unit than fifteen; the sum of ten and six; sixteen units or objects. 2. A symbol representing sixteen units, as 16, or xvi.
sixteenmo |See Sextodecimo.
sixteenth |1. Sixth after the tenth; next in order after the fifteenth. 2. Constituting or being one of sixteen equal parts into which anything is divided. Sixteenth note (Mus.), the sixteenth part of a whole note; a semiquaver.\n\n1. The quotient of a unit divided by sixteen; one of sixteen equal parts of one whole. 2. The next in order after the fifteenth; the sixth after the tenth. 3. (Mus.)  An interval comprising two octaves and a second. Moore (Encyc. of Music.)
sixth |1. First after the fifth; next in order after the fifth. 2. Constituting or being one of six equal parts into which anything is divided.\n\n1. The quotient of a unit divided by six; one of six equal parts which form a whole. 2. The next in order after the fifth. 3. (Mus.)  The interval embracing six diatonic degrees of the scale.
sixthly |In the sixth place. Bacon.
sixtieth |1. Next in order after the fifty-ninth. 2. Constituting or being one one of sixty equal parts into which anything is divided.\n\n1. The quotient of a unit divided by sixty; one of sixty equal parts forming a whole. 2. The next in order after the fifty-ninth; the tenth after the fiftieth.
sixty |Six times ten; fifty-nine and one more; threescore.\n\n1. The sum of six times ten; sixty units or objects. 2. A symbol representing sixty units, as 60, lx., or LX.
sixty-fourth |Constituting or being one of sixty-four equal parts into which a thing is divided. Sixty-fourth note (Mus.), the sixty-fourth part of a whole note; a hemi-demi-semiquaver.
sizable |1. Of considerable size or bulk. \"A sizable volume.\" Bp. Hurd. 2. Being of reasonable or suitable size; as, sizable timber; sizable bulk. Arbuthnot.
sizar |One of a body of students in the universities of Cambridge (Eng.) and Dublin, who, having passed a certain examination, are exempted from paying college fees and charges. A sizar corresponded to a servitor at Oxford. The sizar paid nothing for food and tuition, and very little for lodging. Macaulay. Note: They formerly waited on the table at meals; but this is done away with. They were probably so called from being thus employed in distributing the size, or provisions. See 4th Size, 2.
sizarship |The position or standing of a sizar.
size |Six.\n\n1. A thin, weak glue used in various trades, as in painting, bookbinding, paper making, etc. 2. Any viscous substance, as gilder's varnish.\n\nTo cover with size; to prepare with size.\n\n1. A settled quantity or allowance. See Assize. [Obs.] \"To scant my sizes.\" Shak. 2. (Univ. of Cambridge, Eng.)  An allowance of food and drink from the buttery, aside from the regular dinner at commons; -- corresponding to battel at Oxford. 3. Extent of superficies or volume; bulk; bigness; magnitude; as, the size of a tree or of a mast; the size of a ship or of a rock. 4. Figurative bulk; condition as to rank, ability, character, etc.; as, the office demands a man of larger size. Men of a less size and quality. L'Estrange. The middling or lower size of people. Swift. 5. A conventional relative measure of dimension, as for shoes, gloves, and other articles made up for sale. 6. An instrument consisting of a number of perforated gauges fastened together at one end by a rivet, -- used for ascertaining the size of pearls. Knight. Size roll, a small piese of parchment added to a roll. -- Size stick, a measuring stick used by shoemakers for ascertaining the size of the foot. Syn. -- Dimension; bigness; largeness; greatness; magnitude.\n\n1. To fix the standard of. \"To size weights and measures.\" [R.] Bacon. 2. To adjust or arrange according to size or bulk. Specifically: (a) (Mil.) To take the height of men, in order to place them in the ranks according to their stature. (b) (Mining) To sift, as pieces of ore or metal, in order to separate the finer from the coarser parts. 3. To swell; to increase the bulk of. Beau. & Fl. 4. (Mech.)  To bring or adjust anything exactly to a required dimension, as by cutting. To size up, to estimate or ascertain the character and ability of. See 4th Size, 4. [Slang, U.S.] We had to size up our fellow legislators. The Century.\n\n1. To take greater size; to increase in size. Our desires give them fashion, and so, As they wax lesser, fall, as they size, grow. Donne. 2. (Univ. of Cambridge, Eng.)  To order food or drink from the buttery; hence, to enter a score, as upon the buttery book.
sized |1. Adjusted according to size. 2. Having a particular size or magnitude; -- chiefly used in compounds; as, large-sized; common-sized.
sizel |Same as Scissel, 2.
sizer |1. See Sizar. 2. (Mech.) (a) An instrument or contrivance to size articles, or to determine their size by a standard, or to separate and distribute them according to size. (b) An instrument or tool for bringing anything to an exact size.
siziness |The quality or state of being sizy; viscousness.
sizing |1. Act of covering or treating with size. 2. A weak glue used in various trades; size.\n\n1. The act of sorting with respect to size. 2. The act of bringing anything to a certain size. 3. (Univ. of Cambridge, Eng.)  Food and drink ordered from the buttery by a student.
sizy |Sizelike; viscous; glutinous; as, sizy blood. Arbuthnot.
sizzle |To make a hissing sound; to fry, or to dry and shrivel up, with a hissing sound. [Prov. Eng. & Colloq. U. S.] Forby.\n\nA hissing sound, as of something frying over a fire. [Prov. Eng. & Colloq. U. S.]
sizzling |from Sizzle.
skaddle |Hurt; damage. [Obs. or Prov. Eng.] Ray.\n\nHurtful. [Obs. or Prov. Eng.] Ray.
skaddon |The larva of a bee. [Prov. Eng.]
