slutch |Slush. [Prov. Eng.]
slutchy |Slushy. [Prov. Eng.] Pennant.
sluthhound |Sleuthhound.
sluttery |The qualities and practices of a slut; sluttishness; slatternlines. Drayton.
sluttish |Like a slut; untidy; indecently negligent of cleanliness; disorderly; as, a sluttish woman. Why is thy lord so slutish, I thee pray. Chaucer. An air of liberal, though sluttish, plenty, indicated the wealthy farmer. Sir W. Scott. -- Slut\"tish*ly, adv. -- Slut\"tish*ness, n.
sly |1. Dexterous in performing an action, so as to escape notice; nimble; skillful; cautious; shrewd; knowing; -- in a good sense. Be ye sly as serpents, and simple as doves. Wyclif (Matt. x. 16). Whom graver age And long experience hath made wise and sly. Fairfax. 2. Artfully cunning; secretly mischievous; wily. For my sly wiles and subtle craftiness, The litle of the kingdom I possess. Spenser. 3. Done with, and marked by, artful and dexterous secrecy; subtle; as, a sly trick. Envy works in a sly and imperceptible manner. I. Watts. 4. Light or delicate; slight; thin. [Obs.] By the sly, or On the sly, in a sly or secret manner. [Colloq.] \"Gazed on Hetty's charms by the sly.\" G. Eliot. -- Sly goose (Zo√∂l.), the common sheldrake; -- so named from its craftiness. Syn. -- Cunning; crafty; subtile; wily. See Cunning.\n\nSlyly. [Obs. or Poetic] Spenser.
slyboots |A humerous appellation for a sly, cunning, or waggish person. Slyboots was cursedly cunning to hide 'em. Goldsmith.
slyly |In a sly manner; shrewdly; craftily. Honestly and slyly he it spent. Chaucer.
slyness |The quality or state of being sly.
slype |A narrow passage between two buildings, as between the transept and chapter house of a monastery. [Eng.]
smack |A small sailing vessel, commonly rigged as a sloop, used chiefly in the coasting and fishing trade.\n\n1. Taste or flavor, esp. a slight taste or flavor; savor; tincture; as, a smack of bitter in the medicine. Also used figuratively. So quickly they have taken a smack in covetousness. Robynson (More's Utopia). They felt the smack of this world. Latimer. 2. A small quantity; a taste. Dryden. 3. A loud kiss; a buss. \"A clamorous smack.\" Shak. 4. A quick, sharp noise, as of the lips when suddenly separated, or of a whip. 5. A quick, smart blow; a slap. Johnson.\n\nAs if with a smack or slap. [Colloq.]\n\n1. To have a smack; to be tinctured with any particular taste. 2. To have or exhibit indications of the presence of any character or quality. All sects, all ages, smack of this vice. Shak. 3. To kiss with a close compression of the lips, so as to make a sound when they separate; to kiss with a sharp noise; to buss. 4. To make a noise by the separation of the lips after tasting anything.\n\n1. To kiss with a sharp noise; to buss. 2. To open, as the lips, with an inarticulate sound made by a quick compression and separation of the parts of the mouth; to make a noise with, as the lips, by separating them in the act of kissing or after tasting. Drinking off the cup, and smacking his lips with an air of ineffable relish. Sir W. Scott. 3. To make a sharp noise by striking; to crack; as, to smack a whip. \"She smacks the silken thong.\" Young.
smacking |A sharp, quick noise; a smack. Like the faint smacking of an after kiss. Dryden.\n\nMaking a sharp, brisk sound; hence, brisk; as, a smacking breeze.
small |1. Having little size, compared with other things of the same kind; little in quantity or degree; diminutive; not large or extended in dimension; not great; not much; inconsiderable; as, a small man; a small river. To compare Great things with small. Milton. 2. Being of slight consequence; feeble in influence or importance; unimportant; trivial; insignificant; as, a small fault; a small business. 3. Envincing little worth or ability; not large-minded; -- sometimes, in reproach, paltry; mean. A true delineation of the smallest man is capable of interesting the reatest man. Carlyle. 4. Not prolonged in duration; not extended in time; short; as, after a small space. Shak. 5. Weak; slender; fine; gentle; soft; not loud. \"A still, small voice.\" 1 Kings xix. 12. Great and small,of all ranks or degrees; -- used especially of persons. \"His quests, great and small.\" Chaucer. -- Small arms, muskets, rifles, pistols, etc., in distinction from cannon. -- Small beer. See under Beer. -- Small coal. (a) Little coals of wood formerly used to light fires. Gay. (b) Coal about the size of a hazelnut, separated from the coarser parts by screening. -- Small craft (Naut.), a vessel, or vessels in general, of a small size. -- Small fruits. See under Fruit. -- Small hand, a certain size of paper. See under Paper. -- Small hours. See under Hour. -- Small letter. (Print.), a lower-case letter. See Lower-case, and Capital letter, under Capital, a. -- Small piece, a Scotch coin worth about 2 -- Small register. See the Note under 1st Register, 7. -- Small stuff (Naut.), spun yarn, marline, and the smallest kinds of rope. R. H. Dana, Jr. -- Small talk, light or trifling conversation; chitchat. -- Small wares (Com.), various small textile articles, as tapes, braid, tringe, and the like. M`Culloch.\n\n1. In or to small extent, quantity, or degree; little; slightly. [Obs.] \"I wept but small.\" Chaucer. \"It small avails my mood.\" Shak. 2. Not loudly; faintly; timidly. [Obs. or Humorous] You may speak as small as you will. Shak.\n\n1. The small or slender part of a thing; as, the small of the leg or of the back. 2. pl.  Smallclothes. [Colloq.] Hood. Dickens. 3. pl.  Same as Little go. See under Little, a.\n\nTo make little or less. [Obs.]
smallage |A biennial umbelliferous plant (Apium graveolens) native of the seacoats of Europe and Asia. When deprived of its acrid and even poisonous properties by cultivation, it becomes celery.
smallclothes |A man's garment for the hips and thighs; breeches. See Breeches.
smallish |Somewhat small. G. W. Cable.
smallness |The quality or state of being small.
smallpox |A contagious, constitutional, febrile disease characterized by a peculiar eruption; variola. The cutaneous eruption is at first a collection of papules which become vesicles (first flat, subsequently umbilicated) and then pustules, and finally thick crusts which slough after a certain time, often leaving a pit, or scar.
smalls |See Small, n., 2, 3.
smallsword |A light sword used for thrusting only; especially, the sword worn by civilians of rank in the eighteenth century.
smally |In a small quantity or degree; with minuteness. [R.] Ascham.
smalt |A deep blue pigment or coloring material used in various arts. It is a vitreous substance made of cobalt, potash, and calcined quartz fused, and reduced to a powder.
smalt-blue |Deep blue, like smalt.
smaltine |A tin-white or gray mineral of metallic luster. It is an arsenide of cobalt, nickel, and iron. Called also speiskobalt.
smaltite |A tin-white or gray mineral of metallic luster. It is an arsenide of cobalt, nickel, and iron. Called also speiskobalt.
smaragd |The emerald. [Obs.] Bale.
smaragdine |Of or pertaining to emerald; resembling emerald; of an emerald green.
smaragdite |A green foliated kind of amphibole, observed in eclogite and some varietis of gabbro.
smart |1. To feel a lively, pungent local pain; -- said of some part of the body as the seat of irritation; as, my finger smarts; these wounds smart. Chaucer. Shak. 2. To feel a pungent pain of mind; to feel sharp pain or grief; to suffer; to feel the sting of evil. No creature smarts so little as a fool. Pope. He that is surety for a stranger shall smart for it. Prov. xi. 15.\n\nTo cause a smart in. \"A goad that . . . smarts the flesh.\" T. Adams.\n\n1. Quick, pungent, lively pain; a pricking local pain, as the pain from puncture by nettles. \"In pain's smart.\" Chaucer. 2. Severe, pungent pain of mind; pungent grief; as, the smart of affliction. To stand 'twixt us and our deserved smart. Milton. Counsel mitigates the greatest smart. Spenser. 3. A fellow who affects smartness, briskness, and vivacity; a dandy. [Slang] Fielding. 4. Smart money (see below). [Canf]\n\n1. Causing a smart; pungent; pricking; as, a smart stroke or taste. How smart lash that speech doth give my conscience. Shak. 2. Keen; severe; poignant; as, smart pain. 3. Vigorous; sharp; severe. \"Smart skirmishes, in which many fell.\" Clarendon. 4. Accomplishing, or able to accomplish, results quickly; active; sharp; clever. [Colloq.] 5. Efficient; vigorous; brilliant. \"The stars shine smarter.\" Dryden. 6. Marked by acuteness or shrewdness; quick in suggestion or reply; vivacious; witty; as, a smart reply; a smart saying. Who, for the poor renown of being smart Would leave a sting within a brother's heart Young. A sentence or two, . . . which I thought very smart. Addison. 7. Pretentious; showy; spruce; as, a smart gown. 8. Brisk; fresh; as, a smart breeze. Smart money. (a) Money paid by a person to buy himself off from some unpleasant engagement or some painful situation. (b) (Mil.) Money allowed to soldiers or sailors, in the English service, for wounds and injures received; also, a sum paid by a recruit, previous to being sworn in, to procure his release from service. (c) (Law) Vindictive or exemplary damages; damages beyond a full compensation for the actual injury done. Burrill. Greenleaf. -- Smart ticket, a certificate given to wounded seamen, entitling them to smart money. [Eng.] Brande & C. Syn. -- Pungent; poignant; sharp; tart; acute; quick; lively; brisk; witty; clever; keen; dashy; showy. -- Smart, Clever. Smart has been much used in New England to describe a person who is intelligent, vigorous, and active; as, a smart young fellow; a smart workman, etc., conciding very nearly with the English sense of clever. The nearest approach to this in England is in such expressions as, he was smart (pungent or witty) in his reply, etc.; but smart and smartness, when applied to persons, more commonly refer to dress; as, a smart appearance; a smart gown, etc.
smarten |To make smart or spruce; -- usually with up. [Colloq.] She had to go and smarten herself up somewhat. W. Black.
smartle |To waste away. [Prov. Eng.]
smartly |In a smart manner.
smartness |The quality or state of being smart.
smartweed |An acrid plant of the genus Polygonum (P. Hydropiper), which produces smarting if applied where the skin is tender.
smash |To break in pieces by violence; to dash to pieces; to crush. Here everything is broken and smashed to pieces. Burke.\n\nTo break up, or to pieces suddenly, as the result of collision or pressure.\n\n1. A breaking or dashing to pieces; utter destruction; wreck. 2. Hence, bankruptcy. [Colloq.]
smasher |1. One who, or that which, smashes or breaks things to pieces. 2. Anything very large or extraordinary. [Slang] 3. One who passes counterfeit coin. [Cant, Eng.]
smatch |Taste; tincture; smack. [Obs.] Thy life hath had some smatch of honor in it. Shak.\n\nTo smack. [Obs.] Banister (1578).
smatter |1. To talk superficially or ignorantly; to babble; to chatter. Of state affairs you can not smatter. Swift. 2. To have a slight taste, or a slight, superficial knowledge, of anything; to smack.\n\n1. To talk superficially about. 2. To gain a slight taste of; to acquire a slight, superficial knowledge of; to smack. Chaucer.\n\nSuperficial knowledge; a smattering.
smatterer |One who has only a slight, superficial knowledge; a sciolist.
smattering |A slight, superficial knowledge of something; sciolism. I had a great desire, not able to attain to a superficial skill in any, to have some smattering in all. Burton.
smear |1. To overspread with anything unctuous, viscous, or adhesive; to daub; as, to smear anything with oil. \"Smear the sleepy grooms with blood.\" Shak. 2. To soil in any way; to contaminate; to pollute; to stain morally; as, to be smeared with infamy. Shak.\n\n1. A fat, oily substance; oinment. Johnson. 2. Hence, a spot made by, or as by, an unctuous or adhesive substance; a blot or blotch; a daub; a stain. Slow broke the morn, All damp and rolling vapor, with no sun, But in its place a moving smear of light. Alexander Smith.
smear dab |The sand fluke (b). [Prov. Eng.]
smearcase |Cottage cheese. [Local, U. S.]
smeared |Having the color mark ings ill defined, as if rubbed; as, the smeared dagger moth (Apatela oblinita).
smeary |Tending to smear or soil; adhesive; viscous. Rowe.
smeath |The smew. [Prov. Eng.]
smectite |A hydrous silicate of alumina, of a greenish color, which, in certain states of humidity, appears transparent and almost gelatinous.
smee |(a) The pintail duck. (b) The widgeon. (c) The poachard. (d) The smew. [Prov. Eng.]
smeeth |To smoke; to blacken with smoke; to rub with soot. [Obs.]\n\nTo smooth. [Prov. Eng.] Halliwell.
smegma |The matter secreted by any of the sebaceous glands. Specifically: (a) The soapy substance covering the skin of newborn infants. (b) The cheesy, sebaceous matter which collects between the glans penis and the foreskin.
smegmatic |Being of the nature of soap; soapy; cleansing; detersive.
smeir |A salt glaze on pottery, made by adding common salt to an earthenware glaze.
smell |1. To perceive by the olfactory nerves, or organs of smell; to have a sensation of, excited through the nasal organs when affected by the appropriate materials or qualities; to obtain the scent of; as, to smell a rose; to smell perfumes. 2. To detect or perceive, as if by the sense of smell; to scent out; -- often with out. \"I smell a device.\" Shak. Can you smell him out by that Shak. 3. To give heed to. [Obs.] From that time forward I began to smellthe Word of God, and forsook the school doctors. Latimer. To smell a rat, to have a sense of something wrong, not clearly evident; to have reason for suspicion. [Colloq.] -- To smell out, to find out by sagacity. [Colloq.]\n\n1. To affect the olfactory nerves; to have an odor or scent; -- often followed by of; as, to smell of smoke, or of musk. 2. To have a particular tincture or smack of any quality; to savor; as, a report smells of calumny. Praises in an enemy are superfluous, or smell of craft. Milton. 3. To exercise the sense of smell. Ex. xxx. 38. 4. To exercise sagacity. Shak.\n\n1. The sense or faculty by which certain qualities of bodies are perceived through the instrumentally of the olfactory nerves. See Sense. 2. The quality of any thing or substance, or emanation therefrom, which affects the olfactory organs; odor; scent; fragrance; perfume; as, the smell of mint. Breathing the smell of field and grove. Milton. That which, above all others, yields the sweetest smell in the air, is the violent. Bacon. Syn. -- Scent; odor; perfume; fragrance.
smell-feast |1. One who is apt to find and frequent good tables; a parasite; a sponger. The epicure and the smell-feast. South. 2. A feast at which the guests are supposed to feed upon the odors only of the viands.
smell-less |Destitute of smell; having no odor. Daisies smell-less, yet most quaint. Beau & Fl.
smeller |1. One who smells, or perceives by the sense of smell; one who gives out smell. 2. The nose. [Pugilists' Slang]
smelling |1. The act of one who smells. 2. The sense by which odors are perceived; the sense of smell. Locke. Smelling bottle, a small bottle filled with something suited to stimulate the sense of smell, or to remove faintness, as spirits of ammonia.
smelling salts |An aromatic preparation of carbonate of ammonia and, often, some scent, to avoid or relieve faintness, headache, or the like.
smelt |of Smell.\n\n1. (Zo√∂l.)  Any one of numerous species of small silvery salmonoid fishes of the genus Osmerus and allied genera, which ascend rivers to spawn, and sometimes become landlocked in lakes. They are esteemed as food, and have a peculiar odor and taste. Note: The most important species are the European smelt (Osmerus eperlans) (called also eperlan, sparling, and spirling), the Eastern American smelt (O. mordax), the California smelt (O. thalichthys), and the surf smelt (Hypomesus olidus). The name is loosely applied to various other small fishes, as the lant, the California tomcod, the spawn eater, the silverside. 2. Fig.: A gull; a simpleton. [Obs.] eau & Fl. Sand smelt (Zo√∂l.), the silverside.\n\nTo melt or fuse, as, ore, for the purpose of separating and refining the metal; hence, to reduce; to refine; to flux or scorify; as, to smelt tin.
smelter |One who, or that which, smelts.
smeltery |A house or place for smelting.
smeltie |A fish, the bib. [Prov. Eng.]
smelting |a. & n. from Smelt. Smelting furnace (Metal.), a furnace in which ores are smelted or reduced.
smerk |See Smirk.\n\nSmart; jaunty; spruce. See Smirk, a. [Obs.] So smerk, so smooth, his pricked ears. Spenser.
smerky |Smart; jaunty; spruce. See Smirk, a. [Obs.] So smerk, so smooth, his pricked ears. Spenser.
smerlin |A small loach.
smew |(a) small European merganser (Mergus albellus) which has a white crest; -- called also smee, smee duck, white merganser, and white nun. (b) The hooded merganser. [Local, U.S.]
smicker |To look amorously or wantonly; to smirk.\n\nAmorous; wanton; gay; spruce. [Obs.]
smickering |Amorous glance or inclination. [Obs.] \"A smickering to our young lady.\" Dryden.
smicket |A woman's under-garment; a smock. [Obs. or Prov. Eng.] Johnson.
smickly |Smugly; finically. [Obs.] Ford.
smiddy |A smithy. [Prov. Eng. & Scot.]
smift |A match for firing a charge of powder, as in blasting; a fuse.
smight |To smite. [Obs.] Spenser.
smilacin |See Parrilin.
smilax |(a) A genus of perennial climbing plants, usually with a prickly woody stem; green brier, or cat brier. The rootstocks of certain species are the source of the medicine called sarsaparilla. (b) A delicate trailing plant (Myrsiphyllum asparagoides) much used for decoration. It is a native of the Cape of Good Hope.
smile |1. To express amusement, pleasure, moderate joy, or love and kindness, by the features of the face; to laugh silently. He doth nothing but frown . . . He hears merry tales and smiles not. Shak. She led to see the doughty hero slain. Pope. When last I saw thy young blue eyes, they smiled. Byron. 2. To express slight contempt by a look implying sarcasm or pity; to sneer. 'T was what I said to Craggs and Child, Who praised my modesty, and smiled. Pope. 3. To look gay and joyous; to have an appearance suited to excite joy; as, smiling spring; smilimg plenty. The desert smiled, And paradise was opened in the wild. Pope. 4. To be propitious or favorable; to favor; to countenance; -- often with on; as, to smile on one's labors.\n\n1. To express by a smile; as, to smile consent; to smile a welcome to visitors. 2. To affect in a certain way with a smile. [R.] And sharply smile prevailing folly dead. Young.\n\n1. The act of smiling; a peculiar change or brightening of the face, which expresses pleasure, moderate joy, mirth, approbation, or kindness; -- opposed to frown. Sweet intercourse Of looks and smiles: for smiles from reason flow. Milton. 2. A somewhat similar expression of countenance, indicative of satisfaction combined with malevolent feelings, as contempt, scorn, etc; as, a scornful smile. 3. Favor; countenance; propitiousness; as, the smiles of Providence. \"The smile of heaven.\" Shak. 4. Gay or joyous appearance; as, the smiles of spring. The brightness of their [the flowers'] smile was gone. Bryant.
smileless |Not having a smile.
smiler |One who smiles. Tennyson.
smilet |A little smile. [R.] Those happy smilets That played on her ripe lip. Shak.
smilingly |In a smiling manner. Shak.
smilingness |Quality or state of being smiling. And made despair a smilingness assume. Byron.
smilodon |An extinct genus of saber-toothed tigers. See Mach.
smilt |To melt. [Obs.] Mortimer.
sminthurid |Any one of numerous small species of springtails, of the family Sminthurid, -- usually found on flowers. See Illust. under Collembola.
smirch |To smear with something which stains, or makes dirty; to smutch; to begrime; to soil; to sully. I'll . . . with a kind of umber smirch my face. Shak.\n\nA smutch; a dirty stain.
smirk |To smile in an affected or conceited manner; to smile with affected complaisance; to simper.\n\nA forced or affected smile; a simper. The bride, all smirk and blush, had just entered. Sir W. Scott.\n\nNice,; smart; spruce; affected; simpering. \"So smirk, so smooth.\" Spenser.
smirkingly |With smirking; with a smirk.
smirky |Smirk; smirking.
smit |imp. & p. p. of Smite. Spenser. Smit with the beauty of so fair a scene. Cowper.\n\n3d. pers. sing. pres. of Smite. Chaucer.
smite |1. To strike; to inflict a blow upon with the hand, or with any instrument held in the hand, or with a missile thrown by the hand; as, to smite with the fist, with a rod, sword, spear, or stone. Whosoever shall smite thee on thy right cheek, turn to him the other also. Matt. v. 39. And David . . . took thence a stone, and slang it, and smote the Philistine in his forehead. 1 Sam. xvii. 49. 2. To cause to strike; to use as an instrument in striking or hurling. Profpesy, and smite thine hands together. Ezek. xxi. 14. Saul . . . smote the javelin into the wall. 1 Sam. xix. 10. 3. To destroy the life of by beating, or by weapons of any kind; to slay by a blow; to kill; as, to smite one with the sword, or with an arrow or other instrument. 4. To put to rout in battle; to overthrow by war. 5. To blast; to destroy the life or vigor of, as by a stroke or by some visitation. The flax and the barely was smitten. Ex. ix. 31. 6. To afflict; to chasten; to punish. Let us not mistake God's goodness, nor imagine, because he smites us, that we are forsaken by him. Wake. 7. To strike or affect with passion, as love or fear. The charms that smite the simple heart. Pope. Smith with the love of sister arts we came. Pope. To smite off, to cut off. -- To smite out, to knock out, as a tooth. Exod,xxi.27. -- To smite with the tongue, to reproach or upbarid; to revile. [Obs.] Jer. xviii. 18.\n\nTo strike; to collide; to beat. [Archaic] The heart meleth, and the knees smite together. Nah. ii. 10.\n\nThe act of smiting; a blow.
smiter |One who smites. I give my back to the smiters. Isa. l. 6.
smithcraft |The art or occupation of a smith; smithing. [R.] Sir W. Raleigh.
smither |1. Light, fine rain. [Prov. Eng.] 2. pl.  Fragments; atoms; finders. [Prov. Eng.] Smash the bottle to smithers. Tennyson.
smithereens |Fragments; atoms; smithers. [Colloq.] W. Black.
smithery |1. The workshop of a smith; a smithy or stithy. 2. Work done by a smith; smithing. The din of all his smithery may some time or other possibly wake this noble duke. Burke.
smithing |The act or art of working or forging metals, as iron, into any desired shape. Moxon.
smithsonian |Of or pertaining to the Englishman J.L.M. Smithson, or to the national institution of learning which he endowed at Washington, D.C.; as, the Smithsonian Institution; Smithsonian Reports. -- n.  The Smithsonian Institution.
smithsonite |Native zinc carbonate. It generally occurs in stalactitic, reniform, or botryoidal shapes, of a white to gray, green, or brown color. See Note under Calamine.
smithy |The workshop of a smith, esp. a blacksmith; a smithery; a stithy. [Written also smiddy.] Under a spreading chestnut tree The village smithy stands. Lonfellow.
smitt |Fine clay or ocher made up into balls, used for marking sheep. [Eng.] Woodsward.
smitten |p. p. of Smite.
smittle |To infect. [Prov. Eng.]\n\nInfection. [Pov. Eng.] Wright.\n\nInfectious; catching. [Scot. & Prov. Eng.] H. Kingsley.
smittlish |Infectious; catching. [Scot. & Prov. Eng.] H. Kingsley.
smock |1. A woman's under-garment; a shift; a chemise. In her smock, with head and foot all bare. Chaucer. 2. A blouse; a smoock frock. Carlyle.\n\nOf or pertaining to a smock; resembling a smock; hence, of or pertaining to a woman. Smock mill, a windmill of which only the cap turns round to meet the wind, in distinction from a post mill, whose whole building turns on a post. -- Smock race, a race run by women for the prize of a smock. [Prov. Eng.]\n\nTo provide with, or clothe in, a smock or a smock frock. Tennyson.
smock frock |A coarse frock, or shirt, worn over the other dress, as by farm laborers. Macaulay.
smock-faced |Having a feminine countenance or complexion; smooth-faced; girlish. Fenton.
smockless |Wanting a smock. Chaucer.
smokable |Capable of being smoked; suitable or ready to be smoked; as, smokable tobacco.
smoke |1. The visible exhalation, vapor, or substance that escapes, or expelled, from a burning body, especially from burning vegetable matter, as wood, coal, peat, or the like. Note: The gases of hydrocarbons, raised to a red heat or thereabouts, without a mixture of air enough to produce combustion, disengage their carbon in a fine powder, forming smoke. The disengaged carbon when deposited on solid bodies is soot. 2. That which resembles smoke; a vapor; a mist. 3. Anything unsubstantial, as idle talk. Shak. 4. The act of smoking, esp. of smoking tobacco; as, to have a smoke. [Colloq.] Note: Smoke is sometimes joined with other word. forming self- explaining compounds; as, smoke-consuming, smoke-dried, smoke- stained, etc. Smoke arch, the smoke box of a locomotive. -- Smoke ball (Mil.), a ball or case containing a composition which, when it burns, sends forth thick smoke. -- Smoke black, lampblack. [Obs.] -- Smoke board, a board suspended before a fireplace to prevent the smoke from coming out into the room. -- Smoke box, a chamber in a boiler, where the smoke, etc., from the furnace is collected before going out at the chimney. -- Smoke sail (Naut.), a small sail in the lee of the galley stovepipe, to prevent the smoke from annoying people on deck. -- Smoke tree (Bot.), a shrub (Rhus Cotinus) in which the flowers are mostly abortive and the panicles transformed into tangles of plumose pedicels looking like wreaths of smoke. -- To end in smoke, to burned; hence, to be destroyed or ruined; figuratively, to come to nothing. Syn. -- Fume; reek; vapor.\n\n1. To emit smoke; to throw off volatile matter in the form of vapor or exhalation; to reek. Hard by a cottage chimney smokes. Milton. 2. Hence, to burn; to be kindled; to rage. The anger of the Lord and his jealousy shall smoke agains. that man. Deut. xxix. 20. 3. To raise a dust or smoke by rapid motion. Proud of his steeds, he smokes along the field. Dryden. 4. To draw into the mouth the smoke of tobacco burning in a pipe or in the form of a cigar, cigarette, etc.; to habitually use tobacco in this manner. 5. To suffer severely; to be punished. Some of you shall smoke for it in Rome. Shak.\n\n1. To apply smoke to; to hang in smoke; to disinfect, to cure, etc., by smoke; as, to smoke or fumigate infected clothing; to smoke beef or hams for preservation. 2. To fill or scent with smoke; hence, to fill with incense; to perfume. \"Smoking the temple.\" Chaucer. 3. To smell out; to hunt out; to find out; to detect. I alone Smoked his true person, talked with him. Chapman. He was first smoked by the old Lord Lafeu. Shak. Upon that . . . I began to smoke that they were a parcel of mummers. Addison. 4. To ridicule to the face; to quiz. [Old Slang] 5. To inhale and puff out the smoke of, as tobacco; to burn or use in smoking; as, to smoke a pipe or a cigar. 6. To subject to the operation of smoke, for the purpose of annoying or driving out; -- often with out; as, to smoke a woodchuck out of his burrow.
smoke ball |Same as Puffball.
smoke-dry |To dry by or in smoke.
smokehouse |A building where meat or fish is cured by subjecting it to a dense smoke.
smokejack |A contrivance for turning a spit by means of a fly or wheel moved by the current of ascending air in a chimney.
smokeless |Making or having no smoke. \"Smokeless towers.\" Pope.
smokeless powder |A high-explosive gunpowder whose explosion produces little, if any, smoke.
smoker |1. One who dries or preserves by smoke. 2. One who smokes tobacco or the like. 3. A smoking car or compartment. [U. S.]
smokestack |A chimney; esp., a pipe serving as a chimney, as the pipe which carries off the smoke of a locomotive, the funnel of a steam vessel, etc.
smokily |In a smoky manner.
smokiness |The quality or state of being smoky.
smoking |from Smoke. Smoking bean (Bot.), the long pod of the catalpa, or Indian-bean tree, often smoked by boys as a substitute for cigars. -- Smoking car, a railway car carriage reserved for the use of passengers who smoke tobacco.
smoky |1. Emitting smoke, esp. in large quantities or in an offensive manner; fumid; as, smoky fires. 2. Having the appearance or nature of smoke; as, a smoky fog. \"Unlustrous as the smoky light.\" Shak. 3. Filled with smoke, or with a vapor resembling smoke; thick; as, a smoky atmosphere. 4. Subject to be filled with smoke from chimneys or fireplace; as, a smoky house. 5. Tarnished with smoke; noisome with smoke; as, smoky rafters; smoky cells. 6. Suspicious; open to suspicion. [Obs.] Foote. Smoky quartz (Min.), a variety of quartz crystal of a pale to dark smoky-brown color. See Quartz.
smolder |1. To burn and smoke without flame; to waste away by a slow and supressed combustion. The smoldering dust did round about him smoke. Spenser. 2. To exist in a state of suppressed or smothered activity; to burn inwardly; as, a smoldering feud.\n\nTo smother; to suffocate; to choke. [Obs.] Holinshed. Palsgrave.\n\nSmoke; smother. [Obs.] The smolder stops our nose with stench. Gascoigne.
smoldering |Being in a state of suppressed activity; quiet but not dead. Some evil chance Will make the smoldering scandal break and blaze. Tennyson.
smolderingness |The state of smoldering.
smoldry |Smoldering; suffocating; smothery. [Obs.] A flaming fire ymixt with smoldry smoke. Spenser.
smolt |A young salmon two or three years old, when it has acquired its silvery color.
smooch |See Smutch.
smoor |To suffocate or smother. [Written also smore.] [Obs. or Prov. Eng. & Scot.] Sir T. More. Burns.
smooth |1. Having an even surface, or a surface so even that no roughness or points can be perceived by the touch; not rough; as, smooth glass; smooth porcelain. Chaucer. The outlines must be smooth, imperceptible to the touch, and even, without eminence or cavities. Dryden. 2. Evenly spread or arranged; sleek; as, smooth hair. 3. Gently flowing; moving equably; not ruffled or obstructed; as, a smooth stream. 4. Flowing or uttered without check, obstruction, or hesitation; not harsh; voluble; even; fluent. The only smooth poet of those times. Milton. Waller was smooth; but Dryden taught to join The varying verse, the full-resounding line. Pope. When sage Minerva rose, From her sweet lips smooth elocution flows. Gay. 5. Bland; mild; smoothing; fattering. This smooth discourse and mild behavior oft Conceal a traitor. Addison. 6. (Mech. & Physics)  Causing no resistance to a body sliding along its surface; frictionless. Note: Smooth is often used in the formation of selfexplaining compounds; as, smooth-bodied, smooth-browed, smooth-combed, smooth- faced, smooth-finished, smooth-gliding, smooth-grained, smooth- leaved, smooth-sliding, smooth-speaking, smooth-woven, and the like. Syn. -- Even; plain; level; flat; polished; glossy; sleek; soft; bland; mild; soothing; voluble; flattering; adulatory; deceptive.\n\nSmoothly. Chaucer. Smooth runs the water where the brook is deep. Shak.\n\n1. The act of making smooth; a stroke which smooths. Thackeray. 2. That which is smooth; the smooth part of anything. \"The smooth of his neck.\" Gen. xxvii. 16.\n\nTo make smooth; to make even on the surface by any means; as, to smooth a board with a plane; to smooth cloth with an iron. Specifically: -- (a) To free from obstruction; to make easy. Thou, Abelard! the last sad office pay, And smooth my passage to the realms of day. Pope. (b) To free from harshness; to make flowing. In their motions harmony divine So smooths her charming tones that God's own ear Listens delighted. Milton. (c) To palliate; to gloze; as, to smooth over a fault. (d) To give a smooth or calm appearance to. Each perturbation smoothed with outward calm. Milton. (e) To ease; to regulate. Dryden.\n\nTo flatter; to use blandishment. Because I can not flatter and speak fair, Smile in men's faces, smooth, deceive and cog. Shak.
smooth-chinned |Having a smooth chin; beardless. Drayton.
smooth-spoken |Speaking smoothly; plausible; flattering; smooth-tongued.
smooth-tongued |Having a smooth tongue; plausible; flattering.
smoothbore |Having a bore of perfectly smooth surface; -- distinguished from rifled. -- n.  A smoothbore firearm.
smoothen |To make smooth. [Obs.]
smoother |One who, or that which, smooths.
smoothing |fr. Smooth, v. Smoothing iron, an iron instrument with a polished face, for smoothing clothes; a sadiron; a flatiron. -- Smoothing plane, a short, finely set plane, for smoothing and finishing work.
smoothly |In a smooth manner.
smoothness |Quality or state of being smooth.
smore |To smother. See Smoor. [Obs.] Some dying vomit blood, and some were smored. Du Bartas.
smorsato |Growing gradually fainter and softer; dying away; morendo.
smorzando |Growing gradually fainter and softer; dying away; morendo.
smote |imp. (and rare p. p.) of Smite.
smoterlich |Dirty foul. [Obs.] Chaucer.
smother |1. To destroy the life of by suffocation; to deprive of the air necessary for life; to cover up closely so as to prevent breathing; to suffocate; as, to smother a child. 2. To affect as by suffocation; to stife; to deprive of air by a thick covering, as of ashes, of smoke, or the like; as, to smother a fire. 3. Hence, to repress the action of; to cover from public view; to suppress; to conceal; as, to smother one's displeasure.\n\n1. To be suffocated or stifled. 2. To burn slowly, without sufficient air; to smolder.\n\n1. Stifling smoke; thick dust. Shak. 2. A state of suppression. [Obs.] Not to keep their suspicions in smother. Bacon. Smother fly (Zo√∂l.), an aphid.
smothered mate |Checkmate given when movement of the king is completely obstructed by his own men.
smotheriness |The quality or state of being smothery.
smotheringly |In a smothering manner.
smothery |Tending to smother; stifling.
smouch |To kiss closely. [Obs.] P. Stubbes.\n\nTo smutch; to soil; as, to smouch the face.\n\nA dark soil or stain; a smutch.
smoulder |1. To burn and smoke without flame; to waste away by a slow and supressed combustion. The smoldering dust did round about him smoke. Spenser. 2. To exist in a state of suppressed or smothered activity; to burn inwardly; as, a smoldering feud.\n\nTo smother; to suffocate; to choke. [Obs.] Holinshed. Palsgrave.\n\nSmoke; smother. [Obs.] The smolder stops our nose with stench. Gascoigne.\n\nSee Smolder.
smouldering |Being in a state of suppressed activity; quiet but not dead. Some evil chance Will make the smoldering scandal break and blaze. Tennyson.
smoulderingness |The state of smoldering.
smouldry |Smoldering; suffocating; smothery. [Obs.] A flaming fire ymixt with smoldry smoke. Spenser.\n\nSee Smoldry.
smudge |1. A suffocating smoke. Grose. 2. A heap of damp combustibles partially ignited and burning slowly, placed on the windward side of a house, tent, or the like, in order, by the thick smoke, to keep off mosquitoes or other insects. [U. S.] Bartlett. 3. That which is smeared upon anything; a stain; a blot; a smutch; a smear.\n\n1. To stifle or smother with smoke; to smoke by means of a smudge. 2. To smear; to smutch; to soil; to blacken with smoke.
smudginess |The quality or state of being smudged, soiled, or blurred. C. A. Young.
smug |Studiously neat or nice, especially in dress; spruce; affectedly precise; smooth and prim. They be so smug and smooth. Robynson (More's Utopia). The smug and scanty draperies of his style. De Quincey. A young, smug, handsome holiness has no fellow. Beau & Fl.\n\nTo make smug, or spruce. [Obs.] Thus said, he smugged his beard, and stroked up fair. Dryton.
smuggle |1. To import or export secretly, contrary to the law; to import or export without paying the duties imposed by law; as, to smuggle lace. 2. Fig.: To convey or introduce clandestinely.\n\nTo import or export in violation of the customs laws.
smuggler |1. One who smuggles. 2. A vessel employed in smuggling.
smugly |In a smug manner. [R.] Gay.
smugness |The quality or state of being smug.
smut |1. Foul matter, like soot or coal dust; also, a spot or soil made by such matter. 2. (Mining)  Bad, soft coal, containing much earthy matter, found in the immediate locality of faults. 3. (Bot.)  An affection of cereal grains producing a swelling which is at length resolved into a powdery sooty mass. It is caused by parasitic fungi of the genus Ustilago. Ustilago segetum, or U. Carbo, is the commonest kind; that of Indian corn is Ustilago maydis. 4. Obscene language; ribaldry; obscenity. He does not stand upon decency . . . but will talk smut, though a priest and his mother be in the room. Addison. Smut mill, a machine for cleansing grain from smut.\n\n1. To stain or mark with smut; to blacken with coal, soot, or other dirty substance. 2. To taint with mildew, as grain. Bacon. 3. To blacken; to sully or taint; to tarnish. 4. To clear of smut; as, to smut grain for the mill.\n\n1. To gather smut; to be converted into smut; to become smutted. Mortimer. 2. To give off smut; to crock.
smutch |A stain; a dirty spot. B. Jonson.\n\nTo blacken with smoke, soot, or coal. [Written also smooch.] B. Jonson.
smutchin |Snuff. [Obs.] Howell.
smutty |1. Soiled with smut; smutted. 2. Tainted with mildew; as, smutty corn. 3. Obscene; not modest or pure; as, a smutty saying. The smutty joke, ridiculously lewd. Smollett. -- Smut\"ti*ly, adv. -- Smut\"ti*ness, n.
smyrniot |Of or pertaining to Smyrna. -- n.  A native or inhabitant of Smyrna.
snack |1. A share; a part or portion; -- obsolete, except in the colloquial phrase, to go snacks, i. e., to share. At last he whispers, \"Do, and we go snacks.\" Pope. 2. A slight, hasty repast. [Colloq.]
snacket |See Snecket. [Prov. Eng.]
snacot |A pipefish of the genus Syngnathus. See Pipefish.
snaffle |A kind of bridle bit, having a joint in the part to be placed in the mouth, and rings and cheek pieces at the ends, but having no curb; -- called also snaffle bit.\n\nTo put a snaffle in the mouth of; to subject to the snaffle; to bridle.
snag |1. A stump or base of a branch that has been lopped off; a short branch, or a sharp or rough branch; a knot; a protuberance. The coat of arms Now on a naked snag in triumph borne. Dryden. 2. A tooth projecting beyond the rest; contemptuously, a broken or decayed tooth. Prior. 3. A tree, or a branch of a tree, fixed in the bottom of a river or other navigable water, and rising nearly or quite to the surface, by which boats are sometimes pierced and sunk. 4. (Zo√∂l.)  One of the secondary branches of an antler. Snag boat, a steamboat fitted with apparatus for removing snags and other obstructions in navigable streams. [U.S.] -- Snag tooth. Same as Snag, 2. How thy snag teeth stand orderly, Like stakes which strut by the water side. J. Cotgrave.\n\n1. To cut the snags or branches from, as the stem of a tree; to hew roughly. [Prov. Eng.] Halliwell. 2. To injure or destroy, as a steamboat or other vessel, by a snag, or projecting part of a sunken tree. [U. S.]
snagged |Full of snags; snaggy.
snaggy |1. Full of snags; full of short, rough branches or sharp points; abounding with knots. \"Upon a snaggy oak.\" Spenser. 2. Snappish; cross; ill-tempered. [Prov. Eng.]
snail |1. (Zo√∂l.) (a) Any one of numerous species of terrestrial air-breathing gastropods belonging to the genus Helix and many allied genera of the family Helicid√¶. They are abundant in nearly all parts of the world except the arctic regions, and feed almost entirely on vegetation; a land sanil. (b) Any gastropod having a general resemblance to the true snails, including fresh-water and marine species. See Pond snail, under Pond, and Sea snail. 2. Hence, a drone; a slow-moving person or thing. 3. (Mech.)  A spiral cam, or a flat piece of metal of spirally curved outline, used for giving motion to, or changing the position of, another part, as the hammer tail of a striking clock. 4. A tortoise; in ancient warfare, a movable roof or shed to protect besiegers; a testudo. [Obs.] They had also all manner of gynes [engines] . . . that needful is [in] taking or sieging of castle or of city, as snails, that was naught else but hollow pavises and targets, under the which men, when they fought, were heled [protected], . . . as the snail is in his house; therefore they cleped them snails. Vegetius (Trans.). 5. (Bot.)  The pod of the sanil clover. Ear snail, Edible snail, Pond snail, etc. See under Ear, Edible, etc. -- Snail borer (Zo√∂l.), a boring univalve mollusk; a drill. -- Snail clover (Bot.), a cloverlike plant (Medicago scuttellata, also, M. Helix); -- so named from its pods, which resemble the shells of snails; -- called also snail trefoil, snail medic, and beehive. -- Snail flower (Bot.), a leguminous plant (Phaseolus Caracalla) having the keel of the carolla spirally coiled like a snail shell. -- Snail shell (Zo√∂l.), the shell of snail. -- Snail trefoil. (Bot.) See Snail clover, above.
snail-like |Like or suiting a snail; as, snail-like progress.\n\nIn the manner of a snail; slowly.
snail-paced |Slow-moving, like a snail. Bid the snail-paced Ajax arm for shame. Shak. 'SNAILS 'Snails, interj.  God's nails, or His nails, that is, the nails with which the Savior was fastened to the cross; -- an ancient form of oath, corresponding to 'Od's bodikins (dim. of body, i.e., God's dear body). Beau & Fl.
snailfish |See Sea snail (a).
snake |Any species of the order Ophidia; an ophidian; a serpent, whether harmless or venomous. See Ophidia, and Serpent. Note: Snakes are abundant in all warm countries, and much the larger number are harmless to man. Blind snake, Garter snake, Green snake, King snake, Milk snake, Rock snake, Water snake, etc. See under Blind, Garter, etc. -- Fetich snake (Zo√∂l.), a large African snake (Python Seb√¶) used by the natives as a fetich. -- Ringed snake (Zo√∂l.), a common European columbrine snake (Tropidonotus natrix). -- Snake eater. (Zo√∂l.) (a) The markhoor. (b) The secretary bird. -- Snake fence, a worm fence (which see). [U.S.] -- Snake fly (Zo√∂l.), any one of several species of neuropterous insects of the genus Rhaphidia; -- so called because of their large head and elongated neck and prothorax. -- Snake gourd (Bot.), a cucurbitaceous plant (Trichosanthes anguina) having the fruit shorter and less snakelike than that of the serpent cucumber. -- Snake killer. (Zo√∂l.) (a) The secretary bird. (b) The chaparral cock. -- Snake moss (Bot.), the common club moss (Lycopodium clavatum). See Lycopodium. -- Snake nut (Bot.), the fruit of a sapindaceous tree (Ophiocaryon paradoxum) of Guiana, the embryo of which resembles a snake coiled up. -- Tree snake (Zo√∂l.), any one of numerous species of colubrine snakes which habitually live in trees, especially those of the genus Dendrophis and allied genera.\n\n1. To drag or draw, as a snake from a hole; -- often with out. [Colloq. U.S.] Bartlett. 2. (Naut.)  To wind round spirally, as a large rope with a smaller, or with cord, the small rope lying in the spaces between the strands of the large one; to worm.\n\nTo crawl like a snake.
snakebird |1. Any one of four species of aquatic birds of the genus Anhinga or Plotus. They are allied to the gannets and cormorants, but have very long, slender, flexible necks, and sharp bills. Note: The American species (Anhinga, or Plotus, anhinga) inhabits the Southern United States and tropical America; -- called also darter, and water turkey. The Asiatic species (A. melanogaster) is native of Southern Asia and the East Indies. Two other species inhabit Africa and Australia respectively. 2. (Zo√∂l.)  The wryneck.
snakefish |(a) The band fish. (b) The lizard fish.
snakehead |1. A loose, bent-up end of one of the strap rails, or flat rails, formerly used on American railroads. It was sometimes so bent by the passage of a train as to slip over a wheel and pierce the bottom of a car. 2. (Bot.) (a) The turtlehead. (b) The Guinea-hen flower. See Snake's-head, and under Guinea.
snakeneck |The snakebird, 1.
snakeroot |Any one of several plants of different genera and species, most of which are (or were formerly) reputed to be efficacious as remedies for the bites of serpents; also, the roots of any of these. Note: The Virginia snakeroot is Aristolochia Serpentaria; black snakeroot is Sanicula, esp. S. Marilandica, also Cimicifuga racemosa; Seneca snakeroot is Polygala Senega; button snakeroot is Liatris, also Eryngium; white snakeroot is Eupatorium ageratoides. The name is also applied to some others besides these. SNAKE'S-HEAD Snake's\"-head`, n. (Bot.)  The Guinea-hen flower; -- so called in England because its spotted petals resemble the scales of a snake's head. Dr. Prior. Snake's-head iris (Bot.), an iridaceous plant (Hermodactylus tuberosus) of the Mediterranean region. The flowers slightly resemble a serpent's open mouth.
snakestone |1. A kind of hone slate or whetstone obtained in Scotland. 2. (Paleon.)  An ammonite; -- so called from its form, which resembles that of a coiled snake. SNAKE'S-TONGUE Snake's-tongue`, n. (Bot.)  Same as Adder's-tongue.
snakeweed |(a) A kind of knotweed (Polygonum Bistorta). (b) The Virginia snakeroot. See Snakeroot.
snakewood |(a) An East Indian climbing plant (Strychnos colubrina) having a bitter taste, and supposed to be a remedy for the bite of the hooded serpent. (b) An East Indian climbing shrub (Ophioxylon serpentinum) which has the roots and stems twisted so as to resemble serpents. (c) Same as Trumpetwood. (d) A tropical American shrub (Plumieria rubra) which has very fragrant red blossoms. (e) Same as Letterwood.
snakish |Having the qualities or characteristics of a snake; snaky.
snaky |1. Of or pertaining to a snake or snakes; resembling a snake; serpentine; winding. The red light playing upon its gilt and carving gave it an appearance of snaky life. L. Wallace. 2. Sly; cunning; insinuating; deceitful. So to the coast of Jordan he directs His easy steps, girded with snaky wiles. Milton. 3. Covered with serpents; having serpents; as, a snaky rod or wand. Dryden. That snaky-headed, Gorgon shield. Milton.
snap |1. To break at once; to break short, as substances that are brittle. Breaks the doors open, snaps the locks. Prior. 2. To strike, to hit, or to shut, with a sharp sound. 3. To bite or seize suddenly, especially with the teeth. He, by playing too often at the mouth of death, has been snapped by it at last. South. 4. To break upon suddenly with sharp, angry words; to treat snappishly; -- usually with up. Granville. 5. To crack; to cause to make a sharp, cracking noise; as, to snap a whip. MacMorian snapped his fingers repeatedly. Sir W. Scott. 6. To project with a snap. To snap back (Football), to roll the ball back with the foot; -- done only by the center rush, who thus delivers the ball to the quarter back on his own side when both sides are ranged in line. -- To snap off. (a) To break suddenly. (b) To bite off suddenly.\n\n1. To break short, or at once; to part asunder suddenly; as, a mast snaps; a needle snaps. But this weapon will snap short, unfaithful to the hand that employs it. Burke. 2. To give forth, or produce, a sharp, cracking noise; to crack; as, blazing firewood snaps. 3. To make an effort to bite; to aim to seize with the teeth; to catch eagerly (at anything); -- often with at; as, a dog snapsat a passenger; a fish snaps at the bait. 4. To utter sharp, harsh, angry words; -- often with at; as, to snap at a child. 5. To miss fire; as, the gun snapped.\n\n1. A sudden breaking or rupture of any substance. 2. A sudden, eager bite; a sudden seizing, or effort to seize, as with the teeth. 3. A sudden, sharp motion or blow, as with the finger sprung from the thumb, or the thumb from the finger. 4. A sharp, abrupt sound, as that made by the crack of a whip; as, the snap of the trigger of a gun. 5. A greedy fellow. L'Estrange. 6. That which is, or may be, snapped up; something bitten off, seized, or obtained by a single quick movement; hence, a bite, morsel, or fragment; a scrap. He's a nimble fellow, And alike skilled in every liberal science, As having certain snaps of all. B. Jonson. 7. A sudden severe interval or spell; -- applied to the weather; as, a cold snap. Lowell. 8. A small catch or fastening held or closed by means of a spring, or one which closes with a snapping sound, as the catch of a bracelet, necklace, clasp of a book, etc. 9. (Zo√∂l.)  A snap beetle. 10. A thin, crisp cake, usually small, and flavored with ginger; -- used chiefly in the plural. 11. Briskness; vigor; energy; decision. [Colloq.] 12. Any circumstance out of which money may be made or an advantage gained. [Slang] Snap back (Football), the act of snapping back the ball. -- Snap beetle, or Snap bug (Zo√∂l.), any beetle of the family Elaterid√¶, which, when laid on its back, is able to leap to a considerable height by means of a thoracic spring; -- called also snapping beetle. -- Snap flask (Molding), a flask for small work, having its sides separable and held together by latches, so that the flask may be removed from around the sand mold. -- Snap judgment, a judgment formed on the instant without deliberation. -- Snap lock, a lock shutting with a catch or snap. -- Snap riveting, riveting in which the rivets have snapheads formed by a die or swaging tool. -- Snap shot, a quick offhand shot, without deliberately taking aim.
snap shot |1. Commonly Snap shot. (a) A quick offhand shot, made without deliberately taking aim over the sights. (b) (Photog.) Act of taking a snapshot (in sense 2). 2.  An instantaneous photograph made, usually with a hand camera, without formal posing of, and often without the foreknowledge of, the subject.
snapdragon |1. (Bot.) (a) Any plant of the scrrophulariaceous genus Antirrhinum, especially the cultivated A. majus, whose showy flowers are fancifully likened to the face of a dragon. (b) A West Indian herb (Ruellia tuberosa) with curiously shaped blue flowers. 2. A play in which raisins are snatched from a vessel containing burning brandy, and eaten; also, that which is so eaten. See Flapdragon. Swift.
snape |To bevel the end of a timber to fit against an inclined surface.
snaphance |1. A spring lock for discharging a firearm; also, the firearm to which it is attached. [Obs.] 2. A trifling or second-rate thing or person. [Obs.]
snaphead |A hemispherical or rounded head to a rivet or bolt; also, a swaging tool with a cavity in its face for forming such a rounded head.
snapper |1. One who, or that which, snaps; as, a snapper up of trifles; the snapper of a whip. 2. (Zo√∂l.)  Any one of several species of large sparoid food fishes of the genus Lutjanus, abundant on the southern coasts of the United States and on both coasts of tropical America. Note: The red snapper (Lutjanus aya, or Blackfordi) and the gray, or mangrove, snapper (L. griseus) are large and abundant species. The name is loosely applied to various other fishes, as the bluefish, the rosefish, the red grouper, etc. See Rosefish. 3. (Zo√∂l.)  A snapping turtle; as, the alligator snapper. 4. (Zo√∂l.)  The green woodpecker, or yaffle. 5. (Zo√∂l.)  A snap beetle.
snapping |a. & n. from Snap, v. Snapping beetle. (Zo√∂l.) See Snap beetle, under Snap. -- Snapping turtle. (Zo√∂l.) (a) A large and voracious aquatic turtle (Chelydra serpentina) common in the fresh waters of the United States; -- so called from its habit of seizing its prey by a snap of its jaws. Called also mud turtle. (b) See Alligator snapper, under Alligator.
snappish |1. Apt to snap at persons or things; eager to bite; as, a snapping cur. 2. Sharp in reply; apt to speak angrily or testily; easily provoked; tart; peevish. The taunting address of a snappish missanthrope. Jeffrey. -- Snap\"pish*ly, adv. -- Snap\"pish*ness, n.
snappy |Snappish. [Colloq.]
snapsack |A knapsack. [Obs.] South.
snapshot |1. Commonly Snap shot. (a) A quick offhand shot, made without deliberately taking aim over the sights. (b) (Photog.) Act of taking a snapshot (in sense 2). 2.  An instantaneous photograph made, usually with a hand camera, without formal posing of, and often without the foreknowledge of, the subject.
snapweed |See Impatiens.
snar |To snarl. [Obs.] Spenser.
snare |1. A contrivance, often consisting of a noose of cord, or the like, by which a bird or other animal may be entangled and caught; a trap; a gin. 2. Hence, anything by which one is entangled and brought into trouble. If thou retire, the Dauphin, well appointed, Stands with the snares of war to tangle thee. Shak. 3. The gut or string stretched across the lower head of a drum. 4. (Med.)  An instrument, consisting usually of a wireloop or noose, for removing tumors, etc., by avulsion. Snare drum, the smaller common military drum, as distinguished from the bass drum; -- so called because (in order to render it more resonant) it has stretched across its lower head a catgut string or strings.\n\nTo catch with a snare; to insnare; to entangle; hence, to bring into unexpected evil, perplexity, or danger. Lest that too heavenly form . . . snare them. Milton. The mournful crocodile With sorrow snares relenting passengers. Shak.
snarer |One who lays snares, or entraps.
snarl |To form raised work upon the outer surface of (thin metal ware) by the repercussion of a snarling iron upon the inner surface.\n\n1. To entangle; to complicate; to involve in knots; as, to snarl a skein of thread. \"Her snarled hair.\" Spenser. 2. To embarrass; to insnare. [The] question that they would have snarled him with. Latimer.\n\nA knot or complication of hair, thread, or the like, difficult to disentangle; entanglement; hence, intricate complication; embarrassing difficulty.\n\n1. To growl, as an angry or surly dog; to gnarl; to utter grumbling sounds. \"An angry cur snarls while he feeds.\" Dryden & Lee. 2. To speak crossly; to talk in rude, surly terms. It is malicious and unmanly to snarl at the little lapses of a pen, from which Virgil himself stands not exempted. Dryden.\n\nThe act of snarling; a growl; a surly or peevish expression; an angry contention.
snarler |One who snarls; a surly, growling animal; a grumbling, quarrelsome fellow.\n\nOne who makes use of a snarling iron.
snarling |from Snarl, v. Snarling iron, a tool with a long beak, used in the process of snarling. When one end is held in a vise, and the shank is struck with a hammer, the repercussion of the other end, or beak, within the article worked upon gives the requisite blow for producing raised work. See 1st Snarl.
snary |Resembling, or consisting of, snares; entangling; insidious. Spiders in the vault their snary webs have spread. Dryden.
snast |The snuff, or burnt wick, of a candle. [Obs.] Bacon.
snatch |1. To take or seize hastily, abruptly, or without permission or ceremony; as, to snatch a loaf or a kiss. When half our knowledge we must snatch, not take. Pope. 2. To seize and transport away; to rap. \"Snatch me to heaven.\" Thomson. Syn. -- To twitch; pluck; grab; catch; grasp; gripe.\n\nTo attempt to seize something suddenly; to catch; -- often with at; as, to snatch at a rope.\n\n1. A hasty catching or seizing; a grab; a catching at, or attempt to seize, suddenly. 2. A short period of vigorous action; as, a snatch at weeding after a shower. Tusser. They move by fits and snatches. Bp. Wilkins. 3. A small piece, fragment, or quantity; a broken part; a scrap. We have often little snatches of sunshine. Spectator. Leave me your snatches, and yield me a direct answer. Shak.
snatch block |a kind of block with an opening in one side to receive the bight of a rope.
snatcher |One who snatches, or takes abruptly.
snatchingly |By snatching; abruptly.
snath |The handle of a scythe; a snead. [Variously written in England snead, sneed, sneath, sneeth, snathe, etc.; in Scotland written sned.]\n\nThe handle of a scythe; a snead. [Variously written in England snead, sneed, sneath, sneeth, snathe, etc.; in Scotland written sned.]
snathe |To lop; to prune. [Prov. Eng.]
snattock |A chip; a alice. [Prov. Eng.] Gayton.
snaw |Snow. [Obs. or Scot.] Burns.
snead |1. A snath. 2. A line or cord; a string. [Prov. Eng.]
sneak |1. To creep or steal (away or about) privately; to come or go meanly, as a person afraid or ashamed to be seen; as, to sneak away from company. imp. & p. p. \"snuck\" is more common now, but not even mentioned here. In MW10, simply \"sneaked or snuck\" You skulked behind the fence, and sneaked away. Dryden. 2. To act in a stealthy and cowardly manner; to behave with meanness and servility; to crouch.\n\nTo hide, esp. in a mean or cowardly manner. [Obs.] \"[Slander] sneaks its head.\" Wake.\n\n1. A mean, sneaking fellow. A set of simpletons and superstitious sneaks. Glanvill. 2. (Cricket)  A ball bowled so as to roll along the ground; -- called also grub. [Cant] R. A. Proctor.
sneak current |A current which, though too feeble to blow the usual fuse or to injure at once telegraph or telephone instruments, will in time burn them out.
sneak-cup |One who sneaks from his cups; one who balks his glass. [Obs.] Shak.
sneaker |1. One who sneaks. Lamb. 2. A vessel of drink. [Prov. Eng.] A sneaker of five gallons. Spectator.
sneakiness |The quality of being sneaky.
sneaking |Marked by cowardly concealment; deficient in openness and courage; underhand; mean; crouching. -- Sneak\"ing*ly, adv. -- Sneak\"ing*ness, n.
sneaksby |A paltry fellow; a sneak. [Obs.] \"Such a bashful sneaksby.\" Barrow.
sneaky |Like a sneak; sneaking.
sneap |1. To check; to reprimand; to rebuke; to chide. [Obs.] Bp. Hall. 2. To nip; to blast; to blight. [Obs.] Biron is like an envious, sneaping frost. Shak.\n\nA reprimand; a rebuke. [Obs.] My lord, I will not undergo this sneap without reply. Shak.
sneath |See Snath.
sneathe |See Snath.
sneb |To reprimand; to sneap. [Obs.] \"Scold and sneb the good oak.\" Spenser.
sneck |To fasten by a hatch; to latch, as a door. [Scot. & Prov. Eng.] Sneck up, be silent; shut up; hold your peace. Shak.\n\nA door latch. [Scot. & Prov. Eng.] Sneck band, a latchstring. Burns. -- Sneck drawer, a latch lifter; a bolt drawer; hence, a sly person; a cozener; a cheat; -- called also sneckdraw. -- Sneck drawing, lifting the latch.
snecket |A door latch, or sneck. [Prov. Eng.]
sned |To lop; to snathe. [Prov. Eng.]\n\nSee Snath.
sneed |See Snath.
sneer |1. To show contempt by turning up the nose, or by a particular facial expression. 2. To inssinuate contempt by a covert expression; to speak derisively. I could be content to be a little sneared at. Pope. 3. To show mirth awkwardly. [R.] Tatler. Syn. -- To scoff; gibe; jeer. -- Sneer, Scoff, Jeer. The verb to sneer implies to cast contempt indirectly or by covert expressions. To jeer is stronger, and denotes the use of several sarcastic reflections. To scoff is stronger still, implying the use of insolent mockery and derision. And sneers as learnedly as they, Like females o'er their morning tea. Swift. Midas, exposed to all their jeers, Had lost his art, and kept his ears. Swift. The fop, with learning at defiance, Scoffs at the pedant and science. Gay.\n\n1. To utter with a grimace or contemptuous expression; to utter with a sneer; to say sneeringly; as, to sneer fulsome lies at a person. Congreve. \"A ship of fools,\" he sneered. Tennyson. 2. To treat with sneers; to affect or move by sneers. Nor sneered nor bribed from virtue into shame. Savage.\n\n1. The act of sneering. 2. A smile, grin, or contortion of the face, indicative of contempt; an indirect expression or insinuation of contempt. \"Who can refute a sneer\" Raley.
sneerer |One who sneers.
sneerful |Given to sneering. [Obs.]
sneeringly |In a sneering manner.
sneeze |To emit air, chiefly through the nose, audibly and violently, by a kind of involuntary convulsive force, occasioned by irritation of the inner membrane of the nose. Not to be sneezed at, not to be despised or contemned; not to be treated lightly. [Colloq.] \"He had to do with old women who were not to be sneezed at.\" Prof. Wilson.\n\nA sudden and violent ejection of air with an audible sound, chiefly through the nose.
sneezeweed |A yellow-flowered composite plant (Helenium autumnale) the odor of which is said to cause sneezing.
sneezewood |The wood of a South African tree. See Neishout.
sneezewort |A European herbaceous plant (Achillea Ptarmica) allied to the yarrow, having a strong, pungent smell.
sneezing |The act of violently forcing air out through the nasal passages while the cavity of the mouth is shut off from the pharynx by the approximation of the soft palate and the base of the tongue.
snell |Active; brisk; nimble; quick; sharp. [Archaic or Prov. Eng. & Scot.] That horny-handed, snell, peremptory little man. Dr. J. Brown.\n\nA short line of horsehair, gut, etc., by which a fishhook is attached to a longer line.
snet |The fat of a deer. [Obs. or Prov. Eng.]\n\nThe clear of mucus; to blow. [Obs.] \"Snetting his nose.\" Holland.
snew |To snow; to abound. [Obs.] It snewed in his house of meat and drink. Chaucer.
snib |To check; to sneap; to sneb. [Obs.] Him would he snib sharply for the nones. Chaucer.\n\nA reprimand; a snub. [Obs.] Marston.
snick |1. A small cut or mark. 2. (Cricket)  A slight hit or tip of the ball, often unintentional. 3. (Fiber)  A knot or irregularity in yarn. Knight. 4. (Furriery)  A snip or cut, as in the hair of a beast. Snick and snee Etym: [cf. D. snee, snede, a cut], a combat with knives. [Obs.] Wiseman.\n\n1. To cut slightly; to strike, or strike off, as by cutting. H. Kingsley. 2. (Cricket)  To hit (a ball) lightly. R. A. Proctor.\n\nSee Sneck. [Prov. Eng. & Scot.] Snick up, shut up; silenced. See Sneck up, under Sneck. Give him money, George, and let him go snick up. Beau & Fl.
snicker |1. To laugh slyly; to laugh in one's sleeve. 2. To laugh with audible catches of voice, as when persons attempt to suppress loud laughter.\n\nA half suppressed, broken laugh. [Written also snigger.]
snide |Tricky; deceptive; contemptible; as, a snide lawyer; snide goods. [Slang]
snider |A breech-loading rifle formerly used in the British service; -- so called from the inventor.
snider rifle |A breech-loading rifle formerly used in the British service; -- so called from the inventor.
sniff |To draw air audibly up the nose; to snuff; -- sometimes done as a gesture of suspicion, offense, or contempt. So ye grow squeamish, gods, and sniff at heaven. M. Arnold.\n\n1. To draw in with the breath through the nose; as, to sniff the air of the country. 2. To perceive as by sniffing; to snuff, to scent; to smell; as, to sniff danger.\n\nThe act of sniffing; perception by sniffing; that which is taken by sniffing; as, a sniff of air.
sniffing |A rapid inspiratory act, in which the mouth is kept shut and the air drawn in through the nose.
sniffle |To snuffle, as one does with a catarrh. [Prov. Eng.]
snift |1. To snort. [Obs.] \"Resentment expressed by snifting.\" Johnson. 2. To sniff; to snuff; to smell. It now appears that they were still snifing and hankering after their old quarters. Landor.\n\n1. A moment. [Prov. Eng.] Halliwell. 2. Slight snow; sleet. [Prov. Eng.] Halliwell.
snifting |from Snift. Snifting valve, a small valve opening into the atmosphere from the cylinder or condenser of a steam engine, to allow the escape of air when the piston makes a stroke; -- so called from the noise made by its action.
snig |To chop off; to cut. [Prov. Eng.]\n\nTo sneak. [Prov. Eng.]\n\nA small eel. [Prov. Eng.]
snigg |A small eel. [Prov. Eng.]
snigger |See Snicker. Thackeray.\n\nSee Snicker. Dickens.
sniggle |To fish for eels by thrusting the baited hook into their holes or hiding places. Walton.\n\nTo catch, as an eel, by sniggling; hence, to hook; to insnare. Beau & Fl.
snip |To cut off the nip or neb of, or to cut off at once with shears or scissors; to clip off suddenly; to nip; hence, to break off; to snatch away. Curbed and snipped in my younger years by fear of my parents from those vicious excrescences to which that age was subject. Fuller. The captain seldom ordered anything out of the ship's stores . . . but I snipped some of it for my own share. De Foe.\n\n1. A single cut, as with shears or scissors; a clip. Shak. 2. A small shred; a bit cut off. Wiseman. 3. A share; a snack. [Obs.] L'Estrange 4. A tailor. [Slang] Nares. C. Kingsley. 5. Small hand shears for cutting sheet metal.
snip-snap |A tart dialogue with quick replies. [R.] Pope.\n\nQuick; short; sharp; smart. Shak.
snipe |1. (Zo√∂l.)  Any one of numerous species of limicoline game birds of the family Scolopacid√¶, having a long, slender, nearly straight beak. Note: The common, or whole, snipe (Gallinago coelestis) and the great, or double, snipe (G. major), are the most important European species. The Wilson's snipe (G. delicata) (sometimes erroneously called English snipe) and the gray snipe, or dowitcher (Macrohamphus griseus), are well-known American species. 2. A fool; a blockhead. [R.] Shak. Half snipe, the dunlin; the jacksnipe. -- Jack snipe. See Jacksnipe. -- Quail snipe. See under Quail. -- Robin snipe, the knot. -- Sea snipe. See in the Vocabulary. -- Shore snipe, any sandpiper. -- Snipe hawk, the marsh harrier. [Prov. Eng.] -- Stone snipe, the tattler. -- Summer snipe, the dunlin; the green and the common European sandpipers. -- Winter snipe. See Rock snipe, under Rock. -- Woodcock snipe, the great snipe.
snipebill |1. A plane for cutting deep grooves in moldings. 2. A bolt by which the body of a cart is fastened to the axle. [Local, U.S.]
snipefish |(a) The bellows fish. (b) A long, slender deep-sea fish (Nemichthys scolopaceus) with a slender beak.
snippack |The common snipe. [Prov. Eng.]
snipper |One who snips.
snipper-snaper |A small, insignificant fellow. [Colloq.]
snippet |A small part or piece. To be cut into snippets and shreds. F. Harrison.
snippety |Ridiculously small; petty. \"Snippety facts.\" London Spectator.
snipy |Like a snipe.
snite |A snipe. [Obs. or Scot.] Carew.\n\nTo blow, as the nose; to snuff, as a candle. [Obs. or Scot.]
snithe |Sharp; piercing; cutting; -- applied to the wind. [Prov. Eng.]
snithy |Sharp; piercing; cutting; -- applied to the wind. [Prov. Eng.]
snivel |1. To run at the nose; to make a snuffling noise. 2. To cry or whine with snuffling, as children; to cry weakly or whiningly. Put stop to thy sniveling ditty. Sir W. Scott.\n\nMucus from the nose; snot.
sniveler |One who snivels, esp. one who snivels habitually.
snively |Running at the nose; sniveling pitiful; whining.
snob |1. A vulgar person who affects to be better, richer, or more fashionable, than he really is; a vulgar upstart; one who apes his superiors. Thackeray. Essentially vulgar, a snob. -- a gilded snob, but none the less a snob. R. G. White. 2. (Eng. Univ.)  A townsman. [Canf] 3. A journeyman shoemaker. [Prov. Eng.] Halliwell. 4. A workman who accepts lower than the usual wages, or who refuses to strike when his fellows do; a rat; a knobstick. Those who work for lower wages during a strike are called snobs, the men who stand out being \"nobs\" De Quincey.
snobbery |The quality of being snobbish; snobbishness.
snobbish |Of or pertaining to a snob; characteristic of, or befitting, a snob; vulgarly pretentious. -- Snob\"bish*ly, adv.
snobbishness |Vulgar affectation or ostentation; mean admiration of mean things; conduct or manners of a snob.
snobbism |Snobbery.
snobby |Snobbish. [R.] E. B. Ramsay.
snobling |A little snob. [Jocose] Thackeray.
snobocracy |Snobs, collectively. [Hybrid & Recent] C. Kingsley.
snod |A fillet; a headband; a snood. [Obs. or Prov. Eng.]\n\nTrimmed; smooth; neat; trim; sly; cunning; demure. [Prov. Eng. & Scot.]
snoff |A short candle end used for igniting a fuse. Raymond.
snood |1. The fillet which binds the hair of a young unmarried woman, and is emblematic of her maiden character. [Scot.] And seldom was a snood amid Such wild, luxuriant ringlets hid. Sir W. Scott. 2. A short line (often of horsehair) connecting a fishing line with the hook; a snell; a leader.\n\nTo bind or braid up, as the hair, with a snood. [Scot.]
snooded |Wearing or having a snood. \"The snooded daughter.\" Whittier.
snook |To lurk; to lie in ambush. [Obs.]\n\n(a) A large perchlike marine food fish (Centropomus undecimalis) found both on the Atlantic and Pacific coasts of tropical America; -- called also ravallia, and robalo. (b) The cobia. (c) The garfish.
snooze |A short sleep; a nap. [Colloq.]\n\nTo doze; to drowse; to take a short nap; to slumber. [Colloq.]
snore |To breathe with a rough, hoarse, nasal voice in sleep.\n\nA harsh nasal noise made in sleep.
snorer |One who snores.
snoring |The act of respiring through the open mouth so that the currents of inspired and expired air cause a vibration of the uvula and soft palate, thus giving rise to a sound more or less harsh. It is usually unvoluntary, but may be produced voluntarily.
snort |1. To force the air with violence through the nose, so as to make a noise, as do high-spirited horsed in prancing and play. Fairfax. 2. To snore. [R.] \"The snorting citizens.\" Shak. 3. To laugh out loudly. [Colloq.] Halliwell.\n\nThe act of snorting; the sound produced in snorting.\n\nTo expel throught the nostrils with a snort; to utter with a snort. Keats.
snorter |1. One who snorts. 2. (Zo√∂l.)  The wheather; -- so called from its cry. [Prov. Eng.]
snot |1. Mucus secreted in, or discharged from, the nose. [Low] 2. A mean, insignificant fellow. [Low]\n\nTo blow, wipe, or clear, as the nose.
snotter |To snivel; to cry or whine. [Prov. Eng.] Grose.\n\nA rope going over a yardarm, used to bend a tripping line to, in sending down topgallant and royal yards in vessels of war; also, the short line supporting the heel of the sprit in a small boat.
snottery |Filth; abomination. [Obs.] To purge the snottery of our slimy time. Marston.
snotty |Foul with snot; hence, mean; dirty. -- Snort\"ti*ly, adb. -- Snot\"ti*ness, n.
snout |1. The long, projecting nose of a beast, as of swine. 2. The nose of a man; -- in contempt. Hudibras. 3. The nozzle of a pipe, hose, etc. 4. (Zo√∂l.) (a) The anterior prolongation of the head of a gastropod; -- called also rostrum. (b) The anterior prolongation of the head of weevils and allied beetles. Snout beetle (Zo√∂l.), any one of many species of beetles having an elongated snout and belonging to the tribe Rhynchophora; a weevil. -- Snout moth (Zo√∂l.), any pyralid moth. See Pyralid.\n\nTo furnish with a nozzle or point.
snouty |Resembling a beast's snout. The nose was ugly, long, and big, Broad and snouty like a pig. Otway.
snow |A square-rigged vessel, differing from a brig only in that she has a trysail mast close abaft the mainmast, on which a large trysail is hoisted.\n\n1. Watery particles congealed into white or transparent crystals or flakes in the air, and falling to the earth, exhibiting a great variety of very beautiful and perfect forms. Note: Snow is often used to form compounds, most of which are of obvious meaning; as, snow-capped, snow-clad, snow-cold, snow-crowned, snow-crust, snow-fed, snow-haired, snowlike, snow-mantled, snow- nodding, snow-wrought, and the like. 2. Fig.: Something white like snow, as the white color (argent) in heraldry; something which falls in, or as in, flakes. The field of snow with eagle of black therein. Chaucer. Red snow. See under Red. Snow bunting. (Zo√∂l.) See Snowbird, 1. -- Snow cock (Zo√∂l.), the snow pheasant. -- Snow flea (Zo√∂l.), a small black leaping poduran (Achorutes nivicola) often found in winter on the snow in vast numbers. -- Snow flood, a flood from melted snow. -- Snow flower (Bot.), the fringe tree. -- Snow fly, or Snow insect (Zo√∂l.), any one of several species of neuropterous insects of the genus Boreus. The male has rudimentary wings; the female is wingless. These insects sometimes appear creeping and leaping on the snow in great numbers. -- Snow gnat (Zo√∂l.), any wingless dipterous insect of the genus Chionea found running on snow in winter. -- Snow goose (Zo√∂l.), any one of several species of arctic geese of the genus Chen. The common snow goose (Chen hyperborea), common in the Western United States in winter, is white, with the tips of the wings black and legs and bill red. Called also white brant, wavey, and Texas goose. The blue, or blue-winged, snow goose (C. coerulescens) is varied with grayish brown and bluish gray, with the wing quills black and the head and upper part of the neck white. Called also white head, white-headed goose, and bald brant. -- Snow leopard (Zool.), the ounce. -- Snow line, lowest limit of perpetual snow. In the Alps this is at an altitude of 9,000 feet, in the Andes, at the equator, 16,000 feet. -- Snow mouse (Zo√∂l.), a European vole (Arvicola nivalis) which inhabits the Alps and other high mountains. -- Snow pheasant (Zo√∂l.), any one of several species of large, handsome gallinaceous birds of the genus Tetraogallus, native of the lofty mountains of Asia. The Himalayn snow pheasant (T.Himalayensis) in the best-known species. Called also snow cock, and snow chukor. -- Snow partridge. (Zo√∂l.) See under Partridge. -- Snow pigeon (Zo√∂l.), a pigeon (Columba leuconota) native of the Himalaya mountains. Its back, neck, and rump are white, the top of the head and the ear coverts are black. -- Snow plant (Bot.), a fleshy parasitic herb (Sarcodes sanguinea) growing in the coniferous forests of California. It is all of a bright red color, and is fabled to grow from the snow, through which it sometimes shoots up.\n\nTo fall in or as snow; -- chiefly used impersonally; as, it snows; it snowed yesterday.\n\nTo scatter like snow; to cover with, or as with, snow. Donne. Shak.
snow banner |A bannerlike stream of snow blown into the air from a mountain peak, often having a pinkish color and extending horizontally for several miles across the sky.
snow-blind |Affected with blindness by the brilliancy of snow. -- Snow\"-blind`ness, n.
snow-bound |Enveloped in, or confined by, snow. Whittier.
snow-broth |Snow and water mixed, or snow just melted; very cold liquor. Shak.
snow-capped |Having the top capped or covered with snow; as, snow-capped mountains.
snow-white |White as snow; very white. \"Snow-white and rose-red\" Chaucer.
snowball |1. A round mass of snow pressed or roller together, or anything resembling such a mass. 2. (Bot.)  The Guelder-rose. Snowball tree (Bot.), the Guelder-rose.\n\nTo pelt with snowballs; to throw snowballs at.\n\nTo throw snowballs.
snowberry |A name of several shrubs with white berries; as, the Symphoricarpus racemosus of the Northern United States, and the Chiococca racemosa of Florida and tropical America. Creeping snowberry. (Bot.) See under Creeping.
snowbird |(a) An arctic finch (Plectrophenax, or Plectrophanes, nivalis) common, in winter, both in Europe and the United States, and often appearing in large flocks during snowstorms. It is partially white, but variously marked with chestnut and brown. Called also snow bunting, snowflake, snowfleck, and snowflight. (b) Any finch of the genus Junco which appears in flocks in winter time, especially J. hyemalis in the Eastern United States; -- called also blue snowbird. See Junco. (c) The fieldfare. [Prov. Eng.]
snowcap |A very small humming bird (Microch√¶ra albocoronata) native of New Grenada. Note: The feathers of the top of the head are white and snining, the body blue black with a purple and bronzy luster. The name is applied also to Microch√¶ra parvirostris of Central America, which is similar in color.
snowdrift |A bank of drifted snow.
snowdrop |A bulbous plant (Galanthus nivalis) bearing white flowers, which often appear while the snow is on the ground. It is cultivated in gardens for its beauty. Snowdrop tree. See Silver-bell tree, under Silver, a.
snowflake |1. A flake, or small filmy mass, of snow. 2. (Zo√∂l.)  See Snowbird, 1. 3. (Bot.)  A name given to several bulbous plants of the genus Leucoium (L. vernum, √¶stivum, etc.) resembling the snowdrop, but having all the perianth leaves of equal size.
snowfleck |See Snowbird, 1.
snowl |The hooded merganser. [Local, U.S.]
snowless |Destitute of snow.
snowplough |An implement operating like a plow, but on a larger scale, for clearing away the snow from roads, railways, etc.
snowplow |An implement operating like a plow, but on a larger scale, for clearing away the snow from roads, railways, etc.
snowshed |A shelter to protect from snow, esp. a long roof over an exposed part of a railroad.
snowshoe |A slight frame of wood three or four feet long and about one third as wide, with thongs or cords stretched across it, and having a support and holder for the foot; -- used by persons for walking on soft snow.
snowshoeing |Traveling on snowshoes.
snowshoer |One who travels on snowshoes; an expert in using snowshoes. W. G. Beers.
snowslip |A large mass or avalanche of snow which slips down the side of a mountain, etc.
snowstorm |A storm with falling snow.
snowy |1. White like snow. \"So shows a snowy dove trooping with crows.\" Shak. 2. Abounding with snow; covered with snow. \"The snowy top of cold Olympus.\" Milton. 3. Fig.: Pure; unblemished; unstained; spotless. There did he lose his snowy innocence. J. Hall (1646). Snowy heron (Zo√∂l.), a white heron, or egret (Ardea candidissima), found in the Southern United States, and southward to Chili; -- called also plume bird. -- Snowy lemming (Zo√∂l.), the collared lemming (Cuniculus torquatus), which turns white in winter. -- Snowy owl (Zo√∂l.), a large arctic owl (Nyctea Scandiaca, or N. nivea) common all over the northern parts of the United States and Europe in winter time. Its plumage is sometimes nearly pure white, but it is usually more or less marked with blackish spots. Called also white owl. -- Snowy plover (Zo√∂l.), a small plover (√Ügialitis nivosa) of the western parts of the United States and Mexico. It is light gray above, with the under parts and portions of the head white.
snub |To sob with convulsions. [Obs.] Bailey.\n\n1. To clip or break off the end of; to check or stunt the growth of; to nop. 2. To check, stop, or rebuke, with a tart, sarcastic reply or remark; to reprimand; to check. J. Foster. 3. To treat with contempt or neglect, as a forward or pretentious person; to slight designedly. To snub a cable or rope (Naut.), to check it suddenly in running out. Totten.\n\n1. A knot; a protuberance; a song. [Obs.] [A club] with ragged snubs and knotty grain. Spenser. 2. A check or rebuke; an intended slight. J. Foster. Snub nose, a short or flat nose. -- Snub post, or Snubbing post (Naut.), a post on a dock or shore, around which a rope is thrown to check the motion of a vessel.
snub-nosed |Having a short, flat nose, slightly turned up; as, the snub- nosed eel. Snub-nosed cachalot (Zo√∂l.), the pygmy sperm whale.
snudge |To lie snug or quiet. [Obs.] Herbert.\n\nA miser; a sneaking fellow. [Obs.]
snuff |The part of a candle wick charred by the flame, whether burning or not. If the burning snuff happens to get out of the snuffers, you have a chance that it may fall into a dish of soup. Swift.\n\nTo crop the snuff of, as a candle; to take off the end of the snuff of. To snuff out, to extinguish by snuffing.\n\n1. To draw in, or to inhale, forcibly through the nose; to sniff. He snuffs the wind, his heels the sand excite. Dryden. 2. To perceive by the nose; to scent; to smell.\n\n1. To inhale air through the nose with violence or with noise, as do dogs and horses. Dryden. 2. To turn up the nose and inhale air, as an expression of contempt; hence, to take offense. Do the enemies of the church rage and snuff Bp. Hall.\n\n1. The act of snuffing; perception by snuffing; a sniff. 2. Pulverized tobacco, etc., prepared to be taken into the nose; also, the amount taken at once. 3. Resentment, displeasure, or contempt, expressed by a snuffing of the nose. [Obs.] Snuff dipping. See Dipping, n., 5. -- Snuff taker, one who uses snuff by inhaling it through the nose. -- To take it in snuff, to be angry or offended. Shak. -- Up to snuff, not likely to be imposed upon; knowing; acute. [Slang]
snuffbox |A small box for carrying snuff about the person.
snuffer |1. One who snuffs. 2. (Zo√∂l.)  The common porpoise.
snuffers |An instrument for cropping and holding the snuff of a candle.
snuffingly |In a snuffing manner.
snuffle |To speak through the nose; to breathe through the nose when it is obstructed, so as to make a broken sound. One clad in purple Eats, and recites some lamentable rhyme . . . Snuffling at nose, and croaking in his throat. Dryden.\n\n1. The act of snuffing; a sound made by the air passing through the nose when obstructed. This dread sovereign, Breath, in its passage, gave a snort or snuffle. Coleridge. 2. An affected nasal twang; hence, cant; hypocrisy. 3. pl.  Obstruction of the nose by mucus; nasal catarrh of infants or children. [Colloq.]
snuffler |One who snuffles; one who uses cant.
snuffy |1. Soiled with snuff. 2. Sulky; angry; vexed. [Obs. or Scot.] Jamieson.
snug |1. Close and warm; as, an infant lies snug. 2. Close; concealed; not exposed to notice. Lie snug, and hear what critics say. Swift. 3. Compact, convenient, and comfortable; as, a snug farm, house, or property.\n\nSame as Lug, n., 3.\n\nTo lie close; to snuggle; to snudge; -- often with up, or together; as, a child snugs up to its mother.\n\n1. To place snugly. [R.] Goldsmith. 2. To rub, as twine or rope, so as to make it smooth and improve the finish.
snuggery |A snug, cozy place. [Colloq.] Dickens.
snuggle |To move one way and the other so as to get a close place; to lie close for comfort; to cuddle; to nestle.
snugly |In a snug manner; closely; safely.
snugness |The quality or state of being snug.
sny |An upward bend in a piece of timber; the sheer of a vessel.
snying |A curved plank, placed edgewise, to work in the bows of a vessel. R. H. Dana, Jr.
so |1. In that manner or degree; as, indicated (in any way), or as implied, or as supposed to be known. Why is his chariot so long in coming Judges v. 28. 2. In like manner or degree; in the same way; thus; for like reason; whith equal reason; -- used correlatively, following as, to denote comparison or resemblance; sometimes, also, following inasmuch as. As a war should be undertaken upon a just motive, so a prince ought to consider the condition he is in. Swift. 3. In such manner; to such degree; -- used correlatively with as or that following; as, he was so fortunate as to escape. I viewed in may mind, so far as I was able, the beginning and progress of a rising world. T. Burnet. He is very much in Sir Roger's esteem, so that he lives in the family rather as a relation than dependent. Addison. 4. Very; in a high degree; that is, in such a degree as can not well be expressed; as, he is so good; he planned so wisely. 5. In the same manner; as has been stated or suggested; in this or that condition or state; under these circumstances; in this way; -- with reflex reference to something just asserted or implied; used also with the verb to be, as a predicate. Use him [your tutor] with great respect yourself, and cause all your family to do so too. Locke. It concerns every man, with the greatest seriousness, to inquire into those matters, whether they be so or not. Tillotson. He is Sir Robert's son, and so art thou. Shak. 6. The case being such; therefore; on this account; for this reason; on these terms; -- used both as an adverb and a conjuction. God makes him in his own image an intellectual creature, and so capable of dominion. Locke. Here, then, exchange we mutually forgiveness; So may the guilt of all my broken vows, My perjuries to thee, be all forgotten. Rowe. 7. It is well; let it be as it is, or let it come to pass; -- used to express assent. And when 't is writ, for my sake read it over, And if it please you, so; if not, why, so. Shak. There is Percy; if your father will do me any honor, so; if not, let him kill the next Percy himself. Shak. 8. Well; the fact being as stated; -- used as an expletive; as, so the work is done, is it 9. Is it thus do you mean what you say -- with an upward tone; as, do you say he refuses So [Colloq.] 10. About the number, time, or quantity specified; thereabouts; more or less; as, I will spend a week or so in the country; I have read only a page or so. A week or so will probably reconcile us. Gay. Note: See the Note under Ill, adv. So . . . as. So is now commonly used as a demonstrative correlative of as when it is the puprpose to emphasize the equality or comparison suggested, esp. in negative assertions, and questions implying a negative answer. By Shakespeare and others so . . . as was much used where as . . . as is now common. See the Note under As, 1. So do, as thou hast said. Gen. xviii. 5. As a flower of the field, so he flourisheth. Ps. ciii. 15. Had woman been so strong as men. Shak. No country suffered so much as England. Macaulay. -- So far, to that point or extent; in that particular. \"The song was moral, and so far was right.\" Cowper. -- So far forth, as far; to such a degree. Shak. Bacon. -- So forth, further in the same or similar manner; more of the same or a similar kind. See And so forth, under And. -- So, so, well, well. \"So, so, it works; now, mistress, sit you fast.\" Dryden. Also, moderately or tolerably well; passably; as, he succeeded but so so. \"His leg is but so so.\" Shak. -- So that, to the end that; in order that; with the effect or result that. -- So then, thus then it is; therefore; the consequence is.\n\nProvided that; on condition that; in case that; if. Though all the winds of doctrine were let loose play upon the earth, so truth be in the field, we do injuriously, by licensing and prohibiting, to misdoubt her strength. Milton.\n\nBe as you are; stand still; stop; that will do; right as you are; -- a word used esp. to cows; also used by sailors.
so-called |So named; called by such a name (but perhaps called thus with doubtful propriety).
so-so |Neither very good nor very bad; middling; passable; tolerable; indifferent. In some Irish houses, where things are so-so, One gammon of bacon hangs up for a show. Goldsmith. He [Burns] certainly wrote some so-so verses to the Tree of Liberty. Prof. Wilson.\n\nTolerably; passably. H. James.
soak |1. To cause or suffer to lie in a fluid till the substance has imbibed what it can contain; to macerate in water or other liquid; to steep, as for the purpose of softening or freshening; as, to soak cloth; to soak bread; to soak salt meat, salt fish, or the like. 2. To drench; to wet thoroughly. Their land shall be soaked with blood. Isa. xxiv. 7. 3. To draw in by the pores, or through small passages; as, a sponge soaks up water; the skin soaks in moisture. 4. To make (its way) by entering pores or interstices; -- often with through. The rivulet beneath soaked its way obscurely through wreaths of snow. Sir W. Scott. 5. Fig.: To absorb; to drain. [Obs.] Sir H. Wotton.\n\n1. To lie steeping in water or other liquid; to become sturated; as, let the cloth lie and soak. 2. To enter (into something) by pores or interstices; as, water soaks into the earth or other porous matter. 3. To drink intemperately or gluttonously. [Slang]
soakage |The act of soaking, or the state of being soaked; also, the quantity that enters or issues by soaking.
soaker |1. One who, or that which, soaks. 2. A hard drinker. [Slang] South.
soaking |Wetting thoroughly; drenching; as, a soaking rain. -- Soak\"ing*ly, adv.
soaky |Full of moisture; wet; soppy.
soal |1. The sole of a shoe. [Obs. or R.] 2. (Zo√∂l.)  See Sole, the fish. [Obs.]\n\nA dirty pond. [Prov. Eng.] Halliwell.
soam |A chain by which a leading horse draws a plow. Knight.
soap |A substance which dissolves in water, thus forming a lather, and is used as a cleansing agent. Soap is produced by combining fats or oils with alkalies or alkaline earths, usually by boiling, and consists of salts of sodium, potassium, etc., with the fatty acids (oleic, stearic, palmitic, etc.). See the Note below, and cf. Saponification. By extension, any compound of similar composition or properties, whether used as a cleaning agent or not. Note: In general, soaps are of two classes, hard and soft. Calcium, magnesium, lead, etc., form soaps, but they are insoluble and useless. The purifying action of soap depends upon the fact that it is decomposed by a large quantity of water into free alkali and an insoluble acid salt. The first of these takes away the fatty dirt on washing, and the latter forms the soap lather which envelops the greasy matter and thus tends to remove it. Roscoe & Schorlemmer. Castile soap, a fine-grained hard soap, white or mottled, made of olive oil and soda; -- called also Marseilles, or Venetian, soap. -- Hard soap, any one of a great variety of soaps, of different ingredients and color, which are hard and compact. All solid soaps are of this class. -- Lead soap, an insoluble, white, pliable soap made by saponifying an oil (olive oil) with lead oxide; -- used externally in medicine. Called also lead plaster, diachylon, etc. -- Marine soap. See under Marine. -- Pills of soap (Med.), pills containing soap and opium. -- Potash soap, any soap made with potash, esp. the soft soaps, and a hard soap made from potash and castor oil. -- Pumice soap, any hard soap charged with a gritty powder, as silica, alumina, powdered pumice, etc., which assists mechanically in the removal of dirt. -- Resin soap, a yellow soap containing resin, -- used in bleaching. -- Silicated soap, a cheap soap containing water glass (sodium silicate). -- Soap bark. (Bot.) See Quillaia bark. -- Soap bubble, a hollow iridescent globe, formed by blowing a film of soap suds from a pipe; figuratively, something attractive, but extremely unsubstantial. This soap bubble of the metaphysicians. J. C. Shairp. -- Soap cerate, a cerate formed of soap, olive oil, white wax, and the subacetate of lead, sometimes used as an application to allay inflammation. -- Soap fat, the refuse fat of kitchens, slaughter houses, etc., used in making soap. -- Soap liniment (Med.), a liniment containing soap, camphor, and alcohol. -- Soap nut, the hard kernel or seed of the fruit of the soapberry tree, -- used for making beads, buttons, etc. -- Soap plant (Bot.), one of several plants used in the place of soap, as the Chlorogalum pomeridianum, a California plant, the bulb of which, when stripped of its husk and rubbed on wet clothes, makes a thick lather, and smells not unlike new brown soap. It is called also soap apple, soap bulb, and soap weed. -- Soap tree. (Bot.) Same as Soapberry tree. -- Soda soap, a soap containing a sodium salt. The soda soaps are all hard soaps. -- Soft soap, a soap of a gray or brownish yellow color, and of a slimy, jellylike consistence, made from potash or the lye from wood ashes. It is strongly alkaline and often contains glycerin, and is used in scouring wood, in cleansing linen, in dyehouses, etc. Figuratively, flattery; wheedling; blarney. [Colloq.] -- Toilet soap, hard soap for the toilet, usually colored and perfumed.\n\n1. To rub or wash over with soap. 2. To flatter; to wheedle. [Slang]
soapberry tree |Any tree of the genus Sapindus, esp. Sapindus saponaria, the fleshy part of whose fruit is used instead of soap in washing linen; -- also called soap tree.
soapfish |Any serranoid fish of the genus Rhypticus; -- so called from the soapy feeling of its skin.
soapiness |Quality or state of being soapy.
soaproot |A perennial herb (Gypsophila Struthium) the root of which is used in Spain as a substitute for soap.
soapstone |See Steatite, and Talc.
soapsuds |Suds made with soap.
soapwort |A common plant (Saponaria officinalis) of the Pink family; -- so called because its bruised leaves, when agitated in water, produce a lather like that from soap. Called also Bouncing Bet.
soapy |1. Resembling soap; having the qualities of, or feeling like, soap; soft and smooth. 2. Smeared with soap; covered with soap.
soar |1. To fly aloft, as a bird; to mount upward on wings, or as on wings. Chaucer. When soars Gaul's vulture with his wings unfurled. Byron. 2. Fig.: To rise in thought, spirits, or imagination; to be exalted in mood. Where the deep transported mind may soar. Milton. Valor soars above What the world calls misfortune. Addison.\n\nThe act of soaring; upward flight. This apparent soar of the hooded falcon. Coleridge.\n\nSee 3d Sore. [Obs.]\n\nSee Sore, reddish brown. Soar falcon. (Zo√∂l.) See Sore falcon, under Sore.
soaring |from Soar. -- Soar\"ing*ly, adv.
soave |Sweet.
soavemente |Sweetly.
sob |To soak. [Obs.] Mortimer.\n\nTo sigh with a sudden heaving of the breast, or with a kind of convulsive motion; to sigh with tears, and with a convulsive drawing in of the breath. Sobbing is the same thing [as sighing], stronger. Bacon. She sighed, she sobbed, and, furious with despair. She rent her garments, and she tore her hair. Dryden.\n\n1. The act of sobbing; a convulsive sigh, or inspiration of the breath, as in sorrow. Break, heart, or choke with sobs my hated breath. Dryden. 2. Any sorrowful cry or sound. The tremulous sob of the complaining owl. Wordsworth.
sobbing |A series of short, convulsive inspirations, the glottis being suddenly closed so that little or no air enters into the lungs.
sober |1. Temperate in the use of spirituous liquors; habitually temperate; as, a sober man. That we may hereafter live a godly, righteous, and sober life, to the glory of Thy holy name. Bk. of Com. Prayer. 2. Not intoxicated or excited by spirituous liquors; as, the sot may at times be sober. 3. Not mad or insane; not wild, visionary, or heated with passion; exercising cool, dispassionate reason; self-controlled; self- possessed. There was not a sober person to be had; all was tempestuous and blustering. Druden. No sober man would put himself into danger for the applause of escaping without breaking his neck. Dryden. 4. Not proceeding from, or attended with, passion; calm; as, sober judgment; a man in his sober senses. 5. Serious or subdued in demeanor, habit, appearance, or color; solemn; grave; sedate. What parts gay France from sober Spain Prior. See her sober over a sampler, or gay over a jointed baby. Pope. Twilight gray Had in her sober livery all things clad. Milton. Syn. -- Grave; temperate; abstinent; abstemious; moderate; regular; steady; calm; quiet; cool; collected; dispassionate; unimpassioned; sedate; staid; serious; solemn; somber. See Grave.\n\nTo make sober. There shallow draughts intoxicate the brain, And drinking largely sobers us again. Pope.\n\nTo become sober; -- often with down. Vance gradually sobered down. Ld. Lytton.
sober-minded |Having a disposition or temper habitually sober. -- So\"ber-mind`ed*ness, n.
soberize |To sober. [R.] Crabbe.
soberly |In a sober manner; temperately; cooly; calmly; gravely; seriously.\n\nGrave; serious; solemn; sad. [Obs.] [He] looked hollow and thereto soberly. Chaucer.
soberness |The quality or state of being sober.
soboles |(a) A shoot running along under ground, forming new plants at short distances. (b) A sucker, as of tree or shrub.
soboliferous |Producing soboles. See Illust. of Houseleek.
sobranje |The unicameral national assembly of Bulgaria, elected for a term of five years by universal suffrage of adult males.
sobriety |1. Habitual soberness or temperance as to the use of spirituous liquors; as, a man of sobriety. Public sobriety is a relative duty. Blackstone. 2. Habitual freedom from enthusiasm, inordinate passion, or overheated imagination; calmness; coolness; gravity; seriousness; as, the sobriety of riper years. Mirth makes them not mad, Nor sobriety sad. Denham. Syn. -- Soberness; temperance; abstinence; abstemiousness; moderation; regularity; steadness; calmness; coolness; sober-mindeness; sedateness; staidness; gravity; seriousness; solemnity.
sobriquet |An assumed name; a fanciful epithet or appellation; a nickname. [Sometimes less correctly written soubriquet.]
soc |1. (O. Eng. Law) (a) The lord's power or privilege of holding a court in a district, as in manor or lordship; jurisdiction of causes, and the limits of that jurisdiction. (b) Liberty or privilege of tenants excused from customary burdens. 2. An exclusive privilege formerly claimed by millers of grrinding all the corn used within the manor or township which the mill stands. [Eng.] Soc and sac (O. Eng. Law), the full right of administering justice in a manor or lordship.
socage |A tenure of lands and tenements by a certain or determinate service; a tenure distinct from chivalry or knight's service, in which the obligations were uncertain. The service must be certain, in order to be denominated socage, as to hold by fealty and twenty shillings rent. [Written also soccage.] Note: Socage is of two kinds; free socage, where the services are not only certain, but honorable; and villein socage, where the services, though certain, are of a baser nature. Blackstone.
socager |A tennant by socage; a socman.
sociability |The quality of being sociable; sociableness.
sociable |1. Capable of being, or fit to be, united in one body or company; associable. [R.] They are sociable parts united into one body. Hooker. 2. Inclined to, or adapted for, society; ready to unite with others; fond of companions; social. Society is no comfort to one not sociable. Shak. What can be uneasy to this sociable creature than the dry, pensive retirements of solitude South. 3. Ready to converse; inclined to talk with others; not taciturn or reserved. 4. Affording opportunites for conversation; characterized by much conversation; as, a sociable party. 5. No longer hostile; friendly. [Obs.] Beau & Fl. Sociable bird, or Sociable weaver (Zo√∂l.), a weaver bird which builds composite nests. See Republican, n., 3. (b). Syn. -- Social; companionable; conversible; friendly; familiar; communicative; accessible.\n\n1. A gathering of people for social purposes; an informal party or reception; as, a church sociable. [Colloq. U. S.] 2. A carriage having two double seats facing each other, and a box for the driver. Miss Edgeworth.
sociableness |The quality of being sociable.
sociably |In a sociable manner.
social |1. Of or pertaining to society; relating to men living in society, or to the public as an aggregate body; as, social interest or concerns; social pleasure; social benefits; social happiness; social duties. \"Social phenomena.\" J. S. Mill. 2. Ready or disposed to mix in friendly converse; companionable; sociable; as, a social person. 3. Consisting in union or mutual intercourse. Best with thyself accompanied, seek'st not Social communication. Milton. 4. (Bot.)  Naturally growing in groups or masses; -- said of many individual plants of the same species. 5. (Zo√∂l.) (a) Living in communities consisting of males, females, and neuters, as do ants and most bees. (b) Forming compound groups or colonies by budding from basal processes or stolons; as, the social ascidians. Social science, the science of all that relates to the social condition, the relations and institutions which are involved in man's existence and his well- being as a member of an organized community; sociology. It concerns itself with questions of the public health, education, labor, punishment of crime, reformation of criminals, and the like. -- Social whale (Zo√∂l.), the blackfish. -- The social evil, prostitution. Syn. -- Sociable; companionable; conversible; friendly; familiar; communicative; convival; festive.
socialism |A theory or system of social reform which contemplates a complete reconstruction of society, with a more just and equitable distribution of property and labor. In popular usage, the term is often employed to indicate any lawless, revolutionary social scheme. See Communism, Fourierism, Saint-Simonianism, forms of socialism. [Socialism] was first applied in England to Owen's theory of social reconstruction, and in France to those also of St. Simon and Fourier . . . The word, however, is used with a great variety of meaning, . . . even by economists and learned critics. The general tendency is to regard as socialistic any interference undertaken by society on behalf of the poor, . . . radical social reform which disturbs the present system of private property . . . The tendency of the present socialism is more and more to ally itself with the most advanced democracy. Encyc. Brit. We certainly want a true history of socialism, meaning by that a history of every systematic attempt to provide a new social existence for the mass of the workers. F. Harrison.
socialist |One who advocates or practices the doctrines of socialism.\n\nPertaining to, or of the nature of, socialism.
socialistic |Pertaining to, or of the nature of, socialism.
sociality |The quality of being social; socialness.
socialize |1. To render social. 2. To subject to, or regulate by, socialism.
socially |In a social manner; sociably.
socialness |The quality or state of being social.
sociate |Associated. [Obs.]\n\nAn associate. [Obs.] As for you, Dr. Reynolds, and your sociates. Fuller.\n\nTo associate. [Obs.] Shelford.
societarian |Of or pertaining to society; social. The all-sweeping besom of societarian reformation. Lamb.
societary |Societarian. [R.]
society |1. The relationship of men to one another when associated in any way; companionship; fellowship; company. \"Her loved society.\" Milton. There is society where none intrudes By the deep sea, and music in its roar. Byron. 2. Connection; participation; partnership. [R.] The meanest of the people and such as have the least society with the acts and crimes of kings. Jer. Taylor. 3. A number of persons associated for any temporary or permanent object; an association for mutual or joint usefulness, pleasure, or profit; a social union; a partnership; as, a missionary society. 4. The persons, collectively considered, who live in any region or at any period; any community of individuals who are united together by a common bond of nearness or intercourse; those who recognize each other as associates, friends, and acquaintances. 5. Specifically, the more cultivated portion of any community in its social relations and influences; those who mutually give receive formal entertainments. Society of Jesus. See Jesuit. -- Society verses Etym: [a translation of F. vers de soci√©t√©], the lightest kind of lyrical poetry; verses for the amusement of polite society.
socinian |Of or pertaining to Socinus, or the Socinians.\n\nOne of the followers of Socinus; a believer in Socinianism.
socinianism |The tenets or doctrines of Faustus Socinus, an Italian theologian of the sixteenth century, who denied the Trinity, the deity of Christ, the personality of the Devil, the native and total depravity of man, the vicarious atonement, and the eternity of future punishment. His theory was, that Christ was a man divinely commissioned, who had no existence before he was conceived by the Virgin Mary; that human sin was the imitation of Adam's sin, and that human salvation was the imitation and adoption of Christ's virtue; that the Bible was to be interpreted by human reason; and that its language was metaphorical, and not to be taken literally.
socinianize |To cause to conform to Socinianism; to regulate by, or imbue with, the principles of Socinianism.
sociologic |Of or pertaining to sociology, or social science. -- So`ci*o*log\"ic*al*ly, adv.
sociologist |One who treats of, or devotes himself to, the study of sociology. J. S. Mill.
sociology |That branch of philosophy which treats of the constitution, phenomena, and development of human society; social science. H. Spencer.
sock |A plowshare. Edin. Encyc.\n\n1. The shoe worn by actors of comedy in ancient Greece and Rome, -- used as a sumbol of comedy, of the comic drams, as distinguished from tragedy, which is symbolized by the buskin. Great Fletcher never treads in buskin here, Nor greater Jonson dares in socks appear. Dryden. 2. A knit or woven covering for the foot and lower leg; a stocking with a short leg. 3. A warm inner sole for a shoe. Simmonds.
sockdolager |1. That which finishes or ends a matter; a settler; a poser, as a heavy blow, a conclusive answer, and the like. [Slang, U.S.] 2. (Angling)  A combination of two hooks which close upon each other, by means of a spring, as soon as the fish bites. [U. S.]
socket |1. An opening into which anything is fitted; any hollow thing or place which receives and holds something else; as, the sockets of the teeth. His eyeballs in their hollow sockets sink. Dryden. 2. Especially, the hollow tube or place in which a candle is fixed in the candlestick. And in the sockets oily bubbles dance. Dryden. Socket bolt (Mach.), a bolt that passes through a thimble that is placed between the parts connected by the bolt. -- Socket chisel. Same as Framing chisel. See under Framing. -- Socket pipe, a pipe with an expansion at one end to receive the end of a connecting pipe. -- Socket pole, a pole armed with iron fixed on by means of a socket, and used to propel boats, etc. [U.S.] -- Socket wrench, a wrench consisting of a socket at the end of a shank or rod, for turning a nut, bolthead, etc., in a narrow or deep recess.
socketed |Having a socket. Dawkins.
sockless |Destitute of socks or shoes. B. & Fl.
socky |Wet; soaky. [Prov. Eng.]
socle |(a) A plain block or plinth forming a low pedestal; any base; especially, the base of a statue, column, or the like. See Plinth. (b) A plain face or plinth at the lower part of a wall. Oxf. Gloss.
socman |One who holds lands or tenements by socage; a socager. Cowell.
socmanry |Tenure by socage.
socome |A custom of tenants to grind corn at the lord's mill. Cowell.
socotrine |Of or pertaining to Socotra, an island in the Indian Ocean, on the east coast of Africa. -- n.  A native or inhabitant of Socotra.
socratic |Of or pertaining to Socrates, the Grecian sage and teacher. (b. c. 469-399), or to his manner of teaching and philosophizing. Note: The Socratic method of reasoning and instruction was by a series of questions leading the one to whom they were addressed to perceive and admit what was true or false in doctrine, or right or wrong in conduct.
socratical |Of or pertaining to Socrates, the Grecian sage and teacher. (b. c. 469-399), or to his manner of teaching and philosophizing. Note: The Socratic method of reasoning and instruction was by a series of questions leading the one to whom they were addressed to perceive and admit what was true or false in doctrine, or right or wrong in conduct.
socratically |In the Socratic method.
socratism |The philosophy or the method of Socrates.
socratist |A disciple or follower of Socrates.
sod |The rock dove. [Prov. Eng.]\n\nimp. of Seethe.\n\nThat stratum of the surface of the soil which is filled with the roots of grass, or any portion of that surface; turf; sward. She there shall dress a sweeter sod Than Fancy's feet have ever trod. Collins.\n\nTo cover with sod; to turf.
soda |(a) Sodium oxide or hydroxide. (b) Popularly, sodium carbonate or bicarbonate. Caustic soda, sodium hydroxide. -- Cooking soda, sodium bicarbonate. [Colloq.] -- Sal soda. See Sodium carbonate, under Sodium. -- Soda alum (Min.), a mineral consisting of the hydrous sulphate of alumina and soda. -- Soda ash, crude sodium carbonate; -- so called because formerly obtained from the ashes of sea plants and certain other plants, as saltwort (Salsola). See under Sodium. -- Soda fountain, an apparatus for drawing soda water, fitted with delivery tube, faucets, etc. -- Soda lye, a lye consisting essentially of a solution of sodium hydroxide, used in soap making. -- Soda niter. See Nitratine. -- Soda salts, salts having sodium for the base; specifically, sodium sulphate or Glauber's salts. -- Soda waste, the waste material, consisting chiefly of calcium hydroxide and sulphide, which accumulates as a useless residue or side product in the ordinary Leblanc process of soda manufacture; -- called also alkali waste. -- Soda water, originally, a beverage consisting of a weak solution of sodium bicarbonate, with some acid to cause effervescence; now, in common usage, a beverage consisting of water highly charged with carbon dioxide (carbonic acid). Fruit sirups, cream, etc., are usually added to give flavor. See Carbonic acid, under Carbonic. -- Washing soda, sodium carbonate. [Colloq.]
sodaic |Pertaining to, or containing, soda. \"Sodaic powder.\" Ure.
sodalite |A mineral of a white to blue or gray color, occuring commonly in dodecahedrons, also massive. It is a silicate of alumina and soda with some chlorine.
sodality |1. A fellowship or fraternity; a brotherhood. 2. (R.C.Ch.)  Specifically, a lay association for devotion or for charitable purposes.
sodamide |A greenish or reddish crystalline substance, NaNH2, obtained by passing ammonia over heated sodium.
sodden |Boiled; seethed; also, soaked; heavy with moisture; saturated; as, sodden beef; sodden bread; sodden fields.\n\nTo be seethed; to become sodden.\n\nTo soak; to make heavy with water.
sodden-witted |Heavy; dull. Shak.
soddy |Consisting of sod; covered with sod; turfy. Cotgrave.
soder |See Solder.
sodger |Var. of Soldier. [Dial. or Slang]
sodic |Of or pertaining to sodium; containing sodium.
sodio- |A combining form (also used adjectively) denoting the presence of sodium or one of its compounds.
sodium |A common metallic element of the alkali group, in nature always occuring combined, as in common salt, in albite, etc. It is isolated as a soft, waxy, white, unstable metal, so readily oxidized that it combines violently with water, and to be preserved must be kept under petroleum or some similar liquid. Sodium is used combined in many salts, in the free state as a reducer, and as a means of obtaining other metals (as magnesium and aluminium) is an important commercial product. Symbol Na (Natrium). Atomic weight 23. Specific gravity 0.97. Sodium amalgam, an alloy of sodium and mercury, usually produced as a gray metallic crystalline substance, which is used as a reducing agent, and otherwise. -- Sodium bicarbonate, a white crystalline substance, HNaCO3, with a slight alkaline taste resembling that of sodium carbonate. It is found in many mineral springs and also produced artificially,. It is used in cookery, in baking powders, and as a source of carbonic acid gas (carbon dioxide) for soda water. Called also cooking soda, saleratus, and technically, acid sodium carbonate, primary sodium carbonate, sodium dicarbonate, etc. -- Sodium carbonate, a white crystalline substance, Na2CO3.10H2O, having a cooling alkaline taste, found in the ashes of many plants, and produced artifically in large quantities from common salt. It is used in making soap, glass, paper, etc., and as alkaline agent in many chemical industries. Called also sal soda, washing soda, or soda. Cf. Sodium bicarbonate, above and Trona. Sodium chloride, common, or table, salt, NaCl. -- Sodium hydroxide, a white opaque brittle solid, NaOH, having a fibrous structure, produced by the action of quicklime, or of calcium hydrate (milk of lime), on sodium carbonate. It is a strong alkali, and is used in the manufacture of soap, in making wood pulp for paper, etc. Called also sodium hydrate, and caustic soda. By extension, a solution of sodium hydroxide.
sodium sulphate |A salt well known as a catharic under the name of Glauber's salt, which term is properly applied to the hydrate, Na2SO4.10H2O.
sodomite |1. An inhabitant of Sodom. 2. One guilty of sodomy.
sodomitical |Pertaining to, or of the nature of, sodomy. -- Sod`om*it\"ic*al*ly, adv.
sodomy |Carnal copulation in a manner against nature; buggery. Gen. xix. 5.
soe |A large wooden vessel for holding water; a cowl. [Obs. or Prov. Eng.] Dr. H. More.
soever |A word compounded of so and ever, used in composition with who, what, where, when, how, etc., and indicating any out of all possible or supposable persons, things, places, times, ways, etc. It is sometimes used separate from the pronoun or adverb. For unto whomsoever much is given, of him shall be much required. Luke xii. 48. What great thing soever a man proposed to do in his life, he should think of achieving it by fifty. Sir W. Temple.
sofa |A long seat, usually with a cushioned bottom, back, and ends; - - much used as a comfortable piece of furniture. Let fall the curtains, wheel the sofa round. Cowper. Sofa bed, a sofa so contrived that it may be extended to form a bed; -- called also sofa bedstead.
soffit |The under side of the subordinate parts and members of buildings, such as staircases, entablatures, archways, cornices, or the like. See Illust. of Lintel.
sofi |Same as Sufi.
sofism |Same as Sufism.
soft |1. Easily yielding to pressure; easily impressed, molded, or cut; not firm in resisting; impressible; yielding; also, malleable; -- opposed to Ant: hard; as, a soft bed; a soft peach; soft earth; soft wood or metal. 2. Not rough, rugged, or harsh to the touch; smooth; delicate; fine; as, soft silk; a soft skin. They that wear soft clothing are in king's houses. Matt. xi. 8. 3. Hence, agreeable to feel, taste, or inhale; not irritating to the tissues; as, a soft liniment; soft wines. \"The soft, delicious air.\" Milton. 4. Not harsh or offensive to the sight; not glaring; pleasing to the eye; not exciting by intensity of color or violent contrast; as, soft hues or tints. The sun, shining upon the upper part of the clouds . . . made the softest lights imaginable. Sir T. Browne. 5. Not harsh or rough in sound; gentle and pleasing to the ear; flowing; as, soft whispers of music. Her voice was ever soft, Gentle, and low, -- an excellent thing in woman. Shak. Soft were my numbers; who could take offense Pope. 6. Easily yielding; susceptible to influence; flexible; gentle; kind. I would to God my heart were flint, like Edward's; Or Edward's soft and pitiful, like mine. Shak. The meek or soft shall inherit the earth. Tyndale. 7. Expressing gentleness, tenderness, or the like; mild; conciliatory; courteous; kind; as, soft eyes. A soft answer turneth away wrath. Prov. xv. 1. A face with gladness overspread, Soft smiles, by human kindness bred. Wordsworth. 8. Effeminate; not courageous or manly, weak. A longing after sensual pleasures is a dissolution of the spirit of a man, and makes it loose, soft, and wandering. Jer. Taylor. 9. Gentle in action or motion; easy. On her soft axle, white she paces even, And bears thee soft with the smooth air along. Milton. 10. Weak in character; impressible. The deceiver soon found this soft place of Adam's. Glanvill. 11. Somewhat weak in intellect. [Colloq.] He made soft fellows stark noddies, and such as were foolish quite mad. Burton. 12. Quiet; undisturbed; paceful; as, soft slumbers. 13. Having, or consisting of, a gentle curve or curves; not angular or abrupt; as, soft outlines. 14. Not tinged with mineral salts; adapted to decompose soap; as, soft water is the best for washing. 15. (Phonetics) (a) Applied to a palatal, a sibilant, or a dental consonant (as g in gem, c in cent, etc.) as distinguished from a guttural mute (as g in go, c in cone, etc.); -- opposed to hard. (b) Belonging to the class of sonant elements as distinguished from the surd, and considered as involving less force in utterance; as, b, d, g, z, v, etc., in contrast with p, t, k, s, f, etc. Soft clam (Zo√∂l.), the common or long clam (Mya arenaria). See Mya. -- Soft coal, bituminous coal, as distinguished from anthracite, or hard, coal. -- Soft crab (Zo√∂l.), any crab which has recently shed its shell. -- Soft dorsal (Zo√∂l.), the posterior part of the dorsal fin of fishes when supported by soft rays. -- Soft grass. (Bot.) See Velvet grass. -- Soft money, paper money, as distinguished from coin, or hard money. [Colloq. U.S.] -- Soft mute. (Phonetics) See Media. -- Soft palate. See the Note under Palate. -- Soft ray (Zo√∂l.), a fin ray which is articulated and usually branched. -- Soft soap. See under Soap. -- Soft-tack, leavened bread, as distinguished from hard-tack, or ship bread. -- Soft tortoise (Zo√∂l.), any river tortoise of the genus Trionyx. See Trionyx.\n\nA soft or foolish person; an idiot. [Colloq.] G. Eliot.\n\nSoftly; without roughness or harshness; gently; quietly. Chaucer. A knight soft riding toward them. Spenser.\n\nBe quiet; hold; stop; not so fast. Soft, you; a word or two before you go. Shak.
soft steel |Steel low in carbon; mild steel; ingot iron.
soft-finned |Having the fin rays cartilaginous or flexible; without spines; -- said of certain fishes.
soft-headed |Weak in intellect.
soft-hearted |Having softness or tenderness of heart; susceptible of pity or other kindly affection; gentle; meek. -- Soft\"-heart`ed*ness, n.
soft-shell |Having a soft or fragile shell. Soft-shell clam (Zo√∂l.), the long clam. See Mya. -- Soft-shelled crab. (Zo√∂l.) See the Note under Crab, 1. -- Soft-shelled turtle. (Zo√∂l.) Same as Soft tortoise, under Soft.
soft-shelled |Having a soft or fragile shell. Soft-shell clam (Zo√∂l.), the long clam. See Mya. -- Soft-shelled crab. (Zo√∂l.) See the Note under Crab, 1. -- Soft-shelled turtle. (Zo√∂l.) Same as Soft tortoise, under Soft.
soft-spoken |Speaking softly; having a mild or gentle voice; hence, mild; affable.
softa |Any one attached to a Mohammedan mosque, esp. a student of the higher branches of theology in a mosque school. [Written also sophta.]
soften |To make soft or more soft. Specifically: -- (a) To render less hard; -- said of matter. Their arrow's point they soften in the flame. Gay. (b) To mollify; to make less fierce or intractable. Diffidence conciliates the proud, and softens the severe. Rambler. (c) To palliate; to represent as less enormous; as, to soften a fault. (d) To compose; to mitigate; to assuage. Music can soften pain to ease. Pope. (e) To make calm and placid. All that cheers or softens life. Pope. (f) To make less harsh, less rude, less offensive, or less violent, or to render of an opposite quality. He bore his great commision in his look, But tempered awe, and softened all he spoke. Dryden. (g) To make less glaring; to tone down; as, to soften the coloring of a picture. (h) To make tender; to make effeminate; to enervate; as, troops softened by luxury. (i) To make less harsh or grating, or of a quality the opposite; as, to soften the voice.\n\nTo become soft or softened, or less rude, harsh, severe, or obdurate.
softener |One who, or that which, softens. [Written also, less properly, softner.]
softening |from Soften, v. Softening of the brain, or Cerebral softening (Med.), a localized softening of the brain substance, due to hemorrhage or inflammation. Three varieties, distinguished by their color and representing different stages of the morbid process, are known respectively as red, yellow, and white, softening.
softish |Somewhat soft. De Witt Clinton.
softling |A soft, effeminate person; a voluptuary. [R.] Bp. Woolton. .
softly |In a soft manner.
softner |See Softener.
softness |The quality or state of being soft; -- opposed to Ant: hardness, and used in the various specific senses of the adjective.
soger |Var. of Soldier. [Dial. or Slang]  R. H. Dana, Jr.
sogginess |The quality or state of being soggy; soddenness; wetness.
soggy |Filled with water; soft with moisture; sodden; soaked; wet; as, soggy land or timber.
soho |Ho; -- a word used in calling from a distant place; a sportsman's halloo. Shak.
soi-disant |Calling himself; self-styled; pretended; would-be.
soil |To feed, as cattle or horses, in the barn or an inclosure, with fresh grass or green food cut for them, instead of sending them out to pasture; hence (such food having the effect of purging them), to purge by feeding on green food; as, to soil a horse.\n\n1. The upper stratum of the earth; the mold, or that compound substance which furnishes nutriment to plants, or which is particularly adapted to support and nourish them. 2. Land; country. Must I thus leave thee, Paradise thus leave Thee, native soil Milton. 3. Dung; f√¶ces; compost; manure; as, night soil. Improve land by dung and other sort of soils. Mortimer. Soil pipe, a pipe or drain for carrying off night soil.\n\nTo enrich with soil or muck; to manure. Men . . . soil their ground, not that they love the dirt, but that they expect a crop. South.\n\nA marshy or miry place to which a hunted boar resorts for refuge; hence, a wet place, stream, or tract of water, sought for by other game, as deer. As deer, being stuck, fly through many soils, Yet still the shaft sticks fast. Marston. To take soil, to run into the mire or water; hence, to take refuge or shelter. O, sir, have you taken soil here It is well a man may reach you after three hours' running. B. Jonson.\n\n1. To make dirty or unclean on the surface; to foul; to dirty; to defile; as, to soil a garment with dust. Our wonted ornaments now soiled and stained. Milton. 2. To stain or mar, as with infamy or disgrace; to tarnish; to sully. Shak. Syn. -- To foul; dirt; dirty; begrime; bemire; bespatter; besmear; daub; bedaub; stain; tarnish; sully; defile; pollute.\n\nTo become soiled; as, light colors soil sooner than dark ones.\n\nThat which soils or pollutes; a soiled place; spot; stain. A lady's honor . . . will not bear a soil. Dryden.
soil pipe |A pipe or drain for carrying off night soil.
soiliness |Stain; foulness. [R.] Bacon.
soilless |Destitute of soil or mold.
soilure |Stain; pollution. Shak. Then fearing rust or soilure, fashioned for it A case of silk. Tennyson.
soily |Dirty; soiled. [Obs.] Fuller.
soiree |An evening party; -- distinguished from levee, and matin√©e.
soja |An Asiatic leguminous herb (Glycine Soja) the seeds of which are used in preparing the sauce called soy.
sojer |Var. of Soldier. [Dial. or Slang]
sojourn |To dwell for a time; to dwell or live in a place as a temporary resident or as a stranger, not considering the place as a permanent habitation; to delay; to tarry. Abram went down into Egypt to sojourn there. Gen. xii. 30. Home he goeth, he might not longer sojourn. Chaucer. The soldiers first assembled at Newcastle, and there sojourned three days. Hayward.\n\nA temporary residence, as that of a traveler in a foreign land. Though long detained In that obscure sojourn. Milton.
sojourner |One who sojourns. We are strangers before thee, and sojourners. 1. Chron. xxix. 15.
sojourning |The act or state of one who sojourns.
sojournment |Temporary residence, as that of a stranger or a traveler. [R.]
soke |1. (Eng. Law)  See Soc. 2. One of the small territorial divisions into which Lincolnshire, England, is divided.
sokeman |See Socman.
sokemanry |See Socmanry.
soken |1. A toll. See Soc, n., 2. [Obs.] Great sooken had this miller, out of doubt. Chaucer. 2. A district held by socage.
soko |An African anthropoid ape, supposed to be a variety of the chimpanzee.
sol |1. The sun. 2. (Alchem.)  Gold; -- so called from its brilliancy, color, and value. Chaucer.\n\n(a) A syllable applied in solmization to the note G, or to the fifth tone of any diatonic scale. (b) The tone itself.\n\n1. A sou. 2. A silver and gold coin of Peru. The silver sol is the unit of value, and is worth about 68 cents.
sol-fa |To sing the notes of the gamut, ascending or descending; as, do or ut, re, mi, fa, sol, la, si, do, or the same in reverse order. Yet can I neither solfe ne sing. Piers Plowman.\n\nThe gamut, or musical scale. See Tonic sol-fa, under Tonic, n.
sola |See Solus.\n\nA leguminous plant (√Üschynomene aspera) growing in moist places in Southern India and the East Indies. Its pithlike stem is used for making hats, swimming-jackets, etc. [Written also solah, shola.]\n\nAlone; -- chiefly used in stage directions, and the like.
solace |1. Comfort in grief; alleviation of grief or anxiety; also, that which relieves in distress; that which cheers or consoles; relief. In business of mirth and of solace. Chaucer. The proper solaces of age are not music and compliments, but wisdom and devotion. Rambler. 2. Rest; relaxation; ease. [Obs.] To make his steed some solace. Chaucer. Syn. -- Comfort; consolation; alleviation; relief.\n\n1. To cheer in grief or under calamity; to comfort; to relieve in affliction, solitude, or discomfort; to console; -- applied to persons; as, to solace one with the hope of future reward. 2. To allay; to assuage; to soothe; as, to solace grief. Syn. -- To comfort; assuage; allay. See Comfort.\n\nTo take comfort; to be cheered. Shak.
solacement |The act of solacing, or the state of being solaced; also, that which solaces. [R.]
solacious |Affording solace; as, a solacious voice. [Obs.] Bale.
solan goose |The common gannet.
solanaceous |Of or pertaining to plants of the natural order Solanace√¶, of which the nightshade (Solanum) is the type. The order includes also the tobacco, ground cherry, tomato, eggplant, red pepper, and many more.
soland |A solan goose.
solander |See Sallenders.
solania |Solanine.
solanicine |An alkaloid produced by the action of hydrochloric acid on solanidine, as a tasteless yellow crystalline substance.
solanidine |An alkaloid produced by the decomposition of solanine, as a white crystalline substance having a harsh bitter taste.
solanine |A poisonous alkaloid glucoside extracted from the berries of common nightshade (Solanum nigrum), and of bittersweet, and from potato sprouts, as a white crystalline substance having an acrid, burning taste; -- called also solonia, and solanina.
solano |A hot, oppressive wind which sometimes blows in the Mediterranean, particularly on the eastern coast of Spain.
solanoid |Resembling a potato; -- said of a kind of cancer.
solanum |A genus of plants comprehending the potato (S. tuberosum), the eggplant (S. melongena, and several hundred other species; nightshade.
solar |A loft or upper chamber; a garret room. [Obs.] [Written also soler, solere, sollar.] Oxf. Gloss.\n\n1. Of or pertaining to the sun; proceeding from the sun; as, the solar system; solar light; solar rays; solar influence. See Solar system, below. 2. (Astrol.)  Born under the predominant influence of the sun. [Obs.] And proud beside, as solar people are. Dryden. 3. Measured by the progress or revolution of the sun in the ecliptic; as, the solar year. 4. Produced by the action of the sun, or peculiarly affected by its influence. They denominate some herbs solar, and some lunar. Bacon. Solar cycle. See under Cycle. -- Solar day. See Day, 2. -- Solar engine, an engine in which the energy of solar heat is used to produce motion, as in evaporating water for a steam engine, or expanding air for an air engine. -- Solar flowers (Bot.), flowers which open and shut daily at certain hours. -- Solar lamp, an argand lamp. -- Solar microscope, a microscope consisting essentially, first, of a mirror for reflecting a beam of sunlight through the tube, which sometimes is fixed in a window shutter; secondly, of a condenser, or large lens, for converging the beam upon the object; and, thirdly, of a small lens, or magnifier, for throwing an enlarged image of the object at its focus upon a screen in a dark room or in a darkened box. -- Solar month. See under Month. -- Solar oil, a paraffin oil used an illuminant and lubricant. -- Solar phosphori (Physics), certain substances, as the diamond, siulphide of barium (Bolognese or Bologna phosphorus), calcium sulphide, etc., which become phosphorescent, and shine in the dark, after exposure to sunlight or other intense light. -- Solar plexus (Anat.), a nervous plexus situated in the dorsal and anterior part of the abdomen, consisting of several sympathetic ganglia with connecting and radiating nerve fibers; -- so called in allusion to the radiating nerve fibers. -- Solar spots. See Sun spots, under Sun. -- Solar system (Astron.), the sun, with the group of celestial bodies which, held by its attraction, revolve round it. The system comprises the major planets, with their satellites; the minor planets, or asteroids, and the comets; also, the meteorids, the matter that furnishes the zodiacal light, and the rings of Saturn. The satellites that revolve about the major planets are twenty-two in number, of which the Earth has one (see Moon.), Mars two, Jupiter five, Saturn nine, Uranus four, and Neptune one. The asteroids, between Mars and Jupiter, thus far discovered (1900), number about five hundred, the first four of which were found near the beginning of the century, and are called Ceres, Pallas, Juno, and Vesta. Note: The principal elements of the major planets, and of the comets seen at more than one perihelion passage, are exhibited in the following tables: -- I. -- Major Planets. Symbol.Name.Mean distance -- that of the Earth being unity.Period in days.Eccentricity.Inclination of orbit.Diameter in miles II. -- Periodic Comets. Name.Greatest distance from sun.Least distance from sun.Inclination of orbit.Perihelion passage. ¬∫ min 54 Encke's3.314.100.34212 541885.2 -- Solar telegraph, telegraph for signaling by flashes of reflected sunlight. -- Solar time. See Apparent time, under Time.
solar myth |A myth which essentially consists of allegory based upon ideas as to the sun's course, motion, influence, or the like.
solar parallax |The parallax of the sun, that is, the angle subtended at the sun by the semidiameter of the earth. It is 8.\"80, and is the fundamental datum.
solarium |1. An apartment freely exposed to the sun; anciently, an apartment or inclosure on the roof of a house; in modern times, an apartment in a hospital, used as a resort for convalescents. 2. (Zo√∂l.)  Any one of several species of handsome marine spiral shells of the genus Solarium and allied genera. The shell is conical, and usually has a large, deep umbilicus exposing the upper whorls. Called also perspective shell.
solarization |Injury of a photographic picture caused by exposing it for too long a time to the sun's light in the camera; burning; excessive insolation.
solarize |To injure by too long exposure to the light of the sun in the camera; to burn.\n\nTo become injured by undue or too long exposure to the sun's rays in the camera.
solary |Solar. [Obs.] Sir T. Browne.
solas |Solace. [Obs.] Chaucer.
