southwestern |Of or pertaining to the southwest; southwesterly; as, to sail a southwestern course.
southwestward |Toward the southwest.
southwestwardly |Toward the southwest.
souvenance |Remembrance. [Obs.] Of his way he had no sovenance. Spenser.
souvenir |That which serves as a reminder; a remembrancer; a memento; a keepsake.
sovenaunce |Remembrance. [Obs.] Of his way he had no sovenance. Spenser.
sovereign |1. Supreme or highest in power; superior to all others; chief; as, our sovereign prince. 2. Independent of, and unlimited by, any other; possessing, or entitled to, original authority or jurisdiction; as, a sovereign state; a sovereign discretion. 3. Princely; royal. \"Most sovereign name.\" Shak. At Babylon was his sovereign see. Chaucer. 4. Predominant; greatest; utmost; paramount. We acknowledge him [God] our sovereign good. Hooker. 5. Efficacious in the highest degree; effectual; controlling; as, a sovereign remedy. Dryden. Such a sovereign influence has this passion upon the regulation of the lives and actions of men. South. Sovereign state, a state which administers its own government, and is not dependent upon, or subject to, another power.\n\n1. The person, body, or state in which independent and supreme authority is vested; especially, in a monarchy, a king, queen, or emperor. No question is to be made but that the bed of the Mississippi belongs to the sovereign, that is, to the nation. Jefferson. 2. A gold coin of Great Britain, on which an effigy of the head of the reigning king or queen is stamped, valued at one pound sterling, or about $4.86. 3. (Zoöl.)  Any butterfly of the tribe Nymphalidi, or genus Basilarchia, as the ursula and the viceroy. Syn. -- King; prince; monarch; potentate; emperor.
sovereignize |To exercise supreme authority. [Obs.] Sir T. Herbert.
sovereignly |In a sovereign manner; in the highest degree; supremely. Chaucer.
sovereignty |The quality or state of being sovereign, or of being a sovereign; the exercise of, or right to exercise, supreme power; dominion; sway; supremacy; independence; also, that which is sovereign; a sovereign state; as, Italy was formerly divided into many sovereignties. Woman desiren to have sovereignty As well over their husband as over their love. Chaucer.
sovran |A variant of Sovereign. [Poetic] On thy bald, awful head, O sovran Blanc. Coleridge.
sow |To sew. See Sew. [Obs.] Chaucer.\n\n1. (Zoöl.)  The female of swine, or of the hog kind. 2. (Zoöl.)  A sow bug. 3. (Metal.) (a) A channel or runner which receives the rows of molds in the pig bed. (b) The bar of metal which remains in such a runner. (c) A mass of solidified metal in a furnace hearth; a salamander. 4. (Mil.)  A kind of covered shed, formerly used by besiegers in filling up and passing the ditch of a besieged place, sapping and mining the wall, or the like. Craig. Sow bread. (Bot.) See Cyclamen. -- Sow bug, or Sowbug (Zoöl.), any one of numerous species of terrestrial Isopoda belonging to Oniscus, Porcellio, and allied genera of the family Oniscidæ. They feed chiefly on decaying vegetable substances. -- Sow thistle Etym: [AS. sugepistel] (Bot.), a composite plant (Sonchus oleraceus) said to be eaten by swine and some other animals.\n\n1. To scatter, as seed, upon the earth; to plant by strewing; as, to sow wheat. Also used figuratively: To spread abroad; to propagate. \"He would sow some difficulty.\" Chaucer. A sower went forth to sow; and when he sowed, some seeds fell by the wayside. Matt. xiii. 3, 4. And sow dissension in the hearts of brothers. Addison. 2. To scatter seed upon, in, or over; to supply or stock, as land, with seeds. Also used figuratively: To scatter over; to besprinkle. The intellectual faculty is a goodly field, . . . and it is the worst husbandry in the world to sow it with trifles. Sir M. Hale. [He] sowed with stars the heaven. Milton. Now morn . . . sowed the earth with orient pearl. Milton.\n\nTo scatter seed for growth and the production of a crop; -- literally or figuratively. They that sow in tears shall reap in joi. Ps. cxxvi. 5.
sowans |See Sowens.
sowar |In India, a mounted soldier.
sowbane |The red goosefoot (Chenopodium rubrum), -- said to be fatal to swine.
sowce |See Souse. [Obs.]
sowdan |Sultan. [Obs.] Chaucer.
sowdanesse |A sultaness. [Obs.] Chaucer.
sowens |A nutritious article of food, much used in Scotland, made from the husk of the oat by a process not unlike that by which common starch is made; -- called flummery in England. [Written also sowans, and sowins.]
sower |One who, or that which, sows.
sowins |See Sowens.
sowl |To pull by the ears; to drag about. [Obs.] hak.\n\nSee Soul, v. i. [Obs.]
sowle |To pull by the ears; to drag about. [Obs.] hak.
sown |p. p. of Sow.
sowne |To sound. [Obs.] Chaucer.
sowse |See Souse. [Obs.] ryden.
sowter |See Souter. [Obs.] B. Jonson.
soy |1. A Chinese and Japanese liquid sauce for fish, etc., made by subjecting boiled beans (esp. soja beans), or beans and meal, to long fermentation and then long digestion in salt and water. 2. (Bot.)  The soja, a kind of bean. See Soja.
soyle |To solve, to clear up; as, to soyl all other texts. [Obs.] Tyndate.\n\nPrey. [Obs.] Spenser.
soyned |Filled with care; anxious. [Obs.] Mir. for Mag.
sozzle |1. To splash or wet carelessly; as, to sozzle the feet in water. [Local, U.S.] Bartlett. 2. To heap up in confusion. [Prov. Eng.] Forby.\n\n1. One who spills water or other liquids carelessly; specifically, a sluttish woman. [Local, U.S.] 2. A mass, or heap, confusedly mingled. [Prov. Eng.]
spa |A spring or mineral water; -- so called from a place of this name in Belgium.
spaad |A kind of spar; earth flax, or amianthus. [Obs.] oodward.
space |1. Extension, considered independently of anything which it may contain; that which makes extended objects conceivable and possible. Pure space is capable neither of resistance nor motion. Locke. 2. Place, having more or They gave him chase, and hunted him as hare; Long had he no space to dwell [in]. R. of Brunne. While I have time and space. Chaucer. 3. A quantity or portion of extension; distance from one thing to another; an interval between any two or more objects; as, the space between two stars or two hills; the sound was heard for the space of a mile. Put a space betwixt drove and drove. Gen. xxxii. 16. 4. Quantity of time; an interval between two points of time; duration; time. \"Grace God gave him here, this land to keep long space.\" R. of brunne. Nine times the space that measures day and night. Milton. God may defer his judgments for a time, and give a people a longer space of repentance. Tillotson. 5. A short time; a while. [R.] \"To stay your deadly strife a space.\" Spenser. 6. Walk; track; path; course. [Obs.] This ilke [same] monk let old things pace, And held after the new world the space. Chaucer. 7. (print.) (a) A small piece of metal cast lower than a face type, so as not to receive the ink in printing, -- used to separate words or letters. (b) The distance or interval between words or letters in the lines, or between lines, as in books. Note: Spaces are of different thicknesses to enable the compositor to arrange the words at equal distances from each other in the same line. 8. (Mus.)  One of the intervals, or open places, between the lines of the staff. Absolute space, Euclidian space, etc. See under Absolute, Euclidian, etc. -- Space line (Print.), a thin piece of metal used by printers to open the lines of type to a regular distance from each other, and for other purposes; a lead. Hansard. -- Space rule (Print.), a fine, thin, short metal rule of the same height as the type, used in printing short lines in tabular matter.\n\nTo walk; to rove; to roam. [Obs.] And loved in forests wild to space. Spenser.\n\nTo arrange or adjust the spaces in or between; as, to space words, lines, or letters.
space bar |A bar or key, in a typewriter or typesetting machine, used for spacing between letters.
space key |A bar or key, in a typewriter or typesetting machine, used for spacing between letters.
spaceful |Wide; extensive. Sandys.
spaceless |Without space. Coleridge.
spacial |See Spatial.
spacially |See Spatially. Sir W,Hamilton.
spacious |1. Extending far and wide; vast in extent. \"A spacious plain outstretched in circuit wide.\" Milton. 2. Inclosing an extended space; having large or ample room; not contracted or narrow; capacious; roomy; as, spacious bounds; a spacious church; a spacious hall. -- Spa\"cious*ly, adv. -- Spa\"cious*ness, n.
spad |A nail one or two inches long, of iron, brass, tin, or tinner iron, with a hole through the flattened head, used to mark stations in underground surveying.
spadassin |A bravo; a bully; a duelist. Ld. Lytton.
spaddle |A little spade. [Obs.]
spade |1. (Zoöl.)  A hart or stag three years old. [Written also spaid, spayade.] 2. Etym: [Cf. L. spado.]  A castrated man or beast.\n\n1. An implement for digging or cutting the ground, consisting usually of an oblong and nearly rectangular blade of iron, with a handle like that of a shovel. \"With spade and pickax armed.\" Milton. 2. Etym: [Sp. espada, literally, a sword; -- so caused because these cards among the Spanish bear the figure of a sword. Sp. espada is fr. L. spatha, Gr. spa`qh. See the Etymology above.]  One of that suit of cards each of which bears one or more figures resembling a spade. \"Let spades be trumps!\" she said. Pope. 3. A cutting instrument used in flensing a whale. Spade bayonet, a bayonet with a broad blade which may be used digging; -- called also trowel bayonet. -- Spade handle (Mach.), the forked end of a connecting rod in which a pin is held at both ends. See Illust. of Knuckle joint, under Knuckle.\n\nTo dig with a spade; to pare off the sward of, as land, with a spade.
spadebone |Shoulder blade. [Prov. Eng.]
spadefish |An American market fish (Chætodipterus faber) common on the southern coasts; -- called also angel fish, moonfish, and porgy.
spadefoot |Any species of burrowing toads of the genus Scaphiopus, esp. S. Holbrookii, of the Eastern United States; -- called also spade toad.
spadeful |As much as a spade will hold or lift.
spader |One who, or that which, spades; specifically, a digging machine.
spadiceous |1. Of a bright clear brown or chestnut color. Sir T. Browne. 2. (Bot.)  Bearing flowers on a spadix; of the nature of a spadix.
spadicose |Spadiceous.
spadille |The ace of spades in omber and quadrille.
spadix |1. (Bot.)  A fleshy spike of flowers, usually inclosed in a leaf called a spathe. 2. (Zoöl.)  A special organ of the nautilus, due to a modification of the posterior tentacles.
spado |1. Same as Spade, 2. 2. (Law)  An impotent person.
spadroon |A sword, especially a broadsword, formerly used both to cut and thrust.
spae |To foretell; to divine. [Scot.]
spaeman |A prophet; a diviner. [Scot.]
spaewife |A female fortune teller. [Scot.]
spaghetti |A variety or macaroni made in tubes of small diameter.
spagyric |Chemical; alchemical. [Obs.]\n\nA spagyrist. [Obs.] Bp. Hall.
spagyrical |Chemical; alchemical. [Obs.]
spagyrist |1. A chemist, esp. one devoted to alchemistic pursuits. [Obs.] 2. One of a sect which arose in the days of alchemy, who sought to discover remedies for disease by chemical means. The spagyrists historically preceded the iatrochemists. Encyc. Brit.
spahee |1. Formerly, one of the Turkish cavalry. 2. An Algerian cavalryman in the French army.
spahi |1. Formerly, one of the Turkish cavalry. 2. An Algerian cavalryman in the French army.
spaid |See 1st Spade.
spake |imp. of Speak.
spakenet |A net for catching crabs. Halliwell.
spaky |Specky. [Obs.] hapman.
spalding knife |A spalting knife.
spale |1. A lath; a shaving or chip, as of wood or stone. [Prov. Eng. & Scot.] 2. (Shipbuilding)  A strengthening cross timber.
spall |The shoulder. [Obs.] Spenser.\n\nA chip or fragment, especially a chip of stone as struck off the block by the hammer, having at least one feather-edge.\n\n1. (Mining)  To break into small pieces, as ore, for the purpose of separating from rock. Pryce. 2. (Masonry)  To reduce, as irregular blocks of stone, to an approximately level surface by hammering.\n\nTo give off spalls, or wedge-shaped chips; -- said of stone, as when badly set, with the weight thrown too much on the outer surface.
spalpeen |A scamp; an Irish term for a good-for-nothing fellow; -- often used in good-humored contempt or ridicule. [Colloq.]
spalt |Spelter. [Colloq.]\n\n1. Liable to break or split; brittle; as, spalt timber. [Prov. Eng.] Halliwell. 2. Heedless; clumsy; pert; saucy. [Prov. Eng.]\n\nTo split off; to cleave off, as chips from a piece of timber, with an ax. [Prov. Eng. & Local, U.S.]
spalting knife |A knife used in splitting codfish. [Written also spalding knife.]
span |imp. & p. p. of Spin.\n\n1. The space from the thumb to the end of the little finger when extended; nine inches; eighth of a fathom. 2. Hence, a small space or a brief portion of time. Yet not to earth's contracted span Thy goodness let me bound. Pope. Life's but a span; I'll every inch enjoy. Farquhar. 3. The spread or extent of an arch between its abutments, or of a beam, girder, truss, roof, bridge, or the like, between its supports. 4. (Naut.)  A rope having its ends made fast so that a purchase can be hooked to the bight; also, a rope made fast in the center so that both ends can be used. 5. Etym: [Cf. D. span, Sw. spann, Dan. spænd, G. gespann. See Span, v. t. ]  A pair of horses or other animals driven together; usually, such a pair of horses when similar in color, form, and action. Span blocks (Naut.), blocks at the topmast and topgallant-mast heads, for the studding-sail halyards. -- Span counter, an old English child's game, in which one throws a counter on the ground, and another tries to hit it with his counter, or to get his counter so near it that he can span the space between them, and touch both the counters. Halliwell. \"Henry V., in whose time boys went to span counter for French crowns.\" Shak. -- Span iron (Naut.), a special kind of harpoon, usually secured just below the gunwale of a whaleboat. -- Span roof, a common roof, having two slopes and one ridge, with eaves on both sides. Gwilt. -- Span shackle (Naut.), a large bolt driven through the forecastle deck, with a triangular shackle in the head to receive the heel of the old-fashioned fish davit. Ham. Nav. Encyc.\n\n1. To measure by the span of the hand with the fingers extended, or with the fingers encompassing the object; as, to span a space or distance; to span a cylinder. My right hand hath spanned the heavens. Isa. xiviii. 13. 2. To reach from one side of to the order; to stretch over as an arch. The rivers were spanned by arches of solid masonry. prescott. 3. To fetter, as a horse; to hobble.\n\nTo be matched, as horses. [U. S.]
span-new |Quite new; brand-new; fire-new. \"A span-new archbishop's chair.\" Fuller.
spanaemia |A condition of impoverishment of the blood; a morbid state in which the red corpuscles, or other important elements of the blood, are deficient.
spanaemic |Of or pertaining to spanæmia; having impoverished blood.
spancel |A rope used for tying or hobbling the legs of a horse or cow. [Prov. Eng. & Local, U.S.] Grose.\n\nTo tie or hobble with a spancel. [Prov. Eng. & Local, U.S.] Malone.
spandogs |A pair of grappling dogs for hoisting logs and timber.
spandrel |1. (Arch.)  The irregular triangular space between the curve of an arch and the inclosing right angle; or the space between the outer moldings of two contiguous arches and a horizontal line above them, or another arch above and inclosing them. 2. A narrow mat or passe partout for a picture. [Cant]
spane |To wean. [Obs. or Prov. Eng.]
spang |To spangle. [Obs.]\n\nTo spring; to bound; to leap. [Scot.] But when they spang o'er reason's fence, We smart for't at our own expense. Ramsay.\n\nA bound or spring. [Scot.] Sir W. Scott.\n\nA spangle or shining ornament. [Obs.] With glittering spangs that did like stars appear. Spenser.
spangle |1. A small plate or boss of shining metal; something brilliant used as an ornament, especially when stitched on the dress. 2. Figuratively, any little thing that sparkless. \"The rich spangles that adorn the sky.\" Waller. Oak spangle. See under Oak.\n\nTo set or sprinkle with, or as with, spangles; to adorn with small, distinct, brilliant bodies; as, a spangled breastplate. Donne. What stars do spangle heaven with such beauty Shak. Spangled coquette (Zoöl.), a tropical humming bird (Lophornis reginæ). See Coquette, 2.\n\nTo show brilliant spots or points; to glisten; to glitter. Some men by feigning words as dark as mine Make truth to spangle, and its rays to shine. Bunyan.
spangler |One who, or that which, spangles.
spangly |Resembling, or consisting of, spangles; glittering; as, spangly light.
spaniard |A native or inhabitant of Spain.
spaniel |1. (Zoöl.)  One of a breed of small dogs having long and thick hair and large drooping ears. The legs are usually strongly feathered, and the tail bushy. See Illust. under Clumber, and Cocker. Note: There are several varieties of spaniels, some of which, known as field spaniels, are used in hunting; others are used for toy or pet dogs, as the Blenheim spaniel, and the King Charles spaniel (see under Blenheim). Of the field spaniels, the larger kinds are called springers, and to these belong the Sussex, Norfolk, and Clumber spaniels (see Clumber). The smaller field spaniels, used in hunting woodcock, are called cocker spaniels (see Cocker). Field spaniels are remarkable for their activity and intelligence. As a spaniel she will on him leap. Chaucer. 2. A cringing, fawning person. Shak.\n\nCringing; fawning. Shak.\n\nTo fawn; to cringe; to be obsequious. [R.] Churchill.\n\nTo follow like a spaniel. [R.]
spanish |Of or pertaining to Spain or the Spaniards. Spanish bayonet (Bot.), a liliaceous plant (Yucca alorifolia) with rigid spine-tipped leaves. The name is also applied to other similar plants of the Southwestern United States and mexico. Called also Spanish daggers. -- Spanish bean (Bot.) See the Note under Bean. -- Spanish black, a black pigment obtained by charring cork. Ure. -- Spanish broom (Bot.), a leguminous shrub (Spartium junceum) having many green flexible rushlike twigs. -- Spanish brown, a species of earth used in painting, having a dark reddish brown color, due to the presence of sesquioxide of iron. -- Spanish buckeye (Bot.), a small tree (Ungnadia speciosa) of Texas, New Mexico, etc., related to the buckeye, but having pinnate leaves and a three-seeded fruit. -- Spanish burton (Naut.), a purchase composed of two single blocks. A double Spanish burton has one double and two single blocks. Luce (Textbook of Seamanship). -- Spanish chalk (Min.), a kind of steatite; -- so called because obtained from Aragon in Spain. -- Spanish cress (Bot.), a cruciferous plant (lepidium Cadamines), a species of peppergrass. -- Spanish curiew (Zoöl.), the long-billed curlew. [U.S.] -- Spanish daggers (Bot.) See Spanish bayonet. -- Spanish elm (Bot.), a large West Indian tree (Cordia Gerascanthus) furnishing hard and useful timber. -- Spanish feretto, a rich reddish brown pigment obtained by calcining copper and sulphur together in closed crucibles. -- Spanish flag (Zoöl.), the California rockfish (Sebastichthys rubrivinctus). It is conspicuously colored with bands of red and white. -- Spanish fly (Zoöl.), a brilliant green beetle, common in the south of Europe, used for raising blisters. See Blister beetle under Blister, and Cantharis. -- Spanish fox (Naut.), a yarn twisted against its lay. -- Spanish grass. (Bot.) See Esparto. -- Spanish juice (Bot.), licorice. -- Spanish leather. See Cordwain. -- Spanish mackerel. (Zoöl.) (a) A species of mackerel (Scomber colias) found both in Europe and America. In America called chub mackerel, big-eyed mackerel, and bull mackerel. (b) In the United States, a handsome mackerel having bright yellow round spots (Scomberomorus maculatus), highly esteemed as a food fish. The name is sometimes erroneously applied to other species. See Illust. under Mackerel. -- Spanish main, the name formerly given to the southern portion of the Caribbean Sea, together with the contiguous coast, embracing the route traversed by Spanish treasure ships from the New to the Old World. -- Spanish moss. (Bot.) See Tillandsia. -- Spanish needles (Bot.), a composite weed (Bidens bipinnata) having achenia armed with needlelike awns. -- Spanish nut (Bot.), a bulbous plant (Iris Sisyrinchium) of the south of Europe. -- Spanish potato (Bot.), the sweet potato. See under Potato. -- Spanish red, an ocherous red pigment resembling Venetian red, but slightly yellower and warmer. Fairholt. -- Spanish reef (Naut.), a knot tied in the head of a jib-headed sail. -- Spanish sheep (Zoöl.), a merino. -- Spanish white, an impalpable powder prepared from chalk by pulverizing and repeated washings, -- used as a white pigment. -- Spanish windlass (Naut.), a wooden roller, with a rope wound about it, into which a marline spike is thrust to serve as a lever.\n\nThe language of Spain.
spank |To strike, as the breech, with the open hand; to slap.\n\nA blow with the open hand; a slap.\n\nTo move with a quick, lively step between a trot and gallop; to move quickly. Thackeray.
spanker |1. One who spanks, or anything used as an instrument for spanking. 2. (Naut.)  The after sail of a ship or bark, being a fore-and-aft sail attached to a boom and gaff; -- sometimes called driver. See Illust. under Sail. Totten. 3. One who takes long, quick strides in walking; also, a fast horse. [Colloq.] 4. Something very large, or larger than common; a whopper, as a stout or tall person. [Colloq.] Spanker boom (Naut.), a boom to which a spanker sail is attached. See Illust. of Ship.\n\nA small coin. [Obs. or Prov. Eng.]
spanking |1. Moving with a quick, lively pace, or capable of so doing; dashing. Four spanking grays ready harnessed. G. Colman, the Younger. 2. Large; considerable. [Colloq.]
spanking breeze |a strong breeze.
spanless |Incapable of being spanned.
spanner |1. One who, or that which, spans. 2. The lock of a fusee or carbine; also, the fusee or carbine itself. [Obs.] 3. An iron instrument having a jaw to fit a nut or the head of a bolt, and used as a lever to turn it with; a wrench; specifically, a wrench for unscrewing or tightening the couplings of hose. 4. pl.  A contrivance in some of the ealier steam engines for moving the valves for the alternate admission and shutting off of the steam.
spannishing |The full blooming of a flower. [Obs.] Rom. of R.
spanpiece |The collar of a roof; sparpiece.
spanworm |The larva of any geometrid moth, as the cankeworm; a geometer; a measuring worm.
spar |An old name for a nonmetallic mineral, usually cleavable and somewhat lustrous; as, calc spar, or calcite, fluor spar, etc. It was especially used in the case of the gangue minerals of a metalliferous vein. Blue spar, Cube spar, etc. See under Blue, Cube, etc.\n\n1. (Naut.)  A general term any round piece of timber used as a mast, yard, boom, or gaff. 2. (Arch.)  Formerly, a piece of timber, in a general sense; -- still applied locally to rafters. 3. The bar of a gate or door. [Obs.] Chaucer. Spar buoy (Naut.), a buoy anchored by one end so that the other end rises above the surface of the water. -- Spar deck (Naut.), the upper deck of a vessel; especially, in a frigate, the deck which is continued in a straight line from the quarter-deck to the forecastle, and on which spare spars are usually placed. See under Deck. -- Spar torpedo (Naut.), a torpedo carried on the end of a spar usually projecting from the bow of a vessel, and intended to explode upon contact with an enemy's ships.\n\n1. To bolt; to bar. [Obs.] Chaucer. 2. To To supply or equip with spars, as a vessel. Note: A vessel equipped with spars that are too large or too small is said to be oversparred or undersparred.\n\n1. To strike with the feet or spurs, as cocks do. 2. To use the fists and arms scientifically in attack or defense; to contend or combat with the fists, as for exercise or amusement; to box. Made believe to spar at Paul with great science. Dickens. 3. To contest in words; to wrangle. [Colloq.]\n\n1. A contest at sparring or boxing. 2. A movement of offense or defense in boxing.
spar-hung |Hung with spar, as a cave.
sparable |A kind of small nail used by shoemakers.
sparada |A small California surf fish (Micrometrus aggregatus); -- called also shiner.
sparadrap |1. A cerecloth. [Obs.] 2. (Med.)  Any adhesive plaster.
sparage |Obs. or corrupt forms of Asparagus.
sparagrass |Obs. or corrupt forms of Asparagus.
sparagus |Obs. or corrupt forms of Asparagus.
sparble |To scatter; to disperse; to rout. [Obs.] The king's host was sparbled and chased. Fabyan.
spare |1. To use frugally or stintingly, as that which is scarce or valuable; to retain or keep unused; to save. \"No cost would he spare.\" Chaucer. [Thou] thy Father's dreadful thunder didst not spare. Milton. He that hath knowledge, spareth his words. Prov. xvii. 27. 2. To keep to one's self; to forbear to impart or give. Be pleased your plitics to spare. Dryden. Spare my sight the pain Of seeing what a world of tears it costs you. Dryden. 3. To preserve from danger or punishment; to forbear to punish, injure, or harm; to show mercy to. Spare us, good Lord. Book of Common Prayer. Dim sadness did not spare That time celestial visages. Milton. Man alone can whom he conquers spare. Waller. 4. To save or gain, as by frugality; to reserve, as from some occupation, use, or duty. All the time he could spare from the necessary cares of his weighty charge, he Knolles. 5. To deprive one's self of, as by being frugal; to do without; to dispense with; to give up; to part with. Where angry Jove did never spare One breath of kind and temperate air. Roscommon. I could have better spared a better man. Shak. To spare one's self. (a) To act with reserve. [Obs.] Her thought that a lady should her spare. Chaucer. (b) To save one's self labor, punishment, or blame.\n\n1. To be frugal; not to be profuse; to live frugally; to be parsimonious. I, who at some times spend, at others spare, Divided between carelessness and care. Pope. 2. To refrain from inflicting harm; to use mercy or forbearance. He will not spare in the day of vengeance. Prov. vi. 34. 3. To desist; to stop; to refrain. [Obs.] Chaucer.\n\n1. Scanty; not abundant or plentiful; as, a spare diet. 2. Sparing; frugal; parsimonious; chary. He was spare, but discreet of speech. Carew. 3. Being over and above what is necessary, or what must be used or reserved; not wanted, or not used; superfluous; as, I have no spare time. If that no spare clothes he had to give. Spenser. 4. Held in reserve, to be used in an emergency; as, a spare anchor; a spare bed or room. 5. Lean; wanting flesh; meager; thin; gaunt. O, give me the spare men, and spare me the great ones. Shak. 6. Slow. [Obs. or prov. Eng.] Grose.\n\n1. The act of sparing; moderation; restraint. [Obs.] Killing for sacrifice, without any spare. Holland. 2. Parsimony; frugal use. [Obs.] Bacon. Poured out their plenty without spite or spare. Spenser. 3. An opening in a petticoat or gown; a placket. [Obs.] 4. That which has not been used or expended. 5. (Tenpins)  The right of bowling again at a full set of pins, after having knocked all the pins down in less than three bowls. If all the pins are knocked down in one bowl it is a double spare; in two bowls, a single spare.
spareful |Sparing; chary. [Obs.] Fairfax. -- Spare\"ful*ness, n. [Obs.] Sir P. Sidney.
spareless |Unsparing. Sylvester.
sparely |In a spare manner; sparingly.
spareness |The quality or state of being lean or thin; leanness.
sparer |One who spares.
sparerib |A piece of pork, consisting or ribs with little flesh on them.
sparge |To sprinkle; to moisten by sprinkling; as, to sparge paper.
spargefaction |The act of sprinkling. [Obs.] Swift.
sparger |A vessel with a perforated cover, for sprinkling with a liquid; a sprinkler.
sparhawk |The sparrow hawk. [Prov. Eng.]
sparing |Spare; saving; frugal; merciful. Bacon. -- Spar\"ing*ly, adv. -- Spar\"ing*ness, n.
spark |1. A small particle of fire or ignited substance which is emitted by a body in combustion. Man is born unto trouble, as hte sparks fly upward. Job v. 7. 2. A small, shining body, or transient light; a sparkle. 3. That which, like a spark, may be kindled into a flame, or into action; a feeble germ; an elementary principle. \"If any spark of life be yet remaining.\" Shak. \"Small intellectual spark.\" Macaulay. \"Vital spark of heavenly flame.\" Pope. We have here and there a little clear light, some sparks of bright knowledge. Locke. Bright gem instinct with music, vocal spark. Wordsworth. Spark arrester, a contrivance to prevent the escape of sparks while it allows the passage of gas, -- chiefly used in the smokestack of a wood-burning locomotive. Called also spark consumer. [U.S.]\n\n1. A brisk, showy, gay man. The finest sparks and cleanest beaux. Prior. 2. A lover; a gallant; a beau.\n\nTo sparkle. [Obs.] Spenser.\n\nTo play the spark, beau, or lover. A sure sign that his master was courting, or, as it is termed, sparking, within. W. Irwing.
spark coil |(a) An induction coil, esp. of an internal-combustion engine, wireless telegraph apparatus, etc. (b) A self-induction coil used to increase the spark in an electric gas-lighting apparatus.
spark gap |The space filled with air or other dielectric between high potential terminals (as of an electrostatic machine, induction coil, or condenser), through which the discharge passes; the air gap of a jump spark.
spark plug |In internal-combustion engines with electric ignition, a plug, screwed into the cylinder head, having through it an insulated wire which is connected with the induction coil or magneto circuit on the outside, and forms, with another terminal on the base of the plug, a spark gap inside the cylinder.
sparker |A spark arrester.
sparkful |Lively; brisk; gay. [Obs.] \"Our sparkful youth.\" Camden.
sparkish |1. Like a spark; airy; gay. W. Walsh. 2. Showy; well-dresed; fine. L'Estrange.
sparkle |1. A little spark; a scintillation. As fire is wont to quicken and go From a sparkle sprungen amiss, Till a city brent up is. Chaucer. The shock was sufficiently strong to strike out some sparkles of his fiery temper. Prescott. 2. Brilliancy; luster; as, the sparkle of a diamond.\n\n1. To emit sparks; to throw off ignited or incandescent particles; to shine as if throwing off sparks; to emit flashes of light; to scintillate; to twinkle; as, the blazing wood sparkles; the stars sparkle. A mantelet upon his shoulder hanging Bretful of rubies red, as fire sparkling. Chaucer. 2. To manifest itself by, or as if by, emitting sparks; to glisten; to flash. I see bright honor sparkle through your eyes. Milton. 3. To emit little bubbles, as certain kinds of liquors; to effervesce; as, sparkling wine. Syn. -- To shine; glisten; scintillate; radiate; coruscate; glitter; twinkle.\n\nTo emit in the form or likeness of sparks. \"Did sparkle forth great light.\" Spenser.\n\n1. To disperse. [Obs.] The Landgrave hath sparkled his army without any further enterprise. State Papers. 2. To scatter on or over. [Obs.] Purchas.
sparkler |One who scatters; esp., one who scatters money; an improvident person. [Obs.]\n\nOne who, or that which, sparkles.\n\nA tiger beetle.
sparklet |A small spark. [Obs.]
sparkliness |Vivacity. [Obs.] Aubrey.
sparkling |Emitting sparks; glittering; flashing; brilliant; lively; as, sparkling wine; sparkling eyes. -- Spar\"kling*ly, adv. -- Spar\"kling*ness, n. Syn. -- Brilliant; shining. See Shining.
sparling |(a) The European smelt (Osmerus eperlanus). (b) A young salmon. (c) A tern. [Scot. & Prov. Eng.]
sparlyre |The calf of the leg. [Obs.] Wyclif (Deut. xxviii. 35).
sparoid |of or pertaining to the Sparidæ, a family of spinous-finned fishes which includes the scup, sheepshead, and sea bream. -- n.  One of the Sparidæ.
sparpiece |The collar beam of a roof; the spanpiece. Gwilt.
sparpoil |To scatter; to spread; to disperse. [Obs.]
sparrow |1. (Zoöl.)  One of many species of small singing birds of the family Fringilligæ, having conical bills, and feeding chiefly on seeds. Many sparrows are called also finches, and buntings. The common sparrow, or house sparrow, of Europe (Passer domesticus) is noted for its familiarity, its voracity, its attachment to its young, and its fecundity. See House sparrow, under House. Note: The following American species are well known; the chipping sparrow, or chippy, the sage sparrow, the savanna sparrow, the song sparrow, the tree sparrow, and the white-throated sparrow (see Peabody bird). See these terms under Sage, Savanna, etc. 2. (Zoöl.)  Any one of several small singing birds somewhat resembling the true sparrows in form or habits, as the European hedge sparrow. See under Hedge. He that doth the ravens feed, Yea, providently caters for the sparrow, Be comfort to my age! Shak. Field sparrow, Fox sparrow, etc. See under Field, Fox, etc. -- Sparrow bill, a small nail; a castiron shoe nail; a sparable. -- Sparrow hawk. (Zoöl.) (a) A small European hawk (Accipiter nisus) or any of the allied species. (b) A small American falcon (Falco sparverius). (c) The Australian collared sparrow hawk (Accipiter torquatus). Note: The name is applied to other small hawks, as the European kestrel and the New Zealand quail hawk. -- Sparrow owl (Zoöl.), a small owl (Glaucidium passerinum) found both in the Old World and the New. The name is also applied to other species of small owls. -- Sparrow spear (Zoöl.), the female of the reed bunting. [Prov. Eng.]
sparrowgrass |Asparagus. [Colloq.] See the Note under Asparagus.
sparrowwort |An evergreen shrub of the genus Erica (E. passerina).
sparry |Resembling spar, or consisting of spar; abounding with spar; having a confused crystalline structure; spathose. Sparry iron (Min.), siderite. See Siderite (a). -- Sparry limestone (Min.), a coarsely crystalline marble.
sparse |1. Thinly scattered; set or planted here and there; not being dense or close together; as, a sparse population. Carlyle. 2. (Bot.)  Placed irregularly and distantly; scattered; -- applied to branches, leaves, peduncles, and the like.\n\nTo scatter; to disperse. [Obs.] Spenser.
sparsedly |Sparsely. [Obs.]
sparsely |In a scattered or sparse manner.
sparseness |The quality or state of being sparse; as, sparseness of population.
sparsim |Sparsely; scatteredly; here and there.
spartan |of or pertaining to Sparta, especially to ancient Sparta; hence, hardy; undaunted; as, Spartan souls; Spartan bravey. -- n.  A native or inhabitant of Sparta; figuratively, a person of great courage and fortitude.
sparteine |A narcotic alkaloid extracted from the tops of the common broom (Cytisus scoparius, formerly Spartium scoparium), as a colorless oily liquid of aniline-like odor and very bitter taste.
sparterie |Articles made of the blades or fiber of the Lygeum Spartum and Stipa (or Macrochloa) tenacissima, kinds of grass used in Spain and other countries for making ropes, mats, baskets, nets, and mattresses. Loudon.
sparth |An Anglo-Saxon battle-ax, or halberd. [Obs.] He hath a sparth of twenty pound of weight. Chaucer.
sparve |The hedge sparrow. [Prov. Eng.]
spary |Sparing; parsimonious. [Obs.]
spasm |1. (Med.)  An involuntary and unnatural contraction of one or more muscles or muscular fibers. Note: Spasm are usually either clonic or tonic. In clonic spasm, the muscles or muscular fibers contract and relax alternately in very quick succession. In tonic spasm, the contraction is steady and uniform, and continues for a comparatively long time, as in tetanus. 2. A sudden, violent, and temporary effort or emotion; as, a spasm of repentance. Cynic spasm (Med.) See under Cynic. -- Spasm of the chest. See Angina pectoris, under Angina.
spasmatical |Spasmodic. [Obs.]
spasmodic |1. (Med.)  Of or pertaining to spasm; consisting in spasm; occuring in, or characterized by, spasms; as, a spasmodic asthma. 2. Soon relaxed or exhausted; convulsive; intermittent; as, spasmodic zeal or industry. Spasmodic croup (Med.), an affection of childhood characterized by a stoppage of brathing developed suddenly and without fever, and produced by spasmodic contraction of the vocal cords. It is sometimes fatal. Called also laryngismus stridulus, and childcrowing. -- Spasmodic stricture, a stricture caused by muscular spasm without structural change. See Organic stricture, under Organic.\n\nA medicine for spasm.
spasmodical |Same as Spasmodic, a. -- Spas*mod\"ic*al*ly, adv.
spastic |Of or pertaining to spasm; spasmodic; especially, pertaining to tonic spasm; tetanic.
spastically |Spasmodically.
spasticity |1. A state of spasm. 2. The tendency to, or capability of suffering, spasm.
spat |imp. of Spit. [Obs. or R.]\n\nA young oyster or other bivalve mollusk, both before and after it first becomes adherent, or such young, collectively.\n\nTo emit spawn; to emit, as spawn.\n\n1. A light blow with something flat. [U.S. & Prov. Eng.] 2. Hence, a petty combat, esp. a verbal one; a little quarrel, dispute, or dissension. [U. S.]\n\nTo dispute. [R.] Smart.\n\nTo slap, as with the open hand; to clap together; as the hands. [Local, U.S.] Little Isabel leaped up and down, spatting her hands. Judd.
spatangoid |Of or pertaining to the Spatangoidea. -- n.  One of the Spatangoidea.
spatangoidea |An order of irregular sea urchins, usually having a more or less heart-shaped shell with four or five petal-like ambulacra above. The mouth is edentulous and situated anteriorly, on the under side.
spatangus |A genus of heart-shaped sea urchins belonging to the Spatangoidea.
spatchcock |See Spitchcock.
spate |A river flood; an overflow or inundation. Burns. Gareth in a showerful spring Stared at the spate. Tennyson.
spatha |A spathe.
spathaceous |Having a spathe; resembling a spathe; spathal.
spathal |Furnished with a spathe; as, spathal flowers. Howitt.
spathe |A special involucre formed of one leaf and inclosing a spadix, as in aroid plants and palms. See the Note under Bract, and Illust. of Spadix. Note: The name is also given to the several-leaved involucre of the iris and other similar plants.
spathed |Having a spathe or calyx like a sheath.
spathic |Like spar; foliated or lamellar; spathose. Spathic iron (Min.), siderite. See Siderite (a).
spathiform |Resembling spar in form. \"The ocherous, spathiform, and mineralized forms of uranite.\" Lavoisier (Trans.).
spathose |See Spathic.\n\nHaving a spathe; resembling a spathe; spatheceous; spathal.
spathous |Spathose.
spathulate |See Spatulate.
spatial |Of or pertaining to space. \"Spatial quantity and relations.\" L. H. Atwater.
spatially |As regards space.
spatiate |To rove; to ramble. [Obs.] Bacon.
spatter |1. To sprinkle with a liquid or with any wet substance, as water, mud, or the like; to make wet of foul spots upon by sprinkling; as, to spatter a coat; to spatter the floor; to spatter boots with mud. Upon any occasion he is to be spattered over with the blood of his people. Burke. 2. To distribute by sprinkling; to sprinkle around; as, to spatter blood. Pope. 3. Fig.: To injure by aspersion; to defame; to soil; also, to throw out in a defamatory manner.\n\nTo throw something out of the mouth in a scattering manner; to sputter. That mind must needs be irrecoverably depraved, which, . . . tasting but once of one just deed, spatters at it, and abhors the relish ever after. Milton.
spatter-dock |The common yellow water lily (Nuphar advena).
spatterdashed |Wearing spatterdashes. [Colloq.] Thackeray.
spatterdashes |Coverings for the legs, to protect them from water and mud; long gaiters.
spattle |Spawl; spittle. [Obs.] Bale.\n\n1. A spatula. 2. (Pottery)  A tool or implement for mottling a molded article with coloring matter Knoght.
spattling-poppy |A kind of catchfly (Silene inflata) which is sometimes frothy from the action of captured insects.
spatula |An implement shaped like a knife, flat, thin, and somewhat flexible, used for spreading paints, fine plasters, drugs in compounding prescriptions, etc. Cf. Palette knife, under Palette.
spatulate |Shaped like spatula, or like a battledoor, being roundish, with a long, narrow, linear base. [Also written spathulate.]
spauld |The shoulder. [Scot.]
spavin |A disease of horses characterized by a bony swelling developed on the hock as the result of inflammation of the bones; also, the swelling itself. The resulting lameness is due to the inflammation, and not the bony tumor as popularly supposed. Harbaugh. Bog spavin, a soft swelling produced by distention of the capsular ligament of the hock; -- called also blood spavin. -- Bone spavin, spavin attended with exostosis; ordinary spavin.
spavined |Affected with spavin.
spaw |See Spa.
spawl |A splinter or fragment, as of wood or stone. See Spall.\n\nScattered or ejected spittle.\n\nTo scatter spittle from the mouth; to spit, as saliva. Why must he sputter, spawl, and slaver it In vain, against the people's favorite. Swift.
spawling |That which is spawled, or spit out.
spawn |1. To produce or deposit (eggs), as fishes or frogs do. 2. To bring forth; to generate; -- used in contempt. One edition [of books] spawneth another. Fuller.\n\n1. To deposit eggs, as fish or frogs do. 2. To issue, as offspring; -- used contemptuously.\n\n1. The ova, or eggs, of fishes, oysters, and other aquatic animals. 2. Any product or offspring; -- used contemptuously. 3. (Hort.)  The buds or branches produced from underground stems. 4. (Bot.)  The white fibrous matter forming the matrix from which fungi. Spawn eater (Zoöl.), a small American cyprinoid fish (Notropis Hudsonius) allied to the dace.
spawner |1. (Zoöl.)  A mature female fish. The barbel, for the preservation or their seed, both the spawner and the milter, cover their spawn with sand. Walton. 2. Whatever produces spawn of any kind.
spay |To remove or extirpate the ovaries of, as a sow or a bitch; to castrate (a female animal).\n\nThe male of the red deer in his third year; a spade.
spayad |A spay.
spayade |A spay.
speak |1. To utter words or articulate sounds, as human beings; to express thoughts by words; as, the organs may be so obstructed that a man may not be able to speak. Till at the last spake in this manner. Chaucer. Speak, Lord; for thy servant heareth. 1 Sam. iii. 9. 2. To express opinions; to say; to talk; to converse. That fluid substance in a few minutes begins to set, as the tradesmen speak. Boyle. An honest man, is able to speak for himself, when a knave is not. Shak. During the century and a half which followed the Conquest, there is, to speak strictly, no English history. Macaulay. 3. To utter a speech, discourse, or harangue; to adress a public assembly formally. Many of the nobility made themselves popular by speaking in Parliament against those things which were most grateful to his majesty. Clarendon. 4. To discourse; to make mention; to tell. Lycan speaks of a part of Cæsar's army that came to him from the Leman Lake. Addison. 5. To give sound; to sound. Make all our trumpets speak. Shak. 6. To convey sentiments, ideas, or intelligence as if by utterance; as, features that speak of self-will. Thine eye begins to speak. Shak. To speak of, to take account of, to make mention of. Robynson (More's Utopia). -- To speak out, to speak loudly and distinctly; also, to speak unreservedly. -- To speak well for, to commend; to be favorable to. -- To speak with, to converse with. \"Would you speak with me\" Shak. Syn. -- To say; tell; talk; converse; discourse; articulate; pronounce; utter.\n\n1. To utter with the mouth; to pronounce; to utter articulately, as human beings. They sat down with him upn ground seven days and seven nights, and none spake a word unto him. Job. ii. 13. 2. To utter in a word or words; to say; to tell; to declare orally; as, to speak the truth; to speak sense. 3. To declare; to proclaim; to publish; to make known; to exhibit; to express in any way. It is my father;s muste To speak your deeds. Shak. Speaking a still good morrow with her eyes. Tennyson. And for the heaven's wide circuit, let it speak The maker's high magnificence. Milton. Report speaks you a bonny monk. Sir W. Scott. 4. To talk or converse in; to utter or pronounce, as in conversation; as, to speak Latin. And French she spake full fair and fetisely. Chaucer. 5. To address; to accost; to speak to. [He will] thee in hope; he will speak thee fair. Ecclus. xiii. 6. each village senior paused to scan And speak the lovely caravan. Emerson. To speak a ship (Naut.), to hail and speak to her captain or commander.
speakable |1. Capable of being spoken; fit to be spoken. Ascham. 2. Able to speak. Milton.
speaker |1. One who speaks. Specifically: (a) One who utters or pronounces a discourse; usually, one who utters a speech in public; as, the man is a good speaker, or a bad speaker. (b) One who is the mouthpiece of others; especially, one who presides over, or speaks for, a delibrative assembly, preserving order and regulating the debates; as, the Speaker of the House of Commons, originally, the mouthpiece of the House to address the king; the Speaker of a House of Representatives. 2. A book of selections for declamation. [U. S.]
speakership |The office of speaker; as, the speakership of the House of Representatives.
speaking |1. Uttering speech; used for conveying speech; as, man is a speaking animal; a speaking tube. 2. Seeming to be capable of speech; hence, lifelike; as, a speaking likeness. A speaking acquaintance, a slight acquaintance with a person, or one which merely permits the exchange of salutations and remarks on indifferent subjects. -- Speaking trumpet, an instrument somewhat resembling a trumpet, by which the sound of the human voice may be so intensified as to be conveyed to a great distance. -- Speaking tube, a tube for conveying speech, especially from one room to another at a distance. -- To be on speaking terms, to be slightly acquainted.\n\n1. The act of uttering words. 2. Public declamation; oratory.
spear |1. A long, pointed weapon, used in war and hunting, by thrusting or throwing; a weapon with a long shaft and a sharp head or blade; a lance. Note: [See Illust. of Spearhead.] \"A sharp ground spear.\" Chaucer. They shall beat their swords into plowshares, and their spears into pruning hooks. Micah iv. 3. 2. Fig.: A spearman. Sir W. Scott. 3. A sharp-pointed instrument with barbs, used for stabbing fish and other animals. 4. A shoot, as of grass; a spire. 5. The feather of a horse. See Feather, n., 4. 6. The rod to which the bucket, or plunger, of a pump is attached; a pump rod. Spear foot, the off hind foot of a horse. -- Spear grass. (Bot.) (a) The common reed. See Reed, n., 1. (b) meadow grass. See under Meadow. -- Spear hand, the hand in which a horseman holds a spear; the right hand. Crabb. -- Spear side, the male line of a family. Lowell. -- Spear thistle (Bot.), the common thistle (Cnicus lanceolatus).\n\nTo pierce with a spear; to kill with a spear; as, to spear a fish.\n\nTo shoot into a long stem, as some plants. See Spire. Mortimer.
spearer |One who uses a spear; as, a spearer of fish.
spearfish |(a) A large and powerful fish (Tetrapturus albidus) related to the swordfish, but having scales and ventral fins. It is found on the American coast and the Mediterranean. (b) The carp sucker.
spearhead |The pointed head, or end, of a spear.
spearman |One who is armed with a spear. Acts xxiii. 23.
spearmint |A species of mint (Mentha viridis) growing in moist soil. It vields an aromatic oil. See Mint, and Mentha.
spearwood |An Australian tree (Acacia Doratoxylon), and its tough wood, used by the natives for spears.
spearwort |A name given to several species of crowfoot (Ranunculus) which have spear-shaped leaves.
speary |Having the form of a spear.
spece |Species; kind. [Obs.] Chaucer.
specht |A woodpecker. [Obs. or prov. Eng.] Sherwood.
special |1. Of or pertaining to a species; constituting a species or sort. A special is called by the schools a \"species\". I. Watts. 2. Particular; peculiar; different from others; extraordinary; uncommon. Our Savior is represented everywhere in Scripture as the special patron of the poor and the afficted. Atterbury. To this special evil an improvement of style would apply a special redress. De Quincey. 3. Appropriate; designed for a particular purpose, occasion, or person; as, a special act of Parliament or of Congress; a special sermon. 4. Limited in range; confined to a definite field of action, investigation, or discussion; as, a special dictionary of commercial terms; a special branch of study. 5. Chief in excellence. [Obs.] The king hath drawn The special head of all the land together. Shak. Special administration (Law), an administration limited to certain specified effects or acts, or one granted during a particular time or the existence of a special cause, as during a controversy respecting the probate of a will, or the right of administration, etc. -- Special agency, an agency confined to some particular matter. -- Special bail, Bail above, or Bail to the action (Law), sureties who undertake that, if the defendant is convicted, he shall satisfy the plaintiff, or surrender himself into custody. Tomlins. Wharton (Law Dict.). -- Special constable. See under Constable. Bouvier. -- Special damage (Law), a damage resulting from the act complained of, as a natural, but not the necessary, consequence of it. -- Special demurrer (Law), a demurrer for some defect of form in the opposite party pleading, in which the cause of demurrer is particularly stated. -- Special deposit, a deposit made of a specific thing to be kept distinct from others. -- Special homology. (Biol.) See under Homology. -- Special injuction (Law), an injuction granted on special grounds, arising of the circumstances of the case. Daniell. -- Special issue (Law), an issue produced upon a special plea. Stephen. -- Special jury (Law), a jury consisting of persons of some particular calling, station, or qualification, which is called upon motion of either party when the cause is supposed to require it; a struck jury. -- Special orders (Mil.), orders which do not concern, and are not published to, the whole command, such as those relating to the movement of a particular corps, a detail, a temporary camp, etc. -- Special partner, a limited partner; a partner with a limited or restricted responsibility; -- unknown at common law. -- Special partnership, a limited or particular partnership; -- a term sometimes applied to a partnership in a particular business, operation, or adventure. -- Special plea in bar (Law), a plea setting forth particular and new matter, distinguished from the general issue. Bouvier. -- Special pleader (Law), originally, a counsel who devoted himself to drawing special counts and pleas; in a wider sense, a lawyer who draws pleadings. -- Special pleading (Law), the allegation of special or new matter, as distingiushed from a direct denial of matter previously alleged on the side. Bouvier. The popular denomination of the whole science of pleading. Stephen. The phrase is sometimes popularly applied to the specious, but unsound, argumentation of one whose aim is victory, and not truth. Burrill. -- Special property (Law), a qualified or limited ownership possession, as in wild animals, things found or bailed. -- Special session, an extraordinary session; a session at an unusual time or for an unusual purpose; as, a special session of Congress or of a legislature. -- Special statute, or Special law, an act of the legislature which has reference to a particular person, place, or interest; -- in distinction from a general law. -- Special verdict (Law), a special finding of the facts of the case, leaving to the court the application of the law to them. Wharton (Law Dict.). Syn. -- Peculiar; appropriate; specific; dictinctive; particular; exceptional; singular. See Peculiar.\n\n1. A particular. [Obs.] Hammond. 2. One appointed for a special service or occasion. In special, specially; in particular. Chaucer.
specialism |Devotion to a particular and restricted part or branch of knowledge, art, or science; as, medical specialism.
specialist |One who devotes himself to some specialty; as, a medical specialist, one who devotes himself to diseases of particular parts of the body, as the eye, the ear, the nerves, etc.
speciality |1. A particular or peculiar case; a particularity. Sir M. Hale. 2. (Law)  See Specialty, 3. 3. The special or peculiar mark or characteristic of a person or thing; that for which a person is specially distinguished; an object of special attention; a special occupation or object of attention; a specialty. On these two general heads all other specialities are depedent. Hooker. Strive, while improving your one talent, to enrich your whole capital as a man. It is in this way that you escape from the wretched narrow- mindedness which is the characteristic of every one who cultivates his speciality. Ld. Lytton. We 'll say, instead, the inconsequent creature man, -For that'a his speciality. Mrs. Browning. Think of this, sir, . . . remote from the impulses of passion, and apart from the specialities -- if I may use that strong remark -- of prejudice. Dickens. 4. An attribute or quality peculiar to a species.
specialization |1. The act of specializing, or the state of being spezialized. 2. (Biol.)  The setting spart of a particular organ for the performance of a particular function. Darwin.
specialize |1. To mention specialy; to particularize. 2. To apply to some specialty or limited object; to assign to a specific use; as, specialized knowledge. 3. (Biol.)  To supply with an organ or organs having a special function or functions.
specially |1. In a special manner; partcularly; especially. Chaucer. 2. For a particular purpose; as, a meeting of the legislature is specially summoned.
specialty |1. Particularity. Specialty of rule hath been neglected. Shak. 2. A particular or peculiar case. [Obs.] 3. (Law)  A contract or obligation under seal; a contract by deed; a writing, under seal, given as security for a debt particularly specified. Chitty. Bouvier. Wharton (Law Dict.). Let specialties be therefore drawn between us. Shak. 4. That for which a person is distinguished, in which he is specially versed, or which he makes an object of special attention; a speciality. Men of boundless knowledge, like Humbold, must have had once their specialty, their pet subject. C. Kingsley.
specie |abl. of L. species sort, kind. Used in the phrase in specie, that is, in sort, in kind, in (its own) form. \"[The king] expects a return in specie from them\" [i. e., kindness for kindness]. Dryden. In specie (Law), in precise or definite form; specifically; according to the exact terms; of the very thing.\n\nCoin; hard money.
species |1. Visible or sensible presentation; appearance; a sensible percept received by the imagination; an image. [R.] \"The species of the letters illuminated with indigo and violet.\" Sir I. Newton. Wit, . . . the faculty of imagination in the writer, which searches over all the memory for the species or ideas of those things which it designs to represent. Dryden. Note: In the scholastic philosophy, the species was sensible and intelligible. The sensible species was that in any material, object which was in fact discerned by the mind through the organ of perception, or that in any object which rendered it possible that it should be perceived. The sensible species, as apprehended by the understanding in any of the relations of thought, was called an intelligible species. \"An apparent diversity between the species visible and audible is, that the visible doth not mingle in the medium, but the audible doth.\" Bacon. 2. (Logic)  A group of individuals agreeing in common attributes, and designated by a common name; a conception subordinated to another conception, called a genus, or generic conception, from which it differs in containing or comprehending more attributes, and extending to fewer individuals. Thus, man is a species, under animal as a genus; and man, in its turn, may be regarded as a genus with respect to European, American, or the like, as species. 3. In science, a more or less permanent group of existing things or beings, associated according to attributes, or properties determined by scientific observation. Note: In mineralogy and chemistry, objects which possess the same definite chemical structure, and are fundamentally the same in crystallization and physical characters, are classed as belonging to a species. In zoölogy and botany, a species is an ideal group of individuals which are believed to have descended from common ancestors, which agree in essential characteristics, and are capable of indefinitely continued fertile reproduction through the sexes. A species, as thus defined, differs from a variety or subspecies only in the greater stability of its characters and in the absence of individuals intermediate between the related groups. 4. A sort; a kind; a variety; as, a species of low cunning; a species of generosity; a species of cloth. 5. Coin, or coined silver, gold, ot other metal, used as a circulating medium; specie. [Obs.] There was, in the splendor of the Roman empire, a less quantity of current species in Europe than there is now. Arbuthnot. 6. A public spectacle or exhibition. [Obs.] Bacon. 7. (Pharmacy) (a) A component part of compound medicine; a simple. (b) (Med.) An officinal mixture or compound powder of any kind; esp., one used for making an aromatic tea or tisane; a tea mixture. Quincy. 8. (Civil Law)  The form or shape given to materials; fashion or shape; form; figure. Burill. Incipient species (Zoöl.), a subspecies, or variety, which is in process of becoming permanent, and thus changing to a true species, usually by isolation in localities from which other varieties are excluded.
specifiable |Admitting specification; capable of being specified.
specific |1. Of or pertaining to a species; characterizing or constituting a species; possessing the peculiar property or properties of a thing which constitute its species, and distinguish it from other things; as, the specific form of an animal or a plant; the specific qualities of a drug; the specific distinction between virtue and vice. Specific difference is that primary attribute which distinguishes each species from one another. I. Watts. 2. Specifying; definite, or making definite; limited; precise; discriminating; as, a specific statement. 3. (Med.)  Exerting a peculiar influence over any part of the body; preventing or curing disease by a peculiar adaption, and not on general principles; as, quinine is a specific medicine in cases of malaria. In fact, all medicines will be found specific in the perfection of the science. Coleridge. Specific character (Nat. Hist.), a characteristic or characteristics distinguishing one species from every other species of the same genus. -- Specific disease (Med.) (a) A disease which produces a determinate definite effect upon the blood and tissues or upon some special tissue. (b) A disease which is itself uniformly produced by a definite and peculiar poison or organism. -- Specific duty. (Com.) See under Duty. -- Specific gravity. (Physics) See under Gravity. -- Specific heat (Physics), the quantity of heat required to raise temperature of a body one degree, taking as the unit of measure the quantity required to raise the same weight of water from zero to one degree; thus, the specific heat of mercury is 0.033, that of water being 1.000. -- Specific inductive capacity (Physics), the effect of a dielectric body in producing static electric induction as compared with that of some other body or bodies referred to as a standard. -- Specific legacy (Law), a bequest of a particular thing, as of a particular animal or piece of furniture, specified and distinguished from all others. Wharton. Burrill. -- Specific name (Nat., Hist.), the name which, appended to the name of the genus, constitutes the distinctive name of the species; -- originally applied by Linnæus to the essential character of the species, or the essential difference. The present specific name he at first called the trivial name. -- Specific performance (Law), the peformance of a contract or agreement as decreed by a court of equity.\n\n1. (Med.)  A specific remedy. See Specific, a., 3. His parents were weak enough to believe that the royal touch was a specific for this malady. Macaulay. 2. Anything having peculiar adaption to the purpose to which it is applied. Dr. H. More.
specifical |Specific. Bacon.
specifically |In a specific manner.
specificalness |The quality of being specific.
specificate |To show, mark, or designate the species, or the distinguishing particulars of; to specify. [Obs.] ir M. Hale.
specification |1. The act of specifying or determining by a mark or limit; notation of limits. This specification or limitation of the question hinders the disputers from wandering away from the precise point of inquiry. I. Watts. 2. The designation of particulars; particular mention; as, the specification of a charge against an officer. 3. A written statement containing a minute description or enumeration of particulars, as of charges against a public officer, the terms of a contract, the description of an invention, as in a patent; also, a single article, item, or particular, an allegation of a specific act, as in a charge of official misconduct.
specificness |The quality or state of being specific.
specify |To mention or name, as a particular thing; to designate in words so as to distinguish from other things; as, to specify the uses of a plant; to specify articles purchased. He has there given us an exact geography of Greece, where the countries and the uses of their soils are specified. Pope.
specillum |See Stylet, 2.
specimen |A part, or small portion, of anything, or one of a number of things, intended to exhibit the kind and quality of the whole, or of what is not exhibited; a sample; as, a specimen of a man's handwriting; a specimen of painting; aspecimen of one's art. Syn. -- Sample; model; pattern. -- Specimen, Sample. A specimen is a representative of the class of things to which it belongs; as, a specimen of photography. A sample is a part of the thing itself, designed to show the quality of the whole; as, a sample of sugar or of broadcloth. A cabinet of minerals consists of specimens; if a part be broken off from any one of these, it is a sample of the mineral to which it belongs. \"Several persons have exhibited specimens of this art before multitudes of beholders.\" Addison. \"I design this but for a sample of what I hope more fully to discuss.\" Woodward.
speciosity |1. The quality or state of being specious; speciousness. Professions built so largely on speciosity, instead of performance. Carlyle. 2. That which is specious. Dr. H. More.
specious |1. Presenting a pleasing appearance; pleasing in form or look; showy. Some [serpents] specious and beautiful to the eye. Bp. Richardson. The rest, far greater part, Will deem in outward rites and specious forms Religion satisfied. Milton. 2. Apparently right; superficially fair, just, or correct, but not so in reality; appearing well at first view; plausible; as, specious reasoning; a specious argument. Misled for a moment by the specious names of religion, liberty, and property. Macaulay. In consequence of their greater command of specious expression. J. Morley. Syn. -- Plausible; showy; ostensible; colorable; feasible. See Plausible. -- Spe\"xious*ly, adv. -- Spe\"cious*ness, n.
speck |The blubber of whales or other marine mammals; also, the fat of the hippopotamus. Speck falls (Naut.), falls or ropes rove through blocks for hoisting the blubber and bone of whales on board a whaling vessel.\n\n1. A small discolored place in or on anything, or a small place of a color different from that of the main substance; a spot; a stain; a blemish; as, a speck on paper or loth; specks of decay in fruit. \"Gray sand, with black specks.\" Anson. 2. A very small thing; a particle; a mite; as, specks of dust; he has not a speck of money. Many bright specks bubble up along the blue Egean. Landor. 3. (Zoöl.)  A small etheostomoid fish (Ulocentra stigmæa) common in the Eastern United States.\n\nTo cause the presence of specks upon or in, especially specks regarded as defects or blemishes; to spot; to speckle; as, paper specked by impurities in the water used in its manufacture. Carnation, purple, azure, or specked with gold. Milton.
speckle |A little or spot in or anything, of a different substance or color from that of the thing itself. An huge great serpent, all with speckles pied. Spebser.\n\nTo mark with small spots of a different color from that of the rest of the surface; to variegate with spots of a different color from the ground or surface.
speckled |Marked or variegated with small spots of a different color from that of the rest of the surface. Speckled Indians (Ethnol.), the Pintos. -- Speckled trout. (Zoöl.) (a) The common American brook trout. See Trout. (b) The rainbow trout.
speckled-belly |The gadwall. [Local, U.S.]
speckled-bill |The American white-fronted goose (Anser albifrons).
speckledness |The quality of being speckled.
specksioneer |The chief harpooner, who also directs in cutting up the speck, or blubber; -- so called among whalers.
speckt |A woodpecker. See Speight.
spectacle |1. Something exhibited to view; usually, something presented to view as extraordinary, or as unusual and worthy of special notice; a remarkable or noteworthy sight; a show; a pageant; a gazingstock. O, piteous spectacle O, bloody times! Shak. 2. A spy-glass; a looking-glass. [Obs.] Poverty a spectacle is, as thinketh me, Through which he may his very friends see. Chaucer. 3. pl.  An optical instrument consisting of two lenses set in a light frame, and worn to assist sight, to obviate some defect in the organs of vision, or to shield the eyes from bright light. 4. pl.  Fig.: An aid to the intellectual sight. Shakespeare . . . needed not the spectacles of books to read nature. Dryden. Syn. -- Show; sight; exhibition; representation; pageant.
spectacled |1. Furnished with spectacles; wearing spectacles. As spectacled she sits in chimney nook. Keats. 2. (Zoöl.)  Having the eyes surrounded by color markings, or patches of naked skin, resembling spectacles. Spectacled bear (Zoöl.), a South American bear (Tremarclos ornatus) which inhabits the high mountains of Chili and Peru. It has a light-colored ring around each eye. -- Spectacled coot, or Spectacled duck (Zoöl.), the surf scoter, or surf duck. [Local, U.S.] -- Spectacled eider (Zoöl.) See Eider. -- Spectacled goose (Zoöl.), the gannet. -- Spectacled snake (Zoöl.), the cobra de capello.
spectacular |1. Of or pertaining to a shows; of the nature of a show. \"Spectacular sports.\" G. Hickes. 2. Adapted to excite wonder and admiration by a display of pomp or of scenic effects; as, a spectacular celebration of some event; a spectacular play. 3. Pertaining to spectacles, or glasses for the eyes.
spectant |Looking forward.
spectation |Regard; aspect; appearance. Harvey.
spectator |One who on; one who sees or beholds; a beholder; one who is personally present at, and sees, any exhibition; as, the spectators at a show. \"Devised and played to take spectators.\" Shak. Syn. -- Looker-on; beholder; observer; witness.
spectatorial |Of or pertaining to a spectator. Addison.
spectatorship |1. The office or quality of a spectator. [R.] Addison. 2. The act of beholding. [Obs.] Shak.
spectatress |A female beholder or looker-on. \"A spectatress of the whole scene.\" Jeffrey.
spectatrix |A female beholder or looker-on. \"A spectatress of the whole scene.\" Jeffrey.
specter |1. Something preternaturally visible; an apparition; a ghost; a phantom. The ghosts of traitors from the bridge descend, With bold fanatic specters to rejoice. Dryden. 2. (Zoöl.) (a) The tarsius. (b) A stick insect. Specter bat (Zoöl.), any phyllostome bat. -- Specter candle (Zoöl.), a belemnite. -- Specter shrimp (Zoöl.), a skeleton shrimp. See under Skeleton.
spectioneer |Same as Specsioneer.
spectral |1. Of or pertaining to a specter; ghosty. He that feels timid at the spectral form of evil is not the man to spread light. F. W. Robertson. 2. (Opt.)  Of or pertaining to the spectrum; made by the spectrum; as, spectral colors; spectral analysis. Spectral lemur. (Zoöl.) See Tarsius.
spectrally |In the form or manner of a specter.
spectre |1. Something preternaturally visible; an apparition; a ghost; a phantom. The ghosts of traitors from the bridge descend, With bold fanatic specters to rejoice. Dryden. 2. (Zoöl.) (a) The tarsius. (b) A stick insect. Specter bat (Zoöl.), any phyllostome bat. -- Specter candle (Zoöl.), a belemnite. -- Specter shrimp (Zoöl.), a skeleton shrimp. See under Skeleton.\n\nSee Specter.
spectrobolometer |A combination of spectroscope and bolometer for determining the distribution of energy in a spectrum. --Spec`tro*bo`lo*met\"ric (#), a.
spectroelectric |Pert. to or designating any form of spark tube the electric discharge within which is used in spectroscopic observations.
spectrogram |A photograph, map, or diagram of a spectrum.
spectrograph |(a) An apparatus for photographing or mapping a spectrum. (b) A photograph or picture of a spectrum. -- Spec`tro*graph\"ic (#), a. --Spec`tro*graph\"ic*al*ly (#), adv. --Spec*trog\"ra*phy (#), n.
spectroheliogram |A photograph of the sun made by monochromatic light, usually of the calcium line (k), and showing the sun's faculæ and prominences.
spectroheliograph |An apparatus for making spectroheliograms, consisting of a spectroscopic camera used in combination with a telescope, and provided with clockwork for moving the  sun's image across the slit. -- Spec`tro*he`li*o*graph\"ic (#), a.
spectrological |Of or pertaining to spectrology; as, spectrological studies or experiments. -- Spec`tro*log\"ic*al*ly, adv.
spectrology |The science of spectrum analysis in any or all of its relations and applications.
spectrometer |A spectroscope fitted for measurements of the luminious spectra observed with it.
spectrometry |Art or process of using the spectrometer, or of measuring wave lengths of rays of a spectrum. -- Spec`tro*met\"ric (#), a.
spectrophone |An instrument constructed on the principle of the photophone and used in spectrum analysis as an adjunct to the spectroscope. -- Spec`tro*phon\"ic (#), a.
spectrophotometer |An instrument for measuring or comparing the intensites of the colors of the spectrum.
spectrophotometry |The art of comparing, photometrically, the brightness of two spectra, wave length by wave length; the use of the spectrophotometer. --Spec`tro*pho`to*met\"ric (#), a.
spectroscope |An optical instrument for forming and examining spectra (as that of solar light, or those produced by flames in which different substances are volatilized), so as to determine, from the position of the spectral lines, the composition of the substance.
spectroscopic |Of or pertaining to a spectroscope, or spectroscopy. -- Spec`tro*scop\"ic*al*ly, adv.
spectroscopical |Of or pertaining to a spectroscope, or spectroscopy. -- Spec`tro*scop\"ic*al*ly, adv.
spectroscopist |One who investigates by means of a spectroscope; one skilled in the use of the spectroscope.
spectroscopy |The use of the spectroscope; investigations made with the spectroscope.
spectrum |1. An apparition; a specter. [Obs.] 2. (Opt.) (a) The several colored and other rays of which light is composed, separated by the refraction of a prism or other means, and observed or studied either as spread out on a screen, by direct vision, by photography, or otherwise. See Illust. of Light, and Spectroscope. (b) A luminous appearance, or an image seen after the eye has been exposed to an intense light or a strongly illuminated object. When the object is colored, the image appears of the complementary color, as a green image seen after viewing a red wafer lying on white paper. Called also ocular spectrum. Absorption spectrum, the spectrum of light which has passed through a medium capable of absorbing a portion of the rays. It is characterized by dark spaces, bands, or lines. -- Chemical spectrum, a spectrum of rays considered solely with reference to their chemical effects, as in photography. These, in the usual photogrophic methods, have their maximum influence at and beyond the violet rays, but are not limited to this region. -- Chromatic spectrum, the visible colored rays of the solar spectrum, exhibiting the seven principal colors in their order, and covering the central and larger portion of the space of the whole spectrum. -- Continous spectrum, a spectrum not broken by bands or lines, but having the colors shaded into each other continously, as that from an incandescent solid or liquid, or a gas under high pressure. -- Diffraction spectrum, a spectrum produced by diffraction, as by a grating. -- Gaseous spectrum, the spectrum of an incandesoent gas or vapor, under moderate, or especially under very low, pressure. It is characterized by bright bands or lines. -- Normal spectrum, a representation of a spectrum arranged upon conventional plan adopted as standard, especially a spectrum in which the colors are spaced proportionally to their wave lengths, as when formed by a diffraction grating. -- Ocular spectrum. See Spectrum, 2 (b), above. -- Prismatic spectrum, a spectrum produced by means of a prism. -- Solar spectrum, the spectrum of solar light, especially as thrown upon a screen in a darkened room. It is characterized by numerous dark lines called Fraunhofer lines. -- Spectrum analysis, chemical analysis effected by comparison of the different relative positions and qualities of the fixed lines of spectra produced by flames in which different substances are burned or evaporated, each substance having its own characteristic system of lines. -- Thermal spectrum, a spectrum of rays considered solely with reference to their heating effect, especially of those rays which produce no luminous phenomena.
specular |1. Having the qualities of a speculum, or mirror; having a smooth, reflecting surface; as, a specular metal; a specular surface. 2. (Med.)  Of or pertaining to a speculum; conducted with the aid of a speculum; as, a specular examination. 3. Assisting sight, as a lens or the like. [Obs.] Thy specular orb Apply to well-dissected kernels; lo! In each observe the slender threads Of first-beginning trees. J. Philips. 4. Affording view. [R.] \"Look once more, ere we leave this specular mount.\" Milton. Specular iron. (Min.) See Hematite.
speculate |1. To consider by turning a subject in the mind, and viewing it in its different aspects and relations; to meditate; to contemplate; to theorize; as, to speculate on questions in religion; to speculate on political events. It is remarkable that persons who speculate the most boldly often conform with the most pefect quietude to the external regulations of society. Hawthorne. 2. (Philos.)  To view subjects from certain premises given or assumed, and infer conclusions respecting them a priori. 3. (Com.)  To purchase with the expectation of a contingent advance in value, and a consequent sale at a profit; -- often, in a somewhat depreciative sense, of unsound or hazardous transactions; as, to speculate in coffee, in sugar, or in bank stock.\n\nTo consider attentively; as, to speculate the nature of a thing. [R.] Sir W. Hamilton.
speculation |1. The act of speculating. Specifically: -- (a) Examination by the eye; view. [Obs.] (b) Mental view of anything in its various aspects and relations; contemplation; intellectual examination. Thenceforth to speculations high or deep I turned my thoughts. Milton. (c) (Philos.)  The act or process of reasoning a priori from premises given or assumed. (d) (Com.) The act or practice of buying land, goods, shares, etc., in expectation of selling at a higher price, or of selling with the expectation of repurchasing at a lower price; a trading on anticipated fluctuations in price, as distinguished from trading in which the profit expected is the difference between the retail and wholesale prices, or the difference of price in different markets. 1 year) is considered investment. Sudden fortunes, indeed, are sometimes made in such places, by what is called the trade of speculation. A. Smith. Speculation, while confined within moderate limits, is the agent for equalizing supply and demand, and rendering the fluctuations of price less sudden and abrupt than they would otherwise be. F. A. Walker. (e) Any business venture in involving unusual risks, with a chance for large profits. 2. A conclusion to which the mind comes by speculating; mere theory; view; notion; conjecture. From him Socrates derived the principles of morality, and most part of his natural speculations. Sir W. temple. To his speculations on these subjects he gave the lofty name of the \"Oracles of Reason.\" Macaulay. 3. Power of sight. [Obs.] Thou hast no speculation in those eyes. Shak. 4. A game at cards in which the players buy from one another trumps or whole hands, upon a chance of getting the highest trump dealt, which entitles the holder to the pool of stakes.
speculatist |One who speculates, or forms theories; a speculator; a theorist. The very ingenious speculatist, Mr. Hume. V. Knox.
speculative |1. Given to speculation; contemplative. The mind of man being by nature speculative. Hooker. 2. Involving, or formed by, speculation; ideal; theoretical; not established by demonstration. Cudworth. 3. Of or pertaining to vision; also, prying; inquisitive; curious. [R.] Bacon. 4. Of or pertaining to speculation in land, goods, shares, etc.; as, a speculative dealer or enterprise. The speculative merchant exercises no one regular, established, or well-known branch of business. A. Smith. -- Spec\"u*la*tive*ly, adv. -- Spec\"u*la*tive*ness, n.
speculator |One who speculates. Specifically: (a) An observer; a contemplator; hence, a spy; a watcher. [Obs.] Sir T. Browne. (b) One who forms theories; a theorist. A speculator who had dared to affirm that the human soul is by nature mortal. Macaulay. (c) (Com.)  One who engages in speculation; one who buys and sells goods, land, etc., with the expectation of deriving profit from fluctuations in price.
speculatorial |Speculatory; speculative. [Obs.]
speculatory |1. Intended or adapted for viewing or espying; having oversight. T. Warton. 2. Exercising speculation; speculative. T. Carew.
speculist |One who observes or considers; an observer. [R.] Goldsmith.
speculum |1. A mirror, or looking-glass; especially, a metal mirror, as in Greek and Roman archæology. 2. A reflector of polished metal, especially one used in reflecting telescopes. See Speculum metal, below. 3. (Surg.)  An instrument for dilating certain passages of the body, and throwing light within them, thus facilitating examination or surgical operations. 4. (Zoöl.)  A bright and lustrous patch of color found on the wings of ducks and some other birds. It is usually situated on the distal portions of the secondary quills, and is much more brilliant in the adult male than in the female. Speculum metal, a hard, brittle alloy used for making the reflectors of telescopes and other instruments, usually consisting of copper and tin in various proportions, one of the best being that in which there are 126.4 parts of copper to 58.9 parts of tin, with sometimes a small proportion of arsenic, antimony, or zinc added to improve the whiteness.
sped |imp. & p. p. of Speed.
speece |Species; sort. [Obs.]
speech |1. The faculty of uttering articulate sounds or words; the faculty of expressing thoughts by words or articulate sounds; the power of speaking. There is none comparable to the variety of instructive expressions by speech, wherewith man alone is endowed for the communication of his thoughts. Holder. 2. he act of speaking; that which is spoken; words, as expressing ideas; language; conversation. Note: Speech is voice modulated by the throat, tongue, lips, etc., the modulation being accomplished by changing the form of the cavity of the mouth and nose through the action of muscles which move their walls. O goode God! how gentle and how kind Ye seemed by your speech and your visage The day that maked was our marriage. Chaucer. The acts of God . . . to human ears Can nort without process of speech be told. Milton. 3. A particular language, as distinct from others; a tongue; a dialect. People of a strange speech and of an hard language. Ezek. iii. 6. 4. Talk; mention; common saying. The duke . . . did of me demand What was the speech among the Londoners Concerning the French journey. Shak. 5. formal discourse in public; oration; harangue. The constant design of these orators, in all their speeches, was to drive some one particular point. Swift. 6. ny declaration of thoughts. I. with leave of speech implored, . . . replied. Milton. Syn. Harangue; language; address; oration. See Harangue, and Language.\n\nTo make a speech; to harangue. [R.]
speechful |Full of speech or words; voluble; loquacious. [R.]
speechification |The act of speechifying. [Used humorously or in contempt.]
speechifier |One who makes a speech or speeches; an orator; a declaimer. [Used humorously or in contempt.] G. Eliot.
speechify |To make a speech; to harangue. [Used derisively or humorously.]
speechifying |The act of making a speech or speeches. [Used derisively or humorously.] The dinner and speechifying . . . at the opening of the annual season for the buckhounds. M. Arnold.
speeching |The act of making a speech. [R.]
speechless |1. Destitute or deprived of the faculty of speech. 2. Not speaking for a time; dumb; mute; silent. Speechless with wonder, and half dead with fear. Addison. -- Speech\"less*ly, adv. -- Speech\"less*ness, n.
speechmaker |One who makes speeches; one accustomed to speak in a public assembly.
speed |1. Prosperity in an undertaking; favorable issue; success. \"For common speed.\" Chaucer. O Lord God of my master Abraham, I pray thee, send me good speed this day. Gen. xxiv. 12. 2. The act or state of moving swiftly; swiftness; velocity; rapidly; rate of motion; dispatch; as, the speed a horse or a vessel. Speed, to describe whose swiftness number fails. Milton. Note: In kinematics, speedis sometimes used to denote the amount of velocity without regard to direction of motion, while velocity is not regarded as known unless both the direction and the amount are known. 3. One who, or that which, causes or promotes speed or success. [Obs.] \"Hercules be thy speed!\" Shak. God speed, Good speed; prosperity. See Godspeed. -- Speed gauge, Speed indicator, and Speed recorder (Mach.), devices for indicating or recording the rate of a body's motion, as the number of revolutions of a shaft in a given time. -- Speed lathe (Mach.), a power lathe with a rapidly revolving spindle, for turning small objects, for polishing, etc.; a hand lathe. -- Speed pulley, a cone pulley with steps. Syn. -- Haste; swiftness; celerity; quickness; dispatch; expedition; hurry; acceleration. See Haste.\n\n1. To go; to fare. [Obs.] To warn him now he is too farre sped. Remedy of Love. 2. To experience in going; to have any condition, good or ill; to fare. Shak. Ships heretofore in seas lke fishes sped; The mightiest still upon the smallest fed. Waller. 3. To fare well; to have success; to prosper. Save London, and send true lawyers their meed! For whoso wants money with them shall not speed! Lydgate. I told ye then he should prevail, and speed On his bad errand. Milton. 4. To make haste; to move with celerity. I have speeded hither with the very extremest inch of possibility. Shak. 5. To be expedient. [Obs.] Wyclif (2 Cor. xii. 1.)\n\n1. To cause to be successful, or to prosper; hence, to aid; to favor. \"Fortune speed us!\" Shak. With rising gales that speed their happy flight. Dryden. 2. To cause to make haste; to dispatch with celerity; to drive at full speed; hence, to hasten; to hurry. He sped him thence home to his habitation. Fairfax. 3. To hasten to a conclusion; to expedite. Judicial acts . . . are sped in open court at the instance of one or both of the parties. Ayliffe. 4. To hurry to destruction; to put an end to; to ruin; to undo. \"Sped with spavins.\" Shak. A dire dilemma! either way I 'm sped. If foes, they write, if friends, they read, me dead. Pope. 5. To wish success or god fortune to, in any undertaking, especially in setting out upon a journey. Welkome the coming, speed the parting guest. Pope. God speed you, them, etc., may God speed you; or, may you have good speed. Syn. -- To depatch; hasten; expedite; accelerate; hurry.
speed counter |A device for automatically counting the revolutions or pulsations of an engine or other machine; -- called also simply counter.
speeder |1. One who, or that which, speeds. 2. (Spinning)  A machine for drawing and twisting slivers to form rovings.
speedful |Full of speed (in any sense). [Obs.]
speedfully |In a speedful manner. [Obs.]
speedily |In a speedy manner.
speediness |The quality or state of being speedy.
speedless |Being without speed.
speedwell |Any plant of the genus Veronica, mostly low herbs with pale blue corollas, which quickly fall off.
speedy |Not dilatory or slow; quick; swift; nimble; hasty; rapid in motion or performance; as, a speedy flight; on speedy foot. I will wish her speedy strength. Shak. Darts, which not the good could shun, The speedy ould outfly. Dryden.
speer |A sphere. [Obs.] Chaucer.\n\nTo ask. [Scot.] See Spere.
speet |To stab. [Obs.] Gammer Gurton's Needle.
speight |A woodpecker; -- called also specht, spekt, spight. [Obs. or Prov. Eng.]
speir |To ask. See Spere. Sir W. Scott.
speiskobalt |Smaltite.
speiss |A regulus consisting essentially of nickel, obtained as a residue in fusing cobalt and nickel ores with silica and sodium carbonate to make smalt.
spekboom |The purslane tree of South Africa, -- said to be the favorite food of elephants. Balfour (Cyc. of India).
speke |To speak. [Obs.] Chaucer.
spekehouse |The parlor or reception room of a convent. [Obs.]
spelding |A haddock or other small fish split open and dried in the sun; -- called also speldron. [Scot.]
spelicans |See Spilikin.
spelk |A small stick or rod used as a spike in thatching; a splinter. [Prov. Eng.] Grose.
spell |A spelk, or splinter. [Obs.] Holland.\n\nTo supply the place of for a time; to take the turn of, at work; to relieve; as, to spell the helmsman.\n\n1. The relief of one person by another in any piece of work or wathing; also, a turn at work which is carried on by one person or gang relieving another; as, a spellat the pumps; a spell at the masthead. A spell at the wheel isc called a trick. Ham. Nav. Encyc. 2. The time during which one person or gang works until relieved; hence, any relatively short period of time, whether a few hours, days, or weeks. Nothing new hass happened in this quarter, except the setting in of a severe spell of cold weather. Washington. 3. One of two or more persons or gangs who work by spells. [R.] Their toil is so extreme that they can not endure it above four hours in a day, but are succeeded by spells. Garew. 4. A gratuitous helping forward of another's work; as, a logging spell. [Local, U.S.]\n\n1. A story; a tale. [Obs.] \"Hearken to my spell.\" Chaucer. 2. A stanza, verse, or phrase supposed to be endowed with magical power; an incantation; hence, any charm. Start not; her actions shall be holy as You hear my spell is lawful. Shak.\n\n1. To tell; to relate; to teach. [Obs.] Might I that legend find, By fairies spelt in mystic rhymes. T. Warton. 2. To put under the influence of a spell; to affect by a spell; to bewitch; to fascinate; to charm. \"Spelled with words of power.\" Dryden. He was much spelled with Eleanor Talbot. Sir G. Buck. 3. To constitute; to measure. [Obs.] The Saxon heptarchy, when seven kings put together did spell but one in effect. Fuller. 4. To tell or name in their proper order letters of, as a word; to write or print in order the letters of, esp. the proper letters; to form, as words, by correct orthography. The word \"satire\" ought to be spelled with i, and not with y. Dryden. 5. To discover by characters or marks; to read with difficulty; -- usually with out; as, to spell out the sense of an author; to spell out a verse in the Bible. To spell out a God in the works of creation. South. To sit spelling and observing divine justice upon every accident. Milton.\n\n1. To form words with letters, esp. with the proper letters, either orally or in writing. When what small knowledge was, in them did dwell, And he a god, who could but read or spell. Dryden. 2. To study by noting characters; to gain knowledge or learn the meaning of anything, by study. [Obs.] Where I may sit and rightly spell Of every star that heaven doth shew, And every herb that sips the dew. Milton.
spellable |Capable of being spelt. Carlyle.
spellbind |To bind or hold by, or as if by, a spell or charm; to fascinate, esp. by eloquence of speech, as in a political campaign. - - Spell\"bind`er (#), n.
spellbound |Bound by, or as by, a spell.
speller |1. One who spells. 2. A spelling book. [U. S.]
spellful |Abounding in spells, or charms. Here, while his eyes the learned leaves peruse, Each spellful mystery explained he views. Hoole.
spelling |The act of one who spells; formation of words by letters; orthography.\n\nOf or pertaining to spelling. Spelling bee, a spelling match. [U.S.] -- Spelling book, a book with exercises for teaching children to spell; a speller. -- Spelling match, a contest of skill in spelling words, between two or more persons.
spellken |A theater. [Slang] Byron.
spellwork |Power or effect of magic; that which is wrought by magic; enchantment. Like those Peri isles of light That hang by spellwork in the air. Moore.
spelt |imp. & p. p. of Spell. Spelled.\n\nA species of grain (Triticum Spelta) much cultivated for food in Germany and Switzerland; -- called also German wheat.\n\nSpelter. [Colloq.]\n\nTo split; to break; to spalt. [Obs.] Mortimer.
spelter |Zinc; -- especially so called in commerce and arts.
spelunc |A cavern; a cave. [Obs.] Piers Plowman.
spence |1. A place where provisions are kept; a buttery; a larder; a pantry. Chiefly Brit. dial. [MW10] In . . . his spence, or \"pantry\" were hung the carcasses of a sheep or ewe, and two cows lately slaughtered. Sir W. Scott. Bluff Harry broke into the spence, And turned the cowls adrift. Tennyson. 2. The inner apartment of a country house; also, the place where the family sit and eat. [Scot.] Jamieson.
spencer |One who has the care of the spence, or buttery. [Obs.] Promptorium Parvulorum.\n\nA short jacket worn by men and by women. Ld. Lutton.\n\nA fore-and-aft sail, abaft the foremast or the mainmast, hoisted upon a small supplementary mast and set with a gaff and no boom; a trysail carried at the foremast or mainmast; -- named after its inventor, Knight Spencer, of England [1802]. Spencer mast, a small mast just abaft the foremast or mainmast, for hoisting the spencer. R. H. Dana, Jr.
spend |1. To weigh or lay out; to dispose of; to part with; as, to spend money for clothing. Spend thou that in the town. Shak. Wherefore do ye spend money for that which is not bread Isa. lv. 2. 2. To bestow; to employ; -- often with on or upon. I . . . am never loath To spend my judgment. Herbert. 3. To consume; to waste; to squander; to exhaust; as, to spend an estate in gaming or other vices. 4. To pass, as time; to suffer to pass away; as, to spend a day idly; to spend winter abroad. We spend our years as a tale that is told. Ps. xc. 9. 5. To exhaust of force or strength; to waste; to wear away; as, the violence of the waves was spent. Their bodies spent with long labor and thirst. Knolles.\n\n1. To expend money or any other possession; to consume, use, waste, or part with, anything; as, he who gets easily spends freely. He spends as a person who knows that he must come to a reckoning. South. 2. To waste or wear away; to be consumed; to lose force or strength; to vanish; as, energy spends in the using of it. The sound spendeth and is dissipated in the open air. Bacon. 3. To be diffused; to spread. The vines that they use for wine are so often cut, that their sap spendeth into the grapes. Bacon. 4. (Mining)  To break ground; to continue working.
spender |One who spends; esp., one who spends lavishly; a prodigal; a spendthrift.
spending |The act of expending; expenditure. Spending money, money set apart for extra (not necessary) personal expenses; pocket money. [Colloq.]
spendthrift |One who spends money profusely or improvidently; a prodigal; one who lavishes or wastes his estate. Also used figuratively. A woman who was a generous spendthrift of life. Mrs. R. H. Davis.\n\nProdigal; extravagant; wasteful.
spendthrifty |Spendthrift; prodigal. [R.]
spenserian |Of or pertaining to the English poet Spenser; -- specifically applied to the stanza used in his poem \"The Faërie Queene.\",
  "dissuasory |A dissuasive. [R.] This virtuous and reasonable person, however, has ill luck in all his dissuasories. Jeffrey.
spent |1. Exhausted; worn out; having lost energy or motive force. Now thou seest me Spent, overpowered, despairing of success. Addison. Heaps of spent arrows fall and strew the ground. Dryden. 2. (Zoöl.)  Exhausted of spawn or sperm; -- said especially of fishes. Spent ball, a ball shot from a firearm, which reaches an object without having sufficient force to penetrate it.
sper |To shut in; to support; to inclose; to fasten. [Obs.] \"To sperre the gate.\" Spenser.
sperable |Within the range of hpe; proper to be hoped for. [Obs.] Bacon.\n\nSee Sperable.
sperage |Asperagus. [Obs.] Sylvester.
sperate |Hoped for, or to be hoped for. [R.] Bouvier.
spere |To search; to pry; to ask; to inquire. [Prov. Eng. & Scot.] [Written also speer, speir.] Jamieson.\n\nA sphere. [Obs.] Chaucer.
sperge |A charge of wash for the still. Knight.
sperling |(a) A smelt; a sparling. [Prov. Eng.] (b) A young herring. [Local, U.S.]
sperm |The male fecundating fluid; semen. See Semen. Sperm cell (Physiol.), one of the cells from which the spermatozoids are developed. -- Sperm morula. (Biol.) Same as Spermosphere.\n\nSpermaceti. Sperm oil, a fatty oil found as a liquid, with spermaceti, in the head cavities of the sperm whale. -- Sperm whale. (Zoöl.) See in the Vocabulary.
sperm whale |A very large toothed whale (Physeter macrocephalus), having a head of enormous size. The upper jaw is destitute of teeth. In the upper part of the head, above the skull, there is a large cavity, or case, filled with oil and spermaceti. This whale sometimes grows to the length of more than eighty feet. It is found in the warmer parts of all the oceans. Called also cachalot, and spermaceti whale. Pygmy sperm whale (Zoöl.), a small whale (Kogia breviceps), seldom twenty feet long, native of tropical seas, but occasionally found on the American coast. Called also snub-nosed cachalot. -- Sperm-whale porpoise (Zoöl.), a toothed cetacean (Hyperoödon bidens), found on both sides of the Atlantic and valued for its oil. The adult becomes about twenty-five feet long, and its head is very large and thick. Called also bottle-nosed whale.
spermaceti |A white waxy substance obtained from cavities in the head of the sperm whale, and used making candles, oilments, cosmetics, etc. It consists essentially of ethereal salts of palmitic acid with ethal and other hydrocarbon bases. The substance of spermaceti after the removal of certain impurities is sometimes called cetin. Spermaceti whale (Zoöl.), the sperm whale.
spermalist |See Spermist.
spermaphore |That part of the ovary from which the ovules arise; the placenta.
spermary |An organ in which spermatozoa are developed; a sperm gland; a testicle.
spermatheca |A small sac connected with the female reproductive organs of insects and many other invertebrates, serving to receive and retain the spermatozoa.
spermatic |Of or pertaining to semen; as, the spermatic fluid, the spermatic vessels, etc. Spermatic cord (Anat.), the cord which suspends the testicle within the scrotum. It is made up of a connective tissue sheath inclosing the spermatic duct and accompanying vessels and nerves.
spermatical |Spermatic.
spermatin |A substance allied to alkali albumin and to mucin, present in semen, to which it is said to impart the mucilaginous character.
spermatism |The emission of sperm, or semen.
spermatium |One of the motionless spermatozoids in the conceptacles of certain fungi. J. H. Balfour.
spermatize |To yield seed; to emit seed, or sperm. [Obs.] Sir T. Browne.
spermato- |Combining forms from Gr. seed, sperm, semen (of plants or animals); as, spermatoblast, spermoblast.
spermatoblast |Same as Spermoblast.
spermatocyte |Same as Spermoblast.
spermatogemma |Same as Spermosphere.
spermatogenesis |The development of the spermatozoids.
spermatogenetic |Relating to, or connected with, spermatogenesis; as, spermatogenetic function.
spermatogenous |Sperm-producing.
spermatogonium |A primitive seminal cell, occuring in masses in the seminal tubules. It divides into a mass (spermosphere) of small cells (spermoblast), which in turn give rise to spermatozoids.
spermatoid |Spermlike; resembling sperm, or semen.
spermatooen |A spermoblast. -- Sper`ma*to\"al, a. Owen.
spermatoon |A spermoblast. -- Sper`ma*to\"al, a. Owen.
spermatophore |1. (Physiol.)  Same as Spermospore. 2. (Zoöl.)  A capsule or pocket inclosing a number of spermatozoa. They are present in many annelids, brachiopods, mollusks, and crustaceans. In cephalopods the structure of the capsule is very complex.
spermatophorous |Producing seed, or sperm; seminiferous; as, the so-called spermatophorous cells.
spermatophyta |A phylum embracing the highest plants, or those that produce seeds; the  seed plants, or flowering plants. They form the most numerous group, including over 120,000 species. In general, the group is characterized by the marked development of the sporophyte, with great differentiation of its parts (root, stem, leaves, flowers, etc.); by the extreme reduction of the gametophyte; and by the development of seeds. All the Spermatophyta are heterosporous; fertilization of the egg cell is either through a pollen tube emitted by the microspore or (in a few gymnosperms) by spermatozoids. The phrase \"flowering plants\" is less distinctive than \"seed plants,\" since the conifers, grasses, sedges, oaks, etc., do not produce flowers in the popular sense. For this reason the terms Anthrophyta, Phænogamia, and Panerogamia have been superseded as names of the phylum by Spermatophyta.
spermatophyte |Any plant of the phylum Spermatophyta. -- Sper`ma*to*phyt\"ic (#), a.
spermatorrhea |Abnormally frequent involuntary emission of the semen without copulation.
spermatorrhoea |Abnormally frequent involuntary emission of the semen without copulation.
spermatospore |Same as Spermospore.
spermatozoid |The male germ cell in animals and plants, the essential element in fertilization; a microscopic animalcule-like particle, usually provided with one or more cilia by which it is capable of active motion. In animals, the familiar type is that of a small, more or less ovoid head, with a delicate threadlike cilium, or tail. Called also spermatozoön. In plants the more usual term is antherozoid.
spermatozooen |Same as Spermatozoid.
spermatozooid |A spermatozoid.
spermatozoon |Same as Spermatozoid.
spermic |Of or pertaining to sperm, or semen.
spermidium |An achenium.
spermism |The theory, formerly held by many, that the sperm or spermatozoön contains the germ of the future embryo; animalculism.
spermist |A believer in the doctrine, formerly current, of encasement in the male (see Encasement), in which the seminal thread, or spermatozoid, was considered as the real animal germ, the head being the true animal head and the tail the body.
spermo- |Combining forms from Gr. seed, sperm, semen (of plants or animals); as, spermatoblast, spermoblast.
spermoblast |One of the cells formed by the diivision of the spermospore, each of which is destined to become a spermatozoid; a spermatocyte; a spermatoblast.
spermococcus |The nucleus of the sperm cell.
spermoderm |The covering of a seed; -- sometimes limited to the outer coat or testa. Lindley.
spermogonium |A conceptacle of certain lichens, which contains spermatia.
spermologist |One who treats of, or collects, seeds. Bailey.
spermophile |Any ground squirrel of the genus Spermophilus; gopher. See Illust. under Gopher.
spermophore |A spermatophore.
spermophyta |Plants which produce seed; phænogamia. These plants constitute the highest grand division of the vegetable kingdom.
spermophyte |Any plant which produces true seeds; -- a term recently proposed to replace phænogam.
spermophytic |Capable of producing seeds; phænogamic.
spermoplasma |The protoplasm of the sperm cell. Haeckel.
spermosphere |A mass or ball of cells formed by the repeated division of a male germinal cell (spermospore), each constituent cell (spermoblast) of which is converted into a spermatozoid; a spermatogemma.
spermospore |The male germinal or seminal cell, from the breaking up of which the spermoblasts are formed and ultimately the spermatozoids; a spermatospore. Balfour.
spermule |A sperm cell. Haeckel.
sperre |To shut in; to support; to inclose; to fasten. [Obs.] \"To sperre the gate.\" Spenser.
sperrylite |An arsenide of platinum occuring in grains and minute isometric crystals of tin-white color. It is found near Sudbury, Ontario Canada, and is the only known compound of platinum occuring in nature.
sperse |To disperse. [Obs.] Spenser.
spessartite |A manganesian variety of garnet.
spet |To spit; to throw out. [Obs.]\n\nSpittle. [Obs.]
spetches |Parings and refuse of hides, skins, etc., from which glue is made.
spew |1. To eject from the stomach; to vomit. 2. To cast forth with abhorrence or disgust; to eject. Because thou art lukewarm, and neither hot nor cold, I will spew thee out of my mouth. Rev. ii. 16.\n\n1. To vomit. Chaucer. 2. To eject seed, as wet land swollen with frost.\n\nThat which is vomited; vomit.
spewer |One who spews.
spewiness |The state of being spewy.
spewy |Wet; soggy; inclined to spew.
sphacel |Gangrene.
sphacelate |To die, decay, or become gangrenous, as flesh or bone; to mortify.\n\nTo affect with gangrene.\n\nAffected with gangrene; mortified.
sphacelated |Affected with gangrene; mortified.
sphacelation |The process of becoming or making gangrenous; mortification.
sphacelus |Gangrenous part; gangrene; slough.
sphaerenchyma |Vegetable tissue composed of thin-walled rounded cells, -- a modification of parenchyma.
sphaeridium |A peculiar sense organ found upon the exterior of most kinds of sea urchins, and consisting of an oval or sherical head surmounting a short pedicel. It is generally supposed to be an olfactory organ.
sphaerospore |One of the nonsexual spores found in red algæ; a tetraspore.
sphaerulite |Same as Spherulite.
sphagnicolous |Growing in moss of the genus Sphagnum.
sphagnous |Pertaining to moss of the genus Sphagnum, or bog moss; abounding in peat or bog moss.
sphagnum |A genus of mosses having white leaves slightly tinged with red or green and found growing in marshy places; bog moss; peat moss.
sphalerite |Zinc sulphide; -- called also blende, black-jack, false galena, etc. See Blende (a).
sphene |A mineral found usually in thin, wedge-shaped crystals of a yellow or green to black color. It is a silicate of titanium and calcium; titanite.
sphenethmoid |Of or pertaining to both the sphenoidal and the ethmoidal regions of the skull, or the sphenethmoid bone; sphenethmoidal. Sphenethmoid bone (Anat.), a bone of the skull which surrounds the anterior end of the brain in many amphibia; the girdle bone.\n\nThe sphenethmoid bone.
sphenethmoidal |Relating to the sphenoethmoid bone; sphenoethmoid.
spheniscan |Any species of penguin.
spheno- |A combining form used in anatomy to indicate connection with, or relation to, the sphenoid bone; as in sphenomaxillary, sphenopalatine.
sphenodon |Same as Hatteria.
sphenoethmoidal |Sphenethmoid.
sphenogram |A cuneiform, or arrow-headed, character.
sphenographer |One skilled in sphenography; a sphenographist.
sphenographic |Of or pertaining to sphenography.
sphenographist |A sphenographer.
sphenography |The art of writing in cuneiform characters, or of deciphering inscriptions made in such characters.
sphenoid |1. Wedge-shaped; as, a sphenoid crystal. 2. (Anat.)  Of or pertaining to the sphenoid bone. Sphenoid bone (Anat.), an irregularly shaped bone in front of the occipital in the base of the skull of the higher vertebrates. It is composed of several fetal bones which become united the adult. See Alisphenoid, Basisphenoid, Orbitosphenoid, Presphenoid.\n\n1. (Crystallog.)  A wedge-shaped crystal bounded by four equal isosceles triangles. It is the hemihedral form of a square pyramid. 2. (Anat.)  The sphenoid bone.
sphenoidal |1. Sphenoid. 2. (Crystalloq.)  Pertaining to, or resembling, a sphenoid.
sphenotic |Of, pertaining to, or designating, the sphenotic bone. Sphenotic bone (Anat.), a bone on the anterior side of the auditory capsule of many fishes, and connected with, or adjoining, the sphenoid bone.\n\nThe sphenotic bone.
spheral |1. Of or pertaining to a sphere or the spheres. 2. Rounded like a sphere; sphere-shaped; hence, symmetrical; complete; perfect.
sphere |1. (Geom.)  A body or space contained under a single surface, which in every part is equally distant from a point within called its center. 2. Hence, any globe or globular body, especially a celestial one, as the sun, a planet, or the earth. Of celestial bodies, first the sun, A mighty sphere, he framed. Milton. 3. (Astron.) (a) The apparent surface of the heavens, which is assumed to be spherical and everywhere equally distant, in which the heavenly bodies appear to have their places, and on which the various astronomical circles, as of right ascension and declination, the equator, ecliptic, etc., are conceived to be drawn; an ideal geometrical sphere, with the astronomical and geographical circles in their proper positions on it. (b) In ancient astronomy, one of the concentric and eccentric revolving spherical transparent shells in which the stars, sun, planets, and moon were supposed to be set, and by which they were carried, in such a manner as to produce their apparent motions. 4. (Logic)  The extension of a general conception, or the totality of the individuals or species to which it may be applied. 5. Circuit or range of action, knowledge, or influence; compass; province; employment; place of existence. To be called into a huge sphere, and not to be seen to move in 't. Shak. Taking her out of the ordinary relations with humanity, and inclosing her in a sphere by herself. Hawthorne. Each in his hidden sphere of joy or woe Our hermit spirits dwell. Keble. 6. Rank; order of society; social positions. 7. An orbit, as of a star; a socket. [R.] Shak. Armillary sphere, Crystalline sphere, Oblique sphere,. See under Armillary, Crystalline,. -- Doctrine of the sphere, applications of the principles of spherical trigonometry to the properties and relations of the circles of the sphere, and the problems connected with them, in astronomy and geography, as to the latitudes and longitudes, distance and bearing, of places on the earth, and the right ascension and declination, altitude and azimuth, rising and setting, etc., of the heavenly bodies; spherical geometry. -- Music of the spheres. See under Music. Syn. -- Globe; orb; circle. See Globe.\n\n1. To place in a sphere, or among the spheres; to insphere. The glorious planet Sol In noble eminence enthroned and sphered Amidst the other. Shak. 2. To form into roundness; to make spherical, or spheral; to perfect. Tennyson.
spheric |1. Having the form of a sphere; like a sphere; globular; orbicular; as, a spherical body. 2. Of or pertaining to a sphere. 3. Of or pertaining to the heavenly orbs, or to the sphere or spheres in which, according to ancient astronomy and astrology, they were set. Knaves, thieves, and treachers by spherical predominance. Shak. Though the stars were suns, and overburned Their spheric limitations. Mrs. Browning. Spherical angle, Spherical coördinate, Spherical excess, etc. See under Angle, Coordinate, etc. -- Spherical geometry, that branch of geometry which treats of spherical magnitudes; the doctrine of the sphere, especially of the circles described on its surface. -- Spherical harmonic analysis. See under Harmonic, a. -- Spherical lune,portion of the surface of a sphere included between two great semicircles having a common diameter. -- Spherical opening, the magnitude of a solid angle. It is measured by the portion within the solid angle of the surface of any sphere whose center is the angular point. -- Spherical polygon,portion of the surface of a sphere bounded by the arcs of three or more great circles. -- Spherical projection, the projection of the circles of the sphere upon a plane. See Projection. -- Spherical sector. See under Sector. -- Spherical segment, the segment of a sphere. See under Segment. -- Spherical triangle,re on the surface of a sphere, bounded by the arcs of three great circles which intersect each other. -- Spherical trigonometry. See Trigonometry. -- Spher\"ic*al*ly, adv. -- Spher\"ic*al*ness, n.
spherical |1. Having the form of a sphere; like a sphere; globular; orbicular; as, a spherical body. 2. Of or pertaining to a sphere. 3. Of or pertaining to the heavenly orbs, or to the sphere or spheres in which, according to ancient astronomy and astrology, they were set. Knaves, thieves, and treachers by spherical predominance. Shak. Though the stars were suns, and overburned Their spheric limitations. Mrs. Browning. Spherical angle, Spherical coördinate, Spherical excess, etc. See under Angle, Coordinate, etc. -- Spherical geometry, that branch of geometry which treats of spherical magnitudes; the doctrine of the sphere, especially of the circles described on its surface. -- Spherical harmonic analysis. See under Harmonic, a. -- Spherical lune,portion of the surface of a sphere included between two great semicircles having a common diameter. -- Spherical opening, the magnitude of a solid angle. It is measured by the portion within the solid angle of the surface of any sphere whose center is the angular point. -- Spherical polygon,portion of the surface of a sphere bounded by the arcs of three or more great circles. -- Spherical projection, the projection of the circles of the sphere upon a plane. See Projection. -- Spherical sector. See under Sector. -- Spherical segment, the segment of a sphere. See under Segment. -- Spherical triangle,re on the surface of a sphere, bounded by the arcs of three great circles which intersect each other. -- Spherical trigonometry. See Trigonometry. -- Spher\"ic*al*ly, adv. -- Spher\"ic*al*ness, n.
sphericity |The quality or state of being spherial; roundness; as, the sphericity of the planets, or of a drop of water.
sphericle |A small sphere.
spherics |The doctrine of the sphere; the science of the properties and relations of the circles, figures, and other magnitudes of a sphere, produced by planes intersecting it; spherical geometry and trigonometry.
spherobacteria |See the Note under Microbacteria.
spheroconic |A nonplane curve formed by the intersection of the surface of an oblique cone with the surface of a sphere whose center is at the vertex of the cone.
spherograph |An instrument for facilitating the practical use of spherics in navigation and astronomy, being constructed of two cardboards containing various circles, and turning upon each other in such a manner that any possible spherical triangle may be readily found, and the measures of the parts read off by inspection.
spheroid |A body or figure approaching to a sphere, but not perfectly spherical; esp., a solid generated by the revolution of an ellipse about one of its axes. Oblate spheroid, Prolate spheroid. See Oblate, Prolate, and Ellipsoid.
spheroidal |Having the form of a spheroid. -- Sphe*roid\"al*ly, adv. Spheroidal state (Physics.), the state of a liquid, as water, when, on being thrown on a surface of highly heated metal, it rolls about in spheroidal drops or masses, at a temperature several degrees below ebullition, and without actual contact with the heated surface, -- a phenomenon due to the repulsive force of heat, the intervention of a cushion of nonconducting vapor, and the cooling effect of evaporation.
spheroidic |See Spheroidal. Cheyne.
spheroidical |See Spheroidal. Cheyne.
spheroidicity |The quality or state of being spheroidal.
spheroidity |The quality or state of being spheroidal.
spheromere |Any one of the several symmetrical segments arranged around the central axis and composing the body of a radiate anmal.
spherometer |An instrument for measuring the curvature of spherical surface, as of lenses for telescope, etc.
spherosiderite |Siderite occuring in spheroidal masses.
spherosome |The body wall of any radiate animal.
spherulate |Covered or set with spherules; having one or more rows of spherules, or minute tubercles.
spherule |A little sphere or spherical body; as, quicksilver, when poured upon a plane, divides itself into a great number of minute spherules.
spherulite |A minute spherical crystalline body having a radiated structure, observed in some vitreous volcanic rocks, as obsidian and pearlstone.
spherulitic |Of or pertaining to a spherulite; characterized by the presence of spherulites.
sphery |1. Round; spherical; starlike. [R.] \"Hermia's sphery eyne.\" Shak. 2. Of or pertaining to the spheres. [R.] She can teach ye how to climb Higher than the sphery chime. Milton.
sphex |Any one of numerous species of sand wasps of the genus Sphex and allied genera. These wasps have the abdomen attached to the thorax by a slender pedicel. See Illust. of Sand wasp, under Sand. Sphex fly (Zoöl.), any one of numerous species of small dipterous flies of the genus Conops and allied genera. The form of the body is similar to that of a sphex.
sphigmometer |See Sphygmometer.
sphincter |A muscle which surrounds, and by its contraction tends to close, a natural opening; as, the sphincter of the bladder.\n\nOf, pertaining to, or designating, a sphincter; as, a sphincter muscle.
sphingid |A sphinx.\n\nOf or pertaining to a sphinx, or the family Sphingidæ.
sphinx |1. (a) In Egyptian art, an image of granite or porphyry, having a human head, or the head of a ram or of a hawk, upon the wingless body of a lion. The awful ruins of the days of old . . . Or jasper tomb, or mutilated sphinx. Shelley. (b) On Greek art and mythology, a she-monster, usually represented as having the winged body of a lion, and the face and breast of a young woman. Note: The most famous Grecian sphinx, that of Thebes in Boeotia, is said to have proposed a riddle to the Thebans, and killed those who were unable to guess it. The enigma was solved by \"Subtle as sphinx.\" Shak. 2. Hence: A person of enigmatical character and purposes, especially in politics and diplomacy. 3. (Zoöl.)  Any one of numerous species of large moths of the family Sphingidæ; -- called also hawk moth. Note: The larva is a stout naked caterpillar which, when at rest, often assumes a position suggesting the Egyptian sphinx, whence the name. 4. (Zoöl.)  The Guinea, or sphinx, baboon (Cynocephalus sphinx). Sphinx baboon (Zoöl.), a large West African baboon (Cynocephalus sphinx), often kept in menageries. -- Sphinx moth. (Zoöl.) Same as Sphinx, 3.
sphragide |Lemnian earth.
sphragistics |The science of seals, their history, age, distinctions, etc., esp. as verifying the age and genuiness of documents.
sphrigosis |A condition of vegetation in which there is too abundant growth of the stem and leaves, accompanied by deficiency of flowers and fruit.
sphygmic |Of or pertaining to the pulse.
sphygmogram |A tracing, called a pulse tracing, consisting of a series of curves corresponding with the beats of the heart, obtained by the application of the sphygmograph.
sphygmograph |An instrument which, when applied over an artery, indicates graphically the movements or character of the pulse. See Sphygmogram.
sphygmographic |Relating to, or produced by, a sphygmograph; as, a sphygmographic tracing.
sphygmometer |An instrument for measuring the strength of the pulse beat; a sphygmograph.
sphygmophone |An electrical instrument for determining by the ear the rhythm of the pulse of a person at a distance.
sphygmoscope |Same as Sphygmograph.
sphyraenoid |Of or pertaining to the Sphyrænidæ, a family of marine fishes including the barracudas.
spial |A spy; a scout. [Obs.] Bacon.
spica |1. (Med.)  A kind of bandage passing, by successive turns and crosses, from an extremity to the trunk; -- so called from its resemblance to a spike of a barley. 2. (Astron.)  A star of the first magnitude situated in the constellation Virgo.
spicate |Having the form of a spike, or ear; arranged in a spike or spikes. Lee.
spicated |Having the form of a spike, or ear; arranged in a spike or spikes. Lee.
spiccato |Detached; separated; -- a term indicating that every note is to be performed in a distinct and pointed manner.
spice |1. Species; kind. [Obs.] The spices of penance ben three. Chaucer. Abstain you from all evil spice. Wyclif (1. Thess,v. 22). Justice, although it be but one entire virtue, yet is described in two kinds of spices. The one is named justice distributive, the other is called commutative. Sir T. Elyot. 2. A vegetable production of many kinds, fragrant or aromatic and pungent to the taste, as pepper, cinnamon, nutmeg, mace, allspice, ginger, cloves, etc., which are used in cookery and to flavor sauces, pickles, etc. Hast thou aught in thy purse [bag] any hot spices Piers Plowman. 3. Figuratively, that which enriches or alters the quality of a thing in a small degree, as spice alters the taste of food; that which gives zest or pungency; a slight flavoring; a relish; hence, a small quantity or admixture; a sprinkling; as, a spice of mischief. So much of the will, with a spice of the willful. Coleridge.\n\n1. To season with spice, or as with spice; to mix aromatic or pungent substances with; to flavor; to season; as, to spice wine; to spice one's words with wit. She 'll receive thee, but will spice thy bread With flowery poisons. Chapman. 2. To fill or impregnate with the odor of spices. In the spiced Indian air, by night. Shak. 3. To render nice or dainty; hence, to render scrupulous. [Obs.] \"A spiced conscience.\" Chaucer.
spicebush |Spicewood.
spicenut |A small crisp cake, highly spiced.
spicer |1. One who seasons with spice. 2. One who deals in spice. [Obs.] Piers Plowman.
spicery |1. Spices, in general. Chaucer. 2. A repository of spices. Addison.
spicewood |An American shrub (Lindera Benzoin), the bark of which has a spicy taste and odor; -- called also Benjamin, wild allspice, and fever bush.
spiciferous |Bearing ears, or spikes; spicate. [Obs.] Bailey.
spiciform |Spike-shaped. Gray.
spicily |In a spicy manner.
spiciness |The quality or state of being spicy.
spick |A spike or nail. [Prov. Eng.] Spick and span, quite new; that is, as new as a spike or nail just made and a chip just split; brand- new; as, a spick and span novelty. See Span-new. Howell.
spicknel |An umbelliferous herb (Meum Athamanticum) having finely divided leaves, common in Europe; -- called also baldmoney, mew, and bearwort. [Written also spignel.]
spicose |Having spikes, or ears, like corn spikes.
spicosity |The state of having, or being full of, ears like corn. [R.] Bailey.
spicous |See Spicose.
spicula |(a) A little spike; a spikelet. (b) A pointed fleshy appendage.
spicular |Resembling a dart; having sharp points.
spiculate |1. Covered with, or having, spicules. 2. (Bot.)  Covered with minute spiculæ, or pointed fleshy appendages; divided into small spikelets.\n\nTo sharpen to a point. [R.] \"With spiculated paling.\" Mason.
spicule |1. A minute, slender granule, or point. 2. (Bot.)  Same as Spicula. 3. (Zoöl.)  Any small calcareous or siliceous body found in the tissues of various invertebrate animals, especially in sponges and in most Alcyonaria. Note: Spicules vary exceedingly in size and shape, and some of those found in siliceous sponges are very complex in structure and elegant in form. They are of great use in classification. Description of the Illustration: a Acerate; b Tricurvate, or Bowshaped; c d Hamate; e Broomshaped; f Scepterellate; g Spinispirulate; h Inequi-anchorate; i Sexradiate; j A Trichite Sheaf; k Six-rayed Capitate; l Rosette of Esperia; m Equi- anchorate.
spiculiform |Having the shape of a spicule.
spiculigenous |Producing or containing spicules.
spiculispongiae |A division of sponges including those which have independent siliceous spicules.
spiculum |Same as Spicule.
spicy |1. Flavored with, or containing, spice or spices; fragrant; aromatic; as, spicy breezes. \"The spicy nut-brown ale.\" Milton. Led by new stars, and borne by spicy gales. Pope. 2. Producing, or abounding with, spices. In hot Ceylon spicy forests grew. Dryden. 3. Fig.: Piquant; racy; as, a spicy debate. Syn. -- Aromatic; fragrant; smart; pungent; pointed; keen. See Racy.
