stirless |Without stirring; very quiet; motionless. \"Lying helpless and stirless.\" Hare.
stirp |Stock; race; family. [Obs.] Bacon.
stirpiculture |The breeding of special stocks or races.
stirps |1. (Law)  Stock; race; family. Blackstone. 2. (Bot.)  A race, or a fixed and permanent variety.
stirrage |The act of stirring; stir; commotion. [Obs.] T. Granger.
stirrer |One who, or that which, stirs something; also, one who moves about, especially after sleep; as, an early stirrer. Shak. Stirrer up, an instigator or inciter. Atterbury.
stirring |Putting in motion, or being in motion; active; active in business; habitually employed in some kind of business; accustomed to a busy life. A more stirring and intellectual age than any which had gone before it. Southey. Syn. -- Animating; arousing; awakening; stimulating; quickening; exciting.
stirrup |1. A kind of ring, or bent piece of metal, wood, leather, or the like, horizontal in one part for receiving the foot of a rider, and attached by a strap to the saddle, -- used to assist a person in mounting a horse, and to enable him to sit steadily in riding, as well as to relieve him by supporting a part of the weight of the body. Our host upon his stirpoes stood anon. Chaucer. 2. (Carp. & Mach.)  Any piece resembling in shape the stirrup of a saddle, and used as a support, clamp, etc. See Bridle iron. 3. (Naut.)  A rope secured to a yard, with a thimble in its lower end for supporting a footrope. Totten. Stirrup bone (Anat.), the stapes. -- Stirrup cup, a parting cup taken after mounting. -- Stirrup iron, an iron stirrup. -- Stirrup leather, or Stirrup strap, the strap which attaches a stirrup to the saddle. See Stirrup, 1.
stirt |Started; leaped. They privily be stirt into a well. Chaucer.
stirte |imp. of Start, v. i. & t. Chaucer.
stitch |1. A single pass of a needle in sewing; the loop or turn of the thread thus made. 2. A single turn of the thread round a needle in knitting; a link, or loop, of yarn; as, to let down, or drop, a stitch; to take up a stitch. 3. Etym: [Cf. OE. sticche, stecche, stucche, a piece, AS. stycce. Cf. Stock.]  A space of work taken up, or gone over, in a single pass of the needle; hence, by extension, any space passed over; distance. You have gone a good stitch. Bunyan. In Syria the husbandmen go lightly over with their plow, and take no deep stitch in making their furrows. Holland. 4. A local sharp pain; an acute pain, like the piercing of a needle; as, a stitch in the side. He was taken with a cold and with stitches, which was, indeed, a pleurisy. Bp. Burnet. 5. A contortion, or twist. [Obs.] If you talk, Or pull your face into a stitch again, I shall be angry. Marston. 6. Any least part of a fabric or dress; as, to wet every stitch of clothes. [Colloq.] 7. A furrow. Chapman. Chain stitch, Lock stitch. See in the Vocabulary. -- Pearl, or Purl stitch. See 2nd Purl, 2.\n\n1. To form stitches in; especially, to sew in such a manner as to show on the surface a continuous line of stitches; as, to stitch a shirt bosom. 2. To sew, or unite together by stitches; as, to stitch printed sheets in making a book or a pamphlet. 3. (Agric.)  To form land into ridges. To stitch up, to mend or unite with a needle and thread; as, to stitch up a rent; to stitch up an artery.\n\nTo practice stitching, or needlework.
stitchel |A kind of hairy wool. [Prov.]
stitcher |One who stitches; a seamstress.
stitchery |Needlework; -- in comtempt. Shak.
stitching |1. The act of one who stitches. 2. Work done by sewing, esp. when a continuous line of stitches is shown on the surface; stitches, collectively.
stitchwort |See Stichwort.
stith |Strong; stiff; rigid. [Obs. or Prov. Eng.]\n\nAn anvil; a stithy. [Obs. or Prov. Eng.] He invented also pincers, hammers, iron crows, and the anvil, or stith. Holland.
stithy |1. An anvil. Sir W. Scott. 2. A smith's shop; a smithy; a smithery; a forge. \"As foul as Vulcan's stithy.\" Shak.\n\nTo forge on an anvil. The forge that stithied Mars his helm. Shak.
stive |To stuff; to crowd; to fill full; hence, to make hot and close; to render stifling. Sandys. His chamber was commonly stived with friends or suitors of one kind or other. Sir H. Wotton.\n\nTo be stifled or suffocated.\n\nThe floating dust in flour mills caused by the operation or grinding. De Colange.
stiver |A Dutch coin, and money of account, of the value of two cents, or about one penny sterling; hence, figuratively, anything of little worth.
stives |Stews; a brothel. [Obs.] Chaucer.
stoak |To stop; to choke.
stoat |The ermine in its summer pelage, when it is reddish brown, but with a black tip to the tail. The name is sometimes applied also to other brown weasels.
stocah |A menial attendant. [Obs.] Spenser.
stoccade |See Stockade.
stoccado |A stab; a thrust with a rapier. Shak.
stochastic |Conjectural; able to conjecture. [Obs.] Whitefoot.
stock |1. The stem, or main body, of a tree or plant; the fixed, strong, firm part; the trunk. Though the root thereof wax old in the earth, and the stock thereof die in the ground, yet through the scent of water it will bud, and bring forth boughs like a plant. Job xiv. 8,9. 2. The stem or branch in which a graft is inserted. The scion overruleth the stock quite. Bacon. 3. A block of wood; something fixed and solid; a pillar; a firm support; a post. All our fathers worshiped stocks and stones. Milton. Item, for a stock of brass for the holy water, seven shillings; which, by the canon, must be of marble or metal, and in no case of brick. Fuller. 4. Hence, a person who is as dull and lifeless as a stock or post; one who has little sense. Let's be no stoics, nor no stocks. Shak. 5. The principal supporting part; the part in which others are inserted, or to which they are attached. Specifically: -- (a) The wood to which the barrel, lock, etc., of a musket or like firearm are secured; also, a long, rectangular piece of wood, which is an important part of several forms of gun carriage. (b) The handle or contrivance by which bits are held in boring; a bitstock; a brace. (c) (Joinery) The block of wood or metal frame which constitutes the body of a plane, and in which the plane iron is fitted; a plane stock. (d) (Naut.) The wooden or iron crosspiece to which the shank of an anchor is attached. See Illust. of Anchor. (e) The support of the block in which an anvil is fixed, or of the anvil itself. (f) A handle or wrench forming a holder for the dies for cutting screws; a diestock. (g) The part of a tally formerly struck in the exchequer, which was delivered to the person who had lent the king money on account, as the evidence of indebtedness. See Counterfoil. [Eng.] 6. The original progenitor; also, the race or line of a family; the progenitor of a family and his direct descendants; lineage; family. And stand betwixt them made, when, severally, All told their stock. Chapman. Thy mother was no goddess, nor thy stock From Dardanus. Denham. 7. Money or capital which an individual or a firm employs in business; fund; in the United States, the capital of a bank or other company, in the form of transferable shares, each of a certain amount; money funded in government securities, called also the public funds; in the plural, property consisting of shares in joint-stock companies, or in the obligations of a government for its funded debt; -- so in the United States, but in England the latter only are called stocks, and the former shares. 8. (Bookkeeping)  Same as Stock account, below. 9. Supply provided; store; accumulation; especially, a merchant's or manufacturer's store of goods; as, to lay in a stock of provisions. Add to that stock which justly we bestow. Dryden. 10. (Agric.)  Domestic animals or beasts collectively, used or raised on a farm; as, a stock of cattle or of sheep, etc.; -- called also live stock. 11. (Card Playing)  That portion of a pack of cards not distributed to the players at the beginning of certain games, as gleek, etc., but which might be drawn from afterward as occasion required; a bank. I must buy the stock; send me good cardings. Beau. & Fl. 12. A thrust with a rapier; a stoccado. [Obs.] 13. Etym: [Cf. Stocking.]  A covering for the leg, or leg and foot; as, upper stocks (breeches); nether stocks (stockings). [Obs.] With a linen stock on one leg. Shak. 14. A kind of stiff, wide band or cravat for the neck; as, a silk stock. 15. pl.  A frame of timber, with holes in which the feet, or the feet and hands, of criminals were formerly confined by way of punishment. He shall rest in my stocks. Piers Plowman. 16. pl. (Shipbuilding)  The frame or timbers on which a ship rests while building. 17. pl.  Red and gray bricks, used for the exterior of walls and the front of buildings. [Eng.] 18. (Bot.)  Any cruciferous plant of the genus Matthiola; as, common stock (Matthiola incana) (see Gilly-flower); ten-weeks stock (M. annua). 19. (Geol.)  An irregular metalliferous mass filling a large cavity in a rock formation, as a stock of lead ore deposited in limestone. 20. A race or variety in a species. 21. (Biol.)  In tectology, an aggregate or colony of persons (see Person), as trees, chains of salpæ, etc. 22. The beater of a fulling mill. Knight. 23. (Cookery)  A liquid or jelly containing the juices and soluble parts of meat, and certain vegetables, etc., extracted by cooking; -- used in making soup, gravy, etc. Bit stock. See Bitstock. -- Dead stock (Agric.), the implements of husbandry, and produce stored up for use; -- in distinction from live stock, or the domestic animals on the farm. See def. 10, above. -- Head stock. See Headstock. -- Paper stock, rags and other material of which paper is made. -- Stock account (Bookkeeping), an account on a merchant's ledger, one side of which shows the original capital, or stock, and the additions thereto by accumulation or contribution, the other side showing the amounts withdrawn. -- Stock car, a railway car for carrying cattle. -- Stock company (Com.), an incorporated company the capital of which is represented by marketable shares having a certain equal par value. -- Stock duck (Zoöl.), the mallard. -- Stock exchange. (a) The building or place where stocks are bought and sold; stock market; hence, transactions of all kinds in stocks. (b) An association or body of stockbrokers who meet and transact business by certain recognized forms, regulations, and usages. Wharton. Brande & C. -- Stock farmer, a farmer who makes it his business to rear live stock. -- Stock gillyflower (Bot.), the common stock. See Stock, n., 18. -- Stock gold, gold laid up so as to form a stock, or hoard. -- Stock in trade, the goods kept for sale by a shopkeeper; the fittings and appliances of a workman. Simmonds. -- Stock list, a list of stocks, or shares, dealt in, of transactions, and of prices. -- Stock lock, a lock inclosed in a wooden case and attached to the face of a door. -- Stock market. (a) A place where stocks are bought and sold; the stock exchange. (b) A market for live stock. -- Stock pigeon. (Zoöl.) Same as Stockdove. -- Stock purse. (a) A common purse, as distinguished from a private purse. (b) (Mil.) Moneys saved out of the expenses of a company or regiment, and applied to objects of common interest. [Eng.] -- Stock shave, a tool used by blockmakers. -- Stock station, a place or district for rearing stock. [Australia] W. Howitt. -- Stock tackle (Naut.), a tackle used when the anchor is hoisted and secured, to keep its stock clear of the ship's sides. Totten. -- Stock taking, an examination and inventory made of goods or stock in a shop or warehouse; -- usually made periodically. -- Tail stock. See Tailstock. -- To have something on the stock, to be at work at something. -- To take stock, to take account of stock; to make an inventory of stock or goods on hand. Dickens. -- To take stock in. (a) To subscribe for, or purchase, shares in a stock company. (b) To put faith in; to accept as trustworthy; as, to take stock in a person's fidelity. [Slang] -- To take stock of, to take account of the stock of; to take an inventory of; hence, to ascertain the facts in regard to (something). [Eng.] At the outset of any inquiry it is proper to take stock of the results obtained by previous explorers of the same field. Leslie Stephen. Syn. -- Fund; capital; store; supply; accumulation; hoard; provision.\n\n1. To lay up; to put aside for future use; to store, as merchandise, and the like. 2. To provide with material requisites; to store; to fill; to supply; as, to stock a warehouse, that is, to fill it with goods; to stock a farm, that is, to supply it with cattle and tools; to stock land, that is, to occupy it with a permanent growth, especially of grass. 3. To suffer to retain milk for twenty-four hours or more previous to sale, as cows. 4. To put in the stocks. [R.] Shak. To stock an anchor (Naut.), to fit it with a stock, or to fasten the stock firmly in place. -- To stock cards (Card Playing), to arrange cards in a certain manner for cheating purposes. [Cant] -- To stock down (Agric.), to sow, as plowed land, with grass seed, in order that it may become swarded, and produce grass. -- To stock up, to extirpate; to dig up.\n\nUsed or employed for constant service or application, as if constituting a portion of a stock or supply; standard; permanent; standing; as, a stock actor; a stock play; a stock sermon. \"A stock charge against Raleigh.\" C. Kingsley. Stock company (Theater), a company of actors regularly employed at one theater, or permanently acting together in various plays under one management.
stock-blind |Blind as a stock; wholly blind.
stock-still |Still as a stock, or fixed post; perfectly still. His whole work stands stock-still. Sterne.
stockade |1. (Mil.)  A line of stout posts or timbers set firmly in the earth in contact with each other (and usually with loopholes) to form a barrier, or defensive fortification. [Written also stoccade.] 2. An inclosure, or pen, made with posts and stakes.\n\nTo surround, fortify, or protect with a stockade.
stockbroker |A broker who deals in stocks.
stockdove |A common European wild pigeon (Columba ænas), so called because at one time believed to be the stock of the domestic pigeon, or, according to some, from its breeding in the stocks, or trunks, of trees. Note: The name is applied, also, to other related species, as the Indian stockdove (Palumbæna Eversmanni).
stocker |One who makes or fits stocks, as of guns or gun carriages, etc.
stockfish |1. Salted and dried fish, especially codfish, hake, ling, and torsk; also, codfish dried without being salted. 2. (Zoöl.)  Young fresh cod.
stockholder |One who is a holder or proprietor of stock in the public funds, or in the funds of a bank or other stock company.
stockinet |An elastic textile fabric imitating knitting, of which stockings, under-garments, etc., are made.
stocking |A close-fitting covering for the foot and leg, usually knit or woven. Blue stocking. See Bluestocking. -- Stocking frame, a machine for knitting stockings or other hosiery goods.\n\nTo dress in GBs. Dryden.
stockinger |A stocking weaver.
stockish |Like a stock; stupid; blockish. Since naught so stockish, hard, and full of rage, But music for the time doth change his nature. Shak.
stockjobber |One who speculates in stocks for gain; one whose occupation is to buy and sell stocks. In England a jobber acts as an intermediary between brokers.
stockjobbing |The act or art of dealing in stocks; the business of a stockjobber.
stockman |A herdsman; a ranchman; one owning, or having charge of, herds of live stock. [Australia & U.S.] W. Howitt.
stockwork |1. (Mining)  A system of working in ore, etc., when it lies not in strata or veins, but in solid masses, so as to be worked in chambers or stories. 2. (Geol.)  A metalliferous deposit characterized by the impregnation of the mass of rock with many small veins or nests irregularly grouped. This kind of deposit is especially common with tin ore. Such deposits are worked in floors or stories.
stocky |1. Short and thick; thick rather than tall or corpulent. Addison. Stocky, twisted, hunchback stems. Mrs. H. H. Jackson. 2. Headstrong. [Prov. Eng.] G. Eliot.
stodgy |Wet. [Prov. Eng.] G. Eliot.
stoechiology |See Stoichiology, Stoichiometry, etc.
stoechiometry |See Stoichiology, Stoichiometry, etc.
stogy |heavy; coarse; clumsy. [Colloq.]\n\n1. A stout, coarse boot or shoe; a brogan. 2.  A kind of cheap, but not necessary inferior, cigar made in the form of a cylindrical roll.
stoic |1. A disciple of the philosopher Zeno; one of a Greek sect which held that men should be free from passion, unmoved by joy or grief, and should submit without complaint to unavoidable necessity, by which all things are governed. 2. Hence, a person not easily excited; an apathetic person; one who is apparently or professedly indifferent to pleasure or pain. A Stoic of the woods, a man without a tear. Campbell. School of Stoics. See The Porch, under Porch.\n\n1. Of or pertaining to the Stoics; resembling the Stoics or their doctrines. 2. Not affected by passion; manifesting indifference to pleasure or pain. -- Sto\"ic*al*ly, adv. -- Sto\"ic*al*ness, n.
stoical |1. Of or pertaining to the Stoics; resembling the Stoics or their doctrines. 2. Not affected by passion; manifesting indifference to pleasure or pain. -- Sto\"ic*al*ly, adv. -- Sto\"ic*al*ness, n.
stoichiological |Of or pertaining to stoichiology.
stoichiology |1. That part of the science of physiology which treats of the elements, or principles, composing animal tissues. 2. (Logic)  The doctrine of the elementary requisites of mere thought. Sir W. Hamilton. 3. The statement or discussion of the first principles of any science or art.
stoichiometric |Of or pertaining to stoichiometry; employed in, or obtained by, stoichiometry.
stoichiometrical |Of or pertaining to stoichiometry; employed in, or obtained by, stoichiometry.
stoichiometry |The art or process of calculating the atomic proportions, combining weights, and other numerical relations of chemical elements and their compounds.
stoicism |1. The opinions and maxims of the Stoics. 2. A real or pretended indifference to pleasure or pain; insensibility; impassiveness.
stoicity |Stoicism. [Obs.] B. Jonson.
stoke |1. To stick; to thrust; to stab. [Obs.] Nor short sword for to stoke, with point biting. Chaucer. 2. To poke or stir up, as a fire; hence, to tend, as the fire of a furnace, boiler, etc.\n\nTo poke or stir up a fire; hence, to tend the fires of furnaces, steamers, etc.
stokehold |The space, or any of the spaces, in front of the boilers of a ship, from which the furnaces are fed; the stokehole of a ship; also, a room containing a ship's boilers; as, forced draft with  closed stokehold; -- called also, in American ships, fireroom.
stokehole |The mouth to the grate of a furnace; also, the space in front of the furnace, where the stokers stand.
stoker |1. One who is employed to tend a furnace and supply it with fuel, especially the furnace of a locomotive or of a marine steam boiler; also, a machine for feeding fuel to a fire. 2. A fire poker. [R.] C. Richardson (Dict.).
stokey |Close; sultry. [Prov. Eng.]
stola |A long garment, descending to the ankles, worn by Roman women. The stola was not allowed to be worn by courtesans, or by women who had been divorced from their husbands. Fairholt.
stole |imp. of Steal.\n\nA stolon.\n\n1. A long, loose garment reaching to the feet. Spenser. But when mild morn, in saffron stole, First issues from her eastern goal. T. Warton. 2. (Eccl.)  A narrow band of silk or stuff, sometimes enriched with embroidery and jewels, worn on the left shoulder of deacons, and across both shoulders of bishops and priests, pendent on each side nearly to the ground. At Mass, it is worn crossed on the breast by priests. It is used in various sacred functions. Groom of the stole, the first lord of the bedchamber in the royal household. [Eng.] Brande & C.
stoled |Having or wearing a stole. After them flew the prophets, brightly stoled In shining lawn. G. Fletcher.
stolen |p. p. of Steal.
stolid |Hopelessly insensible or stupid; not easily aroused or excited; dull; impassive; foolish.
stolidity |The state or quality of being stolid; dullness of intellect; obtuseness; stupidity. Indocile, intractable fools, whose stolidity can baffle all arguments, and be proof against demonstration itself. Bentley.
stolidness |Same as Stolidity.
stolon |1. (Bot.)  A trailing branch which is disposed to take root at the end or at the joints; a stole. 2. (Zoöl.)  An extension of the integument of the body, or of the body wall, from which buds are developed, giving rise to new zooids, and thus forming a compound animal in which the zooids usually remain united by the stolons. Such stolons are often present in Anthozoa, Hydroidea, Bryozoa, and social ascidians. See Illust. under Scyphistoma.
stoloniferous |Producing stolons; putting forth suckers.
stoma |1. (Anat.)  One of the minute apertures between the cells in many serous membranes. 2. (Bot.) (a) The minute breathing pores of leaves or other organs opening into the intercellular spaces, and usually bordered by two contractile cells. (b) The line of dehiscence of the sporangium of a fern. It is usually marked by two transversely elongated cells. See Illust. of Sporangium. 3. (Zoöl.)  A stigma. See Stigma, n., 6 (a) & (b).
stomach |1. (Anat.)  An enlargement, or series of enlargements, in the anterior part of the alimentary canal, in which food is digested; any cavity in which digestion takes place in an animal; a digestive cavity. See Digestion, and Gastric juice, under Gastric. 2. The desire for food caused by hunger; appetite; as, a good stomach for roast beef. Shak. 3. Hence appetite in general; inclination; desire. He which hath no stomach to this fight, Let him depart. Shak. 4. Violence of temper; anger; sullenness; resentment; willful obstinacy; stubbornness. [Obs.] Stern was his look, and full of stomach vain. Spenser. This sort of crying proceeding from pride, obstinacy, and stomach, the will, where the fault lies, must be bent. Locke. 5. Pride; haughtiness; arrogance. [Obs.] He was a man Of an unbounded stomach. Shak. Stomach pump (Med.), a small pump or syringe with a flexible tube, for drawing liquids from the stomach, or for injecting them into it. -- Stomach tube (Med.), a long flexible tube for introduction into the stomach. -- Stomach worm (Zoöl.), the common roundworm (Ascaris lumbricoides) found in the human intestine, and rarely in the stomach.\n\n1. To resent; to remember with anger; to dislike. Shak. The lion began to show his teeth, and to stomach the affront. L'Estrange. The Parliament sit in that body . . . to be his counselors and dictators, though he stomach it. Milton. 2. To bear without repugnance; to brook. [Colloq.]\n\nTo be angry. [Obs.] Hooker.
stomachal |1. Of or pertaining to the stomach; gastric. 2. Helping the stomach; stomachic; cordial.\n\nA stomachic. Dunglison.
stomacher |1. One who stomachs. 2. (  An ornamental covering for the breast, worn originally both by men and women. Those worn by women were often richly decorated. A stately lady in a diamond stomacher. Johnson.
stomachful |Willfully obstinate; stubborn; perverse. [Obs.] -- Stom\"ach*ful*ly, adv. [Obs.] -- Stom\"ach*ful*ness, n. [Obs.]
stomachic |1. Of or pertaining to the stomach; as, stomachic vessels. 2. Strengthening to the stomach; exciting the action of the stomach; stomachal; cordial.\n\nA medicine that strengthens the stomach and excites its action.
stomachical |1. Of or pertaining to the stomach; as, stomachic vessels. 2. Strengthening to the stomach; exciting the action of the stomach; stomachal; cordial.
stomaching |Resentment. [Obs.]
stomachless |1. Being without a stomach. 2. Having no appetite. [R.] Bp. Hall.
stomachous |Stout; sullen; obstinate. [Obs.] With stern looks and stomachous disdain. Spenser.
stomachy |Obstinate; sullen; haughty. A little, bold, solemn, stomachy man, a great professor of piety. R. L. Stevenson.
stomapod |One of the Stomapoda.
stomapoda |An order of Crustacea including the squillas. The maxillipeds are leglike in form, and the large claws are comblike. They have a large and elongated abdomen, which contains a part of the stomach and heart; the abdominal appendages are large, and bear the gills. Called also Gastrula, Stomatopoda, and Squilloidea.
stomate |A stoma.
stomatic |Of or pertaining to a stoma; of the nature of a stoma.\n\nA medicine for diseases of the mouth. Dunglison.
stomatiferous |Having or producing stomata.
stomatitis |Inflammation of the mouth.
stomatoda |A division of Protozoa in which a mouthlike opening exists.
stomatodaeum |Same as Stomodæum.
stomatode |Having a mouth; -- applied to certain Protozoa. -- n.  One of the Stomatoda.
stomatogastric |Of or pertaining to the mouth and the stomach; as, the stomatogastric ganglion of certain Mollusca.
stomatology |Scientific study or knowledge of the mouth.
stomatoplastic |Of or pertaining to the operation of forming a mouth where the aperture has been contracted, or in any way deformed.
stomatoplasty |Plastic surgery of the mouth.
stomatopod |One of the Stomatopoda.
stomatopoda |Same as Stomapoda.
stomatopodous |Of or pertaining to the Stomatopoda.
stomatoscope |An apparatus for examining the interior of the mouth.
stomatous |Having a stoma.
stomodaeum |1. (Anat.)  A part of the alimentary canal. See under Mesenteron. 2. (Zoöl.)  The primitive mouth and esophagus of the embryo of annelids and arthropods.
stomp |To stamp with the foot. [Colloq.] \"In gallant procession, the priests mean to stomp.\" R. Browning.
stond |1. Stop; halt; hindrance. [Obs.] Bacon. 2. A stand; a post; a station. [Obs.] Spenser.\n\nTo stand. [Obs.] Chaucer.
stone |1. Concreted earthy or mineral matter; also, any particular mass of such matter; as, a house built of stone; the boy threw a stone; pebbles are rounded stones. \"Dumb as a stone.\" Chaucer. They had brick for stone, and slime . . . for mortar. Gen. xi. 3. Note: In popular language, very large masses of stone are called rocks; small masses are called stones; and the finer kinds, gravel, or sand, or grains of sand. Stone is much and widely used in the construction of buildings of all kinds, for walls, fences, piers, abutments, arches, monuments, sculpture, and the like. 2. A precious stone; a gem. \"Many a rich stone.\" Chaucer. \"Inestimable stones, unvalued jewels.\" Shak. 3. Something made of stone. Specifically: - (a) The glass of a mirror; a mirror. [Obs.] Lend me a looking-glass; If that her breath will mist or stain the stone, Why, then she lives. Shak. (b) A monument to the dead; a gravestone. Gray. Should some relenting eye Glance on the where our cold relics lie. Pope. 4. (Med.)  A calculous concretion, especially one in the kidneys or bladder; the disease arising from a calculus. 5. One of the testes; a testicle. Shak. 6. (Bot.)  The hard endocarp of drupes; as, the stone of a cherry or peach. See Illust. of Endocarp. 7. A weight which legally is fourteen pounds, but in practice varies with the article weighed. [Eng.] Note: The stone of butchers' meat or fish is reckoned at 8 lbs.; of cheese, 16 lbs.; of hemp, 32 lbs.; of glass, 5 lbs. 8. Fig.: Symbol of hardness and insensibility; torpidness; insensibility; as, a heart of stone. I have not yet forgot myself to stone. Pope. 9. (Print.)  A stand or table with a smooth, flat top of stone, commonly marble, on which to arrange the pages of a book, newspaper, etc., before printing; -- called also imposing stone. Note: Stone is used adjectively or in composition with other words to denote made of stone, containing a stone or stones, employed on stone, or, more generally, of or pertaining to stone or stones; as, stone fruit, or stone-fruit; stone-hammer, or stone hammer; stone falcon, or stone-falcon. Compounded with some adjectives it denotes a degree of the quality expressed by the adjective equal to that possessed by a stone; as, stone-dead, stone-blind, stone-cold, stone- still, etc. Atlantic stone, ivory. [Obs.] \"Citron tables, or Atlantic stone.\" Milton. -- Bowing stone. Same as Cromlech. Encyc. Brit. -- Meteoric stones, stones which fall from the atmosphere, as after the explosion of a meteor. -- Philosopher's stone. See under Philosopher. -- Rocking stone. See Rocking-stone. -- Stone age, a supposed prehistoric age of the world when stone and bone were habitually used as the materials for weapons and tools; -- called also flint age. The bronze age succeeded to this. -- Stone bass (Zoöl.), any one of several species of marine food fishes of the genus Serranus and allied genera, as Serranus Couchii, and Polyprion cernium of Europe; -- called also sea perch. -- Stone biter (Zoöl.), the wolf fish. -- Stone boiling, a method of boiling water or milk by dropping hot stones into it, -- in use among savages. Tylor. -- Stone borer (Zoöl.), any animal that bores stones; especially, one of certain bivalve mollusks which burrow in limestone. See Lithodomus, and Saxicava. -- Stone bramble (Bot.), a European trailing species of bramble (Rubus saxatilis). -- Stone-break. Etym: [Cf. G. steinbrech.] (Bot.) Any plant of the genus Saxifraga; saxifrage. -- Stone bruise, a sore spot on the bottom of the foot, from a bruise by a stone. -- Stone canal. (Zoöl.) Same as Sand canal, under Sand. -- Stone cat (Zoöl.), any one of several species of small fresh- water North American catfishes of the genus Noturus. They have sharp pectoral spines with which they inflict painful wounds. -- Stone coal, hard coal; mineral coal; anthracite coal. -- Stone coral (Zoöl.), any hard calcareous coral. -- Stone crab. (Zoöl.) (a) A large crab (Menippe mercenaria) found on the southern coast of the United States and much used as food. (b) A European spider crab (Lithodes maia). Stone crawfish (Zoöl.), a European crawfish (Astacus torrentium), by many writers considered only a variety of the common species (A. fluviatilis). -- Stone curlew. (Zoöl.) (a) A large plover found in Europe (Edicnemus crepitans). It frequents stony places. Called also thick- kneed plover or bustard, and thick-knee. (b) The whimbrel. [Prov. Eng.] (c) The willet. [Local, U.S.] -- Stone crush. Same as Stone bruise, above. -- Stone eater. (Zoöl.) Same as Stone borer, above. -- Stone falcon (Zoöl.), the merlin. -- Stone fern (Bot.), a European fern (Asplenium Ceterach) which grows on rocks and walls. -- Stone fly (Zoöl.), any one of many species of pseudoneuropterous insects of the genus Perla and allied genera; a perlid. They are often used by anglers for bait. The larvæ are aquatic. -- Stone fruit (Bot.), any fruit with a stony endocarp; a drupe, as a peach, plum, or cherry. -- Stone grig (Zoöl.), the mud lamprey, or pride. -- Stone hammer, a hammer formed with a face at one end, and a thick, blunt edge, parallel with the handle, at the other, -- used for breaking stone. -- Stone hawk (Zoöl.), the merlin; -- so called from its habit of sitting on bare stones. -- Stone jar, a jar made of stoneware. -- Stone lily (Paleon.), a fossil crinoid. -- Stone lugger. (Zoöl.) See Stone roller, below. -- Stone marten (Zoöl.), a European marten (Mustela foina) allied to the pine marten, but having a white throat; -- called also beech marten. -- Stone mason, a mason who works or builds in stone. -- Stone-mortar (Mil.), a kind of large mortar formerly used in sieges for throwing a mass of small stones short distances. -- Stone oil, rock oil, petroleum. -- Stone parsley (Bot.), an umbelliferous plant (Seseli Labanotis). See under Parsley. -- Stone pine. (Bot.) A nut pine. See the Note under Pine, and Piñon. -- Stone pit, a quarry where stones are dug. -- Stone pitch, hard, inspissated pitch. -- Stone plover. (Zoöl.) (a) The European stone curlew. (b) Any one of several species of Asiatic plovers of the genus Esacus; as, the large stone plover (E. recurvirostris). (c) The gray or black-bellied plover. [Prov. Eng.] (d) The ringed plover. (e) The bar-tailed godwit. [Prov. Eng.] Also applied to other species of limicoline birds. -- Stone roller. (Zoöl.) (a) An American fresh-water fish (Catostomus nigricans) of the Sucker family. Its color is yellowish olive, often with dark blotches. Called also stone lugger, stone toter, hog sucker, hog mullet. (b) A common American cyprinoid fish (Campostoma anomalum); -- called also stone lugger. -- Stone's cast, or Stone's throw, the distance to which a stone may be thrown by the hand. -- Stone snipe (Zoöl.), the greater yellowlegs, or tattler. [Local, U.S.] -- Stone toter. (Zoöl.) (a) See Stone roller (a), above. (b) A cyprinoid fish (Exoglossum maxillingua) found in the rivers from Virginia to New York. It has a three-lobed lower lip; -- called also cutlips. -- To leave no stone unturned, to do everything that can be done; to use all practicable means to effect an object.\n\n1. To pelt, beat, or kill with stones. And they stoned Stephen, calling upon God, and saying, Lord Jesus, receive my spirit. Acts vii. 59. 2. To make like stone; to harden. O perjured woman! thou dost stone my heart. Shak. 3. To free from stones; also, to remove the seeds of; as, to stone a field; to stone cherries; to stone raisins. 4. To wall or face with stones; to line or fortify with stones; as, to stone a well; to stone a cellar. 5. To rub, scour, or sharpen with a stone.
stone-blind |As blind as a stone; completely blind.
stone-cold |Cold as a stone. Stone-cold without, within burnt with love's flame. Fairfax.
stone-dead |As dead as a stone.
stone-deaf |As deaf as a stone; completely deaf.
stone-hearted |Hard-hearted; cruel; pitiless; unfeeling.
stone-horse |Stallion. [Obs.] Mortimer.
stone-still |As still as a stone. Shak.
stonebird |The yellowlegs; -- called also stone snipe. See Tattler, 2. [Local, U.S.]
stonebow |A kind of crossbow formerly used for shooting stones. Shak.
stonebrash |A subsoil made up of small stones or finely-broken rock; brash.
stonebrearer |A machine for crushing or hammering stone. Knight.
stonebuck |See Steinbock.
stonechat |(a) A small, active, and very common European singing bird (Pratincola rubicola); -- called also chickstone, stonechacker, stonechatter, stoneclink, stonesmith. (b) The wheatear. (c) The blue titmouse. Note: The name is sometimes applied to various species of Saxicola, Pratincola, and allied genera; as, the pied stonechat of India (Saxicola picata).
stonecray |A distemper in hawks.
stonecrop |1. A sort of tree. [Obs.] Mortimer. 2. (Bot.)  Any low succulent plant of the genus Sedum, esp. Sedum acre, which is common on bare rocks in Europe, and is spreading in parts of America. See Orpine. Virginian, or Ditch, stonecrop, an American plant (Penthorum sedoides).
stonecutter |One whose occupation is to cut stone; also, a machine for dressing stone.
stonecutting |Hewing or dressing stone.
stonegall |See Stannel. [Prov. Eng.]
stonehatch |The ring plover, or dotterel. [Prov. Eng.]
stonehenge |An assemblage of upright stones with others placed horizontally on their tops, on Salisbury Plain, England, -- generally supposed to be the remains of an ancient Druidical temple.
stoner |1. One who stones; one who makes an assault with stones. 2. One who walls with stones.
stoneroot |A North American plant (Collinsonia Canadensis) having a very hard root; horse balm. See Horse balm, under Horse.
stonerunner |(a) The ring plover, or the ringed dotterel. [Prov. Eng.] (b) The dotterel. [Prov. Eng.]
stonesmickle |The stonechat; -- called also stonesmitch. [Prov. Eng.]
stoneware |A species of coarse potter's ware, glazed and baked.
stoneweed |Any plant of the genus Lithospermum, herbs having a fruit composed of four stony nutlets.
stonework |Work or wall consisting of stone; mason's work of stone. Mortimer.
stonewort |Any plant of the genus Chara; -- so called because they are often incrusted with carbonate of lime. See Chara.
stonily |In a stony manner.
stoniness |The quality or state of being stony.
stonish |Stony. [R.] \"Possessed with stonish insensibility.\" Robynson (More's Utopia).
stont |Stands. Chaucer.\n\n3d pers. sing. present of Stand.
stony |1. Of or pertaining to stone, consisting of, or abounding in, stone or stones; resembling stone; hard; as, a stony tower; a stony cave; stony ground; a stony crust. 2. Converting into stone; petrifying; petrific. The stony dart of senseless cold. Spenser. 3. Inflexible; cruel; unrelenting; pitiless; obdurate; perverse; cold; morally hard; appearing as if petrified; as, a stony heart; a stony gaze. Stony coral. (Zoöl.) Same as Stone coral, under Stone.
stood |imp. & p. p. of Stand.
stook |A small collection of sheaves set up in the field; a shock; in England, twelve sheaves.\n\nTo set up, as sheaves of grain, in stooks.
stool |A plant from which layers are propagated by bending its branches into the soil. P. Henderson.\n\nTo ramfy; to tiller, as grain; to shoot out suckers. R. D. Blackmore.\n\n1. A single seat with three or four legs and without a back, made in various forms for various uses. 2. A seat used in evacuating the bowels; hence, an evacuation; a discharge from the bowels. 3. A stool pigeon, or decoy bird. [U. S.] 4. (Naut.)  A small channel on the side of a vessel, for the dead-eyes of the backstays. Totten. 5. A bishop's seat or see; a bishop-stool. J. P. Peters. 6. A bench or form for resting the feet or the knees; a footstool; as, a kneeling stool. 7. Material, such as oyster shells, spread on the sea bottom for oyster spat to adhere to. [Local, U.S.] Stool of a window, or Window stool (Arch.), the flat piece upon which the window shuts down, and which corresponds to the sill of a door; in the United States, the narrow shelf fitted on the inside against the actual sill upon which the sash descends. This is called a window seat when broad and low enough to be used as a seat. Stool of repentance, the cuttystool. [Scot.] -- Stool pigeon, a pigeon used as a decoy to draw others within a net; hence, a person used as a decoy for others.
stoolball |A kind of game with balls, formerly common in England, esp. with young women. Nausicaa With other virgins did at stoolball play. Chapman.
stoom |To stum. [R.]
stoop |Originally, a covered porch with seats, at a house door; the Dutch stoep as introduced by the Dutch into New York. Afterward, an out-of-door flight of stairs of from seven to fourteen steps, with platform and parapets, leading to an entrance door some distance above the street; the French perron. Hence, any porch, platform, entrance stairway, or small veranda, at a house door. [U. S.]\n\nA vessel of liquor; a flagon. [Written also stoup.] Fetch me a stoop of liquor. Shak.\n\nA post fixed in the earth. [Prov. Eng.]\n\n1. To bend the upper part of the body downward and forward; to bend or lean forward; to incline forward in standing or walking; to assume habitually a bent position. 2. To yield; to submit; to bend, as by compulsion; to assume a position of humility or subjection. Mighty in her ships stood Carthage long, . . . Yet stooped to Rome, less wealthy, but more strong. Dryden. These are arts, my prince, In which your Zama does not stoop to Rome. Addison. 3. To descend from rank or dignity; to condescend. \"She stoops to conquer.\" Goldsmith. Where men of great wealth stoop to husbandry, it multiplieth riches exceedingly. Bacon. 4. To come down as a hawk does on its prey; to pounce; to souse; to swoop. The bird of Jove, stooped from his aëry tour, Two birds of gayest plume before him drove. Milton. 5. To sink when on the wing; to alight. And stoop with closing pinions from above. Dryden. Cowering low With blandishment, each bird stooped on his wing. Milton. Syn. -- To lean; yield; submit; condescend; descend; cower; shrink.\n\n1. To bend forward and downward; to bow down; as, to stoop the body. \"Have stooped my neck.\" Shak. 2. To cause to incline downward; to slant; as, to stoop a cask of liquor. 3. To cause to submit; to prostrate. [Obs.] Many of those whose states so tempt thine ears Are stooped by death; and many left alive. Chapman. 4. To degrade. [Obs.] Shak.\n\n1. The act of stooping, or bending the body forward; inclination forward; also, an habitual bend of the back and shoulders. 2. Descent, as from dignity or superiority; condescension; an act or position of humiliation. Can any loyal subject see With patience such a stoop from sovereignty Dryden. 3. The fall of a bird on its prey; a swoop. L'Estrange.
stooper |One who stoops.
stooping |from Stoop. -- Stoop\"ing*ly, adv.
stoor |To rise in clouds, as dust. [Prov. Eng.]\n\nStrong; powerful; hardy; bold; audacious. [Obs. or Scot.] O stronge lady stoor, what doest thou Chaucer.
stop |1. To close, as an aperture, by filling or by obstructing; as, to stop the ears; hence, to stanch, as a wound. Shak. 2. To obstruct; to render impassable; as, to stop a way, road, or passage. 3. To arrest the progress of; to hinder; to impede; to shut in; as, to stop a traveler; to stop the course of a stream, or a flow of blood. 4. To hinder from acting or moving; to prevent the effect or efficiency of; to cause to cease; to repress; to restrain; to suppress; to interrupt; to suspend; as, to stop the execution of a decree, the progress of vice, the approaches of old age or infirmity. Whose disposition all the world well knows Will not be rubbed nor stopped. Shak. 5. (Mus.)  To regulate the sounds of, as musical strings, by pressing them against the finger board with the finger, or by shortening in any way the vibrating part. 6. To point, as a composition; to punctuate. [R.] If his sentences were properly stopped. Landor. 7. (Naut.)  To make fast; to stopper. Syn. -- To obstruct; hinder; impede; repress; suppress; restrain; discontinue; delay; interrupt. To stop off (Founding), to fill (a part of a mold) with sand, where a part of the cavity left by the pattern is not wanted for the casting. -- To stop the mouth. See under Mouth.\n\n1. To cease to go on; to halt, or stand still; to come to a stop. He bites his lip, and starts; Stops on a sudden, looks upon the ground; Then lays his finger on his temple: strait Springs out into fast gait; then stops again. Shak. 2. To cease from any motion, or course of action. Stop, while ye may, suspend your mad career! Cowper. 3. To spend a short time; to reside temporarily; to stay; to tarry; as, to stop with a friend. [Colloq.] By stopping at home till the money was gone. R. D. Blackmore. To stop over, to stop at a station beyond the time of the departure of the train on which one came, with the purpose of continuing one's journey on a subsequent train; to break one's journey. [Railroad Cant, U.S.] stopover\n\n1. The act of stopping, or the state of being stopped; hindrance of progress or of action; cessation; repression; interruption; check; obstruction. It is doubtful . . . whether it contributed anything to the stop of the infection. De Foe. Occult qualities put a stop to the improvement of natural philosophy. Sir I. Newton. It is a great step toward the mastery of our desires to give this stop to them. Locke. 2. That which stops, impedes, or obstructs; as obstacle; an impediment; an obstruction. A fatal stop traversed their headlong course. Daniel. So melancholy a prospect should inspire us with zeal to oppose some stop to the rising torrent. Rogers. 3. (Mach.)  A device, or piece, as a pin, block, pawl, etc., for arresting or limiting motion, or for determining the position to which another part shall be brought. 4. (Mus.) (a) The closing of an aperture in the air passage, or pressure of the finger upon the string, of an instrument of music, so as to modify the tone; hence, any contrivance by which the sounds of a musical instrument are regulated. The organ sound a time survives the stop. Daniel. (b) In the organ, one of the knobs or handles at each side of the organist, by which he can draw on or shut off any register or row of pipes; the register itself; as, the vox humana stop. 5. (Arch.)  A member, plain or molded, formed of a separate piece and fixed to a jamb, against which a door or window shuts. This takes the place, or answers the purpose, of a rebate. Also, a pin or block to prevent a drawer from sliding too far. 6. A point or mark in writing or printing intended to distinguish the sentences, parts of a sentence, or clauses; a mark of punctuation. See Punctuation. 7. (Opt.)  The diaphragm used in optical instruments to cut off the marginal portions of a beam of light passing through lenses. 8. (Zoöl.)  The depression in the face of a dog between the skull and the nasal bones. It is conspicuous in the bulldog, pug, and some other breeds. 9. (Phonetics)  Some part of the articulating organs, as the lips, or the tongue and palate, closed (a) so as to cut off the passage of breath or voice through the mouth and the nose (distinguished as a lip-stop, or a front-stop, etc., as in p, t, d, etc.), or (b) so as to obstruct, but not entirely cut off, the passage, as in l, n, etc.; also, any of the consonants so formed. H. Sweet. Stop bead (Arch.), the molding screwed to the inner side of a window frame, on the face of the pulley stile, completing the groove in which the inner sash is to slide. -- Stop motion (Mach.), an automatic device for arresting the motion of a machine, as when a certain operation is completed, or when an imperfection occurs in its performance or product, or in the material which is supplied to it, etc. -- Stop plank, one of a set of planks employed to form a sort of dam in some hydraulic works. -- Stop valve, a valve that can be closed or opened at will, as by hand, for preventing or regulating flow, as of a liquid in a pipe; -- in distinction from a valve which is operated by the action of the fluid it restrains. -- Stop watch, a watch the hands of which can be stopped in order to tell exactly the time that has passed, as in timing a race. See Independent seconds watch, under Independent, a. Syn. -- Cessation; check; obstruction; obstacle; hindrance; impediment; interruption.
stop order |An order that aims to limit losses by fixing a figure at which purchases shall be sold or sales bought in, as where stock is bought at 100 and the broker is directed to sell if the market price drops to 98.
stop-gap |That which closes or fills up an opening or gap; hence, a temporary expedient. Moral prejudices are the stop-gaps of virtue. Hare.
stop-over |Permitting one to stop over; as, a stop-over check or ticket. See To stop over, under Stop, v. i. [Railroad Cant, U.S.]
stopcock |1. A bib, faucet, or short pipe, fitted with a turning stopper or plug for permitting or restraining the flow of a liquid or gas; a cock or valve for checking or regulating the flow of water, gas, etc., through or from a pipe, etc. 2. The turning plug, stopper, or spigot of a faucet. [R.]
stope |A horizontal working forming one of a series, the working faces of which present the appearance of a flight of steps.\n\n(a) To excavate in the form of stopes. (b) To fill in with rubbish, as a space from which the ore has been worked out.\n\nStepped; gone; advanced. [Obs.] A poor widow, somedeal stope in age. Chaucer.
stopen |Stepped; gone; advanced. [Obs.] A poor widow, somedeal stope in age. Chaucer.
stoping |The act of excavating in the form of stopes.
stopless |Not to be stopped. Davenant.
stoppage |The act of stopping, or arresting progress, motion, or action; also, the state of being stopped; as, the stoppage of the circulation of the blood; the stoppage of commerce.
stopped |Made by complete closure of the mouth organs; shut; -- said of certain consonants (p, b, t, d, etc.). H. Sweet.
stopper |1. One who stops, closes, shuts, or hinders; that which stops or obstructs; that which closes or fills a vent or hole in a vessel. 2. (Naut.)  A short piece of rope having a knot at one or both ends, with a lanyard under the knot, -- used to secure something. Totten. 3. (Bot.)  A name to several trees of the genus Eugenia, found in Florida and the West Indies; as, the red stopper. See Eugenia. C. S. Sargent. Ring stopper (Naut.), a short rope or chain passing through the anchor ring, to secure the anchor to the cathead. -- Stopper bolt (Naut.), a large ringbolt in a ship's deck, to which the deck stoppers are hooked.\n\nTo close or secure with a stopper.
stopping |1. Material for filling a cavity. 2. (Mining)  A partition or door to direct or prevent a current of air. 3. (Far.)  A pad or poultice of dung or other material applied to a horse's hoof to keep it moist. Youatt.
stopping-out |A method adopted in etching, to keep the acid from those parts which are already sufficiently corroded, by applying varnish or other covering matter with a brush, but allowing the acid to act on the other parts.
stopple |That which stops or closes the mouth of a vessel; a stopper; as, a glass stopple; a cork stopple.\n\nTo close the mouth of anything with a stopple, or as with a stopple. Cowper.
stopship |A remora. It was fabled to stop ships by attaching itself to them. Sylvester.
stor |Strong; powerful; hardy; bold; audacious. [Obs. or Scot.] O stronge lady stoor, what doest thou Chaucer.\n\nSee Stoor. [Obs.] Chaucer.
storage |1. The act of depositing in a store or warehouse for safe keeping; also, the safe keeping of goods in a warehouse. 2. Space for the safe keeping of goods. 3. The price changed for keeping goods in a store. Storage battery. (Physics) See the Note under Battery.
storax |Any one of a number of similar complex resins obtained from the bark of several trees and shrubs of the Styrax family. The most common of these is liquid storax, a brown or gray semifluid substance of an agreeable aromatic odor and balsamic taste, sometimes used in perfumery, and in medicine as an expectorant. Note: A yellow aromatic honeylike substance, resembling, and often confounded with, storax, is obtained from the American sweet gum tree (Liquidambar styraciflua), and is much used as a chewing gum, called sweet gum, and liquid storax. Cf. Liquidambar.
store |1. That which is accumulated, or massed together; a source from which supplies may be drawn; hence, an abundance; a great quantity, or a great number. The ships are fraught with store of victuals. Bacon. With store of ladies, whose bright eyes Rain influence, and give the prize. Milton. 2. A place of deposit for goods, esp. for large quantities; a storehouse; a warehouse; a magazine. 3. Any place where goods are sold, whether by wholesale or retail; a shop. [U.S. & British Colonies] 4. pl.  Articles, especially of food, accumulated for some specific object; supplies, as of provisions, arms, ammunition, and the like; as, the stores of an army, of a ship, of a family. His swine, his horse, his stoor, and his poultry. Chaucer. In store, in a state of accumulation; in keeping; hence, in a state of readiness. \"I have better news in store for thee.\" Shak. -- Store clothes, clothing purchased at a shop or store; -- in distinction from that which is home-made. [Colloq. U.S.] -- Store pay, payment for goods or work in articles from a shop or store, instead of money. [U.S.] -- To set store by, to value greatly; to have a high appreciation of. -- To tell no store of, to make no account of; to consider of no importance. Syn. -- Fund; supply; abundance; plenty; accumulation; provision. -- Store, Shop. The English call the place where goods are sold (however large or splendid it may be) a shop, and confine the word store to its original meaning; viz., a warehouse, or place where goods are stored. In America the word store is applied to all places, except the smallest, where goods are sold. In some British colonies the word store is used as in the United States. In his needy shop a tortoise hung, An alligator stuffed, and other skins Of ill-shaped fishes; and about his shelves A beggarly account of empty boxes. Shak. Sulphurous and nitrous foam, . . . Concocted and adjusted, they reduced To blackest grain, and into store conveyed. Milton.\n\nAccumulated; hoarded. Bacon.\n\n1. To collect as a reserved supply; to accumulate; to lay away. Dora stored what little she could save. Tennyson. 2. To furnish; to supply; to replenish; esp., to stock or furnish against a future time. Her mind with thousand virtues stored. Prior. Wise Plato said the world with men was stored. Denham. Having stored a pond of four acres with carps, tench, and other fish. Sir M. Hale. 3. To deposit in a store, warehouse, or other building, for preservation; to warehouse; as, to store goods.
stored |Collected or accumulated as a reserve supply; as, stored electricity. It is charged with stored virtue. Bagehot.
storehouse |1. A building for keeping goods of any kind, especially provisions; a magazine; a repository; a warehouse. Joseph opened all the storehouses, and sold unto Egyptians. Gen. xli. 56. The Scripture of God is a storehouse abounding with estimable treasures of wisdom and knowledge. Hooker. 2. A mass or quality laid up. [Obs.] Spenser.
storekeeper |1. A man in charge of stores or goods of any kind; as, a naval storekeeper. 2. One who keeps a \"store;\" a shopkeeper. See 1st Store, 3. [U. S.]
storer |One who lays up or forms a store.
storeroom |Room in a storehouse or repository; a room in which articles are stored.
storeship |A vessel used to carry naval stores for a fleet, garrison, or the like.
storey |See Story.
storge |Parental affection; the instinctive affection which animals have for their young.
storial |Historical. [Obs.] Chaucer.
storied |1. Told in a story. 2. Having a history; interesting from the stories which pertain to it; venerable from the associations of the past. Some greedy minion, or imperious wife, The trophied arches, storied halls, invade. Pope. Can storied urn, or animated bust, Back to its mansion call the fleeting breath Gray. 3. Having (such or so many) stories; -- chiefly in composition; as, a two-storied house.
storier |A relater of stories; an historian. [Obs.] Bp. Peacock.
storify |To form or tell stories of; to narrate or describe in a story. [Obs.]
stork |Any one of several species of large wading birds of the family Ciconidæ, having long legs and a long, pointed bill. They are found both in the Old World and in America, and belong to Ciconia and several allied genera. The European white stork (Ciconia alba) is the best known. It commonly makes its nests on the top of a building, a chimney, a church spire, or a pillar. The black stork (C. nigra) is native of Asia, Africa, and Europe. Black-necked stork, the East Indian jabiru. -- Hair-crested stork, the smaller adjutant of India (Leptoptilos Javanica). -- Giant stork, the adjutant. -- Marabou stork. See Marabou. -- Saddle-billed stork, the African jabiru. See Jabiru. -- Stork's bill (Bot.), any plant of the genus Pelargonium; -- so called in allusion to the beaklike prolongation of the axis of the receptacle of its flower. See Pelargonium.
stork-billed |Having a bill like that of the stork.
storm |1. A violent disturbance of the atmosphere, attended by wind, rain, snow, hail, or thunder and lightning; hence, often, a heavy fall of rain, snow, or hail, whether accompanied with wind or not. We hear this fearful tempest sing, Yet seek no shelter to avoid the storm. Shak. 2. A violent agitation of human society; a civil, political, or domestic commotion; sedition, insurrection, or war; violent outbreak; clamor; tumult. I will stir up in England some black storm. Shak. Her sister Began to scold and raise up such a storm. Shak. 3. A heavy shower or fall, any adverse outburst of tumultuous force; violence. A brave man struggling in the storms of fate. Pope. 4. (Mil.)  A violent assault on a fortified place; a furious attempt of troops to enter and take a fortified place by scaling the walls, forcing the gates, or the like. Note: Storm is often used in the formation of self-explained compounds; as, storm-presaging, stormproof, storm-tossed, and the like. Magnetic storm. See under Magnetic. -- Storm-and-stress period Etym: [a translation of G. sturm und drang periode], a designation given to the literary agitation and revolutionary development in Germany under the lead of Goethe and Schiller in the latter part of the 18th century. -- Storm center (Meteorol.), the center of the area covered by a storm, especially by a storm of large extent. -- Storm door (Arch.), an extra outside door to prevent the entrance of wind, cold, rain, etc.; -- usually removed in summer. -- Storm path (Meteorol.), the course over which a storm, or storm center, travels. -- Storm petrel. (Zoöl.) See Stormy petrel, under Petrel. -- Storm sail (Naut.), any one of a number of strong, heavy sails that are bent and set in stormy weather. -- Storm scud. See the Note under Cloud. Syn. -- Tempest; violence; agitation; calamity. -- Storm, Tempest. Storm is violent agitation, a commotion of the elements by wind, etc., but not necessarily implying the fall of anything from the clouds. Hence, to call a mere fall or rain without wind a storm is a departure from the true sense of the word. A tempest is a sudden and violent storm, such as those common on the coast of Italy, where the term originated, and is usually attended by a heavy rain, with lightning and thunder. Storms beat, and rolls the main; O! beat those storms, and roll the seas, in vain. Pope. What at first was called a gust, the same Hath now a storm's, anon a tempest's name. Donne.\n\nTo assault; to attack, and attempt to take, by scaling walls, forcing gates, breaches, or the like; as, to storm a fortified town.\n\n1. To raise a tempest. Spenser. 2. To blow with violence; also, to rain, hail, snow, or the like, usually in a violent manner, or with high wind; -- used impersonally; as, it storms. 3. To rage; to be in a violent passion; to fume. The master storms, the lady scolds. Swift.
storm-beat |Beaten, injured, or impaired by storms. Spenser.
stormcock |(a) The missel thrush. (b) The fieldfare. (c) The green woodpecker.
stormfinch |The storm petrel.
stormful |Abounding with storms. \"The stormful east.\" Carlyle. -- Storm\"ful*ness, n.
stormglass |A glass vessel, usually cylindrical, filled with a solution which is sensitive to atmospheric changes, indicating by a clouded appearance, rain, snow, etc., and by clearness, fair weather.
stormily |In a stormy manner.
storminess |The state of being stormy; tempestuousness; biosteruousness; impetuousness.
storming |from Storm, v. Storming party (Mil.), a party assigned to the duty of making the first assault in storming a fortress.
stormless |Without storms. Tennyson.
stormwind |A heavy wind; a wind that brings a storm; the blast of a storm. Longfellow.
stormy |1. Characterized by, or proceeding from, a storm; subject to storms; agitated with furious winds; biosterous; tempestous; as, a stormy season; a stormy day or week. \"Beyond the stormy Hebrides.\" Milton. 2. Proceeding from violent agitation or fury; as, a stormy sound; stormy shocks. 3. Violent; passionate; rough; as, stormy passions. Stormy chiefs of a desert but extensive domain. Sir W. Scott.
storthing |The Parliament of Norway, chosen by indirect election once in three years, but holding annual sessions.
storven |p. p. of Starve. Chaucer.
story |A set of rooms on the same floor or level; a floor, or the space between two floors. Also, a horizontal division of a building's exterior considered architecturally, which need not correspond exactly with the stories within. [Written also storey.] Note: A story comprehends the distance from one floor to another; as, a story of nine or ten feet elevation. The spaces between floors are numbered in order, from below upward; as, the lower, second, or third story; a house of one story, of two stories, of five stories. Story post (Arch.), a vertical post used to support a floor or superincumbent wall.\n\n1. A narration or recital of that which has occurred; a description of past events; a history; a statement; a record. One malcontent who did indeed get a name in story. Barrow. Venice, with its unique city and its Impressive story. Ed. Rev. The four great monarchies make the subject of ancient story. Sir W. Temple. 2. The relation of an incident or minor event; a short narrative; a tale; especially, a fictitious narrative less elaborate than a novel; a short romance. Addison. 3. A euphemism or child's word for \"a lie;\" a fib; as, to tell a story. [Colloq.]\n\nTo tell in historical relation; to make the subject of a story; to narrate or describe in story. How worthy he is I will leave to appear hereafter, rather than story him in his own hearing. Shak. It is storied of the brazen colossus in Rhodes, that it was seventy cubits high. Bp. Wilkins.
story-teller |1. One who tells stories; a narrator of anecdotes,incidents, or fictitious tales; as, an amusing story-teller. 2. An historian; -- in contempt. Swift. 3. A euphemism or child's word for \"a liar.\",
  "upsyturvy |Upside down; topsy-turvy. [Obs.] Robert Greene.
story-telling |Being accustomed to tell stories. -- n.  The act or practice of telling stories.
story-writer |1. One who writes short stories, as for magazines. 2. An historian; a chronicler. [Obs.] \"Rathums, the story-writer.\" 1 Esdr. ii. 17.
storybook |A book containing stories, or short narratives, either true or false.
stot |1. A horse. [Obs.] Chaucer. Thorold Rogers. 2. A young bull or ox, especially one three years old. [Prov. Eng. & Scot.]
stote |See Stoat.
stound |To be in pain or sorrow. [Obs. or Prov. Eng. & Scot.]\n\nStunned. [Obs.]\n\n1. A sudden, severe pain or grief; peril; alarm. [Obs.] Spenser. 2. Astonishment; amazement. [Obs.] Spenser. Gay.\n\n1. Hour; time; season. [Obs.] Chaucer. 2. A brief space of time; a moment. [Obs.] Chaucer. In a stound, suddenly. [Obs.] Chaucer.\n\nA vessel for holding small beer. [Prov. Eng.] Halliwell.
stoup |1. A flagon; a vessel or measure for liquids. [Scot.] 2. (Eccl.)  A basin at the entrance of Roman Catholic churches for containing the holy water with which those who enter, dipping their fingers in it, cross themselves; -- called also holy-water stoup.
stour |A battle or tumult; encounter; combat; disturbance; passion. [Obs.] Fairfax. \"That woeful stowre.\" Spenser. She that helmed was in starke stours [fierce conflicts]. Chaucer.\n\nTall; strong; stern. [Obs. or Prov. Eng. & Scot.]
stout |1. Strong; lusty; vigorous; robust; sinewy; muscular; hence, firm; resolute; dauntless. With hearts stern and stout. Chaucer. A stouter champion never handled sword. Shak. He lost the character of a bold, stout, magnanimous man. Clarendon. The lords all stand To clear their cause, most resolutely stout. Daniel. 2. Proud; haughty; arrogant; hard. [Archaic] Your words have been stout against me. Mal. iii. 13. Commonly . . . they that be rich are lofty and stout. Latimer. 3. Firm; tough; materially strong; enduring; as, a stout vessel, stick, string, or cloth. 4. Large; bulky; corpulent. Syn. -- Stout, Corpulent, Portly. Corpulent has reference simply to a superabundance or excess of flesh. Portly implies a kind of stoutness or corpulence which gives a dignified or imposing appearance. Stout, in our early writers (as in the English Bible), was used chiefly or wholly in the sense of strong or bold; as, a stout champion; a stout heart; a stout resistance, etc. At a later period it was used for thickset or bulky, and more recently, especially in England, the idea has been carried still further, so that Taylor says in his Synonyms: \"The stout man has the proportions of an ox; he is corpulent, fat, and fleshy in relation to his size.\" In America, stout is still commonly used in the original sense of strong as, a stout boy; a stout pole.\n\nA strong malt liquor; strong porter. Swift.
stout-hearted |Having a brave heart; courageous. -- Stout\"-heart\"ed*ness, n.
stoutish |Somewhat stout; somewhat corpulent.
stoutly |In a stout manner; lustily; boldly; obstinately; as, he stoutly defended himself.
stoutness |The state or quality of being stout. Syn. -- Strength; bulk; courage; force; valor; lustiness; brawniness; boldness; fortitude; stubbornness.
stovain |A substance, C14H22O2NCl, the hydrochloride of an amino compound containing benzol, used, in solution with strychnine, as a local anæsthetic, esp. by injection into the sheath of the spinal cord, producing anæsthesia below the point of introduction.
stovaine |A substance, C14H22O2NCl, the hydrochloride of an amino compound containing benzol, used, in solution with strychnine, as a local anæsthetic, esp. by injection into the sheath of the spinal cord, producing anæsthesia below the point of introduction.
stove |imp. of Stave.\n\n1. A house or room artificially warmed or heated; a forcing house, or hothouse; a drying room; -- formerly, designating an artificially warmed dwelling or room, a parlor, or a bathroom, but now restricted, in this sense, to heated houses or rooms used for horticultural purposes or in the processes of the arts. When most of the waiters were commanded away to their supper, the parlor or stove being nearly emptied, in came a company of musketeers. Earl of Strafford. How tedious is it to them that live in stoves and caves half a year together, as in Iceland, Muscovy, or under the pole! Burton. 2. An apparatus, consisting essentially of a receptacle for fuel, made of iron, brick, stone, or tiles, and variously constructed, in which fire is made or kept for warming a room or a house, or for culinary or other purposes. Cooking stove, a stove with an oven, opening for pots, kettles, and the like, -- used for cooking. -- Dry stove. See under Dry. -- Foot stove. See under Foot. -- Franklin stove. See in the Vocabulary. -- Stove plant (Bot.), a plant which requires artificial heat to make it grow in cold or cold temperate climates. -- Stove plate, thin iron castings for the parts of stoves.\n\n1. To keep warm, in a house or room, by artificial heat; as, to stove orange trees. Bacon. 2. To heat or dry, as in a stove; as, to stove feathers.
stovehouse |A hothouse.
stovepipe |Pipe made of sheet iron in length and angular or curved pieces fitting together, -- used to connect a portable stove with a chimney flue. Stovepipe hat, the common tall silk hat. [Slang, U.S.]
stover |Fodder for cattle, especially straw or coarse hay. Where live nibbling sheep, And flat meads thatched with stover them to keep. Shak. Thresh barley as yet but as need shall require, Fresh threshed for stover thy cattle desire. Tusser.
stow |1. To place or arrange in a compact mass; to put in its proper place, or in a suitable place; to pack; as, to stowbags, bales, or casks in a ship's hold; to stow hay in a mow; to stow sheaves. Some stow their oars, or stop the leaky sides. Dryden. 2. To put away in some place; to hide; to lodge. Foul thief! where hast thou stowed my daughter Shak. 3. To arrange anything compactly in; to fill, by packing closely; as, to stow a box, car, or the hold of a ship.
stowage |1. The act or method of stowing; as, the stowage of provisions in a vessel. 2. Room in which things may be stowed. Cook. In every vessel is stowage for immense treasures. Addison. 3. The state of being stowed, or put away. \"To have them in safe stowage.\" Shak. 4. Things stowed or packed. Beau. & Fl. 5. Money paid for stowing goods.
stowaway |One who conceals himself board of a vessel about to leave port, or on a railway train, in order to obtain a free passage.
stowboard |A place into which rubbish is put. [Written also stowbord.]
stowce |(a) A windlass. (b) A wooden landmark, to indicate possession of mining land.
stowing |A method of working in which the waste is packed into the space formed by excavating the vein.
stowre |See Stour, a. [Obs.]\n\nSee Stour, n. [Obs.] Spenser.
strabism |Strabismus.
strabismometer |An instrument for measuring the amount of strabismus.
strabismus |An affection of one or both eyes, in which the optic axes can not be directed to the same object, -- a defect due either to undue contraction or to undue relaxation of one or more of the muscles which move the eyeball; squinting; cross-eye.
strabotomy |The operation for the removal of squinting by the division of such muscles as distort the eyeball.
straddle |1. To part the legs wide; to stand or to walk with the legs far apart. 2. To stand with the ends staggered; -- said of the spokes of a wagon wheel where they join the hub.\n\nTo place one leg on one side and the other on the other side of; to stand or sit astride of; as, to straddle a fence or a horse.\n\n1. The act of standing, sitting, or walking, with the feet far apart. 2. The position, or the distance between the feet, of one who straddles; as, a wide straddle. 3. A stock option giving the holder the double privilege of a \"put\" and a \"call,\" i. e., securing to the buyer of the option the right either to demand of the seller at a certain price, within a certain time, certain securities, or to require him to take at the same price, and within the same time, the same securities. [Broker's Cant]
straddling |Applied to spokes when they are arranged alternately in two circles in the hub. See Straddle, v. i., and Straddle, v. t., 3. Knight.
stradometrical |Of, or relating to, the measuring of streets or roads. [R.]
straggle |1. To wander from the direct course or way; to rove; to stray; to wander from the line of march or desert the line of battle; as, when troops are on the march, the men should not straggle. Dryden. 2. To wander at large; to roam idly about; to ramble. The wolf spied out a straggling kid. L'Estrange. 3. To escape or stretch beyond proper limits, as the branches of a plant; to spread widely apart; to shoot too far or widely in growth. Trim off the small, superfluous branches on each side of the hedge that straggle too far out. Mortimer. 4. To be dispersed or separated; to occur at intervals. \"Straggling pistol shots.\" Sir W. Scott. They came between Scylla and Charybdis and the straggling rocks. Sir W. Raleigh.\n\nThe act of straggling. [R.] Carlyle.
straggler |1. One who straggles, or departs from the direct or proper course, or from the company to which he belongs; one who falls behind the rest; one who rambles without any settled direction. 2. A roving vagabond. Shak. 3. Something that shoots, or spreads out, beyond the rest, or too far; an exuberant growth. Let thy hand supply the pruning knife, And crop luxuriant stragglers. Dryden. 4. Something that stands alone or by itself.
straggling |from Straggle, v.
stragglingly |In a straggling manner.
stragulum |The mantle, or pallium, of a bird.
straight |A variant of Strait, a. [Obs. or R.] Egypt is a long country, but it is straight, that is to say, narrow. Sir J. Mandeville.\n\n1. Right, in a mathematical sense; passing from one point to another by the nearest course; direct; not deviating or crooked; as, a straight line or course; a straight piece of timber. And the crooked shall be made straight. Isa. xl. 4. There are many several sorts of crooked lines, but there is only one which is straight. Dryden. 2. (Bot.)  Approximately straight; not much curved; as, straight ribs are such as pass from the base of a leaf to the apex, with a small curve. 3. (Card Playing)  Composed of cards which constitute a regular sequence, as the ace, king, queen, jack, and ten-spot; as, a straight hand; a straight flush. 4. Conforming to justice and rectitude; not deviating from truth or fairness; upright; as, straight dealing. 5. Unmixed; undiluted; as, to take liquor straight. [Slang] 6. Making no exceptions or deviations in one's support of the organization and candidates of a political party; as, a straight Republican; a straight Democrat; also, containing the names of all the regularly nominated candidates of a party and no others; as, a straight ballot. [Political Cant, U.S.] Straight arch (Arch.), a form of arch in which the intrados is straight, but with its joints drawn radially, as in a common arch. -- A straight face, one giving no evidence of merriment or other emotion. -- A straight line. \"That which lies evenly between its extreme points.\" Euclid. \"The shortest line between two points.\" Chauvenet. \"A line which has the same direction through its whole length.\" Newcomb. -- Straight-way valve, a valve which, when opened widely, affords a straight passageway, as for water. walk the straight and narrow.\n\nIn a straight manner; directly; rightly; forthwith; immediately; as, the arrow went straight to the mark. \"Floating straight.\" Shak. I know thy generous temper well; Fling but the appearance of dishonor on it, It straight takes fire, and mounts into a blaze. Addison. Everything was going on straight. W. Black.\n\nA hand of five cards in consecutive order as to value; a sequence. When they are of one suit, it is calles straight flush.\n\nTo straighten. [R.] A Smith.
straight-joint |Having straight joints. Specifically: (a) Applied to a floor the boards of which are so laid that the joints form a continued line transverse to the length of the boards themselves. Brandle & C. (b) In the United States, applied to planking or flooring put together without the tongue and groove, the pieces being laid edge to edge.
straight-lined |Having straight lines.
straight-out |Acting without concealment, obliquity, or compromise; hence, unqualified; thoroughgoing. [Colloq. U.S.] Straight-out and generous indignation. Mrs. Stowe.
straight-pight |Straight in form or upright in position; erect. [Obs.] Shak.
straight-spoken |Speaking with directness; plain-spoken. [Colloq. U.S.] Lowell.
straightedge |A board, or piece of wood or metal, having one edge perfectly straight, -- used to ascertain whether a line is straight or a surface even, and for drawing straight lines.
straighten |1. To make straight; to reduce from a crooked to a straight form. 2. To make right or correct; to reduce to order; as, to straighten one's affairs; to straighten an account. To straighten one's face, to cease laughing or smiling, etc., and compose one's features.\n\nA variant of Straiten. [Obs. or R.]
straightener |One who, or that which, straightens.
straightforth |Straightway. [Obs.]
straightforward |Proceeding in a straight course or manner; not deviating; honest; frank. -- adv.  In a straightforward manner. -- Straight`for\"ward*ly, adv. -- Straight`for\"ward*ness, n.
straighthorn |An orthoceras.
straightly |In a right line; not crookedly.\n\nA variant of Straitly. See 1st Straight.
straightness |The quality, condition, or state, of being straight; as, the straightness of a path.\n\nA variant of Straitness.
straightway |Immediately; without loss of time; without delay. He took the damsel by the hand, and said unto her, Talitha cumi. . . . And straightway the damsel arose. Mark v. 41,42.
straightways |Straightway. [Obs.]
straik |A strake.
strain |1. Race; stock; generation; descent; family. He is of a noble strain. Shak. With animals and plants a cross between different varieties, or between individuals of the same variety but of another strain, gives vigor and fertility to the offspring. Darwin. 2. Hereditary character, quality, or disposition. Intemperance and lust breed diseases, which, propogated, spoil the strain of nation. Tillotson. 3. Rank; a sort. \"The common strain.\" Dryden.\n\n1. To draw with force; to extend with great effort; to stretch; as, to strain a rope; to strain the shrouds of a ship; to strain the cords of a musical instrument. \"To strain his fetters with a stricter care.\" Dryden. 2. (Mech.)  To act upon, in any way, so as to cause change of form or volume, as forces on a beam to bend it. 3. To exert to the utmost; to ply vigorously. He sweats, Strains his young nerves. Shak. They strain their warbling throats To welcome in the spring. Dryden. 4. To stretch beyond its proper limit; to do violence to, in the matter of intent or meaning; as, to strain the law in order to convict an accused person. There can be no other meaning in this expression, however some may pretend to strain it. Swift. 5. To injure by drawing, stretching, or the exertion of force; as, the gale strained the timbers of the ship. 6. To injure in the muscles or joints by causing to make too strong an effort; to harm by overexertion; to sprain; as, to strain a horse by overloading; to strain the wrist; to strain a muscle. Prudes decayed about may track, Strain their necks with looking back. Swift. 7. To squeeze; to press closely. Evander with a close embrace Strained his departing friend. Dryden. 8. To make uneasy or unnatural; to produce with apparent effort; to force; to constrain. He talks and plays with Fatima, but his mirth Is forced and strained. Denham. The quality of mercy is not strained. Shak. 9. To urge with importunity; to press; as, to strain a petition or invitation. Note, if your lady strain his entertainment. Shak. 10. To press, or cause to pass, through a strainer, as through a screen, a cloth, or some porous substance; to purify, or separate from extraneous or solid matter, by filtration; to filter; as, to strain milk through cloth. To strain a point, to make a special effort; especially, to do a degree of violence to some principle or to one's own feelings. -- To strain courtesy, to go beyond what courtesy requires; to insist somewhat too much upon the precedence of others; -- often used ironically. Shak.\n\n1. To make violent efforts. \"Straining with too weak a wing.\" Pope. To build his fortune I will strain a little. Shak. 2. To percolate; to be filtered; as, water straining through a sandy soil.\n\n1. The act of straining, or the state of being strained. Specifically: -- (a) A violent effort; an excessive and hurtful exertion or tension, as of the muscles; as, he lifted the weight with a strain the strain upon a ship's rigging in a gale; also, the hurt or injury resulting; a sprain. Whether any poet of our country since Shakespeare has exerted a greater variety of powers with less strain and less ostentation. Landor. Credit is gained by custom, and seldom recovers a strain. Sir W. Temple. (b) (Mech. Physics)  A change of form or dimensions of a solid or liquid mass, produced by a stress. Rankine. 2. (Mus.)  A portion of music divided off by a double bar; a complete musical period or sentence; a movement, or any rounded subdivision of a movement. Their heavenly harps a lower strain began. Dryden. 3. Any sustained note or movement; a song; a distinct portion of an ode or other poem; also, the pervading note, or burden, of a song, poem, oration, book, etc.; theme; motive; manner; style; also, a course of action or conduct; as, he spoke in a noble strain; there was a strain of woe in his story; a strain of trickery appears in his career. \"A strain of gallantry.\" Sir W. Scott. Such take too high a strain at first. Bacon. The genius and strain of the book of Proverbs. Tillotson. It [Pilgrim's Progress] seems a novelty, and yet contains Nothing but sound and honest gospel strains. Bunyan. 4. Turn; tendency; inborn disposition. Cf. 1st Strain. Because heretics have a strain of madness, he applied her with some corporal chastisements. Hayward.
strainable |1. Capable of being strained. 2. Violent in action. Holinshed.
strainably |Violently. Holinshed.
strained |1. Subjected to great or excessive tension; wrenched; weakened; as, strained relations between old friends. 2. Done or produced with straining or excessive effort; as, his wit was strained.
strainer |1. One who strains. 2. That through which any liquid is passed for purification or to separate it from solid matter; anything, as a screen or a cloth, used to strain a liquid; a device of the character of a sieve or of a filter; specifically, an openwork or perforated screen, as for the end of the suctionpipe of a pump, to prevent large solid bodies from entering with a liquid.
straining |from Strain. Straining piece (Arch.), a short piece of timber in a truss, used to maintain the ends of struts or rafters, and keep them from slipping. See Illust. of Queen-post.
straint |Overexertion; excessive tension; strain. [Obs.] Spenser.
strait |A variant of Straight. [Obs.]\n\n1. Narrow; not broad. Strait is the gate, and narrow is the way, which leadeth unto life, and few there be that find it. Matt. vii. 14. Too strait and low our cottage doors. Emerson. 2. Tight; close; closely fitting. Shak. 3. Close; intimate; near; familiar. [Obs.] \"A strait degree of favor.\" Sir P. Sidney. 4. Strict; scrupulous; rigorous. Some certain edicts and some strait decrees. Shak. The straitest sect of our religion. Acts xxvi. 5 (Rev. Ver.). 5. Difficult; distressful; straited. To make your strait circumstances yet straiter. Secker. 6. Parsimonious; niggargly; mean. [Obs.] I beg cold comfort, and you are so strait, And so ingrateful, you deny me that. Shak.\n\nStrictly; rigorously. [Obs.] Shak.\n\n1. A narrow pass or passage. He brought him through a darksome narrow strait To a broad gate all built of beaten gold. Spenser. Honor travels in a strait so narrow Where one but goes abreast. Shak. 2. Specifically: (Geog.)  A (comparatively) narrow passageway connecting two large bodies of water; -- often in the plural; as, the strait, or straits, of Gibraltar; the straits of Magellan; the strait, or straits, of Mackinaw. We steered directly through a large outlet which they call a strait, though it be fifteen miles broad. De Foe. 3. A neck of land; an isthmus. [R.] A dark strait of barren land. Tennyson. 4. Fig.: A condition of narrowness or restriction; doubt; distress; difficulty; poverty; perplexity; -- sometimes in the plural; as, reduced to great straits. For I am in a strait betwixt two. Phil. i. 23. Let no man, who owns a Providence, grow desperate under any calamity or strait whatsoever. South. Ulysses made use of the pretense of natural infirmity to conceal the straits he was in at that time in his thoughts. Broome.\n\nTo put to difficulties. [Obs.] Shak.
strait-handed |Parsimonious; sparing; niggardly. [R.] -- Strait\"-hand`ed*ness, n. [R.]
strait-jacket |A dress of strong materials for restraining maniacs or those who are violently delirious. It has long sleeves, which are closed at the ends, confining the hands, and may be tied behind the back.
strait-laced |1. Bound with stays. Let nature have scope to fashion the body as she thinks best; we have few well-shaped that are strait-laced. Locke. 2. Restricted; stiff; constrained. [R.] Fuller. 3. Rigid in opinion; strict in manners or morals.
strait-waistcoat |Same as Strait-jacket.
straiten |1. To make strait; to make narrow; hence, to contract; to confine. Waters, when straitened, as at the falls of bridges, give a roaring noise. Bacon. In narrow circuit, straitened by a foe. Milton. 2. To make tense, or tight; to tighten. They straiten at each end the cord. Pope. 3. To restrict; to distress or embarrass in respect of means or conditions of life; -- used chiefly in the past participle; -- as, a man straitened in his circumstances.
straitly |1. In a strait manner; narrowly; strictly; rigorously. Mark i. 43. 2. Closely; intimately. [Obs.]
straitness |The quality or condition of being strait; especially, a pinched condition or situation caused by poverty; as, the straitnessof their circumstances.
strake |imp. of Strike. Spenser.\n\n1. A streak. [Obs.] Spenser.\"White strake.\" Gen. xxx. 37. 2. An iron band by which the fellies of a wheel are secured to each other, being not continuous, as the tire is, but made up of separate pieces. 3. (Shipbuilding)  One breadth of planks or plates forming a continuous range on the bottom or sides of a vessel, reaching from the stem to the stern; a streak. Note: The planks or plates next the keel are called the garboard strakes; the next, or the heavy strakes at the bilge, are the bilge strakes; the next, from the water line to the lower port sill, the wales; and the upper parts of the sides, the sheer strakes. 4. (Mining)  A trough for washing broken ore, gravel, or sand; a launder.
strale |Pupil of the eye. [Prov. Eng.]
stram |To spring or recoil with violence. [Prov. Eng.]\n\nTo dash down; to beat. [Prov. Eng.]
stramash |To strike, beat, or bang; to break; to destroy. [Scot. & Prov. Eng.]\n\nA turmoil; a broil; a fray; a fight. [Scot. & Prov. Eng.] Barham.
stramazoun |A direct descending blow with the edge of a sword. [Obs.] B. Jonson.
stramineous |1. Strawy; consisting of straw. Robinson. 2. Chaffy; like straw; straw-colored. Burton.
stramonium |A poisonous plant (Datura Stramonium); stinkweed. See Datura, and Jamestown weed.
stramony |Stramonium.
strand |One of the twists, or strings, as of fibers, wires, etc., of which a rope is composed.\n\nTo break a strand of (a rope).\n\nThe shore, especially the beach of a sea, ocean, or large lake; rarely, the margin of a navigable river. Chaucer. Strand birds. (Zoöl.) See Shore birds, under Shore. -- Strand plover (Zoöl.), a black-bellied plover. See Illust. of Plover. -- Strand wolf (Zoöl.), the brown hyena.\n\nTo drive on a strand; hence, to run aground; as, to strand a ship.\n\nTo drift, or be driven, on shore to run aground; as, the ship stranded at high water.
strang |Strong. [Obs. or Prov. Eng. & Scot.] Halliwell.
strange |1. Belonging to another country; foreign. \"To seek strange strands.\" Chaucer. One of the strange queen's lords. Shak. I do not contemn the knowledge of strange and divers tongues. Ascham. 2. Of or pertaining to others; not one's own; not pertaining to one's self; not domestic. So she, impatient her own faults to see, Turns from herself, and in strange things delights. Sir J. Davies. 3. Not before known, heard, or seen; new. Here is the hand and seal of the duke; you know the character, I doubt not; and the signet is not strange to you. Shak. 4. Not according to the common way; novel; odd; unusual; irregular; extraordinary; unnatural; queer. \"He is sick of a strange fever.\" Shak. Sated at length, erelong I might perceive Strange alteration in me. Milton. 5. Reserved; distant in deportment. Shak. She may be strange and shy at first, but will soon learn to love thee. Hawthorne. 6. Backward; slow. [Obs.] Who, loving the effect, would not be strange In favoring the cause. Beau. & Fl. 7. Not familiar; unaccustomed; inexperienced. In thy fortunes am unlearned and strange. Shak. Note: Strange is often used as an exclamation. Strange! what extremes should thus preserve the snow High on the Alps, or in deep caves below. Waller. Strange sail (Naut.), an unknown vessel. -- Strange woman (Script.), a harlot. Prov. v. 3. -- To make it strange. (a) To assume ignorance, suspicion, or alarm, concerning it. Shak. (b) To make it a matter of difficulty. [Obs.] Chaucer. -- To make strange, To make one's self strange. (a) To profess ignorance or astonishment. (b) To assume the character of a stranger. Gen. xlii. 7. Syn. -- Foreign; new; outlandish; wonderful; astonishing; marvelous; unusual; odd; uncommon; irregular; queer; eccentric.\n\nStrangely. [Obs.] Most strange, but yet most truly, will I speak. Shak.\n\nTo alienate; to estrange. [Obs.]\n\n1. To be estranged or alienated. [Obs.] 2. To wonder; to be astonished. [Obs.] Glanvill.
strangely |1. As something foreign, or not one's own; in a manner adapted to something foreign and strange. [Obs.] Shak. 2. In the manner of one who does not know another; distantly; reservedly; coldly. You all look strangely on me. Shak. I do in justice charge thee . . . That thou commend it strangely to some place Where chance may nurse or end it. Shak. 3. In a strange manner; in a manner or degree to excite surprise or wonder; wonderfully. How strangely active are the arts of peace! Dryden. It would strangely delight you to see with what spirit he converses. Law.
strangeness |The state or quality of being strange (in any sense of the adjective).
stranger |1. One who is strange, foreign, or unknown. Specifically: -- (a) One who comes from a foreign land; a foreigner. I am a most poor woman and a stranger, Born out of your dominions. Shak. (b) One whose home is at a distance from the place where he is, but in the same country. (c) One who is unknown or unacquainted; as, the gentleman is a stranger to me; hence, one not admitted to communication, fellowship, or acquaintance. Melons on beds of ice are taught to bear, And strangers to the sun yet ripen here. Granville. My child is yet a stranger in the world. Shak. I was no stranger to the original. Dryden. 2. One not belonging to the family or household; a guest; a visitor. To honor and receive Our heavenly stranger. Milton. 3. (Law)  One not privy or party an act, contract, or title; a mere intruder or intermeddler; one who interferes without right; as, actual possession of land gives a good title against a stranger having no title; as to strangers, a mortgage is considered merely as a pledge; a mere stranger to the levy.\n\nTo estrange; to alienate. [Obs.] Shak.
strangle |1. To compress the windpipe of (a person or animal) until death results from stoppage of respiration; to choke to death by compressing the throat, as with the hand or a rope. Our Saxon ancestors compelled the adulteress to strangle herself. Ayliffe. 2. To stifle, choke, or suffocate in any manner. Shall I not then be stifled in the vault, . . . And there die strangled ere my Romeo comes Shak. 3. To hinder from appearance; to stifle; to suppress. \"Strangle such thoughts.\" Shak.\n\nTo be strangled, or suffocated.
strangle hold |In wrestling, a hold by which one's opponent is choked. It is usually not allowed.
strangleable |Capable of being strangled. [R.] Chesterfield.
strangler |One who, or that which, strangles. \"The very strangler of their amity.\" Shak.
strangles |A disease in horses and swine, in which the upper part of the throat, or groups of lymphatic glands elsewhere, swells.
strangulate |Strangulated.
strangulated |1. (Med.)  Having the circulation stopped by compression; attended with arrest or obstruction of circulation, caused by constriction or compression; as, a strangulated hernia. 2. (Bot.)  Contracted at irregular intervals, if tied with a ligature; constricted. Strangulated hernia. (Med.) See under Hernia.
strangulation |1. The act of strangling, or the state of being strangled. 2. (Med.)  Inordinate compression or constriction of a tube or part, as of the throat; especially, such as causes a suspension of breathing, of the passage of contents, or of the circulation, as in cases of hernia.
strangurious |Of or pertaining to strangury. Cheyne.
strangury |1. (Med.)  A painful discharge of urine, drop by drop, produced by spasmodic muscular contraction. 2. (Bot.)  A swelling or other disease in a plant, occasioned by a ligature fastened tightly about it.
strany |The guillemot. [Prov. Eng.]
strap |1. A long, narrow, pliable strip of leather, cloth, or the like; specifically, a strip of thick leather used in flogging. A lively cobbler that . . . had scarce passed a day without giving her [his wife] the discipline of the strap. Addison. 2. Something made of such a strip, or of a part of one, or a combination of two or more for a particular use; as, a boot strap, shawl strap, stirrup strap. 3. A piece of leather, or strip of wood covered with a suitable material, for sharpening a razor; a strop. 4. A narrow strip of anything, as of iron or brass. Specifically: -- (a) (Carp. & Mach.)  A band, plate, or loop of metal for clasping and holding timbers or parts of a machine. (b) (Naut.)  A piece of rope or metal passing around a block and used for fastening it to anything. 5. (Bot.) (a) The flat part of the corolla in ligulate florets, as those of the white circle in the daisy. (b) The leaf, exclusive of its sheath, in some grasses. 6. A shoulder strap. See under Shoulder. Strap bolt, a bolt of which one end is a flat bar of considerable length. -- Strap head (Mach.), a journal box, or pair of brasses, secured to the end of a connecting rod by a strap. See Illust. of Gib and key, under Gib. -- Strap hinge, a hinge with long flaps by which it is fastened, as to a door or wall. -- Strap rail (Railroads), a flat rail formerly used.\n\n1. To beat or chastise with a strap. 2. To fasten or bind with a strap. Cowper. 3. To sharpen by rubbing on a strap, or strop; as, to strap a razor.
strap-shaped |Shaped like a strap; ligulate; as, a strap-shaped corolla.
strappado |A military punishment formerly practiced, which consisted in drawing an offender to the top of a beam and letting him fall to the length of the rope, by which means a limb was often dislocated. Shak.\n\nTo punish or torture by the strappado. Milton.
strapper |1. One who uses strap. 2. A person or thing of uncommon size. [Colloq.]
strapping |Tall; strong; lusty; large; as, a strapping fellow. [Colloq.] There are five and thirty strapping officers gone. Farquhar.
strapple |To hold or bind with, or as with, a strap; to entangle. [Obs.] Chapman.
strapwork |A kind of ornament consisting of a narrow fillet or band folded, crossed, and interlaced.
strass |A brilliant glass, used in the manufacture of artificial paste gems, which consists essentially of a complex borosilicate of lead and potassium. Cf. Glass.
strata |pl. of Stratum.
stratagem |An artifice or trick in war for deceiving the enemy; hence, in general, artifice; deceptive device; secret plot; evil machination. Fit for treasons, stratagems, and spoils. Shak. Those oft are stratagems which error seem, Nor is it Homer nods, but we that dream. Pope.
stratagemical |Containing stratagem; as, a stratagemical epistle. [R.] Swift.
stratarithmetry |The art of drawing up an army, or any given number of men, in any geometrical figure, or of estimating or expressing the number of men in such a figure.
strategetic |Strategic.
strategetical |Strategic.
strategetics |Strategy.
strategic |Of or pertaining to strategy; effected by artifice. -- Stra*te\"gic*al*ly, adv. Strategic line (Mil.), a line joining strategic points. -- Strategic point (Mil.), any point or region in the theater or warlike operations which affords to its possessor an advantage over his opponent, as a mountain pass, a junction of rivers or roads, a fortress, etc.
strategical |Of or pertaining to strategy; effected by artifice. -- Stra*te\"gic*al*ly, adv. Strategic line (Mil.), a line joining strategic points. -- Strategic point (Mil.), any point or region in the theater or warlike operations which affords to its possessor an advantage over his opponent, as a mountain pass, a junction of rivers or roads, a fortress, etc.
strategics |Strategy.
strategist |One skilled in strategy, or the science of directing great military movements.
strategus |The leader or commander of an army; a general.
strategy |1. The science of military command, or the science of projecting campaigns and directing great military movements; generalship. 2. The use of stratagem or artifice.
strath |A valley of considerable size, through which a river runs; a valley bottom; -- often used in composition with the name of the river; as, Strath Spey, Strathdon, Strathmore. [Scot.] The long green strath of Napa valley. R. L. Stevenson.
strathspey |A lively Scottish dance, resembling the reel, but slower; also, the tune.
straticulate |Characterized by the presence of thin parallel strata, or layers, as in an agate.
stratification |1. The act or process of laying in strata, or the state of being laid in the form of strata, or layers. 2. (Physiol.)  The deposition of material in successive layers in the growth of a cell wall, thus giving rise to a stratified appearance.
stratified |Having its substance arranged in strata, or layers; as, stratified rock.
stratiform |Having the form of strata.
stratify |To form or deposit in strata, or layers, as substances in the earth; to arrange in strata.
stratigraphic |Pertaining to, or depended upon, the order or arrangement of strata; as, stratigraphical evidence. -- Strat`i*graph\"ic*al*ly, adv.\n\nSee Stratographic.
stratigraphical |Pertaining to, or depended upon, the order or arrangement of strata; as, stratigraphical evidence. -- Strat`i*graph\"ic*al*ly, adv.\n\nSee Stratographic.
stratigraphy |That branch of geology which treats of the arrangement and succession of strata.
strato-cirrus |An alto-stratus cloud.
strato-cumulus |Large balls or rolls of dark cloud which frequently cover the whole sky, esp. in winter, and give it at times an undulated appearance.
stratocracy |A military government; government by military chiefs and an army.
stratographic |Of or pertaining to stratography.
stratographical |Of or pertaining to stratography.
stratography |A description of an army, or of what belongs to an army.
stratonic |Of or pertaining to an army. [R.]
stratotic |Warlike; military. [R.]
stratum |1. (Geol.)  A bed of earth or rock of one kind, formed by natural causes, and consisting usually of a series of layers, which form a rock as it lies between beds of other kinds. Also used figuratively. 2. A bed or layer artificially made; a course.
stratus |A form of clouds in which they are arranged in a horizontal band or layer. See Cloud.
straught |imp. & p. p. of Stretch.\n\nTo stretch; to make straight. [Written also straucht.] [Scot.] Sir W. Scott.
straw |To spread or scatter. See Strew, and Strow. Chaucer.\n\n1. A stalk or stem of certain species of grain, pulse, etc., especially of wheat, rye, oats, barley, more rarely of buckwheat, beans, and pease. 2. The gathered and thrashed stalks of certain species of grain, etc.; as, a bundle, or a load, of rye straw. 3. Anything proverbially worthless; the least possible thing; a mere trifle. I set not a straw by thy dreamings. Chaucer. Note: Straw is often used in the formation of self-explaining compounds; as, straw-built, straw-crowned, straw-roofed, straw- stuffed, and the like. Man of straw, an effigy formed by stuffing the garments of a man with straw; hence, a fictitious person; an irresponsible person; a puppet.set up a straw man; -- used in disputation. Typically, one party accuses an opponent of setting up a straw man, meaning that the opponent is distorting his true opinion in order to make it look absurd. -- Straw bail, worthless bail, as being given by irresponsible persons. [Colloq. U.S.] -- Straw bid, a worthless bid; a bid for a contract which the bidder is unable or unwilling to fulfill. [Colloq. U.S.] -- Straw cat (Zoöl.), the pampas cat. -- Straw color, the color of dry straw, being a delicate yellow. -- Straw drain, a drain filled with straw. -- Straw plait, or Straw plat, a strip formed by plaiting straws, used for making hats, bonnets, etc. -- To be in the straw, to be brought to bed, as a pregnant woman. [Slang]
straw-colored |Being of a straw color. See Straw color, under Straw, n.
straw-cutter |An instrument to cut straw for fodder.
strawberry |A fragrant edible berry, of a delicious taste and commonly of a red color, the fruit of a plant of the genus Fragaria, of which there are many varieties. Also, the plant bearing the fruit. The common American strawberry is Fragaria virginiana; the European, F. vesca. There are also other less common species. Strawberry bass. (Zoöl.) See Calico bass, under Calico. -- Strawberry blite. (Bot.) See under Blite. -- Strawberry borer (Zoöl.), any one of several species of insects whose larvæ burrow in the crown or roots of the strawberry vine. Especially: (a) The root borer (Anarsia lineatella), a very small dark gray moth whose larvæ burrow both in the larger roots and crown, often doing great damage. (b) The crown borer (Tyloderma fragariæ), a small brown weevil whose larva burrows in the crown and kills the plant. -- Strawberry bush (Bot.), an American shrub (Euonymus Americanus), a kind of spindle tree having crimson pods and the seeds covered with a scarlet aril. -- Strawberry crab (Zoöl.), a small European spider crab (Eurynome aspera); -- so called because the back is covered with pink tubercles. -- Strawberry fish (Zoöl.), the amadavat. -- Strawberry geranium (Bot.), a kind of saxifrage (Saxifraga sarmentosa) having reniform leaves, and producing long runners like those of the strawberry. -- Strawberry leaf. (a) The leaf of the strawberry. (b) The symbol of the rank or estate of a duke, because the ducal coronet is twined with strawberry leaves. \"The strawberry leaves on her chariot panels are engraved on her ladyship's heart.\" Thackeray. -- Strawberry-leaf roller (Zoöl.), any one of several species of moths whose larvæ roll up, and feed upon, the leaves of the strawberry vine; especially, Phoxopteris fragariæ, and Eccopsis permundana. -- Strawberry moth (Zoöl.), any one of several species of moth whose larvæ feed on the strawberry vines; as: (a) The smeared dagger (Apatela oblinita), whose large hairy larva is velvety black with two rows of bright yellow spots on each side. (b) A geometrid (Angerona crocataria) which is yellow with dusky spots on the wings. Called also currant moth. -- Strawberry pear (Bot.), the red ovoid fruit of a West Indian plant of the genus Cereus (C. triangularia). It has a sweetish flavor, and is slightly acid, pleasant, and cooling. Also, the plant bearing the fruit. -- Strawberry sawfly (Zoöl.), a small black sawfly (Emphytus maculatus) whose larva eats the leaves of the strawberry vine. -- Strawberry tomato. (Bot.) See Alkekengi. -- Strawberry tree. (Bot.) See Arbutus. -- Strawberry vine (Bot.), the plant which yields the strawberry. -- Strawberry worm (Zoöl.), the larva of any moth which feeds on the strawberry vine.
strawboard |Pasteboard made of pulp of straw.
strawed |imp. & p. p. of Straw. [Obs.]
strawworm |A caddice worm.
strawy |Of or pertaining to straw; made of, or resembling, straw. Shak.
stray |1. To wander, as from a direct course; to deviate, or go out of the way. Thames among the wanton valleys strays. Denham. 2. To wander from company, or from the proper limits; to rove at large; to roam; to go astray. Now, until the break of day, Through this house each fairy stray. Shak. A sheep doth very often stray. Shak. 3. Figuratively, to wander from the path of duty or rectitude; to err. We have erred and strayed from thy ways. While meaner things, whom instinct leads, Are rarely known to stray. Cowper. Syn. -- To deviate; err; swerve; rove; roam; wander.\n\nTo cause to stray. [Obs.] Shak.\n\nHaving gone astray; strayed; wandering; as, a strayhorse or sheep. Stray line (Naut.), that portion of the log line which is veered from the reel to allow the chip to get clear of the stern eddies before the glass is turned. -- Stray mark (Naut.), the mark indicating the end of the stray line.\n\n1. Any domestic animal that has an inclosure, or its proper place and company, and wanders at large, or is lost; an estray. Used also figuratively. Seeing him wander about, I took him up for a stray. Dryden. 2. The act of wandering or going astray. [R.] Shak.
strayer |One who strays; a wanderer.
stre |Straw. [Obs.] Chaucer.
streak |To stretch; to extend; hence, to lay out, as a dead body. [Obs. or Prov. Eng. & Scot.]\n\n1. A line or long mark of a different color from the ground; a stripe; a vein. What mean those colored streaks in heaven Milton. 2. (Shipbuilding)  A strake. 3. (Min.)  The fine powder or mark yielded by a mineral when scratched or rubbed against a harder surface, the color of which is sometimes a distinguishing character. 4. The rung or round of a ladder. [Obs.]\n\n1. To form streaks or stripes in or on; to stripe; to variegate with lines of a different color, or of different colors. A mule . . . streaked and dappled with white and black. Sandys. Now streaked and glowing with the morning red. Prior. 2. With it as an object: To run swiftly. [Colloq.]
streaked |1. Marked or variegated with stripes. 2. Uncomfortable; out of sorts. [Local, U.S.]
streaky |Same as Streaked, 1. \"The streaky west.\" Cowper.
stream |1. A current water or other fluid; a liquid flowing continuously in a line or course, either on the earth, as a river, brook, etc., or from a vessel, reservoir, or fountain; specifically, any course of running water; as, many streams are blended in the Mississippi; gas and steam came from the earth in streams; a stream of molten lead from a furnace; a stream of lava from a volcano. 2. A beam or ray of light. \"Sun streams.\" Chaucer. 3. Anything issuing or moving with continued succession of parts; as, a stream of words; a stream of sand. \"The stream of beneficence.\" Atterbury. \"The stream of emigration.\" Macaulay. 4. A continued current or course; as, a stream of weather. \"The very stream of his life.\" Shak. 5. Current; drift; tendency; series of tending or moving causes; as, the stream of opinions or manners. Gulf stream. See under Gulf. -- Stream anchor, Stream cable. (Naut.) See under Anchor, and Cable. -- Stream ice, blocks of ice floating in a mass together in some definite direction. -- Stream tin, particles or masses of tin ore found in alluvial ground; -- so called because a stream of water is the principal agent used in separating the ore from the sand and gravel. -- Stream works (Cornish Mining), a place where an alluvial deposit of tin ore is worked. Ure. -- To float with the stream, figuratively, to drift with the current of opinion, custom, etc., so as not to oppose or check it. Syn. -- Current; flow; rush; tide; course. -- Stream, Current. These words are often properly interchangeable; but stream is the broader word, denoting a prevailing onward course. The stream of the Mississippi rolls steadily on to the Gulf of Mexico, but there are reflex currents in it which run for a while in a contrary direction.\n\n1. To issue or flow in a stream; to flow freely or in a current, as a fluid or whatever is likened to fluids; as, tears streamed from her eyes. Beneath those banks where rivers stream. Milton. 2. To pour out, or emit, a stream or streams. A thousand suns will stream on thee. Tennyson. 3. To issue in a stream of light; to radiate. 4. To extend; to stretch out with a wavy motion; to float in the wind; as, a flag streams in the wind.\n\nTo send forth in a current or stream; to cause to flow; to pour; as, his eyes streamed tears. It may so please that she at length will stream Some dew of grace into my withered heart. Spenser. 2. To mark with colors or embroidery in long tracts. The herald's mantle is streamed with gold. Bacon. 3. To unfurl. Shak. To stream the buoy. (Naut.) See under Buoy.
stream clock |An instrument for ascertaining the velocity of the blood in a vessel.
stream gold |Gold in alluvial deposits; placer gold.
stream line |The path of a constituent particle of a flowing fluid undisturbed by eddies or the like.
stream wheel |A wheel used for measuring, by its motion when submerged, the velocity of flowing water; a current wheel.
streamer |1. An ensign, flag, or pennant, which floats in the wind; specifically, a long, narrow, ribbonlike flag. Brave Rupert from afar appears, Whose waving streamers the glad general knows. Dryden. 3. A stream or column of light shooting upward from the horizon, constituting one of the forms of the aurora borealis. Macaulay. While overhead the North's dumb streamers shoot. Lowell. 3. (Mining)  A searcher for stream tin.
streamful |Abounding in streams, or in water. \"The streamful tide.\" Drayton.
streaminess |The state of being streamy; a trailing. R. A. Proctor.
streaming |Sending forth streams.\n\n1. The act or operation of that which streams; the act of that which sends forth, or which runs in, streams. 2. (Mining)  The reduction of stream tin; also, the search for stream tin.
streamless |Destitute of streams, or of a stream, as a region of country, or a dry channel.
streamlet |A small stream; a rivulet; a rill.
streamline |Of or pert. to a stream line; designating a motion or flow that is free from turbulence, like that of a particle in a streamline; hence, designating a surface, body, etc., that is designed so as to afford an unbroken flow of a fluid about it, esp. when the resistance to flow is the least possible; as, a streamline body for an automobile or airship.
streamy |1. Abounding with streams, or with running water; streamful. Arcadia However streamy now, adust and dry, Denied the goddess water. Prior. 2. Resembling a stream; issuing in a stream. His nodding helm emits a streamy ray. Pope.
stree |Straw. [Obs.] Chaucer.
streek |To stretch; also, to lay out, as a dead body. See Streak. [Obs. or Prov. Eng. & Scot.]
streel |To trail along; to saunter or be drawn along, carelessly, swaying in a kind of zigzag motion. [Colloq.] Thackeray.
streen |See Strene. [Obs.] Chaucer.
street |Originally, a paved way or road; a public highway; now commonly, a thoroughfare in a city or village, bordered by dwellings or business houses. He removed [the body of] Amasa from the street unto the field. Coverdale. At home or through the high street passing. Milton. Note: In an extended sense, street designates besides the roadway, the walks, houses, shops, etc., which border the thoroughfare. His deserted mansion in Duke Street. Macaulay. The street (Broker's Cant), that thoroughfare of a city where the leading bankers and brokers do business; also, figuratively, those who do business there; as, the street would not take the bonds. -- Street Arab, Street broker, etc. See under Arab, Broker, etc. -- Street door, a door which opens upon a street, or is nearest the street. Syn. -- See Way.
streetwalker |A common prostitute who walks the streets to find customers.
streetward |An officer, or ward, having the care of the streets. [Obs.] Cowell.\n\nFacing toward the street. Their little streetward sitting room. Tennyson.
streight |See 2nd Strait. [Obs.]
streighten |See Straiten. [Obs.]
strein |To strain. [Obs.] Chaucer.
streit |Drawn. [Obs.] Pyrrhus with his streite sword. Chaucer.\n\nClose; narrow; strict. [Obs.] See Strait.
streite |Narrowly; strictly; straitly. [Obs.]
strelitz |A soldier of the ancient Muscovite guard or Russian standing army; also, the guard itself.
strelitzia |A genus of plants related to the banana, found at the Cape of Good Hope. They have rigid glaucous distichous leaves, and peculiar richly colored flowers.
strene |Race; offspring; stock; breed; strain. [Obs.] Chaucer.
strenger |, the original compar. & superl. of Strong. [Obs.] Two of us shall strenger be than one. Chaucer.
strengest |, the original compar. & superl. of Strong. [Obs.] Two of us shall strenger be than one. Chaucer.
strength |1. The quality or state of being strong; ability to do or to bear; capacity for exertion or endurance, whether physical, intellectual, or moral; force; vigor; power; as, strength of body or of the arm; strength of mind, of memory, or of judgment. All his [Samson's] strength in his hairs were. Chaucer. Thou must outlive Thy youth, thy strength, thy beauty. Milton. 2. Power to resist force; solidity or toughness; the quality of bodies by which they endure the application of force without breaking or yielding; -- in this sense opposed to frangibility; as, the strength of a bone, of a beam, of a wall, a rope, and the like. \"The brittle strength of bones.\" Milton. 3. Power of resisting attacks; impregnability. \"Our castle's strength will laugh a siege to scorn.\" Shak. 4. That quality which tends to secure results; effective power in an institution or enactment; security; validity; legal or moral force; logical conclusiveness; as, the strength of social or legal obligations; the strength of law; the strength of public opinion; strength of evidence; strength of argument. 5. One who, or that which, is regarded as embodying or affording force, strength, or firmness; that on which confidence or reliance is based; support; security. God is our refuge and strength. Ps. xlvi. 1. What they boded would be a mischief to us, you are providing shall be one of our principal strengths. Sprat. Certainly there is not a greater strength against temptation. Jer. Taylor. 6. Force as measured; amount, numbers, or power of any body, as of an army, a navy, and the like; as, what is the strength of the enemy by land, or by sea 7. Vigor or style; force of expression; nervous diction; -- said of literary work. And praise the easy vigor of a life Where Denham's strength and Waller's sweetness join. Pope. 8. Intensity; -- said of light or color. Bright Phoebus in his strength. Shak. 9. Intensity or degree of the distinguishing and essential element; spirit; virtue; excellence; -- said of liquors, solutions, etc.; as, the strength of wine or of acids. 10. A strong place; a stronghold. [Obs.] Shak. On, or Upon, the strength of, in reliance upon. \"The allies, after a successful summer, are too apt, upon the strength of it, to neglect their preparations for the ensuing campaign.\" Addison. Syn. -- Force; robustness; toughness; hardness; stoutness; brawniness; lustiness; firmness; puissance; support; spirit; validity; authority. See Force.\n\nTo strengthen. [Obs.] Chaucer.
strengthen |1. To make strong or stronger; to add strength to; as, to strengthen a limb, a bridge, an army; to strengthen an obligation; to strengthen authority. Let noble Warwick, Cobham, and the rest, . . . With powerful policy strengthen themselves. Shak. 2. To animate; to encourage; to fix in resolution. Charge Joshua, and encourage him, and strengthen him. Deut. iii. 28. Syn. -- To invigorate; confirm; establish; fortify; animate; encourage.\n\nTo grow strong or stronger. The young disease, that must subdue at length, Grows with his growth, and strengthens with his strength. Pope.
strengthener |One who, or that which, gives or adds strength. Sir W. Temple.
strengthening |That strengthens; giving or increasing strength. -- Strength\"en*ing*ly, adv. Strengthening plaster (Med.), a plaster containing iron, and supposed to have tonic effects.
strengthful |Abounding in strength; full of strength; strong. -- Strength\"ful*ness, n. Florence my friend, in court my faction Not meanly strengthful. Marston.
strengthing |A stronghold. [Obs.]
strengthless |Destitute of strength. Boyle.
strengthner |See Strengthener.
strengthy |Having strength; strong. [Obs.]
strenuity |Strenuousness; activity. [Obs.] Chapman.
strenuous |Eagerly pressing or urgent; zealous; ardent; earnest; bold; valiant; intrepid; as, a strenuous advocate for national rights; a strenuous reformer; a strenuous defender of his country. And spirit-stirring wine, that strenuous makes. Chapman. Strenuous, continuous labor is pain. I. Taylor. -- Stren\"u*ous*ly, adv. -- Stren\"u*ous*ness, n.
strepent |Noisy; loud. [R.] Shenstone.
streperous |Loud; boisterous. [R.] Sir T. Browne.
strepitores |A division of birds, including the clamatorial and picarian birds, which do not have well developed singing organs.
strepsipter |One of the Strepsiptera.
strepsiptera |A group of small insects having the anterior wings rudimentary, and in the form of short and slender twisted appendages, while the posterior ones are large and membranous. They are parasitic in the larval state on bees, wasps, and the like; -- called also Rhipiptera. See Illust. under Rhipipter.
strepsipteran |One of the Strepsiptera.
strepsipterous |Of or pertaining to Strepsiptera.
strepsorhina |Same as Lemuroidea.
strepsorhine |Having twisted nostrils; -- said of the lemurs. -- n. (Zoöl.)  One of the Strepsorhina; a lemur. See Illust. under Monkey.
streptobacteria |A so-called variety of bacterium, consisting in reality of several bacteria linked together in the form of a chain.
streptococcus |A long or short chain of micrococci, more or less curved.
streptoneura |An extensive division of gastropod Mollusca in which the loop or visceral nerves is twisted, and the sexes separate. It is nearly to equivalent to Prosobranchiata.
streptothrix |A genus of bacilli occurring of the form of long, smooth and apparently branched threads, either straight or twisted.
stress |1. Distress. [Obs.] Sad hersal of his heavy stress. Spenser. 2. Pressure, strain; -- used chiefly of immaterial things; except in mechanics; hence, urgency; importance; weight; significance. The faculties of the mind are improved by exercise, yet they must not be put to a stress beyond their strength. Locke. A body may as well lay too little as too much stress upon a dream. L'Estrange. 3. (Mech. & Physics)  The force, or combination of forces, which produces a strain; force exerted in any direction or manner between contiguous bodies, or parts of bodies, and taking specific names according to its direction, or mode of action, as thrust or pressure, pull or tension, shear or tangential stress. Rankine. Stress is the mutual action between portions of matter. Clerk Maxwell. 4. (Pron.)  Force of utterance expended upon words or syllables. Stress is in English the chief element in accent and is one of the most important in emphasis. See Guide to pronunciation, §§ 31-35. 5. (Scots Law)  Distress; the act of distraining; also, the thing distrained. Stress of voice, unusual exertion of the voice. -- Stress of weather, constraint imposed by continued bad weather; as, to be driven back to port by stress of weather. -- To lay stress upon, to attach great importance to; to emphasize. \"Consider how great a stress is laid upon this duty.\" Atterbury. -- To put stress upon, or To put to a stress, to strain.\n\n1. To press; to urge; to distress; to put to difficulties. [R.] Spenser. 2. To subject to stress, pressure, or strain.
stressful |Having much stress. Rush.
stretch |1. To reach out; to extend; to put forth. And stretch forth his neck long and small. Chaucer. I in conquest stretched mine arm. Shak. 2. To draw out to the full length; to cause to extend in a straight line; as, to stretch a cord or rope. 3. To cause to extend in breadth; to spread; to expand; as, to stretch cloth; to stretch the wings. 4. To make tense; to tighten; to distend forcibly. The ox hath therefore stretched his yoke in vain. Shak. 5. To draw or pull out to greater length; to strain; as, to stretch a tendon or muscle. Awake, my soul, stretch every nerve. Doddridge. 6. To exaggerate; to extend too far; as, to stretch the truth; to stretch one's credit. They take up, one day, the most violent and stretched prerogative. Burke.\n\n1. To be extended; to be drawn out in length or in breadth, or both; to spread; to reach; as, the iron road stretches across the continent; the lake stretches over fifty square miles. As far as stretcheth any ground. Gower. 2. To extend or spread one's self, or one's limbs; as, the lazy man yawns and stretches. 3. To be extended, or to bear extension, without breaking, as elastic or ductile substances. The inner membrane . . . because it would stretch and yield, remained umbroken. Boyle. 4. To strain the truth; to exaggerate; as, a man apt to stretch in his report of facts. [Obs. or Colloq.] 5. (Naut.)  To sail by the wind under press of canvas; as, the ship stretched to the eastward. Ham. Nav. Encyc. Stretch out, an order to rowers to extend themselves forward in dipping the oar.\n\n1. Act of stretching, or state of being stretched; reach; effort; struggle; strain; as, a stretch of the limbs; a stretch of the imagination. By stretch of arms the distant shore to gain. Dryden. Those put a lawful authority upon the stretch, to the abuse of yower, under the color of prerogative. L'Estrange. 2. A continuous line or surface; a continuous space of time; as, grassy stretches of land. A great stretch of cultivated country. W. Black. But all of them left me a week at a stretch. E. Eggleston. 3. The extent to which anything may be stretched. Quotations, in their utmost stretch, can signify no more than that Luther lay under severe agonies of mind. Atterbury. This is the utmost stretch that nature can. Granville. 4. (Naut.)  The reach or extent of a vessel's progress on one tack; a tack or board. 5. Course; direction; as, the stretch of seams of coal. To be on the stretch, to be obliged to use one's utmost powers. -- Home stretch. See under Home, a.
stretcher |1. One who, or that which, stretches. 2. (Masonry)  A brick or stone laid with its longer dimension in the line of direction of the wall. Gwilt. 3. (Arch.)  A piece of timber used in building. 4. (Naut.) (a) A narrow crosspiece of the bottom of a boat against which a rower braces his feet. (b) A crosspiece placed between the sides of a boat to keep them apart when hoisted up and griped. Dana. 5. A litter, or frame, for carrying disabled, wounded, or dead persons. 6. An overstretching of the truth; a lie. [Slang] 7. One of the rods in an umbrella, attached at one end to one of the ribs, and at the other to the tube sliding upon the handle. 8. An instrument for stretching boots or gloves. 9. The frame upon which canvas is stretched for a painting.
stretching |from Stretch, v. Stretching course (Masonry), a course or series of stretchers. See Stretcher, 2. Britton.
stretto |(a) The crowding of answer upon subject near the end of a fugue. (b) In an opera or oratorio, a coda, or winding up, in an accelerated time. [Written also stretta.]
strew |1. To scatter; to spread by scattering; to cast or to throw loosely apart; -- used of solids, separated or separable into parts or particles; as, to strew seed in beds; to strew sand on or over a floor; to strew flowers over a grave. And strewed his mangled limbs about the field. Dryden. On a principal table a desk was open and many papers [were] strewn about. Beaconsfield. 2. To cover more or less thickly by scattering something over or upon; to cover, or lie upon, by having been scattered; as, they strewed the ground with leaves; leaves strewed the ground. The snow which does the top of Pindus strew. Spenser. Is thine alone the seed that strews the plain Pope. 3. To spread abroad; to disseminate. She may strew dangerous conjectures. Shak.
strewing |1. The act of scattering or spreading. 2. Anything that is, or may be, strewed; -- used chiefly in the plural. Shak.
strewment |Anything scattered, as flowers for decoration. [Obs.] Shak.
strewn |p. p. of Strew.
stria |1. A minute groove, or channel; a threadlike line, as of color; a narrow structural band or line; a striation; as, the striæ, or groovings, produced on a rock by a glacier passing over it; the striæ on the surface of a shell; a stria of nervous matter in the brain. 2. (Arch.)  A fillet between the flutes of columns, pilasters, or the like. Oxf. Gloss.
striate |To mark with striaæ. \"Striated longitudinally.\" Owen.\n\nMarked with striaæ, or fine grooves, or lines of color; showing narrow structural bands or lines; as, a striated crystal; striated muscular fiber.
striated |Marked with striaæ, or fine grooves, or lines of color; showing narrow structural bands or lines; as, a striated crystal; striated muscular fiber.
striation |1. The quality or condition of being striated. 2. A stria; as, the striations on a shell.
striatum |The corpus striatum.
striature |A stria.
strich |An owl. [Obs.] Spenser.
strick |A bunch of hackled flax prepared for drawing into slivers. Knight.
stricken |1. Struck; smitten; wounded; as, the stricken deer. Note: [See Strike, n.] 2. Worn out; far gone; advanced. See Strike, v. t., 21. Abraham was old and well stricken in age. Gen. xxiv. 1. 3. Whole; entire; -- said of the hour as marked by the striking of a clock. [Scot.] He persevered for a stricken hour in such a torrent of unnecessary tattle. Sir W. Scott. Speeches are spoken by the stricken hour, day after day, week, perhaps, after week. Bayne.
strickle |1. An instrument to strike grain to a level with the measure; a strike. 2. An instrument for whetting scythes; a rifle. 3. (Founding)  An instrument used for smoothing the surface of a core. 4. (Carp. & Mason.)  A templet; a pattern. 5. An instrument used in dressing flax. [Prov. Eng.]
strickler |See Strickle.
strickless |See Strickle. [Prov. Eng.]
strict |1. Strained; drawn close; tight; as, a strict embrace; a strict ligature. Dryden. 2. Tense; not relaxed; as, a strict fiber. 3. Exact; accurate; precise; rigorously nice; as, to keep strict watch; to pay strict attention. Shak. It shall be still in strictest measure. Milton. 4. Governed or governing by exact rules; observing exact rules; severe; rigorous; as, very strict in observing the Sabbath. \"Through the strict senteries.\" Milton. 5. Rigidly; interpreted; exactly limited; confined; restricted; as, to understand words in a strict sense. 6. (Bot.)  Upright, or straight and narrow; -- said of the shape of the plants or their flower clusters. Syn. -- Exact; accurate; nice; close; rigorous; severe. -- Strict, Severe. Strict, applied to a person, denotes that he conforms in his motives and acts to a principle or code by which he is bound; severe is strict with an implication often, but not always, of harshness. Strict is opposed to lax; severe is opposed to gentle. And rules as strict his labored work confine, As if the Stagirite o'erlooked each line. Pope. Soon moved with touch of blame, thus Eve: -\"What words have passed thy lips, Adam severe!\" Milton. The Strict Observance, or Friars of the Strict Observance. (R. C. Ch.) See Observance.
striction |The act of constricting, or the state of being constricted. Line of striction (Geom.), the line on a skew surface that cuts each generator in that point of it that is nearest to the succeeding generator.
strictly |In a strict manner; closely; precisely.
strictness |Quality or state of being strict.
stricture |1. Strictness. [Obs.] A man of stricture and firm abstinence. Shak. 2. A stroke; a glance; a touch. [Obs.] Sir M. Hale. 3. A touch of adverse criticism; censure. [I have] given myself the liberty of these strictures by way of reflection on all and every passage. Hammond. 4. (Med.)  A localized morbid contraction of any passage of the body. Cf. Organic stricture, and Spasmodic stricture, under Organic, and Spasmodic. Arbuthnot.
strictured |Affected with a stricture; as, a strictured duct.
strid |A narrow passage between precipitous rocks or banks, which looks as if it might be crossed at a stride. [Prov. Eng.] Howitt. This striding place is called the Strid. Wordsworth.
stride |1. To walk with long steps, especially in a measured or pompous manner. Mars in the middle of the shining shield Is graved, and strides along the liquid field. Dryden. 2. To stand with the legs wide apart; to straddle.\n\n1. To pass over at a step; to step over. \"A debtor that not dares to stride a limit.\" Shak. 2. To straddle; to bestride. I mean to stride your steed. Shak.\n\nThe act of stridding; a long step; the space measured by a long step; as, a masculine stride. Pope. God never meant that man should scale the heavens By strides of human wisdom. Cowper.
strident |Characterized by harshness; grating; shrill. \"A strident voice.\" Thackeray.
stridor |A harsh, shrill, or creaking noise. Dryden.
stridulate |To make a shrill, creaking noise; specifically (Zoöl.),  to make a shrill or musical sound, such as is made by the males of many insects.
stridulation |The act of stridulating. Specifically: (Zoöl.) (a) The act of making shrill sounds or musical notes by rubbing together certain hard parts, as is done by the males of many insects, especially by Orthoptera, such as crickets, grasshoppers, and locusts. (b) The noise itself. Note: The crickets stridulate by rubbing together the strong nervures of the fore wings. Many grasshoppers stridulate by rubbing the hind legs across strong nervures on the fore wings. The green grasshoppers and katydids stridulate by means of special organs at the base of the fore wings.
stridulator |That which stridulates. Darwin.
stridulatory |Stridulous; able to stridulate; used in stridulating; adapted for stridulation. Darwin.
stridulous |Making a shrill, creaking sound. Sir T. Browne. The Sarmatian boor driving his stridulous cart. Longfellow. Stridulous laryngitis (Med.), a form of croup, or laryngitis, in children, associated with dyspnoea, occurring usually at night, and marked by crowing or stridulous breathing.
strife |1. The act of striving; earnest endeavor. [Archaic] Shak. 2. Exertion or contention for superiority; contest of emulation, either by intellectual or physical efforts. Doting about questions and strifes of words. 1 Tim. vi. 4. Thus gods contended -- noble strife -Who most should ease the wants of life. Congreve. 3. Altercation; violent contention; fight; battle. Twenty of them fought in this black strife. Shak. These vows, thus granted, raised a strife above Betwixt the god of war and queen of love. Dryden. 4. That which is contended against; occasion of contest. [Obs.] \"Lamenting her unlucky strife.\" Spenser. Syn. -- Contest; struggle; quarrel. See Contention.
strifeful |Contentious; discordant. The ape was strifeful and ambitious. Spenser.
strigate |Having transverse bands of color.
striges |The tribe of birds which comprises the owls.
strigil |An instrument of metal, ivory, etc., used for scraping the skin at the bath.
strigillose |Set with stiff, slender bristles.
strigine |Of or pertaining to owls; owl-like.
strigment |Scraping; that which is scraped off. [Obs.] Sir T. Browne.
strigose |Set with stiff, straight bristles; hispid; as, a strigose leaf.
strigous |Strigose. [R.]
strike |1. To touch or hit with some force, either with the hand or with an instrument; to smite; to give a blow to, either with the hand or with any instrument or missile. He at Philippi kept His sword e'en like a dancer; while I struck The lean and wrinkled Cassius. Shak. 2. To come in collision with; to strike against; as, a bullet struck him; the wave struck the boat amidships; the ship struck a reef. 3. To give, as a blow; to impel, as with a blow; to give a force to; to dash; to cast. They shall take of the blood, and strike it on the two sideposts. Ex. xii. 7. Who would be free, themselves must strike the blow. Byron. 4. To stamp or impress with a stroke; to coin; as, to strike coin from metal: to strike dollars at the mint. 5. To thrust in; to cause to enter or penetrate; to set in the earth; as, a tree strikes its roots deep. 6. To punish; to afflict; to smite. To punish the just is not good, nor strike princes for equity. Prov. xvii. 26. 7. To cause to sound by one or more beats; to indicate or notify by audible strokes; as, the clock strikes twelve; the drums strike up a march. 8. To lower; to let or take down; to remove; as, to strike sail; to strike a flag or an ensign, as in token of surrender; to strike a yard or a topmast in a gale; to strike a tent; to strike the centering of an arch. 9. To make a sudden impression upon, as by a blow; to affect sensibly with some strong emotion; as, to strike the mind, with surprise; to strike one with wonder, alarm, dread, or horror. Nice works of art strike and surprise us most on the first view. Atterbury. They please as beauties, here as wonders strike. Pope. 10. To affect in some particular manner by a sudden impression or impulse; as, the plan proposed strikes me favorably; to strike one dead or blind. How often has stricken you dumb with his irony! Landor. 11. To cause or produce by a stroke, or suddenly, as by a stroke; as, to strike a light. Waving wide her myrtle wand, She strikes a universal peace through sea and land. Milton. 12. To cause to ignite; as, to strike a match. 13. To make and ratify; as, to strike a bargain. Note: Probably borrowed from the L. foedus ferrire, to strike a compact, so called because an animal was struck and killed as a sacrifice on such occasions. 14. To take forcibly or fraudulently; as, to strike money. [Old Slang] 15. To level, as a measure of grain, salt, or the like, by scraping off with a straight instrument what is above the level of the top. 16. (Masonry)  To cut off, as a mortar joint, even with the face of the wall, or inward at a slight angle. 17. To hit upon, or light upon, suddenly; as, my eye struck a strange word; they soon struck the trail. 18. To borrow money of; to make a demand upon; as, he struck a friend for five dollars. [Slang] 19. To lade into a cooler, as a liquor. B. Edwards. 20. To stroke or pass lightly; to wave. Behold, I thought, He will . . . strike his hand over the place, and recover the leper. 2 Kings v. 11. 21. To advance; to cause to go forward; -- used only in past participle. \"Well struck in years.\" Shak. To strike an attitude, To strike a balance. See under Attitude, and Balance. -- To strike a jury (Law), to constitute a special jury ordered by a court, by each party striking out a certain number of names from a prepared list of jurors, so as to reduce it to the number of persons required by law. Burrill. -- To strike a lead. (a) (Mining) To find a vein of ore. (b) Fig.: To find a way to fortune. [Colloq.] -- To strike a ledger, or an account, to balance it. -- To strike hands with. (a) To shake hands with. Halliwell. (b) To make a compact or agreement with; to agree with. -- To strike off. (a) To erase from an account; to deduct; as, to strike off the interest of a debt. (b) (Print.) To impress; to print; as, to strike off a thousand copies of a book. (c) To separate by a blow or any sudden action; as, to strike off what is superfluous or corrupt. -- To strike oil, to find petroleum when boring for it; figuratively, to make a lucky hit financially. [Slang, U.S.] -- To strike one luck, to shake hands with one and wish good luck. [Obs.] Beau. & Fl. -- To strike out. (a) To produce by collision; to force out, as, to strike out sparks with steel. (b) To blot out; to efface; to erase. \"To methodize is as necessary as to strike out.\" Pope. (c) To form by a quick effort; to devise; to invent; to contrive, as, to strike out a new plan of finance. (d) (Baseball) To cause a player to strike out; -- said of the pitcher. See To strike out, under Strike, v. i. -- To strike sail. See under Sail. -- To strike up. (a) To cause to sound; to begin to beat. \"Strike up the drums.\" Shak. (b) To begin to sing or play; as, to strike up a tune. (c) To raise (as sheet metal), in making diahes, pans, etc., by blows or pressure in a die. -- To strike work, to quit work; to go on a strike.\n\nTo move; to advance; to proceed; to take a course; as, to strike into the fields. A mouse . . . struck forth sternly [bodily]. Piers Plowman. 2. To deliver a quick blow or thrust; to give blows. And fiercely took his trenchant blade in hand, With which he stroke so furious and so fell. Spenser. Strike now, or else the iron cools. Shak. 3. To hit; to collide; to dush; to clash; as, a hammer strikes against the bell of a clock. 4. To sound by percussion, with blows, or as with blows; to be struck; as, the clock strikes. A deep sound strikes like a rising knell. Byron. 5. To make an attack; to aim a blow. A puny subject strikes At thy great glory. Shak. Struck for throne, and striking found his doom. Tennyson. 6. To touch; to act by appulse. Hinder light but from striking on it [porphyry], and its colors vanish. Locke. 7. To run upon a rock or bank; to be stranded; as, the ship struck in the night. 8. To pass with a quick or strong effect; to dart; to penetrate. Till a dart strike through his liver. Prov. vii. 23. Now and then a glittering beam of wit or passion strikes through the obscurity of the poem. Dryden. 9. To break forth; to commence suddenly; -- with into; as, to strike into reputation; to strike into a run. 10. To lower a flag, or colors, in token of respect, or to signify a surrender of a ship to an enemy. That the English ships of war should not strike in the Danish seas. Bp. Burnet. 11. To quit work in order to compel an increase, or prevent a reduction, of wages. 12. To become attached to something; -- said of the spat of oysters. 13. To steal money. [Old Slang, Eng.] Nares. To strike at, to aim a blow at. -- To strike for, to start suddenly on a course for. -- To strike home, to give a blow which reaches its object, to strike with effect. -- To strike in. (a) To enter suddenly. (b) To disappear from the surface, with internal effects, as an eruptive disease. (c) To come in suddenly; to interpose; to interrupt. \"I proposed the embassy of Constantinople for Mr. Henshaw, but my Lord Winchelsea struck in.\" Evelyn. (d) To join in after another has begun,as in singing. -- To strike in with, to conform to; to suit itself to; to side with, to join with at once. \"To assert this is to strike in with the known enemies of God's grace.\" South. To strike out. (a) To start; to wander; to make a sudden excursion; as, to strike out into an irregular course of life. (b) To strike with full force. (c) (Baseball) To be put out for not hitting the ball during one's turn at the bat. -- To strike up, to commence to play as a musician; to begin to sound, as an instrument. \"Whilst any trump did sound, or drum struck up.\" Shak.\n\n1. The act of striking. 2. An instrument with a straight edge for leveling a measure of grain, salt, and the like, scraping off what is above the level of the top; a strickle. 3. A bushel; four pecks. [Prov. Eng.] Tusser. 4. An old measure of four bushels. [Prov. Eng.] 5. Fullness of measure; hence, excellence of quality. Three hogsheads of ale of the first strike. Sir W. Scott. 6. An iron pale or standard in a gate or fence. [Obs.] 7. The act of quitting work; specifically, such an act by a body of workmen, done as a means of enforcing compliance with demands made on their employer. Strikes are the insurrections of labor. F. A. Walker. 8. (Iron Working)  A puddler's stirrer. 9. (Geol.)  The horizontal direction of the outcropping edges of tilted rocks; or, the direction of a horizontal line supposed to be drawn on the surface of a tilted stratum. It is at right angles to the dip. 10. The extortion of money, or the attempt to extort money, by threat of injury; blackmailing. Strike block (Carp.), a plane shorter than a jointer, used for fitting a short joint. Moxon. -- Strike of flax, a handful that may be hackled at once. [Obs. or Prov. Eng.] Chaucer. -- Strike of sugar. (Sugar Making) (a) The act of emptying the teache, or last boiler, in which the cane juice is exposed to heat, into the coolers. (b) The quantity of the sirup thus emptied at once.
striker |1. One who, or that which, strikes; specifically, a blacksmith's helper who wieds the sledge. 2. A harpoon; also, a harpooner. Wherever we come to an anchor, we always send out our strikers, and put out hooks and lines overboard, to try fish. Dampier. 3. A wencher; a lewd man. [Obs.] Massinger. 4. A workman who is on a strike. 5. A blackmailer in politics; also, one whose political influence can be bought. [Political Cant]
striking |a. & n. from Strike, v. Striking distance, the distance through which an object can be reached by striking; the distance at which a force is effective when directed to a particular object. -- Striking plate. (a) The plate against which the latch of a door lock strikes as the door is closed. (b) A part of the centering of an arch, which is driven back to loosen the centering in striking it.\n\nAffecting with strong emotions; surprising; forcible; impressive; very noticeable; as, a striking representation or image; a striking resemblance. \"A striking fact.\" De Quincey. -- Strik\"ing*ly, adv. -- Strik\"ing*ness, n.
strikle |See Strickle.
string |1. A small cord, a line, a twine, or a slender strip of leather, or other substance, used for binding together, fastening, or tying things; a cord, larger than a thread and smaller than a rope; as, a shoe string; a bonnet string; a silken string. Shak. Round Ormond's knee thou tiest the mystic string. Prior. 2. A thread or cord on which a number of objects or parts are strung or arranged in close and orderly succession; hence, a line or series of things arranged on a thread, or as if so arranged; a succession; a concatenation; a chain; as, a string of shells or beads; a string of dried apples; a string of houses; a string of arguments. \"A string of islands.\" Gibbon. 3. A strip, as of leather, by which the covers of a book are held together. Milton. 4. The cord of a musical instrument, as of a piano, harp, or violin; specifically (pl.), the stringed instruments of an orchestra, in distinction from the wind instruments; as, the strings took up the theme. \"An instrument of ten strings.\" Ps. xxx. iii. 2. Me softer airs befit, and softer strings Of lute, or viol still. Milton. 5. The line or cord of a bow. Ps. xi. 2. He twangs the grieving string. Pope. 6. A fiber, as of a plant; a little, fibrous root. Duckweed putteth forth a little string into the water, from the bottom. Bacon. 7. A nerve or tendon of an animal body. The string of his tongue was loosed. Mark vii. 35. 8. (Shipbuilding)  An inside range of ceiling planks, corresponding to the sheer strake on the outside and bolted to it. 9. (Bot.)  The tough fibrous substance that unites the valves of the pericap of leguminous plants, and which is readily pulled off; as, the strings of beans. 10. (Mining)  A small, filamentous ramification of a metallic vein. Ure. 11. (Arch.)  Same as Stringcourse. 12. (Billiards)  The points made in a game. String band (Mus.), a band of musicians using only, or chiefly, stringed instruments. -- String beans. (a) A dish prepared from the unripe pods of several kinds of beans; -- so called because the strings are stripped off. (b) Any kind of beans in which the pods are used for cooking before the seeds are ripe; usually, the low bush bean. -- To have two strings to one's bow, to have a means or expedient in reserve in case the one employed fails.\n\n1. To furnish with strings; as, to string a violin. Has not wise nature strung the legs and feet With firmest nerves, designed to walk the street Gay. 2. To put in tune the strings of, as a stringed instrument, in order to play upon it. For here the Muse so oft her harp has strung, That not a mountain rears its head unsung. Addison. 3. To put on a string; to file; as, to string beads. 4. To make tense; to strengthen. Toil strung the nerves, and purified the blood. Dryden. 5. To deprive of strings; to strip the strings from; as, to string beans. See String, n., 9.
stringboard |Same as Stringpiece.
stringcourse |A horizontal band in a building, forming a part of the design, whether molded, projecting, or carved, or in any way distinguished from the rest of the work.
stringed |1. Having strings; as, a stringed instrument. Ps. cl. 4. 2. Produced by strings. \"Answering the stringed noise.\" Milton.
stringency |The quality or state of being stringent.
stringendo |Urging or hastening the time, as to a climax.
stringent |Binding strongly; making strict requirements; restrictive; rigid; severe; as, stringent rules. They must be subject to a sharper penal code, and to a more stringent code of procedure. Macaulay. -- Strin\"gent*ly, adv. -- Strin\"gent*ness, n.
stringer |1. One who strings; one who makes or provides strings, especially for bows. Be content to put your trust in honest stringers. Ascham. 2. A libertine; a wencher. [Obs.] Beau. & Fl. 3. (Railroad)  A longitudinal sleeper. 4. (Shipbuilding)  A streak of planking carried round the inside of a vessel on the under side of the beams. 5. (Carp.)  A long horizontal timber to connect uprights in a frame, or to support a floor or the like.
stringhalt |An habitual sudden twitching of the hinder leg of a horse, or an involuntary or convulsive contraction of the muscles that raise the hock. [Written also springhalt.]
stringiness |Quality of being stringy.
stringless |Having no strings. His tongue is now a stringless instrument. Shak.
stringpiece |(a) A long piece of timber, forming a margin or edge of any piece of construction; esp.: (b) One of the longitudinal pieces, supporting the treads and rises of a flight or run of stairs.
stringy |1. Consisting of strings, or small threads; fibrous; filamentous; as, a stringy root. 2. Capable of being drawn into a string, as a glutinous substance; ropy; viscid; gluely. Stringy bark (Bot.), a name given in Australia to several trees of the genus Eucalyptus (as E. amygdalina, obliqua, capitellata, macrorhyncha, piperita, pilularis, and tetradonta), which have a fibrous bark used by the aborigines for making cordage and cloth.
strip |1. To deprive; to bereave; to make destitute; to plunder; especially, to deprive of a covering; to skin; to peel; as, to strip a man of his possession, his rights, his privileges, his reputation; to strip one of his clothes; to strip a beast of his skin; to strip a tree of its bark. And strippen her out of her rude array. Chaucer. They stripped Joseph out of his coat. Gen. xxxvii. 23. Opinions which . . . no clergyman could have avowed without imminent risk of being stripped of his gown. Macaulay. 2. To divest of clothing; to uncover. Before the folk herself strippeth she. Chaucer. Strip your sword stark naked. Shak. 3. (Naut.)  To dismantle; as, to strip a ship of rigging, spars, etc. 4. (Agric.)  To pare off the surface of, as land, in strips. 5. To deprive of all milk; to milk dry; to draw the last milk from; hence, to milk with a peculiar movement of the hand on the teats at the last of a milking; as, to strip a cow. 6. To pass; to get clear of; to outstrip. [Obs.] When first they stripped the Malean promontory. Chapman. Before he reached it he was out of breath, And then the other stripped him. Beau. & Fl. 7. To pull or tear off, as a covering; to remove; to wrest away; as, to strip the skin from a beast; to strip the bark from a tree; to strip the clothes from a man's back; to strip away all disguisses. To strip bad habits from a corrupted heart, is stripping off the skin. Gilpin. 8. (Mach.) (a) To tear off (the thread) from a bolt or nut; as, the thread is stripped. (b) To tear off the thread from (a bolt or nut); as, the bolt is stripped. 9. To remove the metal coating from (a plated article), as by acids or electrolytic action. 10. (Carding)  To remove fiber, flock, or lint from; -- said of the teeth of a card when it becomes partly clogged. 11. To pick the cured leaves from the stalks of (tobacco) and tie them into \"hands\"; to remove the midrib from (tobacco leaves).\n\n1. To take off, or become divested of, clothes or covering; to undress. 2. (Mach.)  To fail in the thread; to lose the thread, as a bolt, screw, or nut. See Strip, v. t., 8.\n\n1. A narrow piece, or one comparatively long; as, a strip of cloth; a strip of land. 2. (Mining)  A trough for washing ore. 3. (Gunnery)  The issuing of a projectile from a rifled gun without acquiring the spiral motion. Farrow.
strip-leaf |Tobacco which has been stripped of its stalks before packing.
stripe |1. A line, or long, narrow division of anything of a different color or structure from the ground; hence, any linear variation of color or structure; as, a stripe, or streak, of red on a green ground; a raised stripe. 2. (Weaving)  A pattern produced by arranging the warp threads in sets of alternating colors, or in sets presenting some other contrast of appearance. 3. A strip, or long, narrow piece attached to something of a different color; as, a red or blue stripe sewed upon a garment. 4. A stroke or blow made with a whip, rod, scourge, or the like, such as usually leaves a mark. Forty stripes he may give him, and not exceed. Deut. xxv. 3. 5. A long, narrow discoloration of the skin made by the blow of a lash, rod, or the like. Cruelty marked him with inglorious stripes. Thomson. 6. Color indicating a party or faction; hence, distinguishing characteristic; sign; likeness; sort; as, persons of the same political stripe. [Colloq. U.S.] 7. pl. (Mil.)  The chevron on the coat of a noncommissioned officer. Stars and Stripes. See under Star, n.\n\n1. To make stripes upon; to form with lines of different colors or textures; to variegate with stripes. 2. To strike; to lash. [R.]
striped |Having stripes of different colors; streaked. Striped bass. (Zoöl.) See under Bass. -- Striped maple (Bot.), a slender American tree (Acer Pennsylvanicum) with finely striped bark. Called also striped dogwood, and moosewood. -- Striped mullet. (Zoöl.) See under Mullet, 2. -- Striped snake (Zoöl.), the garter snake. -- Striped squirrel (Zoöl.), the chipmunk.
stripling |A youth in the state of adolescence, or just passing from boyhood to manhood; a lad. Inquire thou whose son the stripling is. 1 Sam. xvii. 56.
stripper |One who, or that which, strips; specifically, a machine for stripping cards.
strippet |A small stream. [Obs.] \"A little brook or strippet.\" Holinshed.
stripping |1. The act of one who strips. The mutual bows and courtesies . . . are remants of the original prostrations and strippings of the captive. H. Spencer. Never were cows that required such stripping. Mrs. Gaskell. 2. pl.  The last milk drawn from a cow at a milking.
strisores |A division of passerine birds including the humming birds, swifts, and goatsuckers. It is now generally considered an artificial group.
strive |1. To make efforts; to use exertions; to endeavor with earnestness; to labor hard. Was for this his ambition strove To equal Cæsar first, and after, Jove Cowley. 2. To struggle in opposition; to be in contention or dispute; to contend; to contest; -- followed by against or with before the person or thing opposed; as, strive against temptation; strive for the truth. Chaucer. My Spirit shall not always strive with man. Gen. vi. 3. Why dost thou strive against him Job xxxiii. 13. Now private pity strove with public hate, Reason with rage, and eloquence with fate. Denham. 3. To vie; to compete; to be a rival. Chaucer. [Not] that sweet grove Of Daphne, by Orontes and the inspired Castalian spring, might with this paradise Of Eden strive. Milton. Syn. -- To contend; vie; struggle; endeavor; aim.\n\n1. An effort; a striving. [R.] Chapman. 2. Strife; contention. [Obs.] Wyclif (luke xxi. 9).
strived |Striven. Yea, so have I strived to preach the gospel. Rom. xv. 20.
striven |p. p. of Strive.
striver |One who strives.
striving |from Strive. -- Striv\"ing*ly, adv.
strix |One of the flutings of a column.
stroam |1. To wander about idly and vacantly. [Obs.] 2. To take long strides in walking. [Prov. Eng.]
strobila |(a) A form of the larva of certain Discophora in a state of development succeeding the scyphistoma. The body of the strobila becomes elongated, and subdivides transversely into a series of lobate segments which eventually become ephyræ, or young medusæ. (b) A mature tapeworm.
strobilaceous |(a) Of or pertaining to a strobile or cone. (b) Producing strobiles.
strobilation |The act or phenomenon of spontaneously dividing transversely, as do certain species of annelids and helminths; transverse fission. See Illust. under Syllidian.
strobile |1. (Bot.)  A scaly multiple fruit resulting from the ripening of an ament in certain plants, as the hop or pine; a cone. See Cone, n., 3. 2. (Biol.)  An individual asexually producing sexual individuals differing from itself also in other respects, as the tapeworm, -- one of the forms that occur in metagenesis. 3. (Zoöl.)  Same as Strobila.
strobiliform |Shaped like a strobile.
strobiline |Of or pertaining to a strobile; strobilaceous; strobiliform; as, strobiline fruits.
stroboscope |1. An instrument for studying or observing the successive phases of a periodic or varying motion by means of light which is periodically interrupted. 2. An optical toy similar to the phenakistoscope. See Phenakistoscope.
strockle |A shovel with a turned-up edge, for frit, sand, etc. [Written also strocal, strocle, strokal.]
strode |See Strude. [Obs.]\n\nimp. of Stride.
stroke |Struck.\n\n1. The act of striking; a blow; a hit; a knock; esp., a violent or hostile attack made with the arm or hand, or with an instrument or weapon. His hand fetcheth a stroke with the ax to cut down the tree. Deut. xix. 5. A fool's lips enter into contention and his mouth calleth for strokes. Prov. xviii. 6. He entered and won the whole kingdom of Naples without striking a stroke. Bacon. 2. The result of effect of a striking; injury or affliction; soreness. In the day that Lord bindeth up the breach of his people, and healeth the stroke of their wound. Isa. xxx. 26. 3. The striking of the clock to tell the hour. Well, but what's o'clock - Upon the stroke of ten. -- Well, let is strike. Shak. 4. A gentle, caressing touch or movement upon something; a stroking. Dryden. 5. A mark or dash in writing or printing; a line; the touch of a pen or pencil; as, an up stroke; a firm stroke. O, lasting as those colors may they shine, Free as thy stroke, yet faultless as thy line. Pope. 6. Hence, by extension, an addition or amandment to a written composition; a touch; as, to give some finishing strokes to an essay. Addison. 7. A sudden attack of disease; especially, a fatal attack; a severe disaster; any affliction or calamity, especially a sudden one; as, a stroke of apoplexy; the stroke of death. At this one stroke the man looked dead in law. Harte. 8. A throb or beat, as of the heart. Tennyson. 9. One of a series of beats or movements against a resisting medium, by means of which movement through or upon it is accomplished; as, the stroke of a bird's wing in flying, or an oar in rowing, of a skater, swimmer, etc.; also: (Rowing) (a) The rate of succession of stroke; as, a quick stroke. (b) The oar nearest the stern of a boat, by which the other oars are guided; -- called also stroke oar. (c) The rower who pulls the stroke oar; the strokesman. 10. A powerful or sudden effort by which something is done, produced, or accomplished; also, something done or accomplished by such an effort; as, a stroke of genius; a stroke of business; a master stroke of policy. 11. (Mach.)  The movement, in either direction, of the piston plunger, piston rod, crosshead, etc., as of a steam engine or a pump, in which these parts have a reciprocating motion; as, the forward stroke of a piston; also, the entire distance passed through, as by a piston, in such a movement; as, the piston is at half stroke. Note: The respective strokes are distinguished as up and down strokes, outward and inward strokes, forward and back strokes, the forward stroke in stationary steam engines being toward the crosshead, but in locomotives toward the front of the vehicle. 12. Power; influence. [Obs.] \"Where money beareth [hath] all the stroke.\" Robynson (More's Utopia). He has a great stroke with the reader. Dryden. 13. Appetite. [Obs.] Swift. To keep stroke, to make strokes in unison. The oars where silver, Which to the tune of flutes kept stroke. Shak.\n\n1. To strike. [Obs.] Ye mote with the plat sword again Stroken him in the wound, and it will close. Chaucer. 2. To rib gently in one direction; especially, to pass the hand gently over by way of expressing kindness or tenderness; to caress; to soothe. He dried the falling drops, and, yet more kind, He stroked her cheeks. Dryden. 3. To make smooth by rubbing. Longfellow. 4. (Masonry)  To give a finely fluted surface to. 5. To row the stroke oar of; as, to stroke a boat.
stroker |One who strokes; also, one who pretends to cure by stroking. Cures worked by Greatrix the stroker. Bp. Warburton.
strokesman |The man who rows the aftermost oar, and whose stroke is to be followed by the rest. Totten.
stroking |1. The act of rubbing gently with the hand, or of smoothing; a stroke. I doubt not with one gentle stroking to wipe away ten thousand tears. Milton. 2. (Needlework)  The act of laying small gathers in cloth in regular order. 3. pl.  See Stripping, 2. Smollett.
stroll |To wander on foot; to ramble idly or leisurely; to rove. These mothers stroll to beg sustenance for their helpless infants. Swift. Syn. -- To rove; roam; range; stray.\n\nA wandering on foot; an idle and leisurely walk; a ramble.
stroller |One who strolls; a vagrant.
stroma |1. (Anat.) (a) The connective tissue or supporting framework of an organ; as, the stroma of the kidney. (b) The spongy, colorless framework of a red blood corpuscle or other cell. 2. (Bot.)  A layer or mass of cellular tissue, especially that part of the thallus of certain fungi which incloses the perithecia.
stromatic |Miscellaneous; composed of different kinds.
stromatology |The history of the formation of stratified rocks.
stromb |Any marine univalve mollusk of the genus Strombus and allied genera. See Conch, and Strombus.
strombite |A fossil shell of the genus Strombus.
stromboid |Of, pertaining to, or like, Strombus.
strombuliform |1. (Geol.)  Formed or shaped like a top. 2. (Bot.)  Coiled into the shape of a screw or a helix.
strombus |A genus of marine gastropods in which the shell has the outer lip dilated into a broad wing. It includes many large and handsome species commonly called conch shells, or conchs. See Conch.
stromeyerite |A steel-gray mineral of metallic luster. It is a sulphide of silver and copper.
strond |Strand; beach. [Obs.] Shak.
strong |1. Having active physical power, or great physical power to act; having a power of exerting great bodily force; vigorous. That our oxen may be strong to labor. Ps. cxliv. 14. Orses the strong to greater strength must yield. Dryden. 2. Having passive physical power; having ability to bear or endure; firm; hale; sound; robust; as, a strong constitution; strong health. 3. Solid; tough; not easily broken or injured; able to withstand violence; able to sustain attacks; not easily subdued or taken; as, a strong beam; a strong rock; a strong fortress or town. 4. Having great military or naval force; powerful; as, a strong army or fleet; a nation strong at sea. 5. Having great wealth, means, or resources; as, a strong house, or company of merchants. 6. Reaching a certain degree or limit in respect to strength or numbers; as, an army ten thousand strong. 7. Moving with rapidity or force; violent; forcible; impetuous; as, a strong current of water or wind; the wind was strong from the northeast; a strong tide. 8. Adapted to make a deep or effectual impression on the mind or imagination; striking or superior of the kind; powerful; forcible; cogent; as, a strong argument; strong reasons; strong evidence; a strong example; strong language. 9. Ardent; eager; zealous; earnestly engaged; as, a strong partisan; a strong Whig or Tory. Her mother, ever strong against that match. Shak. 10. Having virtues of great efficacy; or, having a particular quality in a great degree; as, a strong powder or tincture; a strong decoction; strong tea or coffee. 11. Full of spirit; containing a large proportion of alcohol; intoxicating; as, strong liquors. 12. Affecting any sense powerfully; as, strong light, colors, etc.; a strong flavor of onions; a strong scent. 13. Solid; nourishing; as, strong meat. Heb. v. 12. 14. Well established; firm; not easily overthrown or altered; as, a strong custom; a strong belief. 15. Violent; vehement; earnest; ardent. He had offered up prayers and supplications with strong crying and tears. Heb. v. 7. 16. Having great force, vigor, power, or the like, as the mind, intellect, or any faculty; as, a man of a strong mind, memory, judgment, or imagination. I was stronger in prophecy than in criticism. Dryden. 17. Vigorous; effective; forcible; powerful. Like her sweet voice is thy harmonious song, As high, as sweet, as easy, and as strong. E. Smith. 18. (Stock Exchange)  Tending to higher prices; rising; as, a strong market. 19. (Gram.) (a) Pertaining to, or designating, a verb which forms its preterit (imperfect) by a variation in the root vowel, and the past participle (usually) by the addition of -en (with or without a change of the root vowel); as in the verbs strive, strove, striven; break, broke, broken; drink, drank, drunk. Opposed to weak, or regular. See Weak. (b) Applied to forms in Anglo-Saxon, etc., which retain the old declensional endings. In the Teutonic languages the vowel stems have held the original endings most firmly, and are called strong; the stems in -n are called weak other constant stems conform, or are irregular. F. A. March. Strong conjugation (Gram.), the conjugation of a strong verb; -- called also old, or irregular, conjugation, and distinguished from the weak, or regular, conjugation. Note: Strong is often used in the formation of self-explaining compounds; as, strong-backed, strong-based, strong-bodied, strong- colored, strong-fisted, strong-handed, strong-ribbed, strong- smelling, strong-voiced, etc. Syn. -- Vigorous; powerful; stout; solid; firm; hardy; muscular; forcible; cogent; valid. See Robust.
strong-minded |Having a vigorous mind; esp., having or affecting masculine qualities of mind; -- said of women. -- Strong\"-mind`ed*ness, n.
strong-water |1. An acid. [Obs.] 2. Distilled or ardent spirits; intoxicating liquor.
stronghand |Violence; force; power. It was their meaning to take what they needed by stronghand. Sir W. Raleigh.
