transposal |The act of transposing, or the state of being transposed; transposition.
transpose |1. To change the place or order of; to substitute one for the other of; to exchange, in respect of position; as, to transpose letters, words, or propositions. 2. To change; to transform; to invert. [R.] Things base and vile, holding no quantity, Love can transpose to form and dignity. Shak. 3. (Alg.)  To bring, as any term of an equation, from one side over to the other, without destroying the equation; thus, if a + b = c, and we make a = c - b, then b is said to be transposed. 4. (Gram.)  To change the natural order of, as words. 5. (Mus.)  To change the key of.
transposer |One who transposes.
transposition |The act of transposing, or the state of being transposed. Specifically: --(a) (Alg.)  The bringing of any term of an equation from one side over to the other without destroying the equation. (b) (Gram.) A change of the natural order of words in a sentence; as, the Latin and Greek languages admit transposition, without inconvenience, to a much greater extent than the English. (c) (Mus.) A change of a composition into another key.
transpositional |Of or pertaining to transposition; involving transposition. Pegge.
transpositive |Made by transposing; consisting in transposition; transposable.
transprint |To transfer to the wrong place in printing; to print out of place. [R.] Coleridge.
transprose |To change from prose into verse; to versify; also, to change from verse into prose. [Obs.] Dryden.
transregionate |Foreign. [Obs.] Holinshed.
transshape |To change into another shape or form; to transform. [Written also transhape.] Shak.
transship |To transfer from one ship or conveyance to another. [Written also tranship.]
transshipment |The act of transshipping, or transferring, as goods, from one ship or conveyance to another. [Written also transhipment.]
transsummer |See Transom, 2.
transubstantiate |1. To change into another substance. [R.] The spider love which transubstantiates all, And can convert manna to gall. Donne. 2. (R. C. Theol.)  To change, as the sacramental elements, bread and wine, into the flesh and blood of Christ.
transubstantiation |1. A change into another substance. 2. (R. C. Theol.)  The doctrine held by Roman Catholics, that the bread and wine in the Mass is converted into the body and blood of Christ; -- distinguished from consubstantiation, and impanation.
transubstantiator |One who maintains the doctrine of transubstantiation. Barrow.
transudation |1. The act or process of transuding. 2. (Physics)  Same as Exosmose.
transudatory |Of or pertaining to transudation; passing by transudation.
transude |To pass, as perspirable matter does, through the pores or interstices of textures; as, liquor may transude through leather or wood.
transume |To change; to convert. [R.] Crashaw.
transumpt |A copy or exemplification of a record. [Obs.] Lord Herbert.
transumption |Act of taking from one place to another. [R.] South.
transumptive |Taking from one to another; metaphorical. [R.] \"A transumptive kind of speech.\" Drayton. Fictive, descriptive, digressive, transumptive, and withal definitive. Lowell.
transvasate |To pour out of one vessel into another. [Obs.] Cudworth.
transvasation |The act or process of pouring out of one vessel into another. [Obs.] Holland.
transvection |The act of conveying or carrying over. [R.]
transverberate |To beat or strike through. [Obs.]
transversal |Running or lying across; transverse; as, a transversal line. -- Trans*ver\"sal*ly, adv.\n\nA straight line which traverses or intersects any system of other lines, as a line intersecting the three sides of a triangle or the sides produced.
transverse |Lying or being across, or in a crosswise direction; athwart; -- often opposed to Ant: longitudinal. Transverse axis (of an ellipse or hyperbola) (Geom.), that axis which passes through the foci. -- Transverse partition (Bot.), a partition, as of a pericarp, at right angles with the valves, as in the siliques of mustard.\n\n1. Anything that is transverse or athwart. 2. (Geom.)  The longer, or transverse, axis of an ellipse.\n\nTo overturn; to change. [R.] C. Leslie.\n\nTo change from prose into verse, or from verse into prose. [Obs.] Duke of Buckingham.
transversely |In a transverse manner.
transversion |The act of changing from prose into verse, or from verse into prose.
transvert |To cause to turn across; to transverse. [Obs.] Craft of Lovers (1448).
transvertible |Capable of being transverted. [R.] Sir T. Browne.
transvolation |The act of flying beyond or across. Jer. Taylor.
trant |To traffic in an itinerary manner; to peddle. [Written also traunt.] [Obs.]
tranter |One who trants; a peddler; a carrier. [Written also traunter.] [Obs. or Prov. Eng.]
trap |To dress with ornaments; to adorn; -- said especially of horses. Steeds . . . that trapped were in steel all glittering. Chaucer. To deck his hearse, and trap his tomb-black steed. Spenser. There she found her palfrey trapped In purple blazoned with armorial gold. Tennyson.\n\nAn old term rather loosely used to designate various dark- colored, heavy igneous rocks, including especially the feldspathic- augitic rocks, basalt, dolerite, amygdaloid, etc., but including also some kinds of diorite. Called also trap rock. Trap tufa, Trap tuff, a kind of fragmental rock made up of fragments and earthy materials from trap rocks.\n\nOf or pertaining to trap rock; as, a trap dike.\n\n1. A machine or contrivance that shuts suddenly, as with a spring, used for taking game or other animals; as, a trap for foxes. She would weep if that she saw a mouse Caught in a trap. Chaucer. 2. Fig.: A snare; an ambush; a stratagem; any device by which one may be caught unawares. Let their table be made a snare and a trap. Rom. xi. 9. God and your majesty Protect mine innocence, or I fall into The trap is laid for me! Shak. 3. A wooden instrument shaped somewhat like a shoe, used in the game of trapball. It consists of a pivoted arm on one end of which is placed the ball to be thrown into the air by striking the other end. Also, a machine for throwing into the air glass balls, clay pigeons, etc., to be shot at. 4. The game of trapball. 5. A bend, sag, or partitioned chamber, in a drain, soil pipe, sewer, etc., arranged so that the liquid contents form a seal which prevents passage of air or gas, but permits the flow of liquids. 6. A place in a water pipe, pump, etc., where air accumulates for want of an outlet. 7. A wagon, or other vehicle. [Colloq.] Thackeray. 8. A kind of movable stepladder. Knight. Trap stairs, a staircase leading to a trapdoor. -- Trap tree (Bot.) the jack; -- so called because it furnishes a kind of birdlime. See 1st Jack.\n\n1. To catch in a trap or traps; as, to trap foxes. 2. Fig.: To insnare; to take by stratagem; to entrap. \"I trapped the foe.\" Dryden. 3. To provide with a trap; to trap a drain; to trap a sewer pipe. See 4th Trap, 5.\n\nTo set traps for game; to make a business of trapping game; as, to trap for beaver.
trap shooting |Shooting at pigeons liberated, or glass balls or clay pigeons sprung into the air, from a trap. -- Trap shooter.
trapan |A snare; a stratagem; a trepan. See 3d Trepan. South.\n\nTo insnare; to catch by stratagem; to entrap; to trepan. Having some of his people trapanned at Baldivia. Anson.
trapanner |One who trapans, or insnares.
trapball |An old game of ball played with a trap. See 4th Trap, 4.
trapdoor |1. (Arch.)  A lifting or sliding door covering an opening in a roof or floor. 2. (Mining)  A door in a level for regulating the ventilating current; -- called also weather door. Raymond. Trapdoor spider (Zoöl.), any one of several species of large spiders which make a nest consisting of a vertical hole in the earth, lined with a hinged lid, like a trapdoor. Most of the species belong to the genus Cteniza, as the California species (C. Californica).
trape |To walk or run about in an idle or slatternly manner; to traipse. [Obs. or Colloq.]
trapes |A slattern; an idle, sluttish, or untidy woman. [Obs. or Colloq.]\n\nTo go about in an idle or slatternly fashion; to trape; to traipse. [Colloq.] Thackeray.
trapezate |Having the form of a trapezium; trapeziform.
trapeze |1. (Geom.)  A trapezium. See Trapezium, 1. 2. A swinging horizontal bar, suspended at each end by a rope; -- used by gymnasts.
trapeziform |Having the form of a trapezium; trapezoid.
trapezium |1. (Geom.)  A plane figure bounded by four right lines, of which no two are parallel. 2. (Anat.) (a) A bone of the carpus at the base of the first metacarpal, or thumb. (b) A region on the ventral side of the brain, either just back of the pons Varolii, or, as in man, covered by the posterior extension of its transverse fibers.
trapezohedral |Of, pertaining to, or resembling, a trapezohedron.
trapezohedron |(a) A solid bounded by twenty-four equal and similar trapeziums; a tetragonal trisoctahedron. See the Note under Trisoctahedron. (b) A tetartohedral solid of the hexagonal system, bounded by six trapezoidal planes. The faces of this form are common on quartz crystals.
trapezoid |1. (Geom.)  A plane four-sided figure, having two sides parallel to each other. 2. (Anat.)  A bone of the carpus at the base of the second metacarpal, or index finger.\n\n1. Having the form of a trapezoid; trapezoidal; as, the trapezoid ligament which connects the coracoid process and the clavicle. 2. (Anat.)  Of or pertaining to the trapezoid ligament; as, the trapezoid line.
trapezoidal |1. Having the form of a trapezoid; trapezoid. 2. (Min.)  Tranpezohedral.
traphole |See Trou-de-loup.
trappean |Of or pertaining to trap; being of the nature of trap.
trapper |1. One who traps animals; one who makes a business of trapping animals for their furs. W. Irving. 2. (Mining)  A boy who opens and shuts a trapdoor in a gallery or level. Raymond.
trappings |1. That which serves to trap or adorn; ornaments; dress; superficial decorations. Trappings of life, for ornament, not use. Dryden. These but the trappings and the suits of woe. Shak. 2. Specifically, ornaments to be put on horses. Caparisons and steeds, Bases and tinsel trappings. Milton.
trappist |A monk belonging to a branch of the Cistercian Order, which was established by Armand de Rancé in 1660 at the monastery of La Trappe in Normandy. Extreme austerity characterizes their discipline. They were introduced permanently into the United States in 1848, and have monasteries in Iowa and Kentucky.
trappous |Of or performance to trap; resembling trap, or partaking of its form or qualities; trappy.
trappures |Trappings for a horse. [Obs.] Chaucer.
trappy |Same as Trappous.
traps |Small or portable articles for dress, furniture, or use; goods; luggage; things. [Colloq.]
trapstick |A stick used in playing the game of trapball; hence, fig., a slender leg. Addison.
trash |1. That which is worthless or useless; rubbish; refuse. Who steals my purse steals trash. Shak. A haunch of venison would be trash to a Brahmin. Landor. 2. Especially, loppings and leaves of trees, bruised sugar cane, or the like. Note: In the West Indies, the decayed leaves and stems of canes are called field trash; the bruised or macerated rind of canes is called cane trash; and both are called trash. B. Edwards. 3. A worthless person. [R.] Shak. 4. A collar, leash, or halter used to restrain a dog in pursuing game. Markham. Trash ice, crumbled ice mixed with water.\n\n1. To free from trash, or worthless matter; hence, to lop; to crop, as to trash the rattoons of sugar cane. B. Edwards. 2. To treat as trash, or worthless matter; hence, to spurn, humiliate, or crush. [Obs.] 3. To hold back by a trash or leash, as a dog in pursuing game; hence, to retard, encumber, or restrain; to clog; to hinder vexatiously. [R.] Beau. & Fl.\n\nTo follow with violence and trampling. [R.] The Puritan (1607).
trashily |In a trashy manner.
trashiness |The quality or state of being trashy.
trashy |Like trash; containing much trash; waste; rejected; worthless; useless; as, a trashy novel.
trass |A white to gray volcanic tufa, formed of decomposed trachytic cinders; -- sometimes used as a cement. Hence, a coarse sort of plaster or mortar, durable in water, and used to line cisterns and other reservoirs of water. [Formerly written also tarras, tarrace, terras.] Note: The Dutch trass is made by burning and grinding a soft grayish rock found on the lower Rhine.
traulism |A stammering or stuttering. [Obs.] Dalgarno.
traumatic |(a) Of or pertaining to wounds; applied to wounds. Coxe. (b) Adapted to the cure of wounds; vulnerary. Wiseman. (c) Produced by wounds; as, traumatic tetanus. -- n.  A traumatic medicine.
traumatism |A wound or injury directly produced by causes external to the body; also, violence producing a wound or injury; as, rupture of the stomach caused by traumatism.
traunce |See Trance. [Obs.]
traunt |Same as Trant. [Obs.]
traunter |Same as Tranter. [Obs. or Prov. Eng.]
travail |1. Labor with pain; severe toil or exertion. As everything of price, so this doth require travail. Hooker. 2. Parturition; labor; as, an easy travail.\n\n1. To labor with pain; to toil. [Archaic] \"Slothful persons which will not travail for their livings.\" Latimer. 2. To suffer the pangs of childbirth; to be in labor.\n\nTo harass; to tire. [Obs.] As if all these troubles had not been sufficient to travail the realm, a great division fell among the nobility. Hayward.
travailous |Causing travail; laborious. [Obs.] Wyclif. -- Trav\"ail*ous*ly, adv. [Obs.] Wyclif.
trave |1. (Arch.)  A crossbeam; a lay of joists. Maundrell. 2. A wooden frame to confine an unruly horse or ox while shoeing. She sprung as a colt doth in the trave. Chaucer.
travel |1. To labor; to travail. [Obsoles.] Hooker. 2. To go or march on foot; to walk; as, to travel over the city, or through the streets. 3. To pass by riding, or in any manner, to a distant place, or to many places; to journey; as, a man travels for his health; he is traveling in California. 4. To pass; to go; to move. Time travels in divers paces with divers persons. Shak.\n\n1. To journey over; to traverse; as, to travel the continent. \"I travel this profound.\" Milton. 2. To force to journey. [R.] They shall not be traveled forth of their own franchises. Spenser.\n\n1. The act of traveling, or journeying from place to place; a journey. With long travel I am stiff and weary. Shak. His travels ended at his country seat. Dryden. 2. pl.  An account, by a traveler, of occurrences and observations during a journey; as, a book of travels; -- often used as the title of a book; as, Travels in Italy. 3. (Mach.)  The length of stroke of a reciprocating piece; as, the travel of a slide valve. 4. Labor; parturition; travail. [Obs.]
travel-tainted |Harassed; fatigued with travel. [Obs.] Shak.
traveled |Having made journeys; having gained knowledge or experience by traveling; hence, knowing; experienced. [Written also travelled.] The traveled thane, Athenian Aberdeen. Byron.
traveler |1. One who travels; one who has traveled much. 2. A commercial agent who travels for the purpose of receiving orders for merchants, making collections, etc. 3. (Mach.)  A traveling crane. See under Crane. 4. (Spinning)  The metal loop which travels around the ring surrounding the bobbin, in a ring spinner. 5. (Naut.)  An iron encircling a rope, bar, spar, or the like, and sliding thereon. Traveler's joy (Bot.), the Clematis vitalba, a climbing plant with white flowers. -- Traveler's tree. (Bot.) See Ravenala.
travers |Across; athwart. [Obs.] The earl . . . caused . . . high trees to be hewn down, and laid travers one over another. Ld. Berners.
traversable |1. Capable of being traversed, or passed over; as, a traversable region. 2. Deniable; specifically (Law), liable to legal objection; as, a traversable presentment. Sir M. Hale.
traverse |Lying across; being in a direction across something else; as, paths cut with traverse trenches. Oak . . . being strong in all positions, may be better trusted in cross and traverse work. Sir H. Wotton. The ridges of the fallow field traverse. Hayward. Traverse drill (Mach.), a machine tool for drilling slots, in which the work or tool has a lateral motion back and forth; also, a drilling machine in which the spindle holder can be adjusted laterally.\n\nAthwart; across; crosswise.\n\n1. Anything that traverses, or crosses. Specifically: -- (a) Something that thwarts, crosses, or obstructs; a cross accident; as, he would have succeeded, had it not been for unlucky traverses not under his control. (b) A barrier, sliding door, movable screen, curtain, or the like. Men drinken and the travers draw anon. Chaucer. And the entrance of the king, The first traverse was drawn. F. Beaumont. (c) (Arch.)  A gallery or loft of communication from side to side of a church or other large building. Gwilt. (d) (Fort.) A work thrown up to intercept an enfilade, or reverse fire, along exposed passage, or line of work. (e) (Law) A formal denial of some matter of fact alleged by the opposite party in any stage of the pleadings. The technical words introducing a traverse are absque hoc, without this; that is, without this which follows. (f) (Naut.) The zigzag course or courses made by a ship in passing from one place to another; a compound course. (g) (Geom.) A line lying across a figure or other lines; a transversal. (h) (Surv.) A line surveyed across a plot of ground. (i) (Gun.) The turning of a gun so as to make it point in any desired direction. 2. A turning; a trick; a subterfuge. [Obs.] To work, or solve, a traverse (Naut.), to reduce a series of courses or distances to an equivalent single one; to calculate the resultant of a traverse. -- Traverse board (Naut.), a small board hung in the steerage, having the points of the compass marked on it, and for each point as many holes as there are half hours in a watch. It is used for recording the courses made by the ship in each half hour, by putting a peg in the corresponding hole. -- Traverse jury (Law), a jury that tries cases; a petit jury. -- Traverse sailing (Naut.), a sailing by compound courses; the method or process of finding the resulting course and distance from a series of different shorter courses and distances actually passed over by a ship. -- Traverse table. (a) (Naut. & Surv.) A table by means of which the difference of latitude and departure corresponding to any given course and distance may be found by inspection. It contains the lengths of the two sides of a right-angled triangle, usually for every quarter of a degree of angle, and for lengths of the hypothenuse, from 1 to 100. (b) (Railroad) A platform with one or more tracks, and arranged to move laterally on wheels, for shifting cars, etc., from one line of track to another.\n\n1. To lay in a cross direction; to cross. The parts should be often traversed, or crossed, by the flowing of the folds. Dryden. 2. To cross by way of opposition; to thwart with obstacles; to obstruct; to bring to naught. I can not but . . . admit the force of this reasoning, which I yet hope to traverse. Sir W. Scott. 3. To wander over; to cross in traveling; as, to traverse the habitable globe. What seas you traversed, and what fields you fought. Pope. 4. To pass over and view; to survey carefully. My purpose is to traverse the nature, principles, and properties of this detestable vice -- ingratitude. South. 5. (Gun.)  To turn to the one side or the other, in order to point in any direction; as, to traverse a cannon. 6. (Carp.)  To plane in a direction across the grain of the wood; as, to traverse a board. 7. (Law)  To deny formally, as what the opposite party has alleged. When the plaintiff or defendant advances new matter, he avers it to be true, and traverses what the other party has affirmed. To traverse an indictment or an office is to deny it. And save the expense of long litigious laws, Where suits are traversed, and so little won That he who conquers is but last undone. Dryden. To traverse a yard (Naut.), to brace it fore and aft.\n\n1. To use the posture or motions of opposition or counteraction, as in fencing. To see thee fight, to see thee foin, to see thee traverse. Shak. 2. To turn, as on a pivot; to move round; to swivel; as, the needle of a compass traverses; if it does not traverse well, it is an unsafe guide. 3. To tread or move crosswise, as a horse that throws his croup to one side and his head to the other.
traverse drill |A machine tool for drilling slots, in which the work or tool has a lateral motion back and forth; also, a drilling machine in which the spindle holder can be adjusted laterally.
traverser |1. One who, or that which, traverses, or moves, as an index on a scale, and the like. 2. (Law)  One who traverses, or denies. 3. (Railroad)  A traverse table. See under Traverse, n.
traversing |Adjustable laterally; having a lateral motion, or a swinging motion; adapted for giving lateral motion. Traversing plate (Mil.), one of two thick iron plates at the hinder part of a gun carriage, where the handspike is applied in traversing the piece. Wilhelm. -- Traversing platform (Mil.), a platform for traversing guns.
travertine |A white concretionary form of calcium carbonate, usually hard and semicrystalline. It is deposited from the water of springs or streams holding lime in solution. Extensive deposits exist at Tivoli, near Rome.
travesty |Disguised by dress so as to be ridiculous; travestied; -- applied to a book or shorter composition. [R.]\n\nA burlesque translation or imitation of a work. The second edition is not a recast, but absolutely a travesty of the first. De Quincey.\n\nTo translate, imitate, or represent, so as to render ridiculous or ludicrous. I see poor Lucan travestied, not appareled in his Roman toga, but under the cruel shears of an English tailor. Bentley.
travois |1. A primitive vehicle, common among the North American Indians, usually two trailing poles serving as shafts and bearing a platform or net for a load. On the plains they will have horses dragging travoises; dogs with travoises, women and children loaded with impediments. Julian Ralph. 2.  A logging sled. [Northern U. S. & Canada]
trawl |To take fish, or other marine animals, with a trawl.\n\n1. A fishing line, often extending a mile or more, having many short lines bearing hooks attached to it. It is used for catching cod, halibut, etc.; a boulter. [U. S. & Canada] 2. A large bag net attached to a beam with iron frames at its ends, and dragged at the bottom of the sea, -- used in fishing, and in gathering forms of marine life from the sea bottom.
trawlboat |A boat used in fishing with trawls or trawlnets.
trawler |1. One who, or that which, trawls. 2. A fishing vessel which trails a net behind it.
trawlerman |A fisherman who used unlawful arts and engines to catch fish. [Obs.] Cowell.
trawlnet |Same as Trawl, n., 2.
trawlwarp |A rope passing through a block, used in managing or dragging a trawlnet.
tray |To betray; to deceive. [Obs.] Chaucer.\n\n1. A small trough or wooden vessel, sometimes scooped out of a block of wood, for various domestic uses, as in making bread, chopping meat, etc. 2. A flat, broad vessel on which dishes, glasses, etc., are carried; a waiter; a salver. 3. A shallow box, generally without a top, often used within a chest, trunk, box, etc., as a removable receptacle for small or light articles.
tray-trip |An old game played with dice. [Obs.] Shak.
trayful |As much as a tray will hold; enough to fill a tray.
trays |Traces. [Obs.] Four white bulls in the trays. Chaucer.\n\nSee Trais. Chaucer.
treacher |A traitor; a cheat. [Obs.] Treacher and coward both. Beau. & Fl.
treacherous |Like a traitor; involving treachery; violating allegiance or faith pledged; traitorous to the state or sovereign; perfidious in private life; betraying a trust; faithless. Loyal father of a treacherous son. Shak. The treacherous smile, a mask for secret hate. Cowper. Syn. -- Faithless; perfidious; traitorous; false; insidious; plotting. -- Treach\"er*ous*ly, adv. -- Treach\"er*ous*ness, n.
treachery |Violation of allegiance or of faith and confidence; treasonable or perfidious conduct; perfidy; treason. Be ware, ye lords, of their treachery. Chaucer. In the council chamber at Edinburgh, he had contracted a deep taint of treachery and corruption. Macaulay.
treachetour |A traitor. [Obs.] \"Treachour full of false despite.\" Spenser.
treachour |A traitor. [Obs.] \"Treachour full of false despite.\" Spenser.
treacle |1. (Old Med.)  A remedy against poison. See Theriac, 1. We kill the viper, and make treacle of him. Jer. Taylor. 2. A sovereign remedy; a cure. [Obs.] Christ which is to every harm treacle. Chaucer . 3. Molasses; sometimes, specifically, the molasses which drains from the sugar-refining molds, and which is also called sugarhouse molasses. Note: In the United States molasses is the common name; in England, treacle. 4. A saccharine fluid, consisting of the inspissated juices or decoctions of certain vegetables, as the sap of the birch, sycamore, and the like. Treacle mustard (Bot.), a name given to several species of the cruciferous genus Erysimum, especially the E. cheiranthoides, which was formerly used as an ingredient in Venice treacle, or theriac. -- Treacle water, a compound cordial prepared in different ways from a variety of ingredients, as hartshorn, roots of various plants, flowers, juices of plants, wines, etc., distilled or digested with Venice treacle. It was formerly regarded as a medicine of great virtue. Nares. Venice treacle. (Old Med.) Same as Theriac, 1.
treacly |Like, or composed of, treacle.
tread |1. To set the foot; to step. Where'er you tread, the blushing flowers shall rise. Pope. Fools rush in where angels fear to tread. Pope. The hard stone Under our feet, on which we tread and go. Chaucer. 2. To walk or go; especially, to walk with a stately or a cautious step. Ye that . . . stately tread, or lowly creep. Milton. 3. To copulate; said of birds, esp. the males. Shak. To tread on or upon. (a) To trample; to set the foot on in contempt. \"Thou shalt tread upon their high places.\" Deut. xxxiii. 29. (b) to follow closely. \"Year treads on year.\" Wordsworth. -- To tread upon the heels of, to follow close upon. \"Dreadful consequences that tread upon the heels of those allowances to sin.\" Milton. One woe doth tread upon another's heel. Shak.\n\n1. To step or walk on. Forbid to tread the promised land he saw. Prior. Methought she trod the ground with greater grace. Dryden. 2. To beat or press with the feet; as, to tread a path; to tread land when too light; a well-trodden path. 3. To go through or accomplish by walking, dancing, or the like. \" I am resolved to forsake Malta, tread a pilgrimage to fair Jerusalem.\" Beau. & Fl. They have measured many a mile, To tread a measure with you on this grass. Shak. 4. To crush under the foot; to trample in contempt or hatred; to subdue. Through thy name will we tread them under that rise up against us. Ps. xliv. 5. 5. To copulate with; to feather; to cover; -- said of the male bird. Chaucer. To tread out, to press out with the feet; to press out, as wine or wheat; as, to tread out grain with cattle or horses. -- To tread the stage, to act as a stageplayer; to perform a part in a drama.\n\n1. A step or stepping; pressure with the foot; a footstep; as, a nimble tread; a cautious tread. She is coming, my own, my sweet; Were it ever so airy a tread, My heart would hear her and beat. Tennyson. 2. Manner or style of stepping; action; gait; as, the horse has a good tread. 3. Way; track; path. [R.] Shak. 4. The act of copulation in birds. 5. (Arch.)  The upper horizontal part of a step, on which the foot is placed. 6. (Fort.)  The top of the banquette, on which soldiers stand to fire over the parapet. 7. (Mach.) (a) The part of a wheel that bears upon the road or rail. (b) The part of a rail upon which car wheels bear. 8. (Biol.)  The chalaza of a bird's egg; the treadle. 9. (Far.)  A bruise or abrasion produced on the foot or ankle of a horse that interferes. See Interfere, 3.
tread-softly |Spurge nettle. See under Nettle.
treadboard |See Tread, n., 5.
treader |One who treads. Isa. xvi. 10.
treadfowl |A cock. [Obs.] Chaucer.
treadle |1. The part of a foot lathe, or other machine, which is pressed or moved by the foot. 2. (Biol.)  The chalaza of a bird's egg; the tread.
treadmill |A mill worked by persons treading upon steps on the periphery of a wide wheel having a horizontal axis. It is used principally as a means of prison discipline. Also, a mill worked by horses, dogs, etc., treading an endless belt.
treadwheel |A wheel turned by persons or animals, by treading, climbing, or pushing with the feet, upon its periphery or face. See Treadmill.
treague |A truce. [Obs.] Spenser.
treason |1. The offense of attempting to overthrow the government of the state to which the offender owes allegiance, or of betraying the state into the hands of a foreign power; disloyalty; treachery. The treason of the murthering in the bed. Chaucer. Note: In monarchies, the killing of the sovereign, or an attempt to take his life, is treason. In England, to imagine or compass the death of the king, or of the queen consort, or of the heir apparent to the crown, is high treason, as are many other offenses created by statute. In the United States, treason is confined to the actual levying of war against the United States, or to an adhering to their enemies, giving them aid and comfort. 2. Loosely, the betrayal of any trust or confidence; treachery; perfidy. If he be false, she shall his treason see. Chaucer. Petit treason. See under Petit.
treasonable |Pertaining to treason; consisting of treason; involving the crime of treason, or partaking of its guilt. Most men's heads had been intoxicated with imaginations of plots and treasonable practices. Clarendon. Syn. -- Treacherous; traitorous; perfidious; insidious. -- Trea\"son*a*ble*ness, n. -- Trea\"son*a*bly, adv.
treasonous |Treasonable. Shak. The treasonous book of the Court of King James. Pepys.
treasure |1. Wealth accumulated; especially, a stock, or store of money in reserve. This treasure hath fortune unto us given. Chaucer. 2. A great quantity of anything collected for future use; abundance; plenty. We have treasures in the field, of wheat and of barley, and of oil and of honey. Jer. xli. 8. 3. That which is very much valued. Ye shall be peculiar treasure unto me. Ex. xix. 5. From thy wardrobe bring thy chiefest treasure. Milton. Treasure city, a city for stores and magazines. Ex. i. 11.\n\nTo collect and deposit, as money or other valuable things, for future use; to lay up; to hoard; usually with up; as, to treasure up gold.
treasure-house |A house or building where treasures and stores are kept.
treasure-trove |Any money, bullion, or the like, found in the earth, or otherwise hidden, the owner of which is not known. In England such treasure belongs to the crown; whereas similar treasure found in the sea, or upon the surface of the land, belongs to the finder if no owner appears.
treasurer |One who has the care of a treasure or treasure or treasury; an officer who receives the public money arising from taxes and duties, or other sources of revenue, takes charge of the same, and disburses it upon orders made by the proper authority; one who has charge of collected funds; as, the treasurer of a society or corporation. Lord high treasurer of England, formerly, the third great officer of the crown. His office is now executed by five persons styled the lords commissioners of the treasury, or treasury lords.
treasurership |The office of treasurer.
treasuress |A woman who is a treasurer. [R.]
treasury |1. A place or building in which stores of wealth are deposited; especially, a place where public revenues are deposited and kept, and where money is disbursed to defray the expenses of government; hence, also, the place of deposit and disbursement of any collected funds. 2. That department of a government which has charge of the finances. 3. A repository of abundance; a storehouse. 4. Hence, a book or work containing much valuable knowledge, wisdom, wit, or the like; a thesaurus; as, \" Maunder's Treasury of Botany.\" 5. A treasure. [Obs.] Marston. Board of treasury, the board to which is intrusted the management of all matters relating to the sovereign's civil list or other revenues. [Eng.] Brande & C. -- Treasury bench, the first row of seats on the right hand of the Speaker in the House of Commons; -- so called because occupied by the first lord of the treasury and chief minister of the crown. [Eng.] -- Treasury lord. See Lord high treasurer of England, under Treasurer. [Eng.] -- Treasury note (U. S. Finance), a circulating note or bill issued by government authority from the Treasury Department, and receivable in payment of dues to the government.
treasury stock |Issued stock of an incorporated company held by the company itself.
treat |1. To handle; to manage; to use; to bear one's self toward; as, to treat prisoners cruelly; to treat children kindly. 2. To discourse on; to handle in a particular manner, in writing or speaking; as, to treat a subject diffusely. 3. To entertain with food or drink, especially the latter, as a compliment, or as an expression of friendship or regard; as, to treat the whole company. 4. To negotiate; to settle; to make terms for. [Obs.] To treat the peace, a hundred senators Shall be commissioned. Dryden. 5. (Med.)  To care for medicinally or surgically; to manage in the use of remedies or appliances; as, to treat a disease, a wound, or a patient. 6. To subject to some action; to apply something to; as, to treat a substance with sulphuric acid. Ure. 7. To entreat; to beseech. [Obs.] Ld. Berners.\n\n1. To discourse; to handle a subject in writing or speaking; to make discussion; -- usually with of; as, Cicero treats of old age and of duties. And, shortly of this story for to treat. Chaucer. Now of love they treat. Milton. 2. To negotiate; to come to terms of accommodation; -- often followed by with; as, envoys were appointed to treat with France. Inform us, will the emperor treat! Swift. 3. To give a gratuitous entertainment, esp. of food or drink, as a compliment.\n\n1. A parley; a conference. [Obs.] Bid him battle without further treat. Spenser. 2. An entertainment given as an expression of regard. 3. That which affords entertainment; a gratification; a satisfaction; as, the concert was a rich treat.
treatable |Manageable; tractable; hence, moderate; not violent. [Obs.] \" A treatable disposition, a strong memory.\" R. Parr. A kind of treatable dissolution. Hooker. The heats or the colds of seasons are less treatable than with us. Sir W. Temple.
treatably |In a treatable manner. [Obs.]
treater |One who treats; one who handles, or discourses on, a subject; also, one who entertains.
treatise |1. A written composition on a particular subject, in which its principles are discussed or explained; a tract. Chaucer. He published a treatise in which he maintained that a marriage between a member of the Church of England and a dissenter was a nullity. Macaulay. Note: A treatise implies more form and method than an essay, but may fall short of the fullness and completeness of a systematic exposition. 2. Story; discourse. [R.] Shak.
treatiser |One who writes a treatise. [Obs.]
treatment |1. The act or manner of treating; management; manipulation; handling; usage; as, unkind treatment; medical treatment. 2. Entertainment; treat. [Obs.] Accept such treatment as a swain affords. Pope.
treature |Treatment. [Obs.] Fabyan.
treaty |1. The act of treating for the adjustment of differences, as for forming an agreement; negotiation. \"By sly and wise treaty.\" Chaucer. He cast by treaty and by trains Her to persuade. Spenser. 2. An agreement so made; specifically, an agreement, league, or contract between two or more nations or sovereigns, formally signed by commissioners properly authorized, and solemnly ratified by the several sovereigns, or the supreme power of each state; an agreement between two or more independent states; as, a treaty of peace; a treaty of alliance. 3. A proposal tending to an agreement. [Obs.] Shak. 4. A treatise; a tract. [Obs.] Sir T. Browne.
treble |1. Threefold; triple. A lofty tower, and strong on every side With treble walls. Dryden. 2. (Mus.) (a) Acute; sharp; as, a treble sound. Bacon. (b) Playing or singing the highest part or most acute sounds; playing or singing the treble; as, a treble violin or voice.\n\nTrebly; triply. [Obs.] J. Fletcher.\n\nThe highest of the four principal parts in music; the part usually sung by boys or women; soprano. Note: This is sometimes called the first treble, to distinguish it from the second treble, or alto, which is sung by lower female voices.\n\n1. To make thrice as much; to make threefold. \"Love trebled life.\" Tennyson. 2. To utter in a treble key; to whine. [Obs.] He outrageously (When I accused him) trebled his reply. Chapman.\n\nTo become threefold. Swift.
trebleness |The quality or state of being treble; as, the trebleness of tones. Bacon.
treblet |Same as Triblet.
trebly |In a treble manner; with a threefold number or quantity; triply. Swift.
trebuchet |1. A cucking stool; a tumbrel. Cowell. 2. A military engine used in the Middle Ages for throwing stones, etc. It acted by means of a great weight fastened to the short arm of a lever, which, being let fall, raised the end of the long arm with great velocity, hurling stones with much force. 3. A kind of balance for weighing. [Obs.]
trebucket |1. A cucking stool; a tumbrel. Cowell. 2. A military engine used in the Middle Ages for throwing stones, etc. It acted by means of a great weight fastened to the short arm of a lever, which, being let fall, raised the end of the long arm with great velocity, hurling stones with much force. 3. A kind of balance for weighing. [Obs.]
trecentist |A member of the trecento, or an imitator of its characteristics.
trecento |The fourteenth century, when applied to Italian art, literature, etc. It marks the period of Dante, Petrarch, and boccaccio in literature, and of Giotto in painting.
trechometer |An odometer for vehicles. Knight.
treckschuyt |A covered boat for goods and passengers, used on the Dutch and Flemish canals.
treddle |1. See Treadle. 2. A prostitute; a strumpet. [Obs.] Ford. 3. pl.  The dung of sheep or hares. Holland.
tredille |A game at cards for three.
tree |1. (Bot.)  Any perennial woody plant of considerable size (usually over twenty feet high) and growing with a single trunk. Note: The kind of tree referred to, in any particular case, is often indicated by a modifying word; as forest tree, fruit tree, palm tree, apple tree, pear tree, etc. 2. Something constructed in the form of, or considered as resembling, a tree, consisting of a stem, or stock, and branches; as, a genealogical tree. 3. A piece of timber, or something commonly made of timber; -- used in composition, as in axletree, boottree, chesstree, crosstree, whiffletree, and the like. 4. A cross or gallows; as Tyburn tree. [Jesus] whom they slew and hanged on a tree. Acts x. 39. 5. Wood; timber. [Obs.] Chaucer. In a great house ben not only vessels of gold and of silver but also of tree and of earth. Wyclif (2 Tim. ii. 20). 6. (Chem.)  A mass of crystals, aggregated in arborescent forms, obtained by precipitation of a metal from solution. See Lead tree, under Lead. Tree bear (Zoöl.), the raccoon. [Local, U.S.] -- Tree beetle (Zoöl.) any one of numerous species of beetles which feed on the leaves of trees and shrubs, as the May beetles, the rose beetle, the rose chafer, and the goldsmith beetle. -- Tree bug (Zoöl.), any one of numerous species of hemipterous insects which live upon, and suck the sap of, trees and shrubs. They belong to Arma, Pentatoma, Rhaphigaster, and allied genera. -- Tree cat (Zool.), the common paradoxure (Paradoxurus musang). -- Tree clover (Bot.), a tall kind of melilot (Melilotus alba). See Melilot. -- Tree crab (Zoöl.), the purse crab. See under Purse. -- Tree creeper (Zoöl.), any one of numerous species of arboreal creepers belonging to Certhia, Climacteris, and allied genera. See Creeper, 3. -- Tree cricket (Zoöl.), a nearly white arboreal American cricket (Ecanthus nivoeus) which is noted for its loud stridulation; -- called also white cricket. -- Tree crow (Zoöl.), any one of several species of Old World crows belonging to Crypsirhina and allied genera, intermediate between the true crows and the jays. The tail is long, and the bill is curved and without a tooth. -- Tree dove (Zoöl.) any one of several species of East Indian and Asiatic doves belonging to Macropygia and allied genera. They have long and broad tails, are chiefly arboreal in their habits, and feed mainly on fruit. -- Tree duck (Zoöl.), any one of several species of ducks belonging to Dendrocygna and allied genera. These ducks have a long and slender neck and a long hind toe. They are arboreal in their habits, and are found in the tropical parts of America, Africa, Asia, and Australia. -- Tree fern (Bot.), an arborescent fern having a straight trunk, sometimes twenty or twenty-five feet high, or even higher, and bearing a cluster of fronds at the top. Most of the existing species are tropical. -- Tree fish (Zoöl.), a California market fish (Sebastichthys serriceps). -- Tree frog. (Zoöl.) (a) Same as Tree toad. (b) Any one of numerous species of Old World frogs belonging to Chiromantis, Rhacophorus, and allied genera of the family Ranidæ. Their toes are furnished with suckers for adhesion. The flying frog (see under Flying) is an example. -- Tree goose (Zoöl.), the bernicle goose. -- Tree hopper (Zoöl.), any one of numerous species of small leaping hemipterous insects which live chiefly on the branches and twigs of trees, and injure them by sucking the sap. Many of them are very odd in shape, the prothorax being often prolonged upward or forward in the form of a spine or crest. -- Tree jobber (Zoöl.), a woodpecker. [Obs.] -- Tree kangaroo. (Zoöl.) See Kangaroo. -- Tree lark (Zoöl.), the tree pipit. [Prov. Eng.] -- Tree lizard (Zoöl.), any one of a group of Old World arboreal lizards (Dendrosauria) comprising the chameleons. -- Tree lobster. (Zoöl.) Same as Tree crab, above. -- Tree louse (Zoöl.), any aphid; a plant louse. -- Tree moss. (Bot.) (a) Any moss or lichen growing on trees. (b) Any species of moss in the form of a miniature tree. -- Tree mouse (Zoöl.), any one of several species of African mice of the subfamily Dendromyinæ. They have long claws and habitually live in trees. -- Tree nymph, a wood nymph. See Dryad. -- Tree of a saddle, a saddle frame. -- Tree of heaven (Bot.), an ornamental tree (Ailantus glandulosus) having long, handsome pinnate leaves, and greenish flowers of a disagreeable odor. -- Tree of life (Bot.), a tree of the genus Thuja; arbor vitæ. -- Tree onion (Bot.), a species of garlic (Allium proliferum) which produces bulbs in place of flowers, or among its flowers. -- Tree oyster (Zoöl.), a small American oyster (Ostrea folium) which adheres to the roots of the mangrove tree; -- called also raccoon oyster. -- Tree pie (Zoöl.), any species of Asiatic birds of the genus Dendrocitta. The tree pies are allied to the magpie. -- Tree pigeon (Zoöl.), any one of numerous species of longwinged arboreal pigeons native of Asia, Africa, and Australia, and belonging to Megaloprepia, Carpophaga, and allied genera. -- Tree pipit. (Zoöl.) See under Pipit. -- Tree porcupine (Zoöl.), any one of several species of Central and South American arboreal porcupines belonging to the genera Chætomys and Sphingurus. They have an elongated and somewhat prehensile tail, only four toes on the hind feet, and a body covered with short spines mixed with bristles. One South American species (S. villosus) is called also couiy; another (S. prehensilis) is called also coendou. -- Tree rat (Zoöl.), any one of several species of large ratlike West Indian rodents belonging to the genera Capromys and Plagiodon. They are allied to the porcupines. -- Tree serpent (Zoöl.), a tree snake. -- Tree shrike (Zoöl.), a bush shrike. -- Tree snake (Zoöl.), any one of numerous species of snakes of the genus Dendrophis. They live chiefly among the branches of trees, and are not venomous. -- Tree sorrel (Bot.), a kind of sorrel (Rumex Lunaria) which attains the stature of a small tree, and bears greenish flowers. It is found in the Canary Islands and Teneriffe. -- Tree sparrow (Zoöl.) any one of several species of small arboreal sparrows, especially the American tree sparrow (Spizella monticola), and the common European species (Passer montanus). -- Tree swallow (Zoöl.), any one of several species of swallows of the genus Hylochelidon which lay their eggs in holes in dead trees. They inhabit Australia and adjacent regions. Called also martin in Australia. -- Tree swift (Zoöl.), any one of several species of swifts of the genus Dendrochelidon which inhabit the East Indies and Southern Asia. -- Tree tiger (Zoöl.), a leopard. -- Tree toad (Zoöl.), any one of numerous species of amphibians belonging to Hyla and allied genera of the family Hylidæ. They are related to the common frogs and toads, but have the tips of the toes expanded into suckers by means of which they cling to the bark and leaves of trees. Only one species (Hyla arborea) is found in Europe, but numerous species occur in America and Australia. The common tree toad of the Northern United States (H. versicolor) is noted for the facility with which it changes its colors. Called also tree frog. See also Piping frog, under Piping, and Cricket frog, under Cricket. -- Tree warbler (Zoöl.), any one of several species of arboreal warblers belonging to Phylloscopus and allied genera. -- Tree wool (Bot.), a fine fiber obtained from the leaves of pine trees.\n\n1. To drive to a tree; to cause to ascend a tree; as, a dog trees a squirrel. J. Burroughs. 2. To place upon a tree; to fit with a tree; to stretch upon a tree; as, to tree a boot. See Tree, n., 3.
tree burial |Disposal of the dead by placing the corpse among the branches of a tree or in a hollow trunk, a practice among many primitive peoples.
tree calf |A bright brown polished calfskin binding of  books, stained with a conventional treelike design.
treebeard |A pendulous branching lichen (Usnea barbata); -- so called from its resemblance to hair.
treeful |The quantity or number which fills a tree.
treeless |Destitute of trees. C. Kingsley.
treen |1. Made of wood; wooden. [Obs.] \" Treen cups.\" Camden. 2. Relating to, or drawn from, trees. [Obs.] Spenser. Treen liquors, especially that of the date. Evelyn.\n\npl. of Tree. \" The shady treen.\" Fairfax.
treenail |A long wooden pin used in fastening the planks of a vessel to the timbers or to each other. [Written also trenail, and trunnel.]
tref |Ceremonially unclean, according to the Jewish law; -- opposed to kosher.
trefle |A species of time; -- so called from its resemblance in form to a trefoil.\n\nHaving a three-lobed extremity or extremities, as a cross; also, more rarely, ornamented with trefoils projecting from the edges, as a bearing.
trefoil |1. (Bot.)  Any plant of the genus Trifolium, which includes the white clover, red clover, etc.; -- less properly, applied also to the nonesuch, or black medic. See Clover, and Medic. 2. (Arch.)  An ornamental foliation consisting of three divisions, or foils. 3. (Her.)  A charge representing the clover leaf.
trefoiled |Same as Tréflé.
treget |Guile; trickery. [Obs.] Rom. of R.
tregetour |A juggler who produces illusions by the use of elaborate machinery. [Obs.] Divers appearances Such as these subtle tregetours play. Chaucer.
tregetry |Trickery; also, a trick. [Obs.] Rom. of R.
trehala |An amorphous variety of manna obtained from the nests and cocoons of a Syrian coleopterous insect (Larinus maculatus, L. nidificans, etc.) which feeds on the foliage of a variety of thistle. It is used as an article of food, and is called also nest sugar.
trehalose |Mycose; -- so called because sometimes obtained from trehala.
treillage |Latticework for supporting vines, etc.; an espalier; a trellis. Spectator. I shall plant the roses against my treillage to-morrow. Walpole.
trek |1. To draw or haul a load, as oxen. 2.  To travel, esp. by ox wagon; to go from place to place; to migrate. [Chiefly South Africa] One of the motives which induced the Boers of 1836 to trek out of the Colony. James Bryce.\n\nThe act of trekking; a drawing or a traveling; a journey; a migration. [Chiefly South Africa] To the north a trek was projected, and some years later was nearly carried out, for the occupation of the Mashonaland. James Bryce. Great Trek, the great emigration of Boers from Cape Colony which began in 1836, and resulted in the founding of the South African Republic and Orange Free State.
trekker |One that treks. [Written also trecker.] [South Africa]  James Bryce.
trekometer |A field range finger used in the British service.
trellis |A structure or frame of crossbarred work, or latticework, used for various purposes, as for screens or for supporting plants.
trellised |Having a trellis or trellises. Cottages trellised over with exotic plants. Jeffrey.
tremando |Trembling; -- used as a direction to perform a passage with a general shaking of the whole chord.
trematode |One of the Trematodea. Also used adjectively.
trematodea |An extensive order of parasitic worms. They are found in the internal cavities of animals belonging to all classes. Many species are found, also, on the gills and skin of fishes. A few species are parasitic on man, and some, of which the fluke is the most important, are injurious parasites of domestic animals. The trematodes usually have a flattened body covered with a chitinous skin, and are furnished with two or more suckers for adhesion. Most of the species are hermaphrodite. Called also Trematoda, and Trematoidea. See Fluke, Tristoma, and Cercaria.
trematoid |f or pertaining to the Trematodea. See Illustration in Appendix.
tremble |1. To shake involuntarily, as with fear, cold, or weakness; to quake; to quiver; to shiver; to shudder; -- said of a person or an animal. I tremble still with fear. Shak. Frighted Turnus trembled as he spoke. Dryden. 2. To totter; to shake; -- said of a thing. The Mount of Sinai, whose gray top Shall tremble. Milton. 3. To quaver or shake, as sound; to be tremulous; as the voice trembles.\n\nAn involuntary shaking or quivering. I am all of a tremble when I think of it. W. Black.
trembler |One who trembles.
trembling |Shaking; tottering; quivering. -- Trem\"bling*ly, adv. Trembling poplar (Bot.), the aspen.
tremella |A genus of gelatinous fungi found in moist grounds.
tremendous |Fitted to excite fear or terror; such as may astonish or terrify by its magnitude, force, or violence; terrible; dreadful; as, a tremendous wind; a tremendous shower; a tremendous shock or fall. A tremendous mischief was a foot. Motley. Syn. -- Terrible; dreadful; frightful; terrific; horrible; awful. -- Tre*men\"dous*ly, adv. -- Tre*men\"dous*ness, n.
tremex |A genus of large hymenopterous insects allied to the sawflies. The female lays her eggs in holes which she bores in the trunks of trees with her large and long ovipositor, and the larva bores in the wood. See Illust. of Horntail. Note: The pigeon tremex (Tremex columba), a common American species, infests the elm, pear, and other trees.
tremie |An apparatus for depositing and consolidating concrete under water, essentially a tube of wood or sheet metal with a hooperlike top. It is usually handled by a crane.
tremolando |Same as Tremando.
tremolite |A white variety of amphibole, or hornblende, occurring in long, bladelike crystals, and coarsely fibrous masses.
tremolo |(a) The rapid reiteration of tones without any apparent cessation, so as to produce a tremulous effect. (b) A certain contrivance in an organ, which causes the notes to sound with rapid pulses or beats, producing a tremulous effect; -- called also tremolant, and tremulant.
tremor |A trembling; a shivering or shaking; a quivering or vibratory motion; as, the tremor of a person who is weak, infirm, or old. He fell into an universal tremor of all his joints. Harvey.
tremulant |Tremulous; trembling; shaking. [R.] \" With tremulent white rod.\" Carlyle.
tremulent |Tremulous; trembling; shaking. [R.] \" With tremulent white rod.\" Carlyle.
tremulous |1. Shaking; shivering; quivering; as, a tremulous limb; a tremulous motion of the hand or the lips; the tremulous leaf of the poplar. 2. Affected with fear or timidity; trembling. The tender, tremulous Christian. Dr. H. More. -- Trem\"u*lous*ly, adv. -- Trem\"u*lous*ness, n.
tren |A fish spear. [Obs.] Ainsworth.
trenail |Same as Treenail.
trench |1. To cut; to form or shape by cutting; to make by incision, hewing, or the like. The wide wound that the boar had trenched In his soft flank. Shak. This weak impress of love is as a figure Trenched in ice, which with an hour's heat Dissolves to water, and doth lose its form. Shak. 2. (Fort.)  To fortify by cutting a ditch, and raising a rampart or breastwork with the earth thrown out of the ditch; to intrench. Pope. No more shall trenching war channel her fields. Shak. 3. To cut furrows or ditches in; as, to trench land for the purpose of draining it. 4. To dig or cultivate very deeply, usually by digging parallel contiguous trenches in succession, filling each from the next; as, to trench a garden for certain crops.\n\n1. To encroach; to intrench. Does it not seem as if for a creature to challenge to itself a boundless attribute, were to trench upon the prerogative of the divine nature I. Taylor. 2. To have direction; to aim or tend. [R.] Bacon. To trench at, to make trenches against; to approach by trenches, as a town in besieging it. [Obs.] Like powerful armies, trenching at a town By slow and silent, but resistless, sap. Young.\n\n1. A long, narrow cut in the earth; a ditch; as, a trench for draining land. Mortimer. 2. An alley; a narrow path or walk cut through woods, shrubbery, or the like. [Obs.] In a trench, forth in the park, goeth she. Chaucer. 3. (Fort.)  An excavation made during a siege, for the purpose of covering the troops as they advance toward the besieged place. The term includes the parallels and the approaches. To open the trenches (Mil.), to begin to dig or to form the lines of approach. Trench cavalier (Fort.), an elevation constructed (by a besieger) of gabions, fascines, earth, and the like, about half way up the glacis, in order to discover and enfilade the covered way. -- Trench plow, or Trench plough, a kind of plow for opening land to a greater depth than that of common furrows.
trench-plough |To plow with deep furrows, for the purpose of loosening the land to a greater depth than usual.
trench-plow |To plow with deep furrows, for the purpose of loosening the land to a greater depth than usual.
trenchand |Trenchant. [Obs.] Spenser.
trenchant |1. Fitted to trench or cut; gutting; sharp. \" Trenchant was the blade.\" Chaucer. 2. Fig.: Keen; biting; severe; as, trenchant wit.
trenchantly |In a trenchant, or sharp, manner; sharply; severely.
trencher |1. One who trenches; esp., one who cuts or digs ditches. 2. A large wooden plate or platter, as for table use. 3. The table; hence, the pleasures of the table; food. It could be no ordinary declension of nature that could bring some men, after an ingenuous education, to place their \"summum bonum\" upon their trenchers. South. Trencher cap, the cap worn by studens at Oxford and Cambridge Universities, having a stiff, flat, square appendage at top. A similar cap used in the United States is called Oxford cap, mortar board, etc. -- Trencher fly, a person who haunts the tables of others; a parasite. [R.] L'Estrange. -- Trencher friend, one who frequents the tables of others; a sponger. -- Trencher mate, a table companion; a parasite; a trencher fly. Hooker.
trencher-man |1. A feeder; a great eater; a gormandizer. Shak. 2. A cook. [Obs.] The skillfulest trencher-men of Media. Sir P. Sidney. 3. A table companion; a trencher mate. Thackeray.
trenchmore |A kind of lively dance of a rude, boisterous character. Also, music in triple time appropriate to the dance. [Obs.] All the windows in the town dance new trenchmore. Beau. & Fl.\n\nTo dance the trenchmore. [Obs.] Marston.
trend |To have a particular direction; to run; to stretch; to tend; as, the shore of the sea trends to the southwest.\n\nTo cause to turn; to bend. [R.] Not far beneath i' the valley as she trends Her silver stream. W. Browne.\n\nInclination in a particular direction; tendency; general direction; as, the trend of a coast. Trend of an anchor. (Naut.) (a) The lower end of the shank of an anchor, being the same distance on the shank from the throat that the arm measures from the throat to the bill. R. H. Dana, Jr. (b) The angle made by the line of a vessel's keel and the direction of the anchor cable, when she is swinging at anchor.\n\nTo cleanse, as wool. [Prov. Eng.]\n\nClean wool. [Prov. Eng.]
trender |One whose business is to free wool from its filth. [Prov. Eng.]
trendle |A wheel, spindle, or the like; a trundle. [Obs.] The shaft the wheel, the wheel, the trendle turns. Sylvester.
trennel |Corrupt form of Treenail.
trental |1. (R. C. Ch.)  An office and mass for the dead on the thirtieth day after death or burial. \"Their trentals and their shrifts.\" Spenser. 2. Hence, a dirge; an elegy.
trente et quarante |Same as Rouge et noir, under Rouge.
trenton period |A subdivision in the lower Silurian system of America; -- so named from Trenton Falls, in New York. The rocks are mostly limestones, and the period is divided into the Trenton, Utica, and Cincinnati epochs. See the Chart of Geology.
trepan |1. (Surg.)  A crown-saw or cylindrical saw for perforating the skull, turned, when used, like a bit or gimlet. See Trephine. 2. (Mining)  A kind of broad chisel for sinking shafts.\n\nTo perforate (the skull) with a trepan, so as to remove a portion of the bone, and thus relieve the brain from pressure or irritation; to perform an operation with the trepan.\n\n1. A snare; a trapan. Snares and trepans that common life lays in its way. South. 2. a deceiver; a cheat. He had been from the beginning a spy and a trepan. Macaulay.\n\nTo insnare; to trap; to trapan. Guards even of a dozen men were silently trepanned from their stations. De Quincey.
trepang |Any one of several species of large holothurians, some of which are dried and extensively used as food in China; -- called also bêche de mer, sea cucumber, and sea slug. [Written also tripang.] Note: The edible trepangs are mostly large species of Holothuria, especially H. edulis. They are taken in vast quantities in the East Indies, where they are dried and smoked, and then shipped to China. They are used as an ingredient in certain kinds of soup.
trepanize |To trepan. [Obs.] \"By trepanizing the skull.\" Jer. Taylor.
trepanner |One who trepans. \" Pitiful trepanners and impostors.\" Gauden.
trepeget |A trebuchet. [Obs.]
trephine |An instrument for trepanning, being an improvement on the trepan. It is a circular or cylindrical saw, with a handle like that of a gimlet, and a little sharp perforator called the center pin.\n\nTo perforate with a trephine; to trepan.
trepid |Trembling; quaking. Thackeray.
trepidation |1. An involuntary trembling, sometimes an effect of paralysis, but usually caused by terror or fear; quaking; quivering. 2. Hence, a state of terror or alarm; fear; confusion; fright; as, the men were in great trepidation. 3. (Anc. Astron.)  A libration of the starry sphere in the Ptolemaic system; a motion ascribed to the firmament, to account for certain small changes in the position of the ecliptic and of the stars. Syn. -- Tremor; agitation; disturbance; fear.
trepidity |Trepidation. [R.]
tres-tine |The third tine above the base of a stag's antler; the royal antler.
tres-tyne |In the antler of a stag, the third tyne above the base. This tyne appears in the third year. In those deer in which the brow tyne does not divide, the tres-tyne is the second tyne above the base. See Illust. under Rucervine, and under Rusine.
tresayle |A grandfather's grandfather. [Obs.] Writ of tresayle (O. Eng. Law), a writ which lay for a man claiming as heir to his grandfather's grandfather, to recover lands of which he had been deprived by an abatement happening on the ancestor's death. Mozley & W.
tresor |Treasure. [Obs.] Chaucer.
trespasser |One who commits a trespass; as: (a) (Law) One who enters upon another's land, or violates his rights. (b) A transgressor of the moral law; an offender; a sinner.
tress |1. A braid, knot, or curl, of hair; a ringlet. Her yellow hair was braided in a tress. Chaucer. Fair tresses man's imperial race insnare. Pope. 2. Fig.: A knot or festoon, as of flowers. Keats.
tressed |1. Having tresses. 2. Formed into ringlets or braided; braided; curled. Spenser. Drayton.
tressel |A trestle.
tressful |Tressy. [R.] Sylvester.
tressure |A kind of border similar to the orle, but of only half the breadth of the latter.
tressured |Provided or bound with a tressure; arranged in the form of a tressure. The tressured fleur-de-lis he claims To wreathe his shield. Sir W. Scott.
tressy |Abounding in tresses. J. Baillie.
trestle |1. A movable frame or support for anything, as scaffolding, consisting of three or four legs secured to a top piece, and forming a sort of stool or horse, used by carpenters, masons, and other workmen; also, a kind of framework of strong posts or piles, and crossbeams, for supporting a bridge, the track of a railway, or the like. 2. The frame of a table. Trestle board, a board used by architects, draughtsmen, and the like, for drawing designs upon; -- so called because commonly supported by trestles. -- Trestle bridge. See under Bridge, n.
trestletree |One of two strong bars of timber, fixed horizontally on the opposite sides of the masthead, to support the crosstrees and the frame of the top; -- generally used in the plural. Totten.
trestlework |A viaduct, pier, scaffold, or the like, resting on trestles connected together.
tret |3d pers. sing. pres. of Tread, for treadeth. Chaucer.\n\nAn allowance to purchasers, for waste or refuse matter, of four pounds on every 104 pounds of suttle weight, or weight after the tare deducted. M'Culloch.
tretable |Tractable; moderate. [Obs.] By nature debonaire and tretable. Chaucer.
trething |A tax; an impost. [Obs.] Johnson.
tretis |A treatise; also, a treaty. [Obs.] Chaucer.\n\nLong and well-proportioned; nicely made; pretty. [Obs.] \"Her nose tretys.\" Chaucer.
tretys |A treatise; also, a treaty. [Obs.] Chaucer.\n\nLong and well-proportioned; nicely made; pretty. [Obs.] \"Her nose tretys.\" Chaucer.
trevat |A weaver's cutting instrument; for severing the loops of the pile threads of velvet.
trevet |A stool or other thing supported by three legs; a trivet.
trew |True. [Obs.] Chaucer.
trewe |True. [Obs.] Chaucer.
trews |Trowsers; especially, those of the Scotch Highlanders. \"He wore the trews, or close trowsers, made of tartan.\" Sir W. Scott.
trewth |Truth. [Obs.] Chaucer.
trey |Three, at cards, dice, or dominoes; a card, die, or domino of three spots or pips. Seven is my chance and thine is cinq and trey. Chaucer.
tri- |1. A prefix meaning three, thrice, threefold; as in tricolored, tridentate. 2. (Chem.)  A prefix (also used adjectively) denoting three proportional or combining part, or the third degree of that to the name of which it is prefixed; as in trisulphide, trioxide, trichloride.
triable |1. Fit or possible to be tried; liable to be subjected to trial or test. \"Experiments triable.\" Boyle. 2. (Law)  Liable to undergo a judicial examination; properly coming under the cognizance of a court; as, a cause may be triable before one court which is not triable in another.
triableness |Quality or state of being triable.
triacid |Capable of neutralizing three molecules of a monobasic acid or the equivalent; having three hydrogen atoms which may be acid radicals; -- said of certain bases; thus, glycerin is a triacid base.
triacle |See Treacle. [Obs.] Chaucer.
triacontahedral |Having thirty sides.
triaconter |A vessel with thirty banks of oars, or, as some say, thirty ranks of rowers.
triad |1. A union of three; three objects treated as one; a ternary; a trinity; as, a triad of deities. 2. (Mus.) (a) A chord of three notes. (b) The common chord, consisting of a tone with its third and fifth, with or without the octave. 3. (Chem.)  An element or radical whose valence is three. Triads of the Welsh bards, poetical histories, in which the facts recorded are grouped by threes, three things or circumstances of a kind being mentioned together. -- Hindoo triad. See Trimurti.
triadelphous |Having stamens joined by filaments into three bundles. See Illust. under Adelphous.
triadic |Having the characteristics of a triad; as, boron is triadic.
triakisoctahedron |A trigonal trisoctahedron.
trial |1. The act of trying or testing in any manner. Specifically: -- (a) Any effort or exertion of strength for the purpose of ascertaining what can be done or effected. [I] defy thee to the trial of mortal fight. Milton. (b) The act of testing by experience; proof; test. Repeated trials of the issues and events of actions. Bp. Wilkins. (c) Examination by a test; experiment, as in chemistry, metallurgy, etc. 2. The state of being tried or tempted; exposure to suffering that tests strength, patience, faith, or the like; affliction or temptation that exercises and proves the graces or virtues of men. Others had trial of cruel mockings and scourgings. Heb. xi. 36. 3. That which tries or afflicts; that which harasses; that which tries the character or principles; that which tempts to evil; as, his child's conduct was a sore trial. Every station is exposed to some trials. Rogers. 4. (Law)  The formal examination of the matter in issue in a cause before a competent tribunal; the mode of determining a question of fact in a court of law; the examination, in legal form, of the facts in issue in a cause pending before a competent tribunal, for the purpose of determining such issue. Syn. -- Test; attempt; endeavor; effort; experiment; proof; essay. See Test, and Attempt.
trial balance |The testing of a ledger to discover whether the debits and credits balance, by finding whether the sum of the personal credits increased by the difference between the debit and credit sums in the merchandise and other impersonal accounts equals the sum of personal debits. The equality would not show that the items were all correctly posted.
triality |Three united; state of being three. [R.] H. Wharton.
trialogue |A discourse or colloquy by three persons.
triamide |An amide containing three amido groups.
triamine |An amine containing three amido groups.
triander |Any one of the Triandria.
triandria |A Linnæan class of plants having three distinct and equal stamens.
triandrian |Of or pertaining to the Triandria; having three distinct and equal stamens in the same flower.
triandrous |Of or pertaining to the Triandria; having three distinct and equal stamens in the same flower.
triangle |1. (Geom.)  A figure bounded by three lines, and containing three angles. Note: A triangle is either plane, spherical, or curvilinear, according as its sides are straight lines, or arcs of great circles of a sphere, or any curved lines whatever. A plane triangle is designated as scalene, isosceles, or equilateral, according as it has no two sides equal, two sides equal, or all sides equal; and also as right-angled, or oblique-angled, according as it has one right angle, or none; and oblique-angled triangle is either acute-angled, or obtuse-angled, according as all the angles are acute, or one of them obtuse. The terms scalene, isosceles, equilateral, right-angled, acute-angled, and obtuse-angled, are applied to spherical triangles in the same sense as to plane triangles. 2. (Mus.)  An instrument of percussion, usually made of a rod of steel, bent into the form of a triangle, open at one angle, and sounded by being struck with a small metallic rod. 3. A draughtsman's square in the form of a right-angled triangle. 4. (Mus.)  A kind of frame formed of three poles stuck in the ground and united at the top, to which soldiers were bound when undergoing corporal punishment, -- now disused. 5. (Astron.) (a) A small constellation situated between Aries and Andromeda. (b) A small constellation near the South Pole, containing three bright stars. Triangle spider (Zoöl.), a small American spider (Hyptiotes Americanus) of the family Ciniflonidæ, living among the dead branches of evergreen trees. It constructs a triangular web, or net, usually composed of four radii crossed by a double elastic fiber. The spider holds the thread at the apex of the web and stretches it tight, but lets go and springs the net when an insect comes in contact with it.
triangled |Having three angles; triangular.
triangular |1. Having three angles; having the form of a triangle. 2. (Bot.)  Oblong or elongated, and having three lateral angles; as, a triangular seed, leaf, or stem. Triangular compasses, compasses with three legs for taking off the angular points of a triangle, or any three points at the same time. -- Triangular crab (Zoöl.), any maioid crab; -- so called because the carapace is usually triangular. -- Triangular numbers (Math.), the series of numbers formed by the successive sums of the terms of an arithmetical progression, of which the first term and the common difference are 1. See Figurate numbers, under Figurate.
triangulares |The triangular, or maioid, crabs. See Illust. under Maioid, and Illust. of Spider crab, under Spider.
triangularity |The quality or state of being triangular. Bolingbroke.
triangularly |In a triangular manner; in the form of a triangle. Dampier.
triangulate |1. To divide into triangles; specifically, to survey by means of a series of triangles properly laid down and measured. 2. To make triangular, or three-cornered.
triangulation |The series or network of triangles into which the face of a country, or any portion of it, is divided in a trigonometrical survey; the operation of measuring the elements necessary to determine the triangles into which the country to be surveyed is supposed to be divided, and thus to fix the positions and distances of the several points connected by them.
triarchy |Government by three persons; a triumvirate; also, a country under three rulers. Holland.
triarian |Occupying the third post or rank. [Obs.] Cowley.
triarticulate |Having three joints.
trias |The formation situated between the Permian and Lias, and so named by the Germans, because consisting of three series of strata, which are called in German the Bunter sandstein, Muschelkalk, and Keuper.
triassic |Of the age of, or pertaining to, the Trias. -- n.  The Triassic formation.
triatic |A term used in the phrase triatic stay. See under Stay.
triatomic |(a) Having three atoms; -- said of certain elements or radicals. (b) Having a valence of three; trivalent; sometimes, in a specific sense, having three hydroxyl groups, whether acid or basic; thus, glycerin, glyceric acid, and tartronic acid are each triatomic.
tribal |Of or pertaining to a tribe or tribes; as, a tribal scepter. Bp. Warburton.
tribalism |The state of existing in tribes; also, tribal feeling; tribal prejudice or exclusiveness; tribal peculiarities or characteristics.
tribasic |Capable of neutralizing three molecules of a monacid base, or their equivalent; having three hydrogen atoms capable of replacement by basic elements on radicals; -- said of certain acids; thus, citric acid is a tribasic acid.
tribble |A frame on which paper is dried. Knight.
tribe |1. A family, race, or series of generations, descending from the same progenitor, and kept distinct, as in the case of the twelve tribes of Israel, descended from the twelve sons of Jacob. \"The Lion of the tribe of Juda.\" Rev. v. 5. A wealthy Hebrew of my tribe. Shak. 2. (Bot.)  A number of species or genera having certain structural characteristics in common; as, a tribe of plants; a tribe of animals. Note: By many recent naturalists, tribe has been used for a group of animals or plants intermediate between order and genus.family is between order and genus. 3. A nation of savages or uncivilized people; a body of rude people united under one leader or government; as, the tribes of the Six Nations; the Seneca tribe. 4. A division, class, or distinct portion of a people, from whatever cause that distinction may have originated; as, the city of Athens was divided into ten tribes. 5. (Stock Breeding)  A family of animals descended from some particular female progenitor, through the female line; as, the Duchess tribe of shorthorns.\n\nTo distribute into tribes or classes. [R.] Our fowl, fish, and quadruped are well tribed. Abp. Nicolson.
triblet |1. A goldsmith's tool used in making rings. Ainsworth. 2. A steel cylinder round which metal is drawn in the process of forming tubes. Tomlinson. 3. (Blacksmithing)  A tapering mandrel.
tribolet |1. A goldsmith's tool used in making rings. Ainsworth. 2. A steel cylinder round which metal is drawn in the process of forming tubes. Tomlinson. 3. (Blacksmithing)  A tapering mandrel.
tribometer |An instrument to ascertain the degree of friction in rubbing surfaces. Brande & C.
tribrach |A poetic foot of three short syllables, as, mèlì\\'dcs.
tribracteate |Having three bracts.
tribromophenol |A colorless crystalline substance prepared by the reaction of carbolic acid with bromine.
tribromphenol |A colorless crystalline substance prepared by the reaction of carbolic acid with bromine.
tribual |Of or relating to a tribe; tribal; as, a tribual characteristic; tribular worship. [R.] The tribual lispings of the Ephraimites. Fuller.
tribular |Of or relating to a tribe; tribal; as, a tribual characteristic; tribular worship. [R.] The tribual lispings of the Ephraimites. Fuller.
tribulation |That which occasions distress, trouble, or vexation; severe affliction. When tribulation or persecution ariseth because of the word, by and by he is offended. Matt. xiii. 21. In the world ye shall have tribulation. John. xvi. 33.
tribunal |1. The seat of a judge; the bench on which a judge and his associates sit for administering justice. 2. Hence, a court or forum; as, the House of Lords, in England, is the highest tribunal in the kingdom.
tribunary |Of or pertaining to tribunes; as, tribunary powers or authority.
tribunate |The state or office of a tribune; tribuneship.
tribune |1. (Rom. Antiq.)  An officer or magistrate chosen by the people, to protect them from the oppression of the patricians, or nobles, and to defend their liberties against any attempts that might be made upon them by the senate and consuls. Note: The tribunes were at first two, but their number was increased ultimately to ten. There were also military tribunes, officers of the army, of whom there were from four to six in each legion. Other officers were also called tribunes; as, tribunes of the treasury, etc. 2. Anciently, a bench or elevated place, from which speeches were delivered; in France, a kind of pulpit in the hall of the legislative assembly, where a member stands while making an address; any place occupied by a public orator.
tribuneship |The office or power of a tribune.
tribunician |Of or pertaining to tribunes; befitting a tribune; as, tribunitial power or authority. Dryden. A kind of tribunician veto, forbidding that which is recognized to be wrong. Hare.
tribunitial |Of or pertaining to tribunes; befitting a tribune; as, tribunitial power or authority. Dryden. A kind of tribunician veto, forbidding that which is recognized to be wrong. Hare.
tribunitian |Of or pertaining to tribunes; befitting a tribune; as, tribunitial power or authority. Dryden. A kind of tribunician veto, forbidding that which is recognized to be wrong. Hare.
tribunitious |Tribunician; tribunitial. [Obs.] Bacon.
tributarily |In a tributary manner.
tributariness |The quality or state of being tributary.
tributary |1. Paying tribute to another, either from compulsion, as an acknowledgment of submission, or to secure protection, or for the purpose of purchasing peace. [Julius] unto Rome made them tributary. Chaucer. 2. Hence, subject; subordinate; inferior. He to grace his tributary gods. Milton. 3. Paid in tribute. \"Tributary tears.\" Shak. 4. Yielding supplies of any kind; serving to form or make up, a greater object of the same kind, as a part, branch, etc.; contributing; as, the Ohio has many tributary streams, and is itself tributary to the Mississippi.\n\n1. A ruler or state that pays tribute, or a stated sum, to a conquering power, for the purpose of securing peace and protection, or as an acknowledgment of submission, or for the purchase of security. 2. A stream or river flowing into a larger river or into a lake; an affluent.
tribute |1. An annual or stated sum of money or other valuable thing, paid by one ruler or nation to another, either as an acknowledgment of submission, or as the price of peace and protection, or by virtue of some treaty; as, the Romans made their conquered countries pay tribute. Millions for defense, but not one cent for tribute. C. C. Pinckney. 2. A personal contribution, as of money, praise, service, etc., made in token of services rendered, or as that which is due or deserved; as, a tribute of affection. Implores the passing tribute of a sigh. Gray. 3. (Mining)  A certain proportion of the ore raised, or of its value, given to the miner as his recompense. Pryce. Tomlinson. Tribute money, money paid as a tribute or tax. -- Tribute pitch. (Mining) See under Tributer. [Eng.] Syn. -- See Subsidy.\n\nTo pay as tribute. [R.] Whitlock (1654).
tributer |One who works for a certain portion of the ore, or its value. [Eng.] Note: Tributers generally work in gangs, and have a limited portion of a lode set them, called a tribute pitch, beyond which they are not permitted to work, and for which they receive a certain portion of the ore, or so much per pound, as agreed upon, of the value of what they raise. Weale.
trica |An apothecium in certain lichens, having a spherical surface marked with spiral or concentric ridges and furrows.
tricarballylic |Of, pertaining to, or designating, a complex tribasic organic acid, C3H5.(CO2H)3 occurring naturally in unripe beet roots, and produced artificially from glycerin as a white crystalline substance.
tricarbimide |See under Cyanuric.
trice |1. To pull; to haul; to drag; to pull away. [Obs.] Out of his seat I will him trice. Chaucer. 2. (Naut.)  To haul and tie up by means of a rope.\n\nA very short time; an instant; a moment; -- now used only in the phrase in a trice. \"With a trice.\" Turbervile. \" On a trice.\" Shak. A man shall make his fortune in a trice. Young.
tricennarious |Of or pertaining to thirty years; tricennial. [R.]
tricennial |Of or pertaining to thirty years; consisting of thirty years; occurring once in every thirty years.
tricentenary |Including, or relating to, the interval of three hundred years; tercentenary. -- n.  A period of three centuries, or three hundred years, also, the three-hundredth anniversary of any event; a tercentenary.
triceps |A muscle having three heads; specif., the great extensor of the forearm, arising by three heads and inserted into the olecranon at the elbow.
trichiasis |A disease of the eye, in which the eyelashes, being turned in upon the eyeball, produce constant irritation by the motion of the lids.
trichina |A small, slender nematoid worm (Trichina spiralis) which, in the larval state, is parasitic, often in immense numbers, in the voluntary muscles of man, the hog, and many other animals. When insufficiently cooked meat containing the larvæ is swallowed by man, they are liberated and rapidly become adult, pair, and the ovoviviparous females produce in a short time large numbers of young which find their way into the muscles, either directly, or indirectly by means of the blood. Their presence in the muscles and the intestines in large numbers produces trichinosis.
trichiniasis |Trichinosis.
trichinize |To render trichinous; to affect with trichinæ; -- chiefly used in the past participle; as, trichinized pork.
trichinoscope |An apparatus for the detection of trichinæ in the flesh of animals, as of swine.
trichinosis |The disease produced by the presence of trichinæ in the muscles and intestinal track. It is marked by fever, muscular pains, and symptoms resembling those of typhoid fever, and is frequently fatal.
trichinous |Of or pertaining to trichinæ or trichinosis; affected with, or containing, trichinæ; as, trichinous meat.
trichite |1. (Min.)  A kind of crystallite resembling a bunch of hairs, common in obsidian. See Illust. of Crystallite. 2. (Zoöl.)  A delicate, hairlike siliceous spicule, found in certain sponges. Trichite sheaf (Zoöl.), one of the small sheaflike fascicles of slender setæ characteristic of certain sponges. See Illust. under Spicule.
trichiuriform |Like or pertaining to the genus Trichiurus or family Trichiuridæ, comprising the scabbard fishes and hairtails.
trichiuroid |Of, like, or pertaining to, Trichiurus.
trichiurus |A genus of fishes comprising the hairtails. See Hairtail.
trichloride |A chloride having three atoms of chlorine in the molecule.
trichobranchia |The gill of a crustacean in which the branchial filaments are slender and cylindrical, as in the crawfishes.
trichocyst |A lasso cell.
trichogyne |The slender, hairlike cell which receives the fertilizing particles, or antherozoids, in red seaweeds. -- Trich`o*gyn\"ic, a.
trichomanes |Any fern of the genus Trichomanes. The fronds are very delicate and often translucent, and the sporangia are borne on threadlike receptacles rising from the middle of cup-shaped marginal involucres. Several species are common in conservatories; two are native in the United States.
trichomatose |Affected with a disease which causes agglutination and matting together; -- said of the hair when affected with plica. See Plica, 1.
trichome |A hair on the surface of leaf or stem, or any modification of a hair, as a minute scale, or star, or gland. The sporangia of ferns are believed to be of the nature of trichomes. -- Tri*chom\"a*tous, a.
trichophore |1. (Bot.)  The special cell in red algæ which produces or bears a trichogyne. See Illust. of Trichogyne. 2. (Zoöl.)  One of the saclike organs from which the setæ of annelids arise. -- Trich`o*phor\"ic, a.
trichopter |One of the Trichoptera.
trichoptera |A suborder of Neuroptera usually having the wings covered with minute hairs. It comprises the caddice flies, and is considered by some to be a distinct order.
trichopteran |One of the Trichoptera.
trichopterous |Of, pertaining to, or characterizing, the Trichoptera.
trichord |An instrument, as a lyre or harp, having three strings.
trichoscolices |An extensive group of wormlike animals characterized by being more or less covered with cilia.
trichotomous |Divided into three parts, or into threes; three-forked; as, a trichotomous stem. Martyn.
trichotomy |Division into three parts.
trichroic |Exhibiting trichroism; pleochroic; pleochroism.
trichroism |The quality possessed by some crystals of presenting different colors in three different directions.
trichromatic |Having or existing in three different phases of color; having three distinct color varieties; -- said of certain birds and insects.
trichromatism |The quality, state, or phenomenon of being trichromatic.
trichromic |If, pertaining to, or consisting of, three colors or color sensations.\n\nContaining three atoms of chromium.
tricipital |Having three heads, or three origins; as, a tricipital muscle.
trick |1. An artifice or stratagem; a cunning contrivance; a sly procedure, usually with a dishonest intent; as, a trick in trade. tricks of the trade mean simply specialized knowledge, in a good or neutral sense. He comes to me for counsel, and I show him a trick. South. I know a trick worth two of that. Shak. 2. A sly, dexterous, or ingenious procedure fitted to puzzle or amuse; as, a bear's tricks; a juggler's tricks. 3. Mischievous or annoying behavior; a prank; as, the tricks of boys. Prior. 4. A particular habit or manner; a peculiarity; a trait; as, a trick of drumming with the fingers; a trick of frowning. The trick of that voice I do well remember. Shak. He hath a trick of Coeur de Lion's face. Shak. 5. A knot, braid, or plait of hair. [Obs.] B. Jonson. 6. (Card Playing)  The whole number of cards played in one round, and consisting of as many cards as there are players. On one nice trick depends the general fate. Pope. 7. (Naut.)  A turn; specifically, the spell of a sailor at the helm, -- usually two hours. 8. A toy; a trifle; a plaything. [Obs.] Shak. Syn. -- Stratagem; wile; fraud; cheat; juggle; finesse; sleight; deception; imposture; delusion; imposition.\n\n1. To deceive by cunning or artifice; to impose on; to defraud; to cheat; as, to trick another in the sale of a horse. 2. To dress; to decorate; to set off; to adorn fantastically; -- often followed by up, off, or out. \" Trick her off in air.\" Pope. People lavish it profusely in tricking up their children in fine clothes, and yet starve their minds. Locke. They are simple, but majestic, records of the feelings of the poet; as little tricked out for the public eye as his diary would have been. Macaulay. 3. To draw in outline, as with a pen; to delineate or distinguish without color, as arms, etc., in heraldry. They forget that they are in the statutes: . . . there they are tricked, they and their pedigrees. B. Jonson.
tricker |One who tricks; a trickster.\n\nA trigger. [Obs. or Prov. Eng.] Boyle.
trickery |The art of dressing up; artifice; stratagem; fraud; imposture.
trickiness |The quality of being tricky.
tricking |Given to tricks; tricky. Sir W. Scott.\n\nDress; ornament. Shak.
trickish |Given to tricks; artful in making bargains; given to deception and cheating; knavish. -- Trick\"ish*ly, adv. -- Trick\"ish*ness, n.
trickle |To flow in a small, gentle stream; to run in drops. His salt tears trickled down as rain. Chaucer. Fast beside there trickled softly down A gentle stream. Spenser.
trickment |Decoration. [Obs.] \" No trickments but my tears.\" Beau. & Fl.
tricksiness |The quality or state of being tricksy; trickiness. G. Eliot.
trickster |One who tricks; a deceiver; a tricker; a cheat.
tricksy |Exhibiting artfulness; trickish. \"My tricksy spirit!\" Shak. he tricksy policy which in the seventeenth century passed for state wisdom. Coleridge.
tricktrack |An old game resembling backgammon.
tricky |Given to tricks; practicing deception; trickish; knavish.
triclinate |Triclinic.
tricliniary |Of or pertaining to a triclinium, or to the ancient mode of reclining at table.
triclinic |Having, or characterized by, three unequal axes intersecting at oblique angles. See the Note under crystallization.
triclinium |(a) A couch for reclining at meals, extending round three sides of a table, and usually in three parts. (b) A dining room furnished with such a triple couch.
tricoccous |Having three cocci, or roundish carpels. Gray.
tricolor |1. The national French banner, of three colors, blue, white, and red, adopted at the first revolution. 2. Hence, any three-colored flag.
tricolored |Having three colors.
tricornigerous |Having three horns.
tricorporal |Represented with three bodies conjoined to one head, as a lion.
tricorporate |Represented with three bodies conjoined to one head, as a lion.
tricostate |Three-ribbed; having three ribs from the base.
tricot |A fabric of woolen, silk, or cotton knitted, or women to resemble knitted work.
tricrotic |Of or pertaining to tricrotism; characterized by tricrotism.
tricrotism |That condition of the arterial pulse in which there is a triple beat. The pulse curve obtained in the sphygmographic tracing characteristic of tricrotism shows two secondary crests in addition to the primary.
tricrotous |Tricrotic.
tricurvate |Curved in three directions; as, a tricurvate spicule (see Illust. of Spicule).
tricuspid |1. Having three cusps, or points; tricuspidate; as, a tricuspid molar. 2. (Anat.)  Of or pertaining to the tricuspid valves; as, tricuspid obstruction. Tricuspid valve (Anat.), the valve, consisting of three triangular membranous flaps, at the opening of the right auricle into the right ventricle in the heart of most mammals; -- sometimes called the tricuspid valves, each flap being regarded as a valve.
tricuspidate |Three-pointed; ending in three points; as, a tricuspidate leaf.
tricycle |A three-wheeled velocipede. See Illust. under Velocipede. Cf. Bicycle.
tridacna |A genus of very large marine bivalve shells found on the coral reefs of the Indian and Pacific Oceans. One species (T. gigas) often weighs four or five hundred pounds, and is sometimes used for baptismal fonts. Called also paw shell, and fountain shell.
tridactyl |Having three fingers or toes, or composed of three movable parts attached to a common base.
tridactyle |Having three fingers or toes, or composed of three movable parts attached to a common base.
tridactylous |Tridactyl.
triddler |The jacksnipe. [Local, U.S.]
tride |Short and ready; fleet; as, a tride pace; -- a term used by sportsmen. Bailey.
tridecane |A hydrocarbon, C13H28, of the methane series, which is a probable ingredient both of crude petroleum and of kerosene, and is produced artificially as a light colorless liquid.
tridecatoic |Of, pertaining to, or designating, that acid of the fatty acids heterologous with tridecane. It is a white crystalline substance.
tridecatylene |A hydrocarbon, C13H26, of the ethylene series, corresponding to tridecane, and obtained from Burmah petroleum as a light colorless liquid; -- called also tridecylene, and tridecene.
trident |1. (Class Myth.)  A kind of scepter or spear with three prongs, -- the common attribute of Neptune. 2. (Rom. Antiq.)  A three-pronged spear or goad, used for urging horses; also, the weapon used by one class of gladiators. 3. A three-pronged fish spear. 4. (Geom.)  A curve of third order, having three infinite branches in the direction and a fourth infinite branch in the opposite direction. Trident bat (Zoöl.), an Asiatic rhinolophid bat (Triænops Persicus), having the nose membrane in the shape of a trident.\n\nHaving three teeth or prongs; tridentate.
tridentate |Having three teeth; three-toothed. Lee.
tridentated |Having three teeth; three-toothed. Lee.
tridented |Having three prongs; trident; tridentate; as, a tridented mace. [R.] Quarles.
tridentiferous |Bearing a trident.
tridentine |Of or pertaining to Trent, or the general church council held in that city.
tridiapason |A triple octave, or twenty-second. Busby.
tridimensional |Having three dimensions; extended in three different directions.
triding |A riding. See Trithing.
triduan |Lasting three lays; also, happening every third day. [R.] Blount.
tridymite |Pure silica, like quartz, but crystallizing in hexagonal tables. It is found in trachyte and similar rocks.
tried |imp. & p. p. of Try. Also adj.  Proved; tested; faithful; trustworthy; as, a tried friend.
triedral |See Trihedral.
triennial |1. Continuing three years; as, triennial parliaments; a triennial reign. Howell. 2. Happening, coming about, or appearing once in every three years; as, triennial elections; a triennial catalogue; a triennial visitation. T. Warton.\n\nSomething which takes place or appears once in three years.
triennially |Once in three years.
triens |A Roman copper coin, equal to one third of the as. See 3d As, 2.
trier |1. One who tries; one who makes experiments; one who examines anything by a test or standard. Boyle. 2. One who tries judicially. 3. (Law)  A person appointed according to law to try challenges of jurors; a trior. Burrill. 4. That which tries or approves; a test. Shak.
trierarch |(a) The commander of a trireme. (b) At Athens, one who (singly, or jointly with other citizens) had to fit out a trireme for the public service.
trierarchy |The office duty of a trierarch.
trieterical |Kept or occurring once in three years; triennial. [R.] J. Gregory.
trieterics |Festival games celebrated once in three years. [R.] May.
triethylamine |A tertiary amine analogous to trimethylamine.
trifacial |See Trigeminal.
trifallow |To plow the third time before sowing, as land. Mortimer.
trifarious |Facing three ways; arranged in three vertical ranks, as the leaves of veratrum.
trifasciated |Having, or surrounded by, three fasciæ, or bands.
trifid |Cleft to the middle, or slightly beyond the middle, into three parts; three-cleft.
trifistulary |Having three pipes. Sir T. Browne.
trifle |1. A thing of very little value or importance; a paltry, or trivial, affair. With such poor trifles playing. Drayton. Trifles light as air Are to the jealous confirmation strong As proofs of holy writ. Shak. Small sands the mountain, moments make year, And frifles life. Young. 2. A dish composed of sweetmeats, fruits, cake, wine, etc., with syllabub poured over it.\n\nTo act or talk without seriousness, gravity, weight, or dignity; to act or talk with levity; to indulge in light or trivial amusements. They trifle, and they beat the air about nothing which toucheth us. Hooker. To trifle with, to play the fool with; to treat without respect or seriousness; to mock; as, to trifle with one's feelings, or with sacred things.\n\n1. To make of no importance; to treat as a trifle. [Obs.] Shak. 2. To spend in vanity; to fritter away; to waste; as, to trifle away money. \"We trifle time.\" Shak.
trifler |One who trifles. Waterland.
trifling |Being of small value or importance; trivial; paltry; as, a trifling debt; a trifling affair. -- Tri\"fling*ly, adv. -- Tri\"fling*ness, n.
trifloral |Three-flowered; having or bearing three flowers; as, a triflorous peduncle.
triflorous |Three-flowered; having or bearing three flowers; as, a triflorous peduncle.
trifluctuation |A concurrence of three waves. [Obs.] \"A trifluctuation of evils.\" Sir T. Browne.
trifoliate |Having three leaves or leaflets, as clover. See Illust. of Shamrock.
trifoliated |Having three leaves or leaflets, as clover. See Illust. of Shamrock.
trifoliolate |(Bot.) Having three leaflets.
trifolium |A genus of leguminous herbs with densely spiked flowers and usually trifoliate leaves; trefoil. There are many species, all of which are called clover. See Clover.
trifoly |Sweet trefoil. [Obs.] She was crowned with a chaplet of trifoly. B. Jonson.
triforium |The gallery or open space between the vaulting and the roof of the aisles of a church, often forming a rich arcade in the interior of the church, above the nave arches and below the clearstory windows.
triform |Having a triple form or character. \"This triform antagonism.\" I. Taylor. Goddess Triform, I own thy triple spell. Lowell.
triformity |The state of being triform, or of having a threefold shape.
trifurcate |Having three branches or forks; trichotomous.
trifurcated |Having three branches or forks; trichotomous.
trig |To fill; to stuff; to cram. [Obs.] Dr. H. More.\n\nFull; also, trim; neat. [Prov. Eng. & Scot.] To sit on a horse square and trig. Brit. Quart. Rev.\n\nTo stop, as a wheel, by placing something under it; to scotch; to skid.\n\nA stone, block of wood, or anything else, placed under a wheel or barrel to prevent motion; a scotch; a skid. [Eng.] Wright.
trigamist |One who has been married three times; also, one who has three husbands or three wives at the same time.
trigamous |Having three sorts of flowers in the same head, -- male, female, and hermaphrodite, or perfect, flowers.
trigamy |The act of marrying, or the state of being married, three times; also, the offense of having three husbands or three wives at the same time.
trigastric |Having three bellies; -- said of a muscle. Dunglison.
trigeminal |Of, pertaining to, or designating, the fifth pair of cranial nerves, which divide on each side of the head into three main branches distributed to the orbits, jaws, and parts of the mouth; trifacial.
trigeminous |Born three together; being one of three born at the same birth; also, threefold. E. Phillip
trigenic |Of, pertaining to, or designating, an acid, C4H7N3O2, obtained, by the action of the vapor of cyanic acid on cold aldehyde, as a white crystalline substance having a slightly acid taste and faint smell; -- called also ethidene- or ethylidene-biuret.
triger process |A method of sinking through water-bearing ground, in which the shaft is lined with tubbing and provided with an air lock, work being proceeded with under air pressure.
trigesimo-secundo |Having thirty-two leaves to a sheet; as, a trigesimo-secundo form, book, leaf, size, etc.\n\nA book composed of sheets so folded that each one makes thirty- two leaves; hence, indicating, more or less definitely, a size of book; -- usually written 32mo, or 32º, and called thirty-twomo.
trigger |1. A catch to hold the wheel of a carriage on a declivity. 2. (Mech.)  A piece, as a lever, which is connected with a catch or detent as a means of releasing it; especially (Firearms), the part of a lock which is moved by the finger to release the cock and discharge the piece. Trigger fish (Zoöl.), a large plectognath fish (Balistes Carolinensis or B. capriscus) common on the southern coast of the United States, and valued as a food fish in some localities. Its rough skin is used for scouring and polishing in the place of sandpaper. Called also leather jacket, and turbot.
trigintal |A trental.
triglyceride |A glyceride formed by the replacement of three hydrogen atoms in glycerin by acid radicals.
triglyph |An ornament in the frieze of the Doric order, repeated at equal intervals. Each triglyph consists of a rectangular tablet, slightly projecting, and divided nearly to the top by two parallel and perpendicular gutters, or channels, called glyphs, into three parts, or spaces, called femora. A half channel, or glyph, is also cut upon each of the perpendicular edges of the tablet. See Illust. of Entablature.
triglyphic |1. Consisting of, or pertaining to, triglyphs. 2. Containing three sets of characters or sculptures.
triglyphical |1. Consisting of, or pertaining to, triglyphs. 2. Containing three sets of characters or sculptures.
trigness |The quality or state of being trig; smartness; neatness. Their spars had no man-of-war trigness. Kane.
trigon |1. A figure having three angles; a triangle. 2. (Astrol.) (a) A division consisting of three signs. (b) Trine, an aspect of two planets distant 120 degrees from each other. Hutton. 3. (Gr. & Rom. Antiq.) (a) A kind of triangular lyre or harp. (b) A kind of game at ball played by three persons standing at the angular points of a triangle.\n\nThe cutting region of the crown of an upper molar, usually the anterior part. That of a lower molar is the Tri\"go*nid.
trigonal |Having three angles, or corners; triangular; as, a trigonal stem, one having tree prominent longitudinal angles.
trigone |A smooth triangular area on the inner surface of the bladder, limited by the apertures of the ureters and urethra.
trigonia |A genus of pearly bivalve shells, numerous extinct species of which are characteristic of the Mesozoic rocks. A few living species exist on the coast of Australia.
trigonid |The cutting region of the crown of an upper molar, usually the anterior part. That of a lower molar is the Tri\"go*nid.
trigonocerous |Having horns with three angles, like those of some species of goats.
trigonodont |See Trituberculy.
trigonometric |Of or pertaining to trigonometry; performed by the rules of trigonometry. --Trig`o*no*met\"ric*al*ly, adv. Trigonometrical curve, a curve one of whose coördinates is a trigonometric function of the other. -- Trigonometrical function. See under Function. -- Trigonometrical lines, lines which are employed in solving the different cases of plane and spherical trigonometry, as sines, tangents, secants, and the like. These lines, or the lengths of them, are trigonometrical functions of the arcs and angles to which they belong. -- Trigonometrical survey. See under Survey.
trigonometrical |Of or pertaining to trigonometry; performed by the rules of trigonometry. --Trig`o*no*met\"ric*al*ly, adv. Trigonometrical curve, a curve one of whose coördinates is a trigonometric function of the other. -- Trigonometrical function. See under Function. -- Trigonometrical lines, lines which are employed in solving the different cases of plane and spherical trigonometry, as sines, tangents, secants, and the like. These lines, or the lengths of them, are trigonometrical functions of the arcs and angles to which they belong. -- Trigonometrical survey. See under Survey.
trigonometry |1. That branch of mathematics which treats of the relations of the sides and angles of triangles, which the methods of deducing from certain given parts other required parts, and also of the general relations which exist between the trigonometrical functions of arcs or angles. 2. A treatise in this science. Analytical trigonometry, that branch of trigonometry which treats of the relations and properties of the trigonometrical functions. -- Plane trigonometry, and Spherical trigonometry, those branches of trigonometry in which its principles are applied to plane triangles and spherical triangles respectively.
trigonous |Same as Trigonal.
trigram |Same as Trigraph.
trigrammatic |Containing three letters or characters, or three sets of letters or characters.
trigrammic |Same as Trigrammatic.
trigraph |Three letters united in pronunciation so as to have but one sound, or to form but one syllable, as -ieu in adieu; a triphthong.
trigyn |Any one of the Trigynia.
trigynia |A Linnæan order of plants having three pistils or styles.
trigynian |Having three pistils or styles; of or pertaining to the Trigynia.
trigynous |Having three pistils or styles; of or pertaining to the Trigynia.
trihedral |Having three sides or faces; thus, a trihedral angle is a solid angle bounded by three plane angles. [Written also triedral.]
trihedron |A figure having three sides.
trihoral |Occurring once in every three hours.
trihybrid |A hybrid whose parents differ by three pairs of contrasting Mendelian characters.
trijugate |In three pairs; as, a trijugate leaf, or a pinnate leaf with three pairs of leaflets.
trijugous |Same as Trijugate.
trikosane |A hydrocarbon, C23H48, of the methane series, resembling paraffin; -- so called because it has twenty-three atoms of carbon in the molecule.
trilateral |Having three sides; being three-sided; as, a trilateral triangle. -- Tri*lat\"er*al*ly, adv. -- Tri*lat\"er*al*ness, n.
trilemma |1. (Logic)  A syllogism with three conditional propositions, the major premises of which are disjunctively affirmed in the minor. See Dilemma. 2. A state of things in which it is difficult to determine which one of three courses to pursue.
trilinear |Of, pertaining to, or included by, three lines; as, trilinear coördinates.
trilingual |Containing, or consisting of, three languages; expressed in three languages. The much-noted Rosetta stone . . . bears upon its surface a trilingual inscription. I. Taylor.
trilinguar |See Trilingual.
triliteral |Consisting of three letters; trigrammic; as, a triliteral root or word. -- n.  A triliteral word.
triliteralism |Same as Triliterality.
triliterality |The quality of being triliteral; as, the triliterality of Hebrew roots. W. D. Whitney.
triliteralness |The quality of being triliteral; as, the triliterality of Hebrew roots. W. D. Whitney.
trilith |Same as Trilithon. Mollett.
trilithic |Pertaining to a trilith.
trilithon |A monument consisting of three stones; especially, such a monument forming a kind of doorway, as among the ancient Celts.
trill |To flow in a small stream, or in drops rapidly succeeding each other; to trickle. Sir W. Scott. And now and then an ample tear trilled down Her delicate cheek. Shak. Whispered sounds Of waters, trilling from the riven stone. Glover.\n\nTo turn round; to twirl. [Obs.] Gascoigne. Bid him descend and trill another pin. Chaucer.\n\nTo impart the quality of a trill to; to utter as, or with, a trill; as, to trill the r; to trill a note. The sober-suited songstress trills her lay. Thomson.\n\nTo utter trills or a trill; to play or sing in tremulous vibrations of sound; to have a trembling sound; to quaver. To judge of trilling notes and tripping feet. Dryden.\n\n1. A sound, of consonantal character, made with a rapid succession of partial or entire intermissions, by the vibration of some one part of the organs in the mouth -- tongue, uvula, epiglottis, or lip -- against another part; as, the r is a trill in most languages. 2. The action of the organs in producing such sounds; as, to give a trill to the tongue. d 3. (Mus.)  A shake or quaver of the voice in singing, or of the sound of an instrument, produced by the rapid alternation of two contiguous tones of the scale; as, to give a trill on the high C. See Shake.
trillachan |The oyster catcher. [Prov. Eng.]
trilling |1. One of tree children born at the same birth. Wright. 2. (Crystallog.)  A compound crystal, consisting of three individuals.
trillion |According to the French notation, which is used upon the Continent generally and in the United States, the number expressed by a unit with twelve ciphers annexed; a million millions; according to the English notation, the number produced by involving a million to the third power, or the number represented by a unit with eighteen ciphers annexed. See the Note under Numeration.
trillium |A genus of liliaceous plants; the three-leaved nightshade; -- so called because all the parts of the plant are in threes.
trillo |A trill or shake. See Trill.
trilobate |Having three lobes.
trilobation |The state of being trilobate.
trilobed |Same as Trilobate.
trilobita |An extinct order of arthropods comprising the trilobites.
trilobite |Any one of numerous species of extinct arthropods belonging to the order Trilobita. Trilobites were very common in the Silurian and Devonian periods, but became extinct at the close of the Paleozoic. So named from the three lobes usually seen on each segment.
trilobitic |Of, pertaining to or containing, trilobites; as, trilobitic rocks.
trilocular |Having three cells or cavities; as, a trilocular capsule; a trilocular heart.
trilogy |A series of three dramas which, although each of them is in one sense complete, have a close mutual relation, and form one historical and poetical picture. Shakespeare's \" Henry VI.\" is an example. On the Greek stage, a drama, or acted story, consisted in reality of three dramas, called together a trilogy, and performed consecutively in the course of one day. Coleridge.
triluminar |Having three lights [R.]
triluminous |Having three lights [R.]
trim |1. To make trim; to put in due order for any purpose; to make right, neat, or pleasing; to adjust. The hermit trimmed his little fire. Goldsmith. 2. To dress; to decorate; to adorn; to invest; to embellish; as, to trim a hat. trim a Christmas tree. A rotten building newly trimmed over. Milton. I was trimmed in Julia's gown. Shak. 3. To make ready or right by cutting or shortening; to clip or lop; to curtail; as, to trim the hair; to trim a tree. \" And trimmed the cheerful lamp.\" Byron. 4. (Carp.)  To dress, as timber; to make smooth. 5. (Naut.) (a) To adjust, as a ship, by arranging the cargo, or disposing the weight of persons or goods, so equally on each side of the center and at each end, that she shall sit well on the water and sail well; as, to trim a ship, or a boat. (b) To arrange in due order for sailing; as, to trim the sails. 6. To rebuke; to reprove; also, to beat. [Colloq.] To trim in (Carp.), to fit, as a piece of timber, into other work. -- To trim up, to dress; to put in order. I found her trimming up the diadem On her dead mistress. Shak.\n\nTo balance; to fluctuate between parties, so as to appear to favor each.\n\n1. Dress; gear; ornaments. Seeing him just pass the window in his woodland trim. Sir W. Scott. 2. Order; disposition; condition; as, to be in good trim. \" The trim of an encounter.\" Chapman. 3. The state of a ship or her cargo, ballast, masts, etc., by which she is well prepared for sailing. 4. (Arch)  The lighter woodwork in the interior of a building; especially, that used around openings, generally in the form of a molded architrave, to protect the plastering at those points. In ballast trim (Naut.), having only ballast on board. R. H. Dana, Jr. -- Trim of the masts (Naut.), their position in regard to the ship and to each other, as near or distant, far forward or much aft, erect or raking. -- Trim of sails (Naut.), that adjustment, with reference to the wind, witch is best adapted to impel the ship forward.\n\nFitly adjusted; being in good order., or made ready for service or use; firm; compact; snug; neat; fair; as, the ship is trim, or trim built; everything about the man is trim; a person is trim when his body is well shaped and firm; his dress is trim when it fits closely to his body, and appears tight and snug; a man or a soldier is trim when he stands erect. With comely carriage of her countenance trim. Spenser. So deemed I till I viewed their trim array Of boats last night. Trench.
trimaculated |Marked with three spots, or maculæ.
trimellic |Of, pertaining to, or designating, a certain tribasic acid (called also trimellitic acid) metameric with trimesitic acid.
trimembral |Having, or consisting of, three members.
trimera |A division of Coleoptera including those which have but three joints in the tarsi.
trimeran |One of the Trimera. Also used adjectively.
trimerous |Having the parts in threes.
trimesitic |Of, pertaining to, or designating, a tribasic acid, C6H3.(CO2)3, of the aromatic series, obtained, by the oxidation of mesitylene, as a white crystalline substance. [Written also trimesic.]
