bois durci |A hard, highly polishable composition, made of fine sawdust from hard wood (as rosewood) mixed with blood, and pressed.
boist |A box. [Obs.]
boisterous |1. Rough or rude; unbending; unyielding; strong; powerful. [Obs.] \"Boisterous sword.\" \"Boisterous hand.\" Shak. 2. Exhibiting tumultuous violence and fury; acting with noisy turbulence; violent; rough; stormy. The waters swell before a boisterous storm. Shak. The brute and boisterous force of violent men. Milton. 3. Noisy; rough; turbulent; as, boisterous mirth; boisterous behavior. I like not that loud, boisterous man. Addison. 4. Vehement; excessive. [R.] The heat becomes too powerful and boisterous for them. Woodward. Syn. -- Loud; roaring; violent; stormy; turbulent; furious; tumultuous; noisy; impetuous; vehement.
boisterously |In a boisterous manner.
boisterousness |The state or quality of being boisterous; turbulence; disorder; tumultuousness.
boistous |Rough or rude; coarse; strong; violent; boisterous; noisy. [Obs.] Chaucer. -- Bois\"tous*ly, adv. -- Bois\"tous*ness, n. [Obs.] Chaucer.
bojanus organ |A glandular organ of bivalve mollusca, serving in part as a kidney.
bokadam |See Cerberus.
boke |To poke; to thrust. [Obs. or Dial.]
bolar |Of or pertaining to bole or clay; partaking of the nature and qualities of bole; clayey.
bolas |A kind of missile weapon consisting of one, two, or more balls of stone, iron, or other material, attached to the ends of a leather cord; -- used by the Gauchos of South America, and others, for hurling at and entangling an animal.
bold |1. Forward to meet danger; venturesome; daring; not timorous or shrinking from risk; brave; courageous. Throngs of knights and barons bold. Milton. 2. Exhibiting or requiring spirit and contempt of danger; planned with courage; daring; vigorous. \"The bold design leased highly.\" Milton. 3. In a bad sense, too forward; taking undue liberties; over assuming or confident; lacking proper modesty or restraint; rude; impudent. Thou art too wild, too rude and bold of voice. Shak. 4. Somewhat overstepping usual bounds, or conventional rules, as in art, literature, etc.; taking liberties in o composition or expression; as, the figures of an author are bold. \"Bold tales.\" Waller. The cathedral church is a very bold work. Addison. 5. Standing prominently out to view; markedly conspicuous; striking the eye; in high relief. Shadows in painting . . . make the figure bolder. Dryden. 6. Steep; abrupt; prominent. Where the bold cape its warning forehead rears. Trumbull.\n\nTo make bold or daring. [Obs.] Shak.\n\nTo be or become bold. [Obs.]
bold eagle |an Australian eagle (Aquila audax), which destroys lambs and even the kangaroo. -- To make bold, to take liberties or the liberty; to venture. Syn. -- Courageous; daring; brave; intrepid; fearless; dauntless; valiant; manful; audacious; stouthearted; high-spirited; adventurous; confident; strenuous; forward; impudent.
bold-faced |1. Somewhat impudent; lacking modesty; as, a bold-faced woman. I have seen enough to confute all the bold-faced atheists of this age. Bramhall. 2. (Print.)  Having a conspicuous or heavy face. Note: This line is bold-faced nonpareil.
bolden |To make bold; to encourage; to embolden. Ready speakers, being boldened with their present abilities to say more, . . . use less help of diligence and study. Ascham.
boldly |In a bold manner.
boldness |The state or quality of being bold. Syn. -- Courage; bravery; intrepidity; dauntlessness; hardihood; assurance.
boldo |A fragrant evergreen shrub of Chili (Peumus Boldus). The bark is used in tanning, the wood for making charcoal, the leaves in medicine, and the drupes are eaten.
boldu |A fragrant evergreen shrub of Chili (Peumus Boldus). The bark is used in tanning, the wood for making charcoal, the leaves in medicine, and the drupes are eaten.
bole |The trunk or stem of a tree, or that which is like it. Enormous elm-tree boles did stoop and lean. Tennyson.\n\nAn aperture, with a wooden shutter, in the wall of a house, for giving, occasionally, air or light; also, a small closet. [Scot.] Open the bole wi'speed, that I may see if this be the right Lord Geraldin. Sir W. Scott.\n\nA measure. See Boll, n., 2. Mortimer.\n\n1. Any one of several varieties of friable earthy clay, usually colored more or less strongly red by oxide of iron, and used to color and adulterate various substances. It was formerly used in medicine. It is composed essentially of hydrous silicates of alumina, or more rarely of magnesia. See Clay, and Terra alba. 2. A bolus; a dose. Coleridge. Armenian bole. See under Armenian. -- Bole Armoniac, or Armoniak, Armenian bole. [Obs.] Chaucer.
bolection |A projecting molding round a panel. Same as Bilection. Gwilt.
bolero |A Spanish dance, or the lively music which accompanies it.
bolete |any fungus of the family Boletaceae. [WordNet 1.5]
boletic |Pertaining to, or obtained from, the Boletus. Boletic acid, an acid obtained from the Boletus fomentarius, variety pseudo-igniarius. Same as Fumaric acid.
boletus |A genus of fungi having the under side of the pileus or cap composed of a multitude of fine separate tubes. A few are edible, and others very poisonous.
boley |Same as Booly.
bolide |A kind of meteor; a bolis.
bolis |A meteor or brilliant shooting star, followed by a train of light or sparks; esp. one which explodes.
bolivian |Of or pertaining to Bolivia. -- n.  A native of Bolivia.
boll |1. The pod or capsule of a plant, as of flax or cotton; a pericarp of a globular form. 2. A Scotch measure, formerly in use: for wheat and beans it contained four Winchester bushels; for oats, barley, and potatoes, six bushels. A boll of meal is 140 lbs. avoirdupois. Also, a measure for salt of two bushels. [Sometimes spelled bole.]\n\nTo form a boll or seed vessel; to go to seed. The barley was in the ear, and the flax was bolled. Ex. ix. 31.
bollandists |The Jesuit editors of the \"Acta Sanctorum\| or Lives of the Saints; -- named from John Bolland| who began the work."
bollard |An upright wooden or iron post in a boat or on a dock, used in veering or fastening ropes. Bollard timber (Naut.), a timber, also called a knighthead, rising just within the stem in a ship, on either side of the bowsprit, to secure its end.
bollen |See Boln, a.\n\nSwollen; puffed out. Thin, and boln out like a sail. B. Jonson.
bolling |A tree from which the branches have been cut; a pollard.
bollworm |The larva of a moth (Heliothis armigera) which devours the bolls or unripe pods of the cotton plant, often doing great damage to the crops.
boln |To swell; to puff. Holland.\n\nSwollen; puffed out. Thin, and boln out like a sail. B. Jonson.
bolo |A kind of large knife resembling a machete. [Phil. Islands]
bologna |1. A city of Italy which has given its name to various objects. 2. A Bologna sausage. Bologna sausage Etym: [It. salsiccia di Bologna], a large sausage made of bacon or ham, veal, and pork, chopped fine and inclosed in a skin. -- Bologna stone (Min.), radiated barite, or barium sulphate, found in roundish masses composed of radiating fibers, first discovered near Bologna. It is phosphorescent when calcined. -- Bologna vial, a vial of unannealed glass which will fly into pieces when its surface is scratched by a hard body, as by dropping into it a fragment of flint; whereas a bullet may be dropped into it without injury.
bolognese |Of or pertaining to Bologna. -- n.  A native of Bologna. Bolognese school (Paint.), a school of painting founded by the Carracci, otherwise called the Lombard or Eclectic school, the object of which was to unite the excellences of the preceding schools.
bolognian |Bolognese. Bolognian stone. See Bologna stone, under Bologna.
bolometer |An instrument for measuring minute quantities of radiant heat, especially in different parts of the spectrum; -- called also actinic balance, thermic balance. S. P. Langley.
bolsa |An exchange for the transaction of business. [Sp. Amer. & Phil. Islands]
bolster |1. A long pillow or cushion, used to support the head of a person lying on a bed; -- generally laid under the pillows. And here I'll fling the pillow, there the bolster, This way the coverlet, another way the sheets. Shak. 2. A pad, quilt, or anything used to hinder pressure, support any part of the body, or make a bandage sit easy upon a wounded part; a compress. This arm shall be a bolster for thy head. Gay. 3. Anything arranged to act as a support, as in various forms of mechanism, etc. 4. (Saddlery)  A cushioned or a piece part of a saddle. 5. (Naut.) (a) A cushioned or a piece of soft wood covered with tarred canvas, placed on the trestletrees and against the mast, for the collars of the shrouds to rest on, to prevent chafing. (b) Anything used to prevent chafing. 6. A plate of iron or a mass of wood under the end of a bridge girder, to keep the girder from resting directly on the abutment. 7. A transverse bar above the axle of a wagon, on which the bed or body rests. 8. The crossbeam forming the bearing piece of the body of a railway car; the central and principal cross beam of a car truck. 9. (Mech.)  the perforated plate in a punching machine on which anything rests when being punched. 10. (Cutlery) (a) That part of a knife blade which abuts upon the end of the handle. (b) The metallic end of a pocketknife handle. G. Francis. 11. (Arch.)  The rolls forming the ends or sides of the Ionic capital. G. Francis. 12. (Mil.)  A block of wood on the carriage of a siege gun, upon which the breech of the gun rests when arranged for transportation. Note: [See Illust. of Gun carriage.] Bolster work (Arch.), members which are bellied or curved outward like cushions, as in friezes of certain classical styles.\n\n1. To support with a bolster or pillow. S. Sharp. 2. To support, hold up, or maintain with difficulty or unusual effort; -- often with up. To bolster baseness. Drayton. Shoddy inventions designed to bolster up a factitious pride. Compton Reade.
bolstered |1. Supported; upheld. 2. Swelled out.
bolsterer |A supporter.
bolt |1. A shaft or missile intended to be shot from a crossbow or catapult, esp. a short, stout, blunt-headed arrow; a quarrel; an arrow, or that which resembles an arrow; a dart. Look that the crossbowmen lack not bolts. Sir W. Scott. A fool's bolt is soon shot. Shak. 2. Lightning; a thunderbolt. 3. A strong pin, of iron or other material, used to fasten or hold something in place, often having a head at one end and screw thread cut upon the other end. 4. A sliding catch, or fastening, as for a door or gate; the portion of a lock which is shot or withdrawn by the action of the key. 5. An iron to fasten the legs of a prisoner; a shackle; a fetter. [Obs.] Away with him to prison! lay bolts enough upon him. Shak. 6. A compact package or roll of cloth, as of canvas or silk, often containing about forty yards. 7. A bundle, as of oziers. Bolt auger, an auger of large size; an auger to make holes for the bolts used by shipwrights. -- Bolt and nut, a metallic pin with a head formed upon one end, and a movable piece (the nut) screwed upon a thread cut upon the other end. See B, C, and D, in illust. above. Note: See Tap bolt, Screw bolt, and Stud bolt.\n\n1. To shoot; to discharge or drive forth. 2. To utter precipitately; to blurt or throw out. I hate when Vice can bolt her arguments. Milton. 3. To swallow without chewing; as, to bolt food. 4. (U. S. Politics)  To refuse to support, as a nomination made by a party to which one has belonged or by a caucus in which one has taken part. 5. (Sporting)  To cause to start or spring forth; to dislodge, as conies, rabbits, etc. 6. To fasten or secure with, or as with, a bolt or bolts, as a door, a timber, fetters; to shackle; to restrain. Let tenfold iron bolt my door. Langhorn. Which shackles accidents and bolts up change. Shak.\n\n1. To start forth like a bolt or arrow; to spring abruptly; to come or go suddenly; to dart; as, to bolt out of the room. This Puck seems but a dreaming dolt, . . . And oft out of a bush doth bolt. Drayton. 2. To strike or fall suddenly like a bolt. His cloudless thunder bolted on their heads. Milton. 3. To spring suddenly aside, or out of the regular path; as, the horse bolted. 4. (U.S. Politics)  To refuse to support a nomination made by a party or a caucus with which one has been connected; to break away from a party.\n\nIn the manner of a bolt; suddenly; straight; unbendingly. [He] came bolt up against the heavy dragoon. Thackeray. Bolt upright. (a) Perfectly upright; perpendicular; straight up; unbendingly erect. Addison. (b) On the back at full length. [Obs.] Chaucer.\n\n1. A sudden spring or start; a sudden spring aside; as, the horse made a bolt. 2. A sudden flight, as to escape creditors. This gentleman was so hopelessly involved that he contemplated a bolt to America -- or anywhere. Compton Reade. 3. (U. S. Politics)  A refusal to support a nomination made by the party with which one has been connected; a breaking away from one's party.\n\n1. To sift or separate the coarser from the finer particles of, as bran from flour, by means of a bolter; to separate, assort, refine, or purify by other means. He now had bolted all the flour. Spenser. Ill schooled in bolted language. Shak. 2. To separate, as if by sifting or bolting; -- with out. Time and nature will bolt out the truth of things. L'Estrange. 3. (Law)  To discuss or argue privately, and for practice, as cases at law. Jacob. To bolt to the bran, to examine thoroughly, so as to separate or discover everything important. Chaucer. This bolts the matter fairly to the bran. Harte. The report of the committee was examined and sifted and bolted to the bran. Burke.\n\nA sieve, esp. a long fine sieve used in milling for bolting flour and meal; a bolter. B. Jonson.
boltel |See Boultel.
bolter |One who bolts; esp.: (a) A horse which starts suddenly aside. (b) A man who breaks away from his party.\n\n1. One who sifts flour or meal. 2. An instrument or machine for separating bran from flour, or the coarser part of meal from the finer; a sieve.\n\nA kind of fishing line. See Boulter.
bolthead |1. (Chem.)  A long, straightnecked, glass vessel for chemical distillations; -- called also a matrass or receiver. 2. The head of a bolt.
bolting |A darting away; a starting off or aside.\n\n1. A sifting, as of flour or meal. 2. (Law)  A private arguing of cases for practice by students, as in the Inns of Court. [Obs.] Bolting cloth, wire, hair, silk, or other sieve cloth of different degrees of fineness; -- used by millers for sifting flour. McElrath. -- Bolting hutch, a bin or tub for the bolted flour or meal; (fig.) a receptacle.
boltonite |A granular mineral of a grayish or yellowish color, found in Bolton, Massachusetts. It is a silicate of magnesium, belonging to the chrysolite family.
boltrope |A rope stitched to the edges of a sail to strengthen the sail.
boltsprit |See Bowsprit.
bolty |An edible fish of the Nile (genus Chromis). [Written also bulti.]
bolus |A rounded mass of anything, esp. a large pill.
bolye |Same as Booly.
bom |A large American serpent, so called from the sound it makes.
bomb |1. A great noise; a hollow sound. [Obs.] A pillar of iron . . . which if you had struck, would make . . . a great bomb in the chamber beneath. Bacon. 2. (Mil.)  A shell; esp. a spherical shell, like those fired from mortars. See Shell. 3. A bomb ketch. Bomb chest (Mil.), a chest filled with bombs, or only with gunpowder, placed under ground, to cause destruction by its explosion. -- Bomb ketch, Bomb vessel (Naut.), a small ketch or vessel, very strongly built, on which mortars are mounted to be used in naval bombardments; -- called also mortar vessel. -- Bomb lance, a lance or harpoon with an explosive head, used in whale fishing. -- Volcanic bomb, a mass of lava of a spherical or pear shape. \"I noticed volcanic bombs.\" Darwin.\n\nTo bombard. [Obs.] Prior.\n\nTo sound; to boom; to make a humming or buzzing sound. [Obs.] B. Jonson.
bombace |Cotton; padding. [Obs.]
bombard |1. (Gun.)  A piece of heavy ordnance formerly used for throwing stones and other ponderous missiles. It was the earliest kind of cannon. They planted in divers places twelve great bombards, wherewith they threw huge stones into the air, which, falling down into the city, might break down the houses. Knolles. 2. A bombardment. [Poetic & R.] J. Barlow. 3. A large drinking vessel or can, or a leather bottle, for carrying liquor or beer. [Obs.] Yond same black cloud, yond huge one, looks like a foul bombard that would shed his liquor. Shak. 4. pl.  Padded breeches. [Obs.] Bombard phrase, inflated language; bombast. [Obs.] B. Jonson.\n\nSee Bombardo. [Obs.]\n\nTo attack with bombards or with artillery; especially, to throw shells, hot shot, etc., at or into. Next, she means to bombard Naples. Burke. His fleet bombarded and burnt down Dieppe. Wood.
bombardier |(a) One who used or managed a bombard; an artilleryman; a gunner. [Archaic] (b) A noncommissioned officer in the British artillery. Bombardier beetle (Zoöl.), a kind of beetle (Brachinus crepitans), so called because, when disturbed, it makes an explosive discharge of a pungent and acrid vapor from its anal glands. The name is applied to other related species, as the B. displosor, which can produce ten or twelve explosions successively. The common American species is B. fumans.
bombardman |One who carried liquor or beer in a can or bombard. [Obs.] They . . . made room for a bombardman that brought bouge for a country lady. B. Jonson.
bombardment |An attack upon a fortress or fortified town, with shells, hot shot, rockets, etc.; the act of throwing bombs and shot into a town or fortified place.
bombardo |Originally, a deep-toned instrument of the oboe or bassoon family; thence, a bass reed stop on the organ. The name bombardon is now given to a brass instrument, the lowest of the saxhorns, in tone resembling the ophicleide. Grove.
bombardon |Originally, a deep-toned instrument of the oboe or bassoon family; thence, a bass reed stop on the organ. The name bombardon is now given to a brass instrument, the lowest of the saxhorns, in tone resembling the ophicleide. Grove.
bombasine |Same as Bombazine.
bombast |1. Originally, cotton, or cotton wool. [Obs.] A candle with a wick of bombast. Lupton. 2. Cotton, or any soft, fibrous material, used as stuffing for garments; stuffing; padding. [Obs.] How now, my sweet creature of bombast! Shak. Doublets, stuffed with four, five, or six pounds of bombast at least. Stubbes. 3. Fig.: High-sounding words; an inflated style; language above the dignity of the occasion; fustian. Yet noisy bombast carefully avoid. Dryden.\n\nHigh-sounding; inflated; big without meaning; magniloquent; bombastic. [He] evades them with a bombast circumstance, Horribly stuffed with epithets of war. Shak. Nor a tall metaphor in bombast way. Cowley.\n\nTo swell or fill out; to pad; to inflate. [Obs.] Not bombasted with words vain ticklish ears to feed. Drayton.
bombastic |Characterized by bombast; highsounding; inflated. -- Bom*bas\"tic*al*ly, adv. A theatrical, bombastic, windy phraseology. Burke. Syn. -- Turgid; tumid; pompous; grandiloquent.
bombastical |Characterized by bombast; highsounding; inflated. -- Bom*bas\"tic*al*ly, adv. A theatrical, bombastic, windy phraseology. Burke. Syn. -- Turgid; tumid; pompous; grandiloquent.
bombastry |Swelling words without much meaning; bombastic language; fustian. Bombastry and buffoonery, by nature lofty and light, soar highest of all. Swift.
bombax |A genus of trees, called also the silkcotton tree; also, a tree of the genus Bombax.
bombazet |A sort of thin woolen cloth. It is of various colors, and may be plain or twilled.
bombazette |A sort of thin woolen cloth. It is of various colors, and may be plain or twilled.
bombazine |A twilled fabric for dresses, of which the warp is silk, and the weft worsted. Black bombazine has been much used for mourning garments. [Sometimes spelt bombasin, and bombasine.] Tomlinson.
bombic |Pertaining to, or obtained from, the silkworm; as, bombic acid.
bombilate |To hum; to buzz. [R.]
bombilation |A humming sound; a booming. To . . . silence the bombilation of guns. Sir T. Browne.
bombinate |To hum; to boom.
bombination |A humming or buzzing.
bombolo |A thin spheroidal glass retort or flask, used in the sublimation of camphor. [Written also bumbelo, and bumbolo.]
bombproof |Secure against the explosive force of bombs. -- n.  A structure which heavy shot and shell will not penetrate.
bombshell |A bomb. See Bomb, n.
bombycid |Like or pertaining to the genus Bombyx, or the family Bombycidæ.
bombycinous |1. Silken; made of silk. [Obs.] Coles. 2. Being of the color of the silkworm; transparent with a yellow tint. E. Darwin.
bombylious |Buzzing, like a bumblebee; as, the bombylious noise of the horse fly. [Obs.] Derham.
bombyx |A genus of moths, which includes the silkworm moth. See Silkworm.
bon |Good; valid as security for something.
bon silene |A very fragrant tea rose with petals of various shades of pink.
bon ton |The height of the fashion; fashionable society.
bon vivant |A good fellow; a jovial companion; a free liver.
bon-accord |Good will; good fellowship; agreement. [Scot.]
bona fide |In or with good faith; without fraud or deceit; real or really; actual or actually; genuine or genuinely; as, you must proceed bona fide; a bona fide purchaser or transaction.
bona fides |Good faith; honesty; freedom from fraud or deception.
bona peritura |Perishable goods. Bouvier.
bona roba |A showy wanton; a courtesan. Shak
bonaci |(a) A large grouper (Mycteroperca bonaci) of Florida and the West Indies, valuable as a food fish; -- called also aguaji and, in Florida, black grouper. (b) Also, any one of several other similar fishes.
bonair |Gentle; courteous; complaisant; yielding. [Obs.]
bonanza |In mining, a rich mine or vein of silver or gold; hence, anything which is a mine of wealth or yields a large income. [Colloq. U. S.]
bonapartean |Of or pertaining to Napoleon Bonaparte or his family.
bonapartism |The policy of Bonaparte or of the Bonapartes.
bonapartist |One attached to the policy or family of Bonaparte, or of the Bonapartes.
bonassus |The aurochs or European bison. See Aurochs.
bonasus |The aurochs or European bison. See Aurochs.
bonbon |Sugar confectionery; a sugarplum; hence, any dainty.
bonbonniere |A small fancy box or dish for bonbons.
bonce |A boy's game played with large marbles.
bonchretien |A name given to several kinds of pears. See Bartlett.
boncilate |A substance composed of ground bone, mineral matters, etc., hardened by pressure, and used for making billiard balls, boxes, etc.
bond |1. That which binds, ties, fastens,or confines, or by which anything is fastened or bound, as a cord, chain, etc.; a band; a ligament; a shackle or a manacle. Gnawing with my teeth my bonds in sunder, I gained my freedom. Shak. 2. pl.  The state of being bound; imprisonment; captivity, restraint. \"This man doeth nothing worthy of death or of bonds.\" Acts xxvi. 3. A binding force or influence; a cause of union; a uniting tie; as, the bonds of fellowship. A people with whom I have no tie but the common bond of mankind. Burke. 4. Moral or political duty or obligation. I love your majesty According to my bond, nor more nor less. Shak. 5. (Law)  A writing under seal, by which a person binds himself, his heirs, executors, and administrators, to pay a certain sum on or before a future day appointed. This is a single bond. But usually a condition is added, that, if the obligor shall do a certain act, appear at a certain place, conform to certain rules, faithfully perform certain duties, or pay a certain sum of money, on or before a time specified, the obligation shall be void; otherwise it shall remain in full force. If the condition is not performed, the bond becomes forfeited, and the obligor and his heirs are liable to the payment of the whole sum. Bouvier. Wharton. 6. An instrument (of the nature of the ordinary legal bond) made by a government or a corporation for purpose of borrowing money; as, a government, city, or railway bond. 7. The state of goods placed in a bonded warehouse till the duties are paid; as, merchandise in bond. 8. (Arch.)  The union or tie of the several stones or bricks forming a wall. The bricks may be arranged for this purpose in several different ways, as in English or block bond (Fig. 1), where one course consists of bricks with their ends toward the face of the wall, called headers, and the next course of bricks with their lengths parallel to the face of the wall, called stretchers; Flemish bond (Fig.2), where each course consists of headers and stretchers alternately, so laid as always to break joints; Cross bond, which differs from the English by the change of the second stretcher line so that its joints come in the middle of the first, and the same position of stretchers comes back every fifth line; Combined cross and English bond, where the inner part of the wall is laid in the one method, the outer in the other. 9. (Chem.)  A unit of chemical attraction; as, oxygen has two bonds of affinity. It is often represented in graphic formulæ by a short line or dash. See Diagram of Benzene nucleus, and Valence. Arbitration bond. See under Arbitration. -- Bond crediter (Law), a creditor whose debt is secured by a bond. Blackstone. -- Bond debt (Law), a debt contracted under the obligation of a bond. Burrows. -- Bond (or lap) of a slate, the distance between the top of one slate and the bottom or drip of the second slate above, i. e., the space which is covered with three thicknesses; also, the distance between the nail of the under slate and the lower edge of the upper slate. -- Bond timber, timber worked into a wall to tie or strengthen it longitudinally. Syn. -- Chains; fetters; captivity; imprisonment.\n\n1. To place under the conditions of a bond; to mortgage; to secure the payment of the duties on (goods or merchandise) by giving a bond. 2. (Arch.)  To dispose in building, as the materials of a wall, so as to secure solidity.\n\nA xassal or serf; a slave. [Obs. or Archaic]\n\nIn a state of servitude or slavery; captive. By one Spirit are we all baptized .. whether we be Jews or Bentiles, whether we be bond or free. 1 Cor. xii. 13.
bond servant |A slave; one who is bound to service without wages. If thy brother . . . be waxen poor, and be sold unto thee; thou shalt not compel him to serve as a bond servant: but as an hired servant. Lev. xxv. 39, 40.
bond service |The condition of a bond servant; sevice without wages; slavery. Their children . . . upon those did Solomon levy a tribute of bond service. 1 Kings ix. 21.
bondage |1. The state of being bound; condition of being under restraint; restraint of personal liberty by compulsion; involuntary servitude; slavery; captivity. The King, when he designed you for my guard, Resolved he would not make my bondage hard. Dryden. 2. Obligation; tie of duty. He must resolve by no means to be . . . brought under the bondage of onserving oaths. South. 3. (Old Eng. Law)  Villenage; tenure of land on condition of doing the meanest services for the owner. Syn. -- Thralldom; bond service; imprisonment.
bondager |A field worker, esp. a woman who works in the field. [Scot.]
bondar |A small quadruped of Bengal (Paradoxurus bondar), allied to the genet; -- called also musk cat.
bonded |Placed under, or covered by, a bond, as for the payment of duties, or for conformity to coertain regulations. Bonded goods, goods placed in a bonded warehouse; goods, for the duties on which bonds are given at the customhouse. -- Bonded warehouse, a warehouse in which goods on which the duties are unpaid are stored under bond and in the joint custody of the importer, or his agent, and the customs officers.
bonder |1. One who places goods under bond or in a bonded warehouse. 2. (Masonry)  A bonding stone or brick; a bondstone.\n\nA freeholder on a small scale. [Norway] Emerson.
bondholder |A person who holds the bonds of a public or private corporation for the payment of money at a certain time.
bondmaid |A female slave, or one bound to service without wages, as distinguished from a hired servant.
bondman |1. A man slave, or one bound to service without wages. \"To enfranchise bondmen.\" Macaulay. 2. (Old Eng. Law)  A villain, or tenant in villenage.
bondslave |A person in a state of slavery; one whose person and liberty are subjected to the authority of a master.
bondsman |1. A slave; a villain; a serf; a bondman. Carnal, greedy people, without such a precept, would have no mercy upon their poor bondsmen. Derham. 2. (Law)  A surety; one who is bound, or who gives security, for another.
bondstone |A stone running through a wall from one face to another, to bind it together; a binding stone.
bondswoman |See Bondwoman.
bonduc |See Nicker tree.
bondwoman |A woman who is a slave, or in bondage. He who was of the bondwoman. Gal. iv. 23.
bone |1. (Anat.)  The hard, calcified tissue of the skeleton of vertebrate animals, consisting very largely of calcic carbonate, calcic phosphate, and gelatine; as, blood and bone. Note: Even in the hardest parts of bone there are many minute cavities containing living matter and connected by minute canals, some of which connect with larger canals through which blood vessels ramify. 2. One of the pieces or parts of an animal skeleton; as, a rib or a thigh bone; a bone of the arm or leg; also, any fragment of bony substance. (pl.) The frame or skeleton of the body. 3. Anything made of bone, as a bobbin for weaving bone lace. 4. pl.  Two or four pieces of bone held between the fingers and struck together to make a kind of music. 5. pl.  Dice. 6. Whalebone; hence, a piece of whalebone or of steel for a corset. 7. Fig.: The framework of anything. A bone of contention, a subject of contention or dispute. -- A bone to pick, something to investigate, or to busy one's self about; a dispute to be settled (with some one). -- Bone ash, the residue from calcined bones; -- used for making cupels, and for cleaning jewelry. -- Bone black (Chem.), the black, carbonaceous substance into which bones are converted by calcination in close vessels; -- called also animal charcoal. It is used as a decolorizing material in filtering sirups, extracts, etc., and as a black pigment. See Ivory black, under Black. -- Bone cave, a cave in which are found bones of extinct or recent animals, mingled sometimes with the works and bones of man. Am. Cyc. -- Bone dust, ground or pulverized bones, used as a fertilizer. -- Bone earth (Chem.), the earthy residuum after the calcination of bone, consisting chiefly of phosphate of calcium. -- Bone lace, a lace made of linen thread, so called because woven with bobbins of bone. -- Bone oil, an oil obtained by, heating bones (as in the manufacture of bone black), and remarkable for containing the nitrogenous bases, pyridine and quinoline, and their derivatives; -- also called Dippel's oil. -- Bone setter. Same as Bonesetter. See in the Vocabulary. -- Bone shark (Zoöl.), the basking shark. -- Bone spavin. See under Spavin. -- Bone turquoise, fossil bone or tooth of a delicate blue color, sometimes used as an imitation of true turquoise. -- Bone whale (Zoöl.), a right whale. -- To be upon the bones of, to attack. [Obs.] -- To make no bones, to make no scruple; not to hesitate. [Low] -- To pick a bone with, to quarrel with, as dogs quarrel over a bone; to settle a disagreement. [Colloq.]\n\n1. To withdraw bones from the flesh of, as in cookery. \"To bone a turkey.\" Soyer. 2. To put whalebone into; as, to bone stays. Ash. 3. To fertilize with bone. 4. To steal; to take possession of. [Slang]\n\nTo sight along an object or set of objects, to see if it or they be level or in line, as in carpentry, masonry, and surveying. Knight. Joiners, etc., bone their work with two straight edges. W. M. Buchanan.
boneache |Pain in the bones. Shak.
boneblack |See Bone black, under Bone, n.
boned |1. Having (such) bones; -- used in composition; as, big-boned; strong-boned. No big-boned men framed of the Cyclops' size. Shak. 2. Deprived of bones; as, boned turkey or codfish. 3. Manured with bone; as, boned land.
bonedog |The spiny dogfish.
bonefish |See Ladyfish.
boneless |Without bones. \"Boneless gums.\" Shak.
boneset |A medicinal plant, the thoroughwort (Eupatorium perfoliatum). Its properties are diaphoretic and tonic.
bonesetter |One who sets broken or dislocated bones; -- commonly applied to one, not a regular surgeon, who makes an occupation of setting bones. -- Bone\"set*ting, n.
boneshaw |Sciatica. [Obs.]
bonetta |See Bonito. Sir T. Herbert.
bonfire |A large fire built in the open air, as an expression of public joy and exultation, or for amusement. Full soon by bonfire and by bell, We learnt our liege was passing well. Gay.
bongo |Either of two large antelopes (Boöcercus eurycercus of West Africa, and B. isaaci of East Africa) of a reddish or chestnut-brown color with narrow white stripes on the body. Their flesh is especially esteemed as food.
bongrace |A projecting bonnet or shade to protect the complexion; also, a wide-brimmed hat. [Obs.]
bonhomie |good nature; pleasant and easy manner.
bonhommie |good nature; pleasant and easy manner.
bonibell |See Bonnibel. [Obs.] Spenser.
boniface |An innkeeper.
boniform |Sensitive or responsive to moral excellence. Dr. H. More.
bonify |To convert into, or make, good. To bonify evils, or tincture them with good. Cudworth.
boniness |The condition or quality of being bony.
boning |1. The clearing of bones from fish or meat. 2. The manuring of land with bones. 3. A method of leveling a line or surface by sighting along the tops of two or more straight edges, or a range of properly spaced poles. See 3d Bone, v. t.
bonitary |Beneficial, as opposed to statutory or civil; as, bonitary dominion of land.
bonito |1. A large tropical fish (Orcynus pelamys) allied to the tunny. It is about three feet long, blue above, with four brown stripes on the sides. It is sometimes found on the American coast. 2. The skipjack (Sarda Mediterranea) of the Atlantic, an important and abundant food fish on the coast of the United States, and (S. Chilensis) of the Pacific, and other related species. They are large and active fishes, of a blue color with black oblique stripes. 3. The medregal (Seriola fasciata), an edible fish of the southern of the United States and the West Indies. 4. The cobia or crab eater (Elacate canada), an edible fish of the Middle and Southern United States.
bonmot |A witty repartee; a jest.
bonnaz |A kind of embroidery made with a complicated sewing machine, said to have been originally invented by a Frenchman of the name of Bonnaz. The work is done either in freehand or by following a perforated design.
bonne |(F., prop. good woman.) A female servant charged with the care of a young child.
bonne bouche |A delicious morsel or mouthful; a tidbit.
bonnet |1. A headdress for men and boys; a cap. [Obs.] Milton. Shak. 2. A soft, elastic, very durable cap, made of thick, seamless woolen stuff, and worn by men in Scotland. And pbonnets waving high. Sir W. Scott. 3. A covering for the head, worn by women, usually protecting more or less the back and sides of the head, but no part of the forehead. The shape of the bonnet varies greatly at different times; formerly the front part projected, and spread outward, like the mouth of a funnel. 4. Anything resembling a bonnet in shape or use; as, (a) (Fort.) A small defense work at a salient angle; or a part of a parapet elevated to screen the other part from enfilade fire. (b) A metallic canopy, or projection, over an opening, as a fireplace, or a cowl or hood to increase the draught of a chimney, etc. (c) A frame of wire netting over a locomotive chimney, to prevent escape of sparks. (d) A roofing over the cage of a mine, to protect its occupants from objects falling down the shaft. (e) In pumps, a metal covering for the openings in the valve chambers. 5. (Naut.)  An additional piece of canvas laced to the foot of a jib or foresail in moderate winds. Hakluyt. 6. The second stomach of a ruminating animal. 7. An accomplice of a gambler, auctioneer, etc., who entices others to bet or to bid; a decoy. [Cant] Bonnet head (Zoöl.), a shark (Sphyrna tiburio) of the southern United States and West Indies. -- Bonnet limpet (Zoöl.), a name given, from their shape, to various species of shells (family Calyptræidæ). -- Bonnet monkey (Zoöl.), an East Indian monkey (Macacus sinicus), with a tuft of hair on its head; the munga. -- Bonnet piece, a gold coin of the time of James V. of Scotland, the king's head on which wears a bonnet. Sir W. Scott. -- To have a bee in the bonnet. See under Bee. -- Black bonnet. See under Black. -- Blue bonnet. See in the Vocabulary.\n\nTo take off the bonnet or cap as a mark of respect; to uncover. [Obs.] Shak.
bonnet rouge |The red cap adopted by the extremists in the French Revolution, which became a sign of patriotism at that epoch; hence, a revolutionist; a Red Republican.
bonneted |1. Wearing a bonnet. \"Bonneted and shawled.\" Howitt. 2. (Fort.)  Protected by a bonnet. See Bonnet, 4 (a).
bonnetless |Without a bonnet.
bonnibel |A handsome girl. [Obs.]
bonnie |See Bonny, a.
bonnilass |A \"bonny lass\"; a beautiful girl. [Obs.] Spenser.
bonnily |Gayly; handsomely.
bonniness |The quality of being bonny; gayety [R.]
bonny |1. Handsome; beautiful; pretty; attractively lively and graceful. Till bonny Susan sped across the plain. Gay. Far from the bonnie banks of Ayr. Burns. 2. Gay; merry; frolicsome; cheerful; blithe. Be you blithe and bonny. Shak. Report speaks you a bonny monk, that would hear the matiSir W. Scott.\n\nA round and compact bed of ore, or a distinct bed, not communicating with a vein.
bonnyclabber |Coagulated sour milk; loppered milk; curdled milk; -- sometimes called simply clabber. B. Jonson.
bonspiel |A cur [Scot.]
bontebok |The pied antelope of South Africa (Alcelaphus pygarga). Its face and rump are white. Called also nunni.
bonus |1. (Law)  A premium given for a loan, or for a charter or other privilege granted to a company; as the bank paid a bonus for its charter. Bouvier. 2. An extra dividend to the shareholders of a joint stock company, out of accumulated profits. 3. Money paid in addition to a stated compensation.
bony |1. Consisting of bone, or of bones; full of bones; pertaining to bones. 2. Having large or prominent bones. Bony fish (Zoöl.), the menhaden. -- Bony pike (Zoöl.), the gar pike (Lepidosteus).
bonze |A Buddhist or Fohist priest, monk, or nun. Note: The name was given by the Portuguese to the priests of Japan, and has since been applied to the priests of China, Cochin China, and the neighboring countries.
booby |1. A dunce; a stupid fellow. 2. (Zoöl.) (a) A swimming bird (Sula fiber or S. sula) related to the common gannet, and found in the West Indies, nesting on the bare rocks. It is so called on account of its apparent stupidity. The name is also sometimes applied to other species of gannets; as, S. piscator, the red-footed booby. (b) A species of penguin of the antarctic seas. Booby hatch (Naut.), a kind of wooden hood over a hatch, readily removable. -- Booby hut, a carriage body put upon sleigh runners. [Local, U. S.] Bartlett. -- Booby hutch, a clumsy covered carriage or seat, used in the eastern part of England. Forby. -- Booby trap, a schoolboy's practical joke, as a shower bath when a door is opened.\n\nHaving the characteristics of a booby; stupid.
boobyish |Stupid; dull.
boodh |Same as Buddha. Malcom.
boodhism |Same as Buddhism.
boodhist |Same as Buddhist.
boodle |1. The whole collection or lot; caboodle. [Low, U. S.] Bartlett. 2. Money given in payment for votes or political influence; bribe money; swag. [Polit. slang, U. S.]
booetes |A northern constellation, containing the bright star Arcturus.
boohoe |To bawl; to cry loudly. [Low] Bartlett.
boohoo |The sailfish; -- called also woohoo.
book |1. A collection of sheets of paper, or similar material, blank, written, or printed, bound together; commonly, many folded and bound sheets containing continuous printing or writing. Note: When blank, it is called a blank book. When printed, the term often distinguishes a bound volume, or a volume of some size, from a pamphlet. Note: It has been held that, under the copyright law, a book is not necessarily a volume made of many sheets bound together; it may be printed on a single sheet, as music or a diagram of patterns. Abbott. 2. A composition, written or printed; a treatise. A good book is the precious life blood of a master spirit, embalmed and treasured up on purpose to a life beyond life. Milton. 3. A part or subdivision of a treatise or literary work; as, the tenth book of \"Paradise Lost.\" 4. A volume or collection of sheets in which accounts are kept; a register of debts and credits, receipts and expenditures, etc. 5. Six tricks taken by one side, in the game of whist; in certain other games, two or more corresponding cards, forming a set. Note: Book is used adjectively or as a part of many compounds; as, book buyer, bookrack, book club, book lore, book sale, book trade, memorandum book, cashbook. Book account, an account or register of debt or credit in a book. -- Book debt, a debt for items charged to the debtor by the creditor in his book of accounts. -- Book learning, learning acquired from books, as distinguished from practical knowledge. \"Neither does it so much require book learning and scholarship, as good natural sense, to distinguish true and false.\" Burnet. -- Book louse (Zoöl.), one of several species of minute, wingless insects injurious to books and papers. They belong to the Pseudoneuroptera. -- Book moth (Zoöl.), the name of several species of moths, the larvæ of which eat books. -- Book oath, an oath made on The Book, or Bible. -- The Book of Books, the Bible. -- Book post, a system under which books, bulky manuscripts, etc., may be transmitted by mail. -- Book scorpion (Zoöl.), one of the false scorpions (Chelifer cancroides) found among books and papers. It can run sidewise and backward, and feeds on small insects. -- Book stall, a stand or stall, often in the open air, for retailing books. -- Canonical books. See Canonical. -- In one's books, in one's favor. \"I was so much in his books, that at his decease he left me his lamp.\" Addison. -- To bring to book. (a) To compel to give an account. (b) To compare with an admitted authority. \"To bring it manifestly to book is impossible.\" M. Arnold. -- To course by bell, book, and candle. See under Bell. -- To make a book (Horse Racing), to lay bets (recorded in a pocket book) against the success of every horse, so that the bookmaker wins on all the unsuccessful horses and loses only on the winning horse or horses. -- To speak by the book, to speak with minute exactness. -- Without book. (a) By memory. (b) Without authority.\n\n1. To enter, write, or register in a book or list. Let it be booked with the rest of this day's deeds. Shak. 2. To enter the name of (any one) in a book for the purpose of securing a passage, conveyance, or seat; as, to be booked for Southampton; to book a seat in a theater. 3. To mark out for; to destine or assign for; as, he is booked for the valedictory. [Colloq.] Here I am booked for three days more in Paris. Charles Reade.
book muslin |1. A kind of muslin used for the covers of books. 2. A kind of thin white muslin for ladies' dresses.
book-learned |Versed in books; having knowledge derived from books. [Often in a disparaging sense.] Whate'er these book-learned blockheads say, Solon's the veriest fool in all the play. Dryden.
bookbinder |One whose occupation is to bind books.
bookbindery |A bookbinder's shop; a place or establishment for binding books.
bookbinding |The art, process, or business of binding books.
bookcase |A case with shelves for holding books, esp. one with glazed doors.
bookcraft |Authorship; literary skill.
booked |1. Registered. 2. On the way; destined. [Colloq.]
booker |One who enters accounts or names, etc., in a book; a bookkeeper.
bookful |As much as will fill a book; a book full. Shak. -- a.  Filled with book learning. [R.] \"The bookful blockhead.\" Pope.
bookholder |1. A prompter at a theater. [Obs.] Beau & Fl. 2. A support for a book, holding it open, while one reads or copies from it.
booking clerk |A clerk who registers passengers, baggage, etc., for conveyance, as by railway or steamship, or who sells passage tickets at a booking office.
booking office |1. An office where passengers, baggage, etc., are registered for conveyance, as by railway or steamship. 2. An office where passage tickets are sold. [Eng.]
bookish |1. Given to reading; fond of study; better acquainted with books than with men; learned from books. \"A bookish man.\" Addison. \"Bookish skill.\" Bp. Hall. 2. Characterized by a method of expression generally found in books; formal; labored; pedantic; as, a bookish way of talking; bookish sentences. -- Book\"ish*ly, adv. -- Book\"ish*ness, n.
bookkeeper |One who keeps accounts; one who has the charge of keeping the books and accounts in an office.
bookkeeping |The art of recording pecuniary or business transactions in a regular and systematic manner, so as to show their relation to each other, and the state of the business in which they occur; the art of keeping accounts. The books commonly used are a daybook, cashbook, journal, and ledger. See Daybook, Cashbook, Journal, and Ledger. Bookkeeping by single entry, the method of keeping books by carrying the record of each transaction to the debit or credit of a single account. -- Bookkeeping by double entry, a mode of bookkeeping in which two entries of every transaction are carried to the ledger, one to the Dr., or left hand, side of one account, and the other to the Cr., or right hand, side of a corresponding account, in order thaItalian method.
bookland |Charter land held by deed under certain rents and free services, which differed in nothing from free socage lands. This species of tenure has given rise to the modern freeholds.
bookless |Without books; unlearned. Shenstone.
booklet |A little book. T. Arnold.
bookmaker |1. One who writes and publishes books; especially, one who gathers his materials from other books; a compiler. 2. (Horse Racing)  A betting man who \"makes a book.\" See To make a book, under Book, n.
bookman |A studious man; a scholar. Shak.
bookmark |Something placed in a book to guide in finding a particular page or passage; also, a label in a book to designate the owner; a bookplate.
bookmate |A schoolfellow; an associate in study.
bookmonger |A dealer in books.
bookplate |A label, placed upon or in a book, showing its ownership or its position in a library.
bookseller |One who sells books.
bookselling |The employment of selling books.
bookshelf |A shelf to hold books.
bookshop |A bookseller's shop. [Eng.]
bookstall |A stall or stand where books are sold.
bookstand |1. A place or stand for the sale of books in the streets; a bookstall. 2. A stand to hold books for reading or reference.
bookstore |A store where books are kept for sale; -- called in England a bookseller's shop.
bookwork |1. Work done upon a book or books (as in a printing office), in distinction from newspaper or job work. 2. Study; application to books.
bookworm |1. (Zoöl.)  Any larva of a beetle or moth, which is injurious to books. Many species are known. 2. A student closely attached to books or addicted to study; a reader without appreciation. I wanted but a black gown and a salary to be as mere a bookworm as any there. Pope.
booky |Bookish.
booly |A company of Irish herdsmen, or a single herdsman, wandering from place to place with flocks and herds, and living on their milk, like the Tartars; also, a place in the mountain pastures inclosed for the shelter of cattle or their keepers. [Obs.] [Written also boley, bolye, bouillie.] Spenser.
boom |1. (Naut.)  A long pole or spar, run out for the purpose of extending the bottom of a particular sail; as, the jib boom, the studding-sail boom, etc. 2. (Mech.)  A long spar or beam, projecting from the mast of a derrick, from the outer end of which the body to be lifted is suspended. 3. A pole with a conspicuous top, set up to mark the channel in a river or harbor. [Obs.] 4. (Mil. & Naval)  A strong chain cable, or line of spars bound together, extended across a river or the mouth of a harbor, to obstruct navigation or passage. 5. (Lumbering)  A line of connected floating timbers stretched across a river, or inclosing an area of water, to keep saw logs, etc., from floating away. Boom iron, one of the iron rings on the yards through which the studding-sail booms traverse. -- The booms, that space on the upper deck of a ship between the foremast and mainmast, where the boats, spare spars, etc., are stowed. Totten.\n\nTo extend, or push, with a boom or pole; as, to boom out a sail; to boom off a boat.\n\n1. To cry with a hollow note; to make a hollow sound, as the bittern, and some insects. At eve the beetle boometh Athwart the thicket lone. Tennyson. 2. To make a hollow sound, as of waves or cannon. Alarm guns booming through the night air. W. Irving. 3. To rush with violence and noise, as a ship under a press of sail, before a free wind. She comes booming down before it. Totten. 4. To have a rapid growth in market value or in popular favor; to go on rushingly.\n\n1. A hollow roar, as of waves or cannon; also, the hollow cry of the bittern; a booming. 2. A strong and extensive advance, with more or less noisy excitement; -- applied colloquially or humorously to market prices, the demand for stocks or commodities and to political chances of aspirants to office; as, a boom in the stock market; a boom in coffee. [Colloq. U. S.]\n\nTo cause to advance rapidly in price; as, to boom railroad or mining shares; to create a \"boom\" for; as to boom Mr. C. for senator. [Colloq. U. S.]
boomdas |A small African hyracoid mammal (Dendrohyrax arboreus) resembling the daman.
boomer |1. One who, or that which, booms. 2. (Zoöl.)  A North American rodent, so named because it is said to make a booming noise. See Sewellel. 3. (Zoöl.)  A large male kangaroo. 4. One who works up a \"boom\". [Slang, U. S.]
boomerang |A very singular missile weapon used by the natives of Australia and in some parts of India. It is usually a curved stick of hard wood, from twenty to thirty inches in length, from two to three inches wide, and half or three quarters of an inch thick. When thrown from the hand with a quick rotary motion, it describes very remarkable curves, according to the shape of the instrument and the manner of throwing it, often moving nearly horizontally a long distance, then curving upward to a considerable height, and finally taking a retrograde direction, so as to fall near the place from which it was thrown, or even far in the rear of it.
booming |1. Rushing with violence; swelling with a hollow sound; making a hollow sound or note; roaring; resounding. O'er the sea-beat ships the booming waters roar. Falcone. 2. Advancing or increasing amid noisy excitement; as, booming prices; booming popularity. [Colloq. U. S.]\n\nThe act of producing a hollow or roaring sound; a violent rushing with heavy roar; as, the booming of the sea; a deep, hollow sound; as, the booming of bitterns. Howitt.
boomkin |Same as Bumkin.
boomorah |A small West African chevrotain (Hyæmoschus aquaticus), resembling the musk deer.
boomslange |A large South African tree snake (Bucephalus Capensis). Although considered venomous by natives, it has no poison fangs.
boon |1. A prayer or petition. [Obs.] For which to God he made so many an idle boon. Spenser. 2. That which is asked or granted as a benefit or favor; a gift; a benefaction; a grant; a present. Every good gift and every perfect boon is from above. James i. 17 (Rev. Ver. ).\n\n1. Good; prosperous; as, boon voyage. [Obs.] 2. Kind; bountiful; benign. Which . . . Nature boon Poured forth profuse on hill, and dale, and plain. Milton. 3. Gay; merry; jovial; convivial. A boon companion, loving his bottle. Arbuthnot.\n\nThe woody portion flax, which is separated from the fiber as refuse matter by retting, braking, and scutching.
boor |1. A husbandman; a peasant; a rustic; esp. a clownish or unrefined countryman. 2. A Dutch, German, or Russian peasant; esp. a Dutch colonist in South Africa, Guiana, etc.: a boer. 3. A rude ill-bred person; one who is clownish in manners.
boorish |Like a boor; clownish; uncultured; unmannerly. -- Boor\"ish*ly, adv. -- Boor\"ish*ness, n. Which is in truth a gross and boorish opinion. Milton.
boort |See Bort.
boose |A stall or a crib for an ox, cow, or other animal. [Prov. Eng.] Halliwell.\n\nTo drink excessively. See Booze.
booser |A toper; a guzzler. See Boozer.
boost |To lift or push from behind (one who is endeavoring to climb); to push up; hence, to assist in overcoming obstacles, or in making advancement. [Colloq. U. S.]\n\nA push from behind, as to one who is endeavoring to climb; help. [Colloq. U. S.]
booster |An instrument for regulating the electro-motive force in an alternating-current circuit; -- so called because used to \"boost\| or raise| the pressure in the circuit."
boot |1. Remedy; relief; amends; reparation; hence, one who brings relief. He gaf the sike man his boote. Chaucer. Thou art boot for many a bruise And healest many a wound. Sir W. Scott. Next her Son, our soul's best boot. Wordsworth. 2. That which is given to make an exchange equal, or to make up for the deficiency of value in one of the things exchanged. I'll give you boot, I'll give you three for one. Shak. 3. Profit; gain; advantage; use. [Obs.] Then talk no more of flight, it is no boot. Shak. To boot, in addition; over and above; besides; as a compensation for the difference of value between things bartered. Helen, to change, would give an eye to boot. Shak. A man's heaviness is refreshed long before he comes to drunkenness, for when he arrives thither he hath but changed his heaviness, and taken a crime to boot. Jer. Taylor.\n\n1. To profit; to advantage; to avail; -- generally followed by it; as, what boots it What booteth it to others that we wish them well, and do nothing for them Hooker. What subdued To change like this a mind so far imbued With scorn of man, it little boots to know. Byron. What boots to us your victories Southey. 2. To enrich; to benefit; to give in addition. [Obs.] And I will boot thee with what gift beside Thy modesty can beg. Shak.\n\n1. A covering for the foot and lower part of the leg, ordinarily made of leather. 2. An instrument of torture for the leg, formerly used to extort confessions, particularly in Scotland. So he was put to the torture, which in Scotland they call the boots; for they put a pair of iron boots close on the leg, and drive wedges between them and the leg. Bp. Burnet. 3. A place at the side of a coach, where attendants rode; also, a low outside place before and behind the body of the coach. [Obs.] 4. A place for baggage at either end of an old-fashioned stagecoach. 5. An apron or cover (of leather or rubber cloth) for the driving seat of a vehicle, to protect from rain and mud. 6. (Plumbing)  The metal casing and flange fitted about a pipe where it passes through a roof. Boot catcher, the person at an inn whose business it was to pull off boots and clean them. [Obs.] Swift. -- Boot closer, one who, or that which, sews the uppers of boots. -- Boot crimp, a frame or device used by bootmakers for drawing and shaping the body of a boot. -- Boot hook, a hook with a handle, used for pulling on boots. -- Boots and saddles (Cavalry Tactics), the trumpet call which is the first signal for mounted drill. -- Sly boots. See Slyboots, in the Vocabulary.\n\n1. To put boots on, esp. for riding. Coated and booted for it. B. Jonson. 2. To punish by kicking with a booted foot. [U. S.]\n\nTo boot one's self; to put on one's boots.\n\nBooty; spoil. [Obs. or R.] Shak.
bootblack |One who blacks boots.
booted |1. Wearing boots, especially boots with long tops, as for riding; as, a booted squire. 2. (Zoöl.)  Having an undivided, horny, bootlike covering; -- said of the tarsus of some birds.
bootee |A half boot or short boot.
bootes |A northern constellation, containing the bright star Arcturus.
booth |1. A house or shed built of boards, boughs, or other slight materials, for temporary occupation. Camden. 2. A covered stall or temporary structure in a fair or market, or at a polling place.
boothale |To forage for booty; to plunder. [Obs.] Beau. & Fl.
boothose |1. Stocking hose, or spatterdashes, in lieu of boots. Shak. 2. Hose made to be worn with boots, as by travelers on horseback. Sir W. Scott.
boothy |See Bothy.\n\nA wooden hut or humble cot, esp. a rude hut or barrack for unmarried farm servants; a shepherd's or hunter's hut; a booth. [Scot.]
bootikin |1. A little boot, legging, or gaiter. 2. A covering for the foot or hand, worn as a cure for the gout. H. Walpole.
booting |Advantage; gain; gain by plunder; booty. [Obs.] Sir. J. Harrington.\n\n1. A kind of torture. See Boot, n., 2. 2. A kicking, as with a booted foot. [U. S.]
bootjack |A device for pulling off boots.
bootless |Unavailing; unprofitable; useless; without advantage or success. Chaucer. I'll follow him no more with bootless prayers. Shak. -- Boot\"less*ly, adv. -- Boot\"less*ness, n.
bootlick |A toady. [Low, U. S.] Bartlett.
bootmaker |One who makes boots. -- Boot\"mak`ing, n.
boots |A servant at a hotel or elsewhere, who cleans and blacks the boots and shoes.
boottopping |1. (Naut.)  The act or process of daubing a vessel's bottom near the surface of the water with a mixture of tallow, sulphur, and resin, as a temporary protection against worms, after the slime, shells, etc., have been scraped off. 2. (Naut.)  Sheathing a vessel with planking over felt.
boottree |An instrument to stretch and widen the leg of a boot, consisting of two pieces, together shaped like a leg, between which, when put into the boot, a wedge is driven. The pretty boots trimly stretched on boottrees. Thackeray.
booty |That which is seized by violence or obtained by robbery, especially collective spoil taken in war; plunder; pillage. Milton. To play booty, to play dishonestly, with an intent to lose; to allow one's adversary to win at cards at first, in order to induce him to continue playing and victimize him afterwards. [Obs.] L'Estrange.
booze |To drink greedily or immoderately, esp. alcoholic liquor; to tipple. [Written also bouse, and boose.] Landor. This is better than boozing in public houses. H. R. Haweis.\n\nA carouse; a drinking. Sir W. Scott.
boozer |One who boozes; a toper; a guzzler of alcoholic liquors; a bouser.
boozy |A little intoxicated; fuddled; stupid with liquor; bousy. [Colloq.] C. Kingsley.
bopeep |The act of looking out suddenly, as from behind a screen, so as to startle some one (as by children in play), or of looking out and drawing suddenly back, as if frightened. I for sorrow sung, That such a king should play bopeep, And go the fools among. Shak.
borable |Capable of being bored. [R.]
borachte |A large leather bottle for liquors, etc., made of the skin of a goat or other animal. Hence: A drunkard. [Obs.] You're an absolute borachio. Congreve.
boracic |Pertaining to, or produced from, borax; containing boron; boric; as, boracic acid.
boracite |A mineral of a white or gray color occurring massive and in isometric crystals; in composition it is a magnesium borate with magnesium chloride.
boracous |Relating to, or obtained from, borax; containing borax.
borage |A mucilaginous plant of the genus Borago (B. officinalis), which is used, esp. in France, as a demulcent and diaphoretic.
boragewort |Plant of the Borage family.
boraginaceous |Of, pertaining to, or resembling, a family of plants (Boraginaceæ) which includes the borage, heliotrope, beggar's lice, and many pestiferous plants.
boragineous |Relating to the Borage tribe; boraginaceous.
boramez |See Barometz.
borate |A salt formed by the combination of boric acid with a base or positive radical.
borax |A white or gray crystalline salt, with a slight alkaline taste, used as a flux, in soldering metals, making enamels, fixing colors on porcelain, and as a soap. It occurs native in certain mineral springs, and is made from the boric acid of hot springs in Tuscany. It was originally obtained from a lake in Thibet, and was sent to Europe under the name of tincal. Borax is a pyroborate or tetraborate of sodium, Na2B4O7.10H2O. Borax bead. (Chem.) See Bead, n., 3.
borborygm |A rumbling or gurgling noise produced by wind in the bowels. Dunglison.
bord |1. A board; a table. [Obs.] Chaucer. 2. (Mining)  The face of coal parallel to the natural fissures.\n\nSee Bourd. [Obs.] Spenser.
bord service |Service due from a bordar; bordage.
bordage |The base or servile tenure by which a bordar held his cottage.
bordar |A villein who rendered menial service for his cottage; a cottier. The cottar, the bordar, and the laborer were bound to aid in the work of the home farm. J. R. Green.
bordeaux |Pertaining to Bordeaux in the south of France. -- n.  A claret wine from Bordeaux.
bordeaux mixture |A fungicidal mixture composed of blue vitriol, lime, and water. The formula in common use is: blue vitriol, 6 lbs.; lime, 4 lbs.; water, 35 -- 50 gallons.
bordel |A brothel; a bawdyhouse; a house devoted to prostitution. [Obs.] B. Jonson.
bordelais |Of or pertaining to Bordeaux, in France, or to the district around Bordeaux.
bordeller |A keeper or a frequenter of a brothel. [Obs.] Gower.
bordello |A brothel; a bawdyhouse; a house devoted to prostitution. [Obs.] B. Jonson.
border |1. The outer part or edge of anything, as of a garment, a garden, etc.; margin; verge; brink. Upon the borders of these solitudes. Bentham. In the borders of death. Barrow. 2. A boundary; a frontier of a state or of the settled part of a country; a frontier district. 3. A strip or stripe arranged along or near the edge of something, as an ornament or finish. 4. A narrow flower bed. Border land, land on the frontiers of two adjoining countries; debatable land; -- often used figuratively; as, the border land of science. -- The Border, The Borders, specifically, the frontier districts of Scotland and England which lie adjacent. -- Over the border, across the boundary line or frontier. Syn. -- Edge; verge; brink; margin; brim; rim; boundary; confine.\n\n1. To touch at the edge or boundary; to be contiguous or adjacent; -- with on or upon as, Connecticut borders on Massachusetts. 2. To approach; to come near to; to verge. Wit which borders upon profaneness deserves to be branded as folly. Abp. Tillotson.\n\n1. To make a border for; to furnish with a border, as for ornament; as, to border a garment or a garden. 2. To be, or to have, contiguous to; to touch, or be touched, as by a border; to be, or to have, near the limits or boundary; as, the region borders a forest, or is bordered on the north by a forest. The country is bordered by a broad tract called the \"hot region.\" Prescott. Shebah and Raamah . . . border the sea called the Persian gulf. Sir W. Raleigh. 3. To confine within bounds; to limit. [Obs.] That nature, which contemns its origin, Can not be bordered certain in itself. Shak.
bordereau |A note or memorandum, esp. one containing an enumeration of documents.
borderer |One who dwells on a border, or at the extreme part or confines of a country, region, or tract of land; one who dwells near to a place or region. Borderers of the Caspian. Dyer.
bordland |Either land held by a bordar, or the land which a lord kept for the maintenance of his board, or table. Spelman.
bordlode |The service formerly required of a tenant, to carry timber from the woods to the lord's house. Bailey. Mozley & W.
bordman |A bordar; a tenant in bordage.
bordrag |An incursion upon the borders of a country; a raid. [Obs.] Spenser.
bordraging |An incursion upon the borders of a country; a raid. [Obs.] Spenser.
bordure |A border one fifth the width of the shield, surrounding the field. It is usually plain, but may be charged.
bore |1. To perforate or penetrate, as a solid body, by turning an auger, gimlet, drill, or other instrument; to make a round hole in or through; to pierce; as, to bore a plank. I'll believe as soon this whole earth may be bored. Shak. 2. To form or enlarge by means of a boring instrument or apparatus; as, to bore a steam cylinder or a gun barrel; to bore a hole. Short but very powerful jaws, by means whereof the insect can bore, as with a centerbit, a cylindrical passage through the most solid wood. T. W. Harris. 3. To make (a passage) by laborious effort, as in boring; as, to bore one's way through a crowd; to force a narrow and difficult passage through. \"What bustling crowds I bored.\" Gay. 4. To weary by tedious iteration or by dullness; to tire; to trouble; to vex; to annoy; to pester. He bores me with some trick. Shak. Used to come and bore me at rare intervals. Carlyle. 5. To befool; to trick. [Obs.] I am abused, betrayed; I am laughed at, scorned, Baffled and bored, it seems. Beau. & Fl.\n\n1. To make a hole or perforation with, or as with, a boring instrument; to cut a circular hole by the rotary motion of a tool; as, to bore for water or oil (i. e., to sink a well by boring for water or oil); to bore with a gimlet; to bore into a tree (as insects). 2. To be pierced or penetrated by an instrument that cuts as it turns; as, this timber does not bore well, or is hard to bore. 3. To push forward in a certain direction with laborious effort. They take their flight . . . boring to the west. Dryden. 4. (Ma  To shoot out the nose or toss it in the air; Crabb.\n\n1. A hole made by boring; a perforation. 2. The internal cylindrical cavity of a gun, cannon, pistol, or other firearm, or of a pipe or tube. The bores of wind instruments. Bacon. Love's counselor should fill the bores of hearing. Shak. 3. The size of a hole; the interior diameter of a tube or gun barrel; the caliber. 4. A tool for making a hole by boring, as an auger. 5. Caliber; importance. [Obs.] Yet are they much too light for the bore of the matter. Shak. 6. A person or thing that wearies by prolixity or dullness; a tiresome person or affair; any person or thing which causes ennui. It is as great a bore as to hear a poet read his own verses. Hawthorne.\n\n(a) A tidal flood which regularly or occasionally rushes into certain rivers of peculiar configuration or location, in one or more waves which present a very abrupt front of considerable height, dangerous to shipping, as at the mouth of the Amazon, in South America, the Hoogly and Indus, in India, and the Tsien-tang, in China. (b) Less properly, a very high and rapid tidal flow, when not so abrupt, such as occurs at the Bay of Fundy and in the British Channel.\n\nimp. of 1st & 2d Bear.
boreal |Northern; pertaining to the north, or to the north wind; as, a boreal bird; a boreal blast. So from their own clear north in radiant streams, Bright over Europe bursts the boreal morn. Thomson.
boreas |The north wind; -- usually a personification.
borecole |A brassicaceous plant of many varieties, cultivated for its leaves, which are not formed into a compact head like the cabbage, but are loose, and are generally curled or wrinkled; kale.
boredom |1. The state of being bored, or pestered; a state of ennui. Dickens. 2. The realm of bores; bores, collectively.
boree |Same as BourrÉ\\'82. [Obs.] Swift.
borel |See Borrel.
borele |The smaller two-horned rhinoceros of South Africa (Atelodus bicornis).
borer |1. One that bores; an instrument for boring. 2. (Zoöl.) (a) A marine, bivalve mollusk, of the genus Teredo and allies, which burrows in wood. See Teredo. (b) Any bivalve mollusk (Saxicava, Lithodomus, etc.) which bores into limestone and similar substances. (c) One of the larvæ of many species of insects, which penetrate trees, as the apple, peach, pine, etc. See Apple borer, under Apple. (d) The hagfish (Myxine).
boric |Of, pertaining to, or containing, boron. Boric acid, a white crystalline substance B(OH)3, easily obtained from its salts, and occurring in solution in the hot lagoons of Tuscany.
boride |A binary compound of boron with a more positive or basic element or radical; -- formerly called boruret.
boring |1. The act or process of one who, or that which, bores; as, the boring of cannon; the boring of piles and ship timbers by certain marine mollusks. One of the most important applications of boring is in the formation of artesian wells. Tomlinson. 2. A hole made by boring. 3. pl.  The chips or fragments made by boring. Boring bar, a revolving or stationary bar, carrying one or more cutting tools for dressing round holes. -- Boring tool (Metal Working), a cutting tool placed in a cutter head to dress round holes. Knight.
born |1. Brought forth, as an animal; brought into life; introduced by birth. No one could be born into slavery in Mexico. Prescott. 2. Having from birth a certain character; by or from birth; by nature; innate; as, a born liar. \"A born matchmaker.\" W. D. Howells. Born again (Theol.), regenerated; renewed; having received spiritual life. \"Except a man be born again, he can not see the kingdom of God.\" John iii. 3. -- Born days, days since one was born; lifetime. [Colloq.]
borne |Carried; conveyed; supported; defrayed. See Bear, v. t.
borneol |A rare variety of camphor, C10H17.OH, resembling ordinary camphor, from which it can be produced by reduction. It is said to occur in the camphor tree of Borneo and Sumatra (Dryobalanops camphora), but the natural borneol is rarely found in European or American commerce, being in great request by the Chinese. Called also Borneo camphor, Malay camphor, and camphol.
bornite |A valuable ore of copper, containing copper, iron, and sulphur; -- also called purple copper ore (or erubescite), in allusion to the colors shown upon the slightly tarnished surface.
borofluoride |A double fluoride of boron and hydrogen, or some other positive element, or radical; -- called also fluoboride, and formerly fluoborate.
boroglyceride |A compound of boric acid and glycerin, used as an antiseptic.
boron |A nonmetallic element occurring abundantly in borax. It is reduced with difficulty to the free state, when it can be obtained in several different forms; viz., as a substance of a deep olive color, in a semimetallic form, and in colorless quadratic crystals similar to the diamond in hardness and other properties. It occurs in nature also in boracite, datolite, tourmaline, and some other minerals. Atomic weight 10.9. Symbol B.
borosilicate |A double salt of boric and silicic acids, as in the natural minerals tourmaline, datolite, etc.
borough |1. In England, an incorporated town that is not a city; also, a town that sends members to parliament; in Scotland, a body corporate, consisting of the inhabitants of a certain district, erected by the sovereign, with a certain jurisdiction; in America, an incorporated town or village, as in Pennsylvania and Connecticut. Burrill. Erskine. 2. The collective body of citizens or inhabitants of a borough; as, the borough voted to lay a tax. Close borough, or Pocket borough, a borough having the right of sending a member to Parliament, whose nomination is in the hands of a single person. -- Rotten borough, a name given to any borough which, at the time of the passage of the Reform Bill of 1832, contained but few voters, yet retained the privilege of sending a member to Parliament.\n\n(a) An association of men who gave pledges or sureties to the king for the good behavior of each other. (b) The pledge or surety thus given. Blackstone. Tomlins.
borough-english |A custom, as in some ancient boroughs, by which lands and tenements descend to the youngest son, instead of the eldest; or, if the owner have no issue, to the youngest brother. Blackstone.
boroughhead |See Headborough. [Obs.]
boroughholder |A headborough; a borsholder.
boroughmaster |The mayor, governor, or bailiff of a borough.
boroughmonger |One who buys or sells the parliamentary seats of boroughs.
boroughmongering |The practices of a boroughmonger.
boroughmongery |The practices of a boroughmonger.
borracho |See Borachio. [Obs.]
borrage |See Borage, n., etc.
borraginaceous |See Borage, n., etc.
borrel |1. Coarse woolen cloth; hence, coarse clothing; a garment. [Obs.] Chaucer. 2. A kind of light stuff, of silk and wool.\n\nIgnorant, unlearned; belonging to the laity. [Obs.] Chaucer.
borrow |1. To receive from another as a loan, with the implied or expressed intention of returning the identical article or its equivalent in kind; -- the opposite of lend. 2. (Arith.)  To take (one or more) from the next higher denomination in order to add it to the next lower; -- a term of subtraction when the figure of the subtrahend is larger than the corresponding one of the minuend. 3. To copy or imitate; to adopt; as, to borrow the style, manner, or opinions of another. Rites borrowed from the ancients. Macaulay. It is not hard for any man, who hath a Bible in his hands, to borrow good words and holy sayings in abundance; but to make them his own is a work of grace only from above. Milton. 4. To feign or counterfeit. \"Borrowed hair.\" Spenser. The borrowed majesty of England. Shak. 5. To receive; to take; to derive. Any drop thou borrowedst from thy mother. Shak. To borrow trouble, to be needlessly troubled; to be overapprehensive.\n\n1. Something deposited as security; a pledge; a surety; a hostage. [Obs.] Ye may retain as borrows my two priests. Sir W. Scott. 2. The act of borrowing. [Obs.] Of your royal presence I'll adventure The borrow of a week. Shak.
borrower |One who borrows. Neither a borrower nor a lender be. Shak.
borsholder |The head or chief of a tithing, or borough (see 2d Borough); the headborough; a parish constable. Spelman.
bort |Imperfectly crystallized or coarse diamonds, or fragments made in cutting good diamonds which are reduced to powder and used in lapidary work.
boruret |A boride. [Obs.]
borwe |Pledge; borrow. [Obs.] Chaucer.
bos |A genus of ruminant quadrupeds, including the wild and domestic cattle, distinguished by a stout body, hollow horns, and a large fold of skin hanging from the neck.
bosa |A drink, used in the East. See Boza.
boscage |1. A growth of trees or shrubs; underwood; a thicket; thick foliage; a wooded landscape. 2. (O. Eng. Law)  Food or sustenance for cattle, obtained from bushes and trees; also, a tax on wood.
bosh |Figure; outline; show. [Obs.]\n\nEmpty talk; contemptible nonsense; trash; humbug. [Colloq.]\n\n1. One of the sloping sides of the lower part of a blast furnace; also, one of the hollow iron or brick sides of the bed of a puddling or boiling furnace. 2. pl.  The lower part of a blast furnace, which slopes inward, or the widest space at the top of this part. 3. In forging and smelting, a trough in which tools and ingots are cooled.
boshbok |A kind of antelope. See Bush buck.
boshvark |The bush hog. See under Bush, a thicket.
bosjesman |; pl. Bosjesmans. [D. boschjesman.]  See Bushman.
bosk |A thicket; a small wood. \"Through bosk and dell.\" Sir W. Scott.
boskage |Same as Boscage. Thridding the somber boskage of the wood. Tennyson.
bosket |A grove; a thicket; shrubbery; an inclosure formed by branches of trees, regularly or irregularly disposed.
boskiness |Boscage; also, the state or quality of being bosky.
bosky |1. Woody or bushy; covered with boscage or thickets. Milton. 2. Caused by boscage. Darkened over by long bosky shadows. H. James.
bosom |1. The breast of a human being; the part, between the arms, to which anything is pressed when embraced by them. You must prepare your bosom for his knife. Shak. 2. The breast, considered as the seat of the passions, affections, and operations of the mind; consciousness; se Tut, I am in their bosoms, and I know Wherefore they do it. Shak. If I covered my transgressions as Adam, by hiding my iniquity in my bosom. Job xxxi. 33. 3. Embrace; loving or affectionate inclosure; fold. Within the bosom of that church. Hooker. 4. Any thing or place resembling the breast; a supporting surface; an inner recess; the interior; as, the bosom of the earth. \"The bosom of the ocean.\" Addison. 5. The part of the dress worn upon the breast; an article, or a portion of an article, of dress to be worn upon the breast; as, the bosom of a shirt; a linen bosom. He put his hand into his bosom: and when he took it out, behold, his hand was leprous as snow. Ex. iv. 6. 6. Inclination; desire. [Obs.] Shak. 7. A depression round the eye of a millstone. Knight.\n\n1. Of or pertaining to the bosom. 2. Intimate; confidential; familiar; trusted; cherished; beloved; as, a bosom friend.\n\n1. To inclose or carry in the bosom; to keep with care; to take to heart; to cherish. Bosom up my counsel, You'll find it wholesome. Shak. 2. To conceal; to hide from view; to embosom. To happy convents bosomed deep in vines. Pope.
bosomed |Having, or resembling, bosom; kept in the bosom; hidden.
bosomy |Characterized by recesses or sheltered hollows.
boson |See Boatswain. [Obs.] Dryden.
bosporian |Of or pertaining to the Thracian or the Cimmerian Bosporus. The Alans forced the Bosporian kings to pay them tribute and exterminated the Taurians. Tooke.
bosporus |A strait or narrow sea between two seas, or a lake and a seas; as, the Bosporus (formerly the Thracian Bosporus) or Strait of Constantinople, between the Black Sea and Sea of Marmora; the Cimmerian Bosporus, between the Black Sea and Sea of Azof. [Written also Bosphorus.]
bosquet |A grove; a thicket; shrubbery; an inclosure formed by branches of trees, regularly or irregularly disposed.\n\nSee Bosket.
boss |1. Any protuberant part; a round, swelling part or body; a knoblike process; as, a boss of wood. 2. A protuberant ornament on any work, either of different material from that of the work or of the same, as upon a buckler or bridle; a stud; a knob; the central projection of a shield. See Umbilicus. 3. (Arch.)  A projecting ornament placed at the intersection of the ribs of ceilings, whether vaulted or flat, and in other situations. 4. Etym: [Cf. D. bus box, Dan. bösse.]  A wooden vessel for the mortar used in tiling or masonry, hung by a hook from the laths, or from the rounds of a ladder. Gwilt. 5. (Mech.) (a) The enlarged part of a shaft, on which a wheel is keyed, or at the end, where it is coupled to another. (b) A swage or die used for shaping metals. 6. A head or reservoir of water. [Obs.]\n\nTo ornament with bosses; to stud.\n\nA master workman or superintendent; a director or manager; a political dictator. [Slang, U. S.]
bossage |1. (Arch.)  A stone in a building, left rough and projecting, to be afterward carved into shape. Gwilt. 2. (Arch.)  Rustic work, consisting of stones which seem to advance beyond the level of the building, by reason of indentures or channels left in the joinings. Gwilt.
bossed |Embossed; also, bossy.
bosset |A rudimental antler of a young male of the red deer.
bossism |The rule or practices of bosses, esp. political bosses. [Slang, U. S.]
bossy |Ornamented with bosses; studded.\n\nA cow or calf; -- familiarly so called. [U. S.]
boston |A game at cards, played by four persons, with two packs of fifty-two cards each; -- said to be so called from Boston, Massachusetts, and to have been invented by officers of the French army in America during the Revolutionary war.
bostryx |A form of cymose inflorescence with all the flowers on one side of the rachis, usually causing it to curl; -- called also a uniparous helicoid cyme.
boswellian |Relating to, or characteristic of, Boswell, the biographer of Dr. Johnson.
boswellism |The style of Boswell.
bot |See Bots.
botanic |Of or pertaining to botany; relating to the study of plants; as, a botanical system, arrangement, textbook, expedition. -- Botan\"ic*al*ly, adv. Botanic garden, a garden devoted to the culture of plants collected for the purpose of illustrating the science of botany. -- Botanic physician, a physician whose medicines consist chiefly of herbs and roots.
botanical |Of or pertaining to botany; relating to the study of plants; as, a botanical system, arrangement, textbook, expedition. -- Botan\"ic*al*ly, adv. Botanic garden, a garden devoted to the culture of plants collected for the purpose of illustrating the science of botany. -- Botanic physician, a physician whose medicines consist chiefly of herbs and roots.
botanist |One skilled in botany; one versed in the knowledge of plants.
botanize |To seek after plants for botanical investigation; to study plants.\n\nTo explore for botanical purposes.
botanizer |One who botanizes.
botanologer |A botanist. [Obs.]
botanology |The science of botany. [Obs.] Bailey.
botanomancy |An ancient species of divination by means of plants, esp. sage and fig leaves.
botany |1. The science which treats of the structure of plants, the functions of their parts, their places of growth, their classification, and the terms which are employed in their description and denomination. See Plant. 2. A book which treats of the science of botany. Note: Botany is divided into various departments; as, Structural Botany, which investigates the structure and organic composition of plants; Physiological Botany, the study of their functions and life; and Systematic Botany, which has to do with their classification, description, nomenclature, etc.
botany bay |A harbor on the east coast of Australia, and an English convict settlement there; -- so called from the number of new plants found on its shore at its discovery by Cook in 1770. Note: Hence, any place to which desperadoes resort. Botany Bay kino (Med.), an astringent, reddish substance consisting of the inspissated juice of several Australian species of Eucalyptus. -- Botany Bay resin (Med.), a resin of reddish yellow color, resembling gamboge, the product of different Australian species of Xanthorrhæa, esp. the grass three (X. hastilis.)
botargo |A sort of cake or sausage, made of the salted roes of the mullet, much used on the coast of the Mediterranean as an incentive to drink.
botch |1. A swelling on the skin; a large ulcerous affection; a boil; an eruptive disease. [Obs. or Dial.] Botches and blains must all his flesh emboss. Milton. 2. A patch put on, or a part of a garment patched or mended in a clumsy manner. 3. Work done in a bungling manner; a clumsy performance; a piece of work, or a place in work, marred in the doing, or not properly finished; a bungle. To leave no rubs nor botches in the work. Shak.\n\n1. To mark with, or as with, botches. Young Hylas, botched with stains. Garth. 2. To repair; to mend; esp. to patch in a clumsy or imperfect manner, as a garment; -- sometimes with up. Sick bodies . . . to be kept and botched up for a time. Robynson (More's Utopia). 3. To put together unsuitably or unskillfully; to express or perform in a bungling manner; to spoil or mar, as by unskillful work. For treason botched in rhyme will be thy bane. Dryden.
botchedly |In a clumsy manner.
botcher |1. One who mends or patches, esp. a tailor or cobbler. Shak. 2. A clumsy or careless workman; a bungler. 3. (Zoöl.)  A young salmon; a grilse.
botcherly |Bungling; awkward. [R.]
botchery |A botching, or that which is done by botching; clumsy or careless workmanship.
botchy |Marked with botches; full of botches; poorly done. \"This botchy business.\" Bp. Watson.
bote |(a) Compensation; amends; satisfaction; expiation; as, man bote, a compensation or a man slain. (b) Payment of any kind. Bouvier. (c) A privilege or allowance of necessaries. Note: This word is still used in composition as equivalent to the French estovers, supplies, necessaries; as, housebote, a sufficiency of wood to repair a house, or for fuel, sometimes called firebote; so plowbote, cartbote, wood for making or repairing instruments of husbandry; haybote or hedgebote, wood for hedges, fences, etc. These were privileges enjoyed by tenants under the feudal system. Burrill. Bouvier. Blackstone.
boteless |Unavailing; in vain. See Bootless.
botfly |A dipterous insect of the family (Estridæ, of many different species, some of which are particularly troublesome to domestic animals, as the horse, ox, and sheep, on which they deposit their eggs. A common species is one of the botflies of the horse (Gastrophilus equi), the larvæ of which (bots) are taken into the stomach of the animal, where they live several months and pass through their larval states. In tropical America one species sometimes lives under the human skin, and another in the stomach. See Gadfly.
both |The one and the other; the two; the pair, without exception of either. Note: It is generally used adjectively with nouns; as, both horses ran away; but with pronouns, and often with nous, it is used substantively, and followed by of. Note: It frequently stands as a pronoun. She alone is heir to both of us. Shak. Abraham took sheep and oxen, and gave them unto Abimelech; and both of them made a covenant. Gen. xxi. 27. He will not bear the loss of his rank, because he can bear the loss of his estate; but he will bear both, because he is prepared for both. Bolingbroke. Note: It is often used in apposition with nouns or pronouns. Thy weal and woe are both of them extremes. Shak. This said, they both betook them several ways. Milton. Note: Both now always precedes any other attributive words; as, both their armies; both our eyes. Note: Both of is used before pronouns in the objective case; as, both of us, them, whom, etc.; but before substantives its used is colloquial, both (without of) being the preferred form; as, both the brothers.\n\nAs well; not only; equally. Note: Both precedes the first of two coördinate words or phrases, and is followed by and before the other, both . . . and . . . ; as well the one as the other; not only this, but also that; equally the former and the latter. It is also sometimes followed by more than two coördinate words, connected by and expressed or understood. To judge both quick and dead. Milton. A masterpiece both for argument and style. Goldsmith. To whom bothe heven and erthe and see is sene. Chaucer. Both mongrel, puppy, whelp, and hound. Goldsmith. He prayeth well who loveth well Both man and bird and beast. Coleridge.
both-hands |A factotum. [R.] He is his master's both-hands, I assure you. B. Jonson.
bother |To annoy; to trouble; to worry; to perplex. See Pother. Note: The imperative is sometimes used as an exclamation mildly imprecatory.\n\nTo feel care or anxiety; to make or take trouble; to be troublesome. Without bothering about it. H. James.\n\nOne who, or that which, bothers; state of perplexity or annoyance; embarrassment; worry; disturbance; petty trouble; as, to be in a bother.
botheration |The act of bothering, or state of being bothered; cause of trouble; perplexity; annoyance; vexation. [Colloq.]
botherer |One who bothers.
bothersome |Vexatious; causing bother; causing trouble or perplexity; troublesome.
bothie |Same as Bothy. [Scot.]
bothnian |Of or pertaining to Bothnia, a country of northern Europe, or to a gulf of the same name which forms the northern part of the Baltic sea.
bothnic |Of or pertaining to Bothnia, a country of northern Europe, or to a gulf of the same name which forms the northern part of the Baltic sea.
bothrenchyma |Dotted or pitted ducts or vessels forming the pores seen in many kinds of wood.
bothy |A wooden hut or humble cot, esp. a rude hut or barrack for unmarried farm servants; a shepherd's or hunter's hut; a booth. [Scot.]
botocudos |A Brazilian tribe of Indians, noted for their use of poisons; - - also called Aymborés.
botryogen |A hydrous sulphate of iron of a deep red color. It often occurs in botryoidal form.
botryoid |Having the form of a bunch of grapes; like a cluster of grapes, as a mineral presenting an aggregation of small spherical or spheroidal prominences.
botryoidal |Having the form of a bunch of grapes; like a cluster of grapes, as a mineral presenting an aggregation of small spherical or spheroidal prominences.
botryolite |A variety of datolite, usually having a botryoidal structure.
botryose |(a) Having the form of a cluster of grapes. (b) Of the racemose or acropetal type of inflorescence. Gray.
bots |The larvæ of several species of botfly, especially those larvæ which infest the stomach, throat, or intestines of the horse, and are supposed to be the cause of various ailments. [Written also botts.] Note: See Illust. of Botfly.
bottine |1. A small boot; a lady's boot. 2. An appliance resembling a small boot furnished with straps, buckles, etc., used to correct or prevent distortions in the lower extremities of children. Dunglison.
bottle |1. A hollow vessel, usually of glass or earthenware (but formerly of leather), with a narrow neck or mouth, for holding liquids. 2. The contents of a bottle; as much as a bottle contains; as, to drink a bottle of wine. 3. Fig.: Intoxicating liquor; as, to drown one's reason in the bottle. Note: Bottle is much used adjectively, or as the first part of a compound. Bottle ale, bottled ale. [Obs.] Shak. -- Bottle brush, a cylindrical brush for cleansing the interior of bottles. -- Bottle fish (Zoöl.), a kind of deep-sea eel (Saccopharynx ampullaceus), remarkable for its baglike gullet, which enables it to swallow fishes two or three times its won size. -- Bottle flower. (Bot.) Same as Bluebottle. -- Bottle glass, a coarse, green glass, used in the manufacture of bottles. Ure. -- Bottle gourd (Bot.), the common gourd or calabash (Lagenaria Vulgaris), whose shell is used for bottles, dippers, etc. -- Bottle grass (Bot.), a nutritious fodder grass (Setaria glauca and S. viridis); -- called also foxtail, and green foxtail. -- Bottle tit (Zoöl.), the European long-tailed titmouse; -- so called from the shape of its nest. -- Bottle tree (Bot.), an Australian tree (Sterculia rupestris), with a bottle-shaped, or greatly swollen, trunk. -- Feeding bottle, Nursing bottle, a bottle with a rubber nipple (generally with an intervening tubve), used in feeding infants.\n\nTo put into bottles; to inclose in, or as in, a bottle or bottles; to keep or restrain as in a bottle; as, to bottle wine or porter; to bottle up one's wrath.\n\nA bundle, esp. of hay. [Obs. or Prov. Eng.] Chaucer. Shak.
bottle green |A dark shade of green, like that of bottle glass. -- Bot\"tle-green`, a.
bottle-neck frame |An inswept frame. [Colloq.]
bottle-nose |1. A cetacean of the Dolphin family, of several species, as Delphinus Tursio and Lagenorhyncus leucopleurus, of Europe. 2. The puffin.
bottle-nosed |Having the nose bottleshaped, or large at the end. Dickens.
bottled |1. Put into bottles; inclosed in bottles; pent up in, or as in, a bottle. 2. Having the shape of a bottle; protuberant. Shak.
bottlehead |A cetacean allied to the grampus; -- called also bottle-nosed whale. Note: There are several species so named, as the pilot whales, of the genus Globicephalus, and one or more species of Hyperoödon (H. bidens, etc.), found on the European coast. See Blackfish, 1.
bottleholder |1. One who attends a pugilist in a prize fight; -- so called from the bottle of water of which he has charge. 2. One who assists or supports another in a contest; an abettor; a backer. [Colloq.] Lord Palmerston considered himself the bottleholder of oppressed states. The London Times.
bottler |One who bottles wine, beer, soda water, etc.
bottlescrew |A corkscrew. Swift.
bottling |The act or the process of putting anything into bottles (as beer, mineral water, etc.) and corking the bottles.
bottom |1. The lowest part of anything; the foot; as, the bottom of a tree or well; the bottom of a hill, a lane, or a page. Or dive into the bottom of the deep. Shak. 2. The part of anything which is beneath the contents and supports them, as the part of a chair on which a person sits, the circular base or lower head of a cask or tub, or the plank floor of a ship's hold; the under surface. Barrels with the bottom knocked out. Macaulay. No two chairs were alike; such high backs and low backs and leather bottoms and worsted bottoms. W. Irving. 3. That upon which anything rests or is founded, in a literal or a figurative sense; foundation; groundwork. 4. The bed of a body of water, as of a river, lake, sea. 5. The fundament; the buttocks. 6. An abyss. [Obs.] Dryden. 7. Low land formed by alluvial deposits along a river; low-lying ground; a dale; a valley. \"The bottoms and the high grounds.\" Stoddard. 8. (Naut.)  The part of a ship which is ordinarily under water; hence, the vessel itself; a ship. My ventures are not in one bottom trusted. Shak. Not to sell the teas, but to return them to London in the same bottoms in which they were shipped. Bancroft. Full bottom, a hull of such shape as permits carrying a large amount of merchandise. 9. Power of endurance; as, a horse of a good bottom. 10. Dregs or grounds; lees; sediment. Johnson. At bottom, At the bottom, at the foundation or basis; in reality. \"He was at the bottom a good man.\" J. F. Cooper. -- To be at the bottom of, to be the cause or originator of; to be the source of. [Usually in an opprobrious sense.] J. H. Newman. He was at the bottom of many excellent counsels. Addison. -- To go to the bottom, to sink; esp. to be wrecked. -- To touch bottom, to reach the lowest point; to find something on which to rest.\n\nOf or pertaining to the bottom; fundamental; lowest; under; as, bottom rock; the bottom board of a wagon box; bottom prices. Bottom glade, a low glade or open place; a valley; a dale. Milton. -Bottom grass, grass growing on bottom lands. -- Bottom land. See 1st Bottom, n., 7.\n\n1. To found or build upon; to fix upon as a support; -- followed by on or upon. Action is supposed to be bottomed upon principle. Atterbury. Those false and deceiving grounds upon which many bottom their eternal state]. South. 2. To furnish with a bottom; as, to bottom a chair. 3. To reach or get to the bottom of. Smiles.\n\n1. To rest, as upon an ultimate support; to be based or grounded; -- usually with on or upon. Find on what foundation any proposition bottoms. Locke. 2. To reach or impinge against the bottom, so as to impede free action, as when the point of a cog strikes the bottom of a space between two other cogs, or a piston the end of a cylinder.\n\nA ball or skein of thread; a cocoon. [Obs.] Silkworms finish their bottoms in . . . fifteen days. Mortimer.\n\nTo wind round something, as in making a ball of thread. [Obs.] As you unwind her love from him, Lest it should ravel and be good to none, You must provide to bottom it on me. Shak.
bottom fermentation |A slow alcoholic fermentation during which the yeast cells collect at the bottom of the fermenting liquid. It takes place at a temperature of 4º - 10º C. (39º - 50ºF.). It is used in making lager beer and wines of low alcohol content but fine bouquet.
bottomed |Having at the bottom, or as a bottom; resting upon a bottom; grounded; -- mostly, in composition; as, sharp-bottomed; well- bottomed.
bottomless |Without a bottom; hence, fathomless; baseless; as, a bottomless abyss. \"Bottomless speculations.\" Burke.
bottomry |A contract in the nature of a mortgage, by which the owner of a ship, or the master as his agent, hypothecates and binds the ship (and sometimes the accruing freight) as security for the repayment of money advanced or lent for the use of the ship, if she terminates her voyage successfully. If the ship is lost by perils of the sea, the lender loses the money; but if the ship arrives safe, he is to receive the money lent, with the interest or premium stipulated, although it may, and usually does, exceed the legal rate of interest. See Hypothecation.
bottone |Having a bud or button, or a kind of trefoil, at the end; furnished with knobs or buttons. Cross bottony (Her.), a cross having each arm terminating in three rounded lobes, forming a sort of trefoil.
bottony |Having a bud or button, or a kind of trefoil, at the end; furnished with knobs or buttons. Cross bottony (Her.), a cross having each arm terminating in three rounded lobes, forming a sort of trefoil.
botts |See Bots.
botuliform |Having the shape of a sausage. Henslow.
bouch |1. A mouth. [Obs.] 2. An allowance of meat and drink for the tables of inferior officers or servants in a nobleman's palace or at court. [Obs.]
bouche |Same as Bush, a lining.\n\nSame as Bush, to line.\n\n1. A mouth. [Obs.] 2. An allowance of meat and drink for the tables of inferior officers or servants in a nobleman's palace or at court. [Obs.]
bouchees |Small patties.
boucherize |To impregnate with a preservative solution of copper sulphate, as timber, railroad ties, etc.
boud |A weevil; a worm that breeds in malt, biscuit, etc. [Obs.] Tusser., n. Etym: [F., fr. bouder to pout, be sulky.]  A small room, esp. if pleasant, or elegantly furnished, to which a lady may retire to be alone, or to receive intimate friends; a lady's (or sometimes a gentleman's) private room. Cowper.
boudoir |A small room, esp. if pleasant, or elegantly furnished, to which a lady may retire to be alone, or to receive intimate friends; a lady's (or sometimes a gentleman's) private room. Cowper.
bouffe |Comic opera. See Opera Bouffe.
bougainvillaea |A genus of plants of the order Nyctoginaceæ, from tropical South America, having the flowers surrounded by large bracts.
bouge |1. To swell out. [Obs.] 2. To bilge. [Obs.] \"Their ship bouged.\" Hakluyt.\n\nTo stave in; to bilge. [Obs.] Holland.\n\nBouche (see Bouche, 2); food and drink; provisions. [Obs.] [They] made room for a bombardman that brought bouge for a country lady or two, that fainted . . . with fasting. B. Jonson .
bouget |A charge representing a leather vessel for carrying water; -- also called water bouget.
bough |1. An arm or branch of a tree, esp. a large arm or main branch. 2. A gallows. [Archaic] Spenser.
bought |1. A flexure; a bend; a twist; a turn; a coil, as in a rope; as the boughts of a serpent. [Obs.] Spenser. The boughts of the fore legs. Sir T. Browne. 2. The part of a sling that contains the stone. [Obs.]\n\nimp. & p. p. of Buy.\n\nPurchased; bribed.
boughten |Purchased; not obtained or produced at home. Coleridge.
boughty |Bending. [Obs.] Sherwood.
bougie |1. (Surg.)  A long, flexible instrument, that is Note: introduced into the urethra, esophagus, etc., to remove obstructions, or for the other purposes. It was originally made of waxed linen rolled into cylindrical form. 2. (Pharm.)  A long slender rod consisting of gelatin or some other substance that melts at the temperature of the body. It is impregnated with medicine, and designed for introduction into urethra, etc.
bougie decimale |A photometric standard used in France, having the value of one twentieth of the Violle platinum standard, or slightly less than a British standard candle. Called also decimal candle.
bouilli |Boiled or stewed meat; beef boiled with vegetables in water from which its gravy is to be made; beef from which bouillon or soup has been made.
bouillon |1. A nutritious liquid food made by boiling beef, or other meat, in water; a clear soup or broth. 2. (Far.)  An excrescence on a horse's frush or frog.
bouk |1. The body. [Obs.] Chaucer. 2. Bulk; volume. [Scot.]
boul |A curved handle. Sir W. Scott.
boulangerite |A mineral of a bluish gray color and metallic luster, usually in plumose masses, also compact. It is sulphide of antimony and lead.
boulangism |The spirit or principles of a French political movement identified with Gen. Georges Boulanger (d. 1891), whose militarism and advocacy of revenge on Germany attracted to him a miscellaneous party of monarchists and Republican malcontents. -- Bou*lan\"gist (#), n.
boulder |Same as Bowlder.\n\n1. A large stone, worn smooth or rounded by the action of water; a large pebble. 2. (Geol.)  A mass of any rock, whether rounded or not, that has been transported by natural agencies from its native bed. See Drift. Bowlder clay, the unstratified clay deposit of the Glacial or Drift epoch, often containing large numbers of bowlders. -- Bowlder wall, a wall constructed of large stones or bowlders.
bouldery |Characterized by bowlders.
boule |Same as Buhl, Buhlwork.
boulevard |1. Originally, a bulwark or rampart of fortification or fortified town. 2. A public walk or street occupying the site of demolished fortifications. Hence: A broad avenue in or around a city.
boulevardier |A frequenter of a city boulevard, esp. in Paris.  F. Harrison.
bouleversement |Complete overthrow; disorder; a turning upside down.
boulework |Same as Buhl, Buhlwork.
boult |Corrupted form Bolt.\n\nCorrupted form Bolt.
boultel |(a) A molding, the convexity of which is one fourth of a circle, being a member just below the abacus in the Tuscan and Roman Doric capital; a torus; an ovolo. (b) One of the shafts of a clustered column. [Written also bowtel, boltel, boultell, etc.]
boulter |A long, stout fishing line to which many hooks are attached.
boultin |(a) A molding, the convexity of which is one fourth of a circle, being a member just below the abacus in the Tuscan and Roman Doric capital; a torus; an ovolo. (b) One of the shafts of a clustered column. [Written also bowtel, boltel, boultell, etc.]
boun |Ready; prepared; destined; tending. [Obs.] Chaucer.\n\nTo make or get ready. Sir W. Scott.
bounce |1. To strike or thump, so as to rebound, or to make a sudden noise; a knock loudly. Another bounces as hard as he can knock. Swift. Against his bosom bounced his heaving heart. Dryden. 2. To leap or spring suddenly or unceremoniously; to bound; as, she bounced into the room. Out bounced the mastiff. Swift. Bounced off his arm+chair. Thackeray. 3. To boast; to talk big; to bluster. [Obs.]\n\n1. To drive against anything suddenly and violently; to bump; to thump. Swift. 2. To cause to bound or rebound; sometimes, to toss. 3. To eject violently, as from a room; to discharge unceremoniously, as from employment. [Collog. U. S.] 4. To bully; to scold. [Collog.] J. Fletcher.\n\n1. A sudden leap or bound; a rebound. 2. A heavy, sudden, and often noisy, blow or thump. The bounce burst open the door. Dryden. 3. An explosion, or the noise of one. [Obs.] 4. Bluster; brag; untruthful boasting; audacious exaggeration; an impudent lie; a bouncer. Johnson. De Quincey. 5. (Zoöl.)  A dogfish of Europe (Scyllium catulus).\n\nWith a sudden leap; suddenly. This impudent puppy comes bounce in upon me. Bickerstaff.
bouncer |1. One who bounces; a large, heavy person who makes much noise in moving. 2. A boaster; a bully. [Collog.] Johnson. 3. A bold lie; also, a liar. [Collog.] Marryat. 4. Something big; a good stout example of the kind. The stone must be a bouncer. De Quincey.
bouncing |1. Stout; plump and healthy; lusty; buxom. Many tall and bouncing young ladies. Thackeray. 2. Excessive; big. \"A bouncing reckoning.\" B. & Fl. Bouncing Bet (Bot.), the common soapwort (Saponaria officinalis). Harper's Mag.
bouncingly |With a bounce.
bound |The external or limiting line, either real or imaginary, of any object or space; that which limits or restrains, or within which something is limited or restrained; limit; confine; extent; boundary. He hath compassed the waters with bounds. Job xxvi. 10. On earth's remotest bounds. Campbell. And mete the bounds of hate and love. Tennyson. To keep within bounds, not to exceed or pass beyond assigned limits; to act with propriety or discretion. Syn. -- See Boundary.\n\n1. To limit; to terminate; to fix the furthest point of extension of; -- said of natural or of moral objects; to lie along, or form, a boundary of; to inclose; to circumscribe; to restrain; to confine. Where full measure only bounds excess. Milton. Phlegethon . . . Whose fiery flood the burning empire bounds. Dryden. 2. To name the boundaries of; as, to bound France.\n\n1. To move with a sudden spring or leap, or with a succession of springs or leaps; as the beast bounded from his den; the herd bounded across the plain. Before his lord the ready spaniel bounds. Pope. And the waves bound beneath me as a steed That knows his rider. Byron. 2. To rebound, as an elastic ball.\n\n1. To make to bound or leap; as, to bound a horse. [R.] Shak. 2. To cause to rebound; to throw so that it will rebound; as, to bound a ball on the floor. [Collog.]\n\n1. A leap; an elastic spring; a jump. A bound of graceful hardihood. Wordsworth. 2. Rebound; as, the bound of a ball. Johnson. 3. (Dancing)  Spring from one foot to the other.\n\nimp. & p. p. of Bind.\n\n1. Restrained by a hand, rope, chain, fetters, or the like. 2. Inclosed in a binding or cover; as, a bound volume. 3. Under legal or moral restraint or obligation. 4. Constrained or compelled; destined; certain; -- followed by the infinitive; as, he is bound to succeed; he is bound to fail. 5. Resolved; as, I am bound to do it. [Collog. U. S.] 6. Constipated; costive. Note: Used also in composition; as, icebound, windbound, hidebound, etc. Bound bailiff (Eng. Law), a sheriff's officer who serves writs, makes arrests, etc. The sheriff being answerable for the bailiff's misdemeanors, the bailiff is usually under bond for the faithful discharge of his trust. -- Bound up in, entirely devoted to; inseparable from.\n\nReady or intending to go; on the way toward; going; -- with to or for, or with an adverb of motion; as, a ship is bound to Cadiz, or for Cadiz. \"The mariner bound homeward.\" Cowper.
boundary |That which indicates or fixes a limit or extent, or marks a bound, as of a territory; a bounding or separating line; a real or imaginary limit. But still his native country lies Beyond the boundaries of the skies. N. Cotton. That bright and tranquil stream, the boundary of Louth and Meath. Macaulay. Sensation and reflection are the boundaries of our thoughts. Locke. Syn. -- Limit; bound; border; term; termination; barrier; verge; confines; precinct. Bound, Boundary. Boundary, in its original and strictest sense, is a visible object or mark indicating a limit. Bound is the limit itself. But in ordinary usage the two words are made interchangeable.
bounden |1. Bound; fastened by bonds. [Obs.] 2. Under obligation; bound by some favor rendered; obliged; beholden. This holy word, that teacheth us truly our bounden duty toward our Lord God in every point. Ridley. 3. Made obligatory; imposed as a duty; binding. I am much bounden to your majesty. Shak.
bounder |One who, or that which, limits; a boundary. Sir T. Herbert.
bounding |Moving with a bound or bounds. The bounding pulse, the languid limb. Montgomery.
boundless |Without bounds or confines; illimitable; vast; unlimited. \"The boundless sky.\" Bryant. \"The boundless ocean.\" Dryden. \"Boundless rapacity.\" \"Boundless prospect of gain.\" Macaulay. Syn. -- Unlimited; unconfined; immeasurable; illimitable; infinite. -- Bound\"less*ly, adv. -- Bound\"less*ness, n.
bounteous |Liberal in charity; disposed to give freely; generously liberal; munificent; beneficent; free in bestowing gifts; as, bounteous production. But O, thou bounteous Giver of all good. Cowper. -- Boun\"te*ous*ly, adv. -- Boun\"te*ous*ness, n.
bountiful |1. Free in giving; liberal in bestowing gifts and favors. God, the bountiful Author of our being. Locke. 2. Plentiful; abundant; as, a bountiful supply of food. Syn. -- Liberal; munificent; generous; bounteous. -- Boun\"ti*ful*ly, adv. -- Boun\"ti*ful*ness, n.
bountihead |Goodness; generosity. [Obs.] Spenser.
bounty |1. Goodness, kindness; virtue; worth. [Obs.] Nature set in her at once beauty with bounty. Gower. 2. Liberality in bestowing gifts or favors; gracious or liberal giving; generosity; munificence. My bounty is as boundless as the sea. Shak. 3. That which is given generously or liberally. \"Thy morning bounties.\" Cowper. 4. A premium offered or given to induce men to enlist into the public service; or to encourage any branch of industry, as husbandry or manufactures. Bounty jumper, one who, during the latter part of the Civil War, enlisted in the United States service, and deserted as soon as possible after receiving the bounty. [Collog.] -- Queen Anne's bounty (Eng. Hist.), a provision made in Queen Anne's reign for augmenting poor clerical livings. Syn. -- Munificence; generosity; beneficence.
bountyhood |Goodness; generosity. [Obs.] Spenser.
bouquet |1. A nosegay; a bunch of flowers. 2. A perfume; an aroma; as, the bouquet of wine.
bouquetin |The ibex.
bour |A chamber or a cottage. [Obs.] Chaucer.
bourbon |1. A member of a family which has occupied several European thrones, and whose descendants still claim the throne of France. 2. A politician who is behind the age; a ruler or politician who neither forgets nor learns anything; an obstinate conservative.
bourbon whisky |See under Whisky.
bourbonism |The principles of those adhering to the house of Bourbon; obstinate conservatism.
bourbonist |One who adheres to the house of Bourbon; a legitimist.
bourd |A jest. [Obs.] Chaucer.\n\nTo jest. [Obs.] Chaucer.
bourder |A jester. [Obs.]
bourdon |A pilgrim's staff.\n\n(a) A drone bass, as in a bagpipe, or a hurdy-gurdy. See Burden (of a song.) (b) A kind of organ stop.
bourgeois |A size of type between long primer and brevier. See Type. Note: This line is printed in bourgeois type.\n\nA man of middle rank in society; one of the shopkeeping class. [France.] a.  Characteristic of the middle class, as in France.
bourgeoisie |The French middle class, particularly such as are concerned in, or dependent on, trade.
bourgeon |To sprout; to put forth buds; to shoot forth, as a branch. Gayly to bourgeon and broadly to grow. Sir W. Scott.
bouri |A mullet (Mugil capito) found in the rivers of Southern Europe and in Africa.
bourn |A stream or rivulet; a burn. My little boat can safely pass this perilous bourn. Spenser.\n\nA bound; a boundary; a limit. Hence: Point aimed at; goal. Where the land slopes to its watery bourn. Cowper. The undiscovered country, from whose bourn No traveler returns. Shak. Sole bourn, sole wish, sole object of my song. Wordsworth. To make the doctrine . . . their intellectual bourne. Tyndall.
bourne |A stream or rivulet; a burn. My little boat can safely pass this perilous bourn. Spenser.\n\nA bound; a boundary; a limit. Hence: Point aimed at; goal. Where the land slopes to its watery bourn. Cowper. The undiscovered country, from whose bourn No traveler returns. Shak. Sole bourn, sole wish, sole object of my song. Wordsworth. To make the doctrine . . . their intellectual bourne. Tyndall.
bournless |Without a bourn or limit.
bournonite |A mineral of a steel-gray to black color and metallic luster, occurring crystallized, often in twin crystals shaped like cogwheels (wheel ore), also massive. It is a sulphide of antimony, lead, and copper.
bournous |See Burnoose.
bourree |An old French dance tune in common time.
bourse |An exchange, or place where merchants, bankers, etc., meet for business at certain hours; esp., the Stock Exchange of Paris.
bouse |To drink immoderately; to carouse; to booze. See Booze.\n\nDrink, esp. alcoholic drink; also, a carouse; a booze. \"A good bouse of liquor.\" Carlyle.
bouser |A toper; a boozer.
boustrophedon |An ancient mode of writing, in alternate directions, one line from left to right, and the next from right to left (as fields are plowed), as in early Greek and Hittite.
boustrophedonic |Relating to the boustrophedon mode of writing.
boustrophic |Boustrophedonic.
bousy |Drunken; sotted; boozy. In his cups the bousy poet songs. Dryden.
bout |1. As much of an action as is performed at one time; a going and returning, as of workmen in reaping, mowing, etc.; a turn; a round. In notes with many a winding bout Of linked sweetness long drawn out. Milton. The prince . . . has taken me in his train, so that I am in no danger of starving for this bout. Goldsmith. 2. A conflict; contest; attempt; trial; a set-to at anything; as, a fencing bout; a drinking bout. The gentleman will, for his honor's sake, have one bout with you; he can not by the duello avoid it. Shak.
boutade |An outbreak; a caprice; a whim. [Obs.]
boutefeu |An incendiary; an inciter of quarrels. [Obs.] Animated by . . . John à Chamber, a very boutefeu, . . . they entered into open rebellion. Bacon.
boutonniere |A bouquet worn in a buttonhole.
bouts-rimes |Words that rhyme, proposed as the ends of verses, to be filled out by the ingenuity of the person to whom they are offered.
bovate |An oxgang, or as much land as an ox can plow in a year; an ancient measure of land, of indefinite quantity, but usually estimated at fifteen acres.
bovey coal |A kind of mineral coal, or brown lignite, burning with a weak flame, and generally a disagreeable odor; -- found at Bovey Tracey, Devonshire, England. It is of geological age of the oölite, and not of the true coal era.
bovid |Relating to that tribe of ruminant mammals of which the genus Bos is the type.
boviform |Resembling an ox in form; ox-shaped. [R.]
bovine |1. (Zoöl.)  of or pertaining to the genus Bos; relating to, or resembling, the ox or cow; oxlike; as, the bovine genus; a bovine antelope. 2. Having qualities characteristic of oxen or cows; sluggish and patient; dull; as, a bovine temperament. The bovine gaze of gaping rustics. W. Black.
bow |1. To cause to deviate from straightness; to bend; to inflect; to make crooked or curved. We bow things the contrary way, to make them come to their natural straightness. Milton. The whole nation bowed their necks to the worst kind of tyranny. Prescott. 2. To exercise powerful or controlling influence over; to bend, figuratively; to turn; to incline. Adversities do more bow men's minds to religion. Bacon. Not to bow and bias their opinions. Fuller. 3. To bend or incline, as the head or body, in token of respect, gratitude, assent, homage, or condescension. They came to meet him, and bowed themselves to the ground before him. 2 Kings ii. 15. 4. To cause to bend down; to prostrate; to depress,; Whose heavy hand hath bowed you to the grave. Shak. 5. To express by bowing; as, to bow one's thanks.\n\n1. To bend; to curve. [Obs.] 2. To stop. [Archaic] They stoop, they bow down together. Is. xlvi. 2 3. To bend the head, knee, or body, in token of reverence or submission; -- often with down. O come, let us worship and bow down: let us kneel before the Lord our maker. Ps. xcv. 6. 4. To incline the head in token of salutation, civility, or assent; to make bow. Admired, adored by all circling crowd, For wheresoe'er she turned her face, they bowed. Dryden.\n\nAn inclination of the head, or a bending of the body, in token of reverence, respect, civility, or submission; an obeisance; as, a bow of deep humility.\n\n1. Anything bent, or in the form of a curve, as the rainbow. I do set my bow in the cloud. Gen. ix. 13. 2. A weapon made of a strip of wood, or other elastic material, with a cord connecting the two ends, by means of which an arrow is propelled. 3. An ornamental knot, with projecting lops, formed by doubling a ribbon or string. 4. The U-shaped piece which embraces the neck of an ox and fastens it to the yoke. 5. (Mus.)  An appliance consisting of an elastic rod, with a number of horse hairs stretched from end to end of it, used in playing on a stringed instrument. 6. An acrograph. 7. (Mech. & Manuf.)  Any instrument consisting of an elastic rod, with ends connected by a string, employed for giving reciprocating motion to a drill, or for preparing and arranging the hair, fur, etc., used by hatters. 8. (Naut.)  A rude sort of quadrant formerly used for taking the sun's altitude at sea. 9. (Saddlery) sing. or pl.  Two pieces of wood which form the arched forward part of a saddletree. Bow bearer (O. Eng. Law), an under officer of the forest who looked after trespassers. -- Bow drill, a drill worked by a bow and string. -- Bow instrument (Mus.), any stringed instrument from which the tones are produced by the bow. -- Bow window (Arch.) See Bay window. -- To draw a long bow, to lie; to exaggerate. [Colloq.]\n\nTo play (music) with a bow. -- v. i.  To manage the bow.\n\n1. (Naut.)  The bending or rounded part of a ship forward; the stream or prow. 2. (Naut.)  One who rows in the forward part of a boat; the bow oar. Bow chaser (Naut.), a gun in the bow for firing while chasing another vessel. Totten. - Bow piece, a piece of ordnance carried at the bow of a ship. -- On the bow (Naut.), on that part of the horizon within 45º on either side of the line ahead. Totten.
bow hand |1. (Archery)  The hand that holds the bow, i. e., the left hand. Surely he shoots wide on the bow hand. Spenser. 2. (Mus.)  The hand that draws the bow, i. e., the right hand.
bow net |. 1. A trap for lobsters, being a wickerwork cylinder with a funnel- shaped entrance at one end. 2. A net for catching birds. J. H. Walsh.
bow oar |. 1. The oar used by the bowman. 2. One who rows at the bow of a boat.
bow-bells |The bells of Bow Church in London; cockneydom. People born within the sound of Bow-bells are usually called cockneys. Murray's Handbook of London.
bow-compass |1. An arcograph. 2. A small pair of compasses, one leg of which carries a pencil, or a pen, for drawing circles. Its legs are often connected by a bow- shaped spring, instead of by a joint. 3. A pair of compasses, with a bow or arched plate riveted to one of the legs, and passing through the other.
bow-legged |Having crooked legs, esp. with the knees bent outward. Johnson.
bow-pen |Bow-compasses carrying a drawing pen. See Bow-compass.
bow-pencil |Bow-compasses, one leg of which carries a pencil.
bow-saw |A saw with a thin or narrow blade set in a strong frame.
bowable |Capable of being bowed or bent; flexible; easily influenced; yielding. [Obs.]
bowbell |One born within hearing distance of Bow-bells; a cockney. Halliwell.
bowbent |Bent, like a bow. Milton.
