choregraphical |Pertaining to choregraphy.
choregraphy |The art of representing dancing by signs, as music is represented by notes. Craig.
choreic |Of the nature of, or pertaining to, chorea; convulsive.
chorepiscopal |Pertaining to a chorepiscopus or his change or authority.
chorepiscopus |A \"country\" or suffragan bishop, appointed in the ancient church by a diocesan bishop to exercise episcopal jurisdiction in a rural district.
choreus |(a) a trochee. (b) A tribrach.
choriamb |Same as Choriambus.
choriambic |Pertaining to a choriamb. -- n.  A choriamb.
choriambus |A foot consisting of four syllables, of which the first and last are long, and the other short (- ~ ~ -); that is, a choreus, or trochee, and an iambus united.
choric |Of or pertaining to a chorus. I remember a choric ode in the Hecuba. Coleridge.
chorion |1. (Anat.) (a) The outer membrane which invests the fetus in the womb; also, the similar membrane investing many ova at certain stages of development. (b) The true skin, or cutis. 2. (Bot.)  The outer membrane of seeds of plants.
chorisis |The separation of a leaf or floral organ into two more parts. Note: In collateral chorisis the parts are side by side. -- In parallel or median chorisis they are one in front of another.
chorist |A singer in a choir; a chorister. [R.]
chorister |1. One of a choir; a singer in a chorus. Dryden. 2. One who leads a choir in church music. [U. S.]
choristic |Choric; choral. [R.]
chorograph |An instrument for constructing triangles in marine surveying, etc.
chorographer |1. One who describes or makes a map of a district or region. \"The chorographers of Italy.\" Sir T. Browne. 2. A geographical antiquary; one who investigates the locality of ancient places.
chorographical |Pertaining to chorography. -- Cho`ro*graph\"ic*al*ly, adv.
chorography |the mapping or description of a region or district. The chorography of their provinces. Sir T. Browne.
choroid |resembling the chorion; as, the choroid plexuses of the ventricles of the brain, and the choroid coat of the eyeball. -- n.  The choroid coat of the eye. See Eye. Choroid plexus (Anat.), one of the delicate fringelike processes, consisting almost entirely of blood vessels, which project into the ventricles of the brain.
choroidal |Pertaining to the choroid coat.
chorology |The science which treats of the laws of distribution of living organisms over the earth's surface as to latitude, altitude, locality, etc. Its distribution or chorology. Huxley.
chorometry |The art of surveying a region or district.
chortle |A word coined by Lewis Carroll (Charles L. Dodgson), and usually explained as a combination of chuckle and snort. [Humorous] O frabjous day ! Callooh ! Callay ! He chortled in his joy. Lewis Carroll.
chorus |1. (Antiq.)  A band of singers and dancers. The Grecian tragedy was at first nothing but a chorus of singers. Dryden. 2. (Gr. Drama)  A company of persons supposed to behold what passed in the acts of a tragedy, and to sing the sentiments which the events suggested in couplets or verses between the acts; also, that which was thus sung by the chorus. What the lofty, grave tragedians taught In chorus or iambic. Milton. 3. An interpreter in a dumb show or play. [Obs.] 4. (Mus.)  A company of singers singing in concert. 5. (Mus.)  A composition of two or more parts, each of which is intended to be sung by a number of voices. 6. (Mus.)  Parts of a song or hymn recurring at intervals, as at the end of stanzas; also, a company of singers who join with the singer or choir in singer or choir in singing such parts. 7. The simultaneous of a company in any noisy demonstration; as, a Chorus of shouts and catcalls.\n\nTo sing in chorus; to exclaim simultaneously. W. D. Howells.
chose |A thing; personal property. Chose in action, a thing of which one has not possession or actual enjoyment, but only a right to it, or a right to demand it by action at law, and which does not exist at the time in specie; a personal right to a thing not reduced to possession, but recoverable by suit at law; as a right to recover money due on a contract, or damages for a tort, which can not be enforced against a reluctant party without suit. -- Chose in possession, a thing in possession, as distinguished from a thing in action. -- Chose local, a thing annexed to a place, as a mill. -- Chose transitory, a thing which is movable. Cowell. Blount.\n\nimp. & p. p. of Choose.
chosen |Selected from a number; picked out; choice. Seven hundred chosen men left-handed. Judg. xx. 16.\n\nOne who, or that which is the object of choice or special favor.
chou |1. A cabbage. 2.  A kind of light pastry, usually in the form of a small round cake, and with a filling, as of jelly or cream. 3.  A bunch, knot, or rosette of ribbon or other material, used as an ornament in women's dress.
chouan |One of the royalist insurgents in western France (Brittany, etc.), during and after the French revolution.
chough |A bird of the Crow family (Fregilus graculus) of Europe. It is of a black color, with a long, slender, curved bill and red legs; -- also called chauk, chauk-daw, chocard, Cornish chough, red-legged crow. The name is also applied to several allied birds, as the Alpine chough. Cornish chough (Her.), a bird represented black, with red feet, and beak; -- called also aylet and sea swallow.
chouicha |The salmon of the Columbia River or California. See Quinnat.
chouka |The Indian four-horned antelope; the chikara.
choule |See Jowl. Sir W. Scott.
choultry |See Choltry.
chouse |To cheat, trick, defraud; -- followed by of, or out of; as, to chouse one out of his money. [Colloq.] The undertaker of the afore-cited poesy hath choused your highness. Landor.\n\n1. One who is easily cheated; a tool; a simpleton; a gull. Hudibras. 2. A trick; sham; imposition. Johnson. 3. A swindler. B. Jonson.
chout |An assessment equal to a fourth part of the revenue. [India] J. Mill.
chow |A prefecture or district of the second rank in China, or the chief city of such a district; -- often part of the name of a city, as in Foochow.
chowchow |Consisting of several kinds mingled together; mixed; as, chowchow sweetmeats (preserved fruits put together). Chowchow chop, the last lighter containing the small sundry packages sent off to fill up a ship. S. W. Williams.\n\nA kind of mixed pickles.
chowder |1. (Cookery)  A dish made of fresh fish or clams, biscuit, onions, etc., stewed together. 2. A seller of fish. [Prov. Eng.] Halliwell. Chowder beer, a liquor made by boiling black spruce in water and mixing molasses with the decoction.\n\nTo make a chowder of.
chowry |A whisk to keep off files, used in the East Indies. Malcom.
chowter |To grumble or mutter like a froward child. [Obs.] E. Phillips.
choy root |See Chay root.
chrematistics |The science of wealth; the science, or a branch of the science, of political economy.
chreotechnics |The science of the useful arts, esp. agriculture, manufactures, and commerce. [R.]
chrestomathic |Teaching what is useful. \"A chrestomathic school.\" Southey.
chrestomathy |A selection of passages, with notes, etc., to be used in acquiring a language; as, a Hebrew chrestomathy.
chrism |1. Olive oil mixed with balm and spices, consecrated by the bishop on Maundy Thursday, and used in the administration of baptism, confirmation, ordination, etc. 2. The same as Chrisom.
chrismal |Of or pertaining to or used in chrism.
chrismation |The act of applying the chrism, or consecrated oil. Chrismation or cross-signing with ointment, was used in baptism. Jer. Taylor.
chrismatory |A cruet or vessel in which chrism is kept.
chrisom |1. A white cloth, anointed with chrism, or a white mantle thrown over a child when baptized or christened. [Obs.] 2. A child which died within a month after its baptism; -- so called from the chrisom cloth which was used as a shroud for it. [Obs.] Blount.
christ |The Anointed; an appellation given to Jesus, the Savior. It is synonymous with the Hebrew Messiah.
christcross |1. The mark of the cross, as cut, painted, written, or stamped on certain objects, -- sometimes as the sign of 12 o'clock on a dial. The fescue of the dial is upon the christcross of noon. Old Play. Nares. 2. The beginning and the ending. [Obs.] Quarles.
christcross-row |The alphabet; -- formerly so called, either from the cross usually set before it, or from a superstitious custom, sometimes practiced, of writing it in the form of a cross, by way of a charm. From infant conning of the Christcross-row. Wordsworth.
christen |1. To baptize and give a Christian name to. 2. To give a name; to denominate. \"Christen the thing what you will.\" Bp. Burnet. 3. To Christianize. [Obs.] Jer. Taylor. 4. To use for the first time. [Colloq.]
christendom |1. The profession of faith in Christ by baptism; hence, the Christian religion, or the adoption of it. [Obs.] Shak. 2. The name received at baptism; or, more generally, any name or appelation. [Obs.] Pretty, fond, adoptious christendoms. Shak. 3. That portion of the world in which Christianity prevails, or which is governed under Christian institutions, in distinction from heathen or Mohammedan lands. The Arian doctrine which then divided Christendom. Milton A wide and still widening Christendom. Coleridge. 4. The whole body of Christians. Hooker.
christian |1. One who believes, or professes or is assumed to believe, in Jesus Christ, and the truth as taught by Him; especially, one whose inward and outward life is conformed to the doctrines of Christ. The disciples were called Christians first in Antioch. Acts xi. 26. 2. One born in a Christian country or of Christian parents, and who has not definitely becomes an adherent of an opposing system. 3. (Eccl.) (a) One of a Christian denomination which rejects human creeds as bases of fellowship, and sectarian names. They are congregational in church government, and baptize by immersion. They are also called Disciples of Christ, and Campbellites. (b) One of a sect (called Christian Connection) of open-communion immersionists. The Bible is their only authoritative rule of faith and practice. Note: In this sense, often pronounced, but not by the members of the sects, kris\"chan.\n\n1. Pertaining to Christ or his religion; as, Christian people. 3. Pertaining to the church; ecclesiastical; as, a Christian court. Blackstone. 4. Characteristic of Christian people; civilized; kind; kindly; gentle; beneficent. The graceful tact; the Christian art. Tennyson. Christian Commission. See under Commission. -- Christian court. Same as Ecclesiastical court. -- Christian era, the present era, commencing with the birth of Christ. It is supposed that owing to an error of a monk (Dionysius Exiguus, d. about 556) employed to calculate the era, its commencement was fixed three or four years too late, so that 1890 should be 1893 or 1894. -- Christian name, the name given in baptism, as distinct from the family name, or surname.
christian era |The era in use in all Christian countries, which was intended to commence with the birth of Christ. The era as now established was first used by Dionysius Exiguus (died about 540), who placed the birth of Christ on the 25th of December in the year of Rome 754, which year he counted as 1 a. d. This date for Christ's birth is now generally thought to be about four years too late.
christian science |A system of healing disease of mind and body which teaches that all cause and effect is mental, and that sin, sickness, and death will be destroyed by a full understanding of the Divine Principle of Jesus' teaching and healing. The system was founded by Rev. Mary Baker Glover Eddy, of Concord, N. H., in 1866, and bases its teaching on the Scriptures as understood by its adherents.
christian scientist |A believer in Christian Science; one who practices its teachings.
christian seneca |Joseph Hall (1574 -- 1656), Bishop of Norwich, a divine eminent as a moralist.
christian socialism |Any theory or system that aims to combine the teachings of Christ with the teachings of socialism in their applications to life; Christianized socialism; esp., the principles of this nature advocated by F. D. Maurice, Charles Kingsley, and others in England about 1850. -- Christian socialist.
christianism |1. The Christian religion. [Obs.] Milton. 2. The Christian world; Christendom. [Obs.] Johnson
christianite |(a) Same as Anorthite. [R.] (b) See Phillipsite.
christianity |1. The religion of Christians; the system of doctrines and precepts taught by Christ. 2. Practical conformity of one's inward and outward life to the spirit of the Christian religion 3. The body of Christian believers. [Obs.] To Walys fled the christianitee Of olde Britons. Chaucer.
christianization |The act or process of converting or being converted to a true Christianity.
christianize |1. To make Christian; to convert to Christianity; as, to Christianize pagans. 2. To imbue with or adapt to Christian principles. Christianized philosophers. I. Taylor.\n\nTo adopt the character or belief of a Christian; to become Christian. The pagans began to Christianize. Latham.
christianlike |Becoming to a Christian. A virtuous and a Christianlike conclusion. Shak.
christianly |In a manner becoming the principles of the Christian religion. Sufferings . . . patiently and Christianly borne. Sharp.\n\nChristianlike. Longfellow.
christianness |Consonance with the doctrines of Christianity. [Obs.] Hammond.
christless |Without faith in Christ; unchristian. Tennyson.
christlike |Resembling Christ in character, actions, etc. -- Christ\"like`ness, n.
christly |Christlike. H. Bushnell.
christmas |An annual church festival (December 25) and in some States a legal holiday, in memory of the birth of Christ, often celebrated by a particular church service, and also by special gifts, greetings, and hospitality. Christmas box. (a) A box in which presents are deposited at Christmas. (b) A present or small gratuity given to young people and servants at Christmas; a Christmas gift. -- Christmas carol, a carol sung at, or suitable for, Christmas. -- Christmas day. Same as Christmas. -- Christmas eve, the evening before Christmas. -- Christmas fern (Bot.), an evergreen North American fern (Aspidium acrostichoides), which is much used for decoration in winter. -- Christmas flower, Christmas rose, the black hellebore, a poisonous plant of the buttercup family, which in Southern Europe often produces beautiful roselike flowers midwinter. -- Christmas tree, a small evergreen tree, set up indoors, to be decorated with bonbons, presents, etc., and illuminated on Christmas eve.
christmastide |The season of Christmas.
christocentric |Making Christ the center, about whom all things are grouped, as in religion or history; tending toward Christ, as the central object of thought or emotion. J. W. Chadwick.
christology |A treatise on Christ; that department of theology which treats of the personality, attributes, or life of Christ.
christom |See Chrisom. [Obs.] Shak.
christophany |An appearance of Christ, as to his disciples after the crucifixion. CHRIST'S-THORN Christ's-thorn`, n. (Bot.)  One of several prickly or thorny shrubs found in Palestine, especially the Paliurus aculeatus, Zizyphus Spina-Christi, and Z. vulgaris. The last bears the fruit called jujube, and may be considered to have been the most readily obtainable for the Crown of Thorns.
chromascope |An instrument for showing the optical effects of color.
chromate |A salt of chromic acid.
chromatic |1. Relating to color, or to colors. 2. (Mus.)  Proceeding by the smaller intervals (half steps or semitones) of the scale, instead of the regular intervals of the diatonic scale. Note: The intermediate tones were formerly written and printed in colors. Chromatic aberration. (Opt.) See Aberration, 4. -- Chromatic printing, printing from type or blocks covered with inks of various colors. -- Chromatic scale (Mus.), the scale consisting of thirteen tones, including the eight scale tones and the five intermediate tones.
chromatical |Chromatic. [Obs.]
chromatically |In a chromatic manner.
chromatics |The science of colors; that part of optics which treats of the properties of colors.
chromatin |Tissue which is capable of being stained by dyes.
chromatism |1. (Optics)  The state of being colored, as in the case of images formed by a lens. 2. (Bot.)  An abnormal coloring of plants.
chromatogenous |Producing color.
chromatography |A treatise on colors
chromatology |A treatise on colors.
chromatophore |1. (Zoöl.)  A contractile cell or vesicle containing liquid pigment and capable of changing its form or size, thus causing changes of color in the translucent skin of such animals as possess them. They are highly developed and numerous in the cephalopods. 2. (Bot.)  One of the granules of protoplasm, which in mass give color to the part of the plant containing them.
chromatoscope |A reflecting telescope, part of which is made to rotate eccentrically, so as to produce a ringlike image of a star, instead of a point; -- used in studying the scintillation of the stars.
chromatosphere |A chromosphere. [R.]
chromatrope |1. (Physics)  An instrument for exhibiting certain chromatic effects of light (depending upon the persistence of vision and mixture of colors) by means of rapidly rotating disks variously colored. 2. A device in a magic lantern or stereopticon to produce kaleidoscopic effects.
chromatype |1. (Photog.)  A colored photographic picture taken upon paper made sensitive with potassium bichromate or some other salt of chromium. 2. The process by which such picture is made.
chrome |Same as Chromium. Chrome alum (Chem.), a dark violet substance, (SO4)3Cr2.K2SO4.24H2O, analogous to, and crystallizing like, common alum. It is regarded as a double sulphate of chromium and potassium. -- Chrome green (a) The green oxide of chromium, Cr2O3, used in enamel painting, and glass staining. (b) A pigment made by mixing chrome yellow with Prussian blue. -- Chrome red, a beautiful red pigment originally prepared from the basic chromate of lead, but now made from red oxide of lead. -- Chrome yellow, a brilliant yellow pigment, PbCrO4, used by painters.
chrome steel |Same as Chromium steel, under Steel.
chromic |Pertaining to, or obtained from, chromium; -- said of the compounds of chromium in which it has its higher valence. Chromic acid, an acid, H2CrO4, analogous to sulphuric acid, not readily obtained in the free state, but forming well known salts, many of which are colored pigments, as chrome yellow, chrome red, etc. -- Chromic anhydride, a brilliant red crystalline substance, CrO3, regarded as the anhydride of chromic acid. It is one of the most powerful oxidizers known.
chromid |One of the Chromidæ, a family of fresh-water fishes abundant in the tropical parts of America and Africa. Some are valuable food fishes, as the bulti of the Nile.
chromidrosis |Secretion of abnormally colored perspiration.
chromism |Same as Chromatism.
chromite |1. (Min.)  A black submetallic mineral consisting of oxide of chromium and iron; -- called also chromic iron. 2. (Chem.)  A compound or salt of chromous hydroxide regarded as an acid. [R.]
chromium |A comparatively rare element occurring most abundantly in the mineral chromite. Atomic weight 52.5. Symbol Cr. When isolated it is a hard, brittle, grayish white metal, fusible with difficulty. Its chief commercial importance is for its compounds, as potassium chromate, lead chromate, etc., which are brilliantly colored and are used dyeing and calico printing. Called also chrome.
chromo |A chromolithograph.
chromoblast |An embryonic cell which develops into a pigment cell.
chromogen |1. (Biol.)  Vegetable coloring matter other than green; chromule. 2. (Chem.)  Any colored compound, supposed to contain one or more chromophores.
chromogenic |Containing, or capable of forming, chromogen; as, chromogenic bacteria.
chromograph |An apparatus by which a number of copies of written matter, maps, plans, etc., can be made; -- called also hectograph.
chromoleucite |A chromoplastid.
chromolithograph |A picture printed in tints and colors by repeated impressions from a series of stones prepared by the lithographic process.
chromolithographer |One who is engaged in chromolithography.
chromolithographic |Pertaining to, or made by, chromolithography.
chromolithography |Lithography adapted to printing in inks of various colors.
chromophane |A general name for the several coloring matters, red, green, yellow, etc., present in the inner segments in the cones of the retina, held in solution by fats, and slowly decolorized by light; distinct from the photochemical pigments of the rods of the retina.
chromophore |Any chemical group or residue (as NO
chromophotograph |A picture made by any of the processes for reproducing photographs in colors. --Chro`mo*pho`to*graph\"ic (#), a.
chromophotography |The art of producing photographs in colors.
chromophotolithograph |A photolithograph printed in colors.
chromoplastid |A protoplasmic granule of some other color than green; -- also called chromoleucite.
chromosome |One of the minute bodies into which the chromatin of the nucleus is resolved during mitotic cell division; the idant of Weismann.
chromosphere |An atmosphere of rare matter, composed principally of incandescent hydrogen gas, surrounding the sun and enveloping the photosphere. Portions of the chromosphere are here and there thrown up into enormous tongues of flame.
chromospheric |Of or pertaining to the chromosphere.
chromotype |1. A sheet printed in colors by any process, as a chromolithograph. See Chromolithograph. 2. A photographic picture in the natural colors.
chromous |Of, pertaining to, or derived from, chromium, when this element has a valence lower than that in chromic compounds. Chromous acid, a bluish gray powder, CrO.OH, of weak acid properties and regard as an acid.
chromule |A general name for coloring matter of plants other than chlorophyll, especially that of petals.
chronic |1. Relating to time; according to time. 2. Continuing for a long time; lingering; habitual. Chronic disease, one which is inveterate, of long continuance, or progresses slowly, in distinction from an acute disease, which speedly terminates.
chronical |Chronic. Partly on a chronical, and partly on a topical method. J. A. Alexander.
chronicle |1. An historical register or account of facts or events disposed in the order of time. 2. A narrative of events; a history; a record. 3. pl.  The two canonical books of the Old Testament in which immediately follow 2 Kings. Syn. - Register; record; annals. See History.\n\nTo record in a history or chronicle; to record; to register. Shak.
chronicler |A writer of a chronicle; a recorder of events in the order of time; an historian. Such an honest chronicler as Griffith. Shak.
chronique |A chronicle. L. Addison.
chronogram |1. An inscription in which certain numeral letters, made to appear specially conspicuous, on being added together, express a particular date or epoch, as in the motto of a medal struck by Gustavus Adolphus in 1632: ChrIstVs DVX; ergo trIVMphVs. - the capitals of which give, when added as numerals, the sum 1632. 2. The record or inscription made by a chronograph.
chronogrammatic |Belonging to a chronogram, or containing one.
chronogrammatical |Belonging to a chronogram, or containing one.
chronogrammatist |A writer of chronograms.
chronograph |1. An instrument for measuring or recording intervals of time, upon a revolving drum or strip of paper moved by clockwork. The action of the stylus or pen is controlled by electricity. 2. Same as Chronogram, 1. [R.] 3. A chronoscope.
chronographer |One who writes a chronography; a chronologer. Tooke.
chronographic |Of or pertaining to a chronograph.
chronography |A description or record of past time; history. [Obs.] Bp. Hall.
chronologer |Same as Chronologist.\n\nA person who investigates dates of events and transactions; one skilled in chronology. That learned noise and dust of the chronologist is wholly to be avoided. Locke. THe most exact chronologers tell us that Christ was born in October, and not in December. John Knox.
chronologic |Relating to chronology; containing an account of events in the order of time; according to the order of time; as, chronological tables. Raleigh. -- Chron`o*log\"ic*al*ly, adv.
chronological |Relating to chronology; containing an account of events in the order of time; according to the order of time; as, chronological tables. Raleigh. -- Chron`o*log\"ic*al*ly, adv.
chronologist |A person who investigates dates of events and transactions; one skilled in chronology. That learned noise and dust of the chronologist is wholly to be avoided. Locke. THe most exact chronologers tell us that Christ was born in October, and not in December. John Knox.
chronology |The science which treats of measuring time by regular divisions or periods, and which assigns to events or transactions their proper dates. If history without chronology is dark and confused, chronology without history is dry and insipid. A. Holmes.
chronometer |1. An instrument for measuring time; a timekeeper. 2. A portable timekeeper, with a heavy compensation balance, and usually beating half seconds; -- intended to keep time with great accuracy for use an astronomical observations, in determining longitude, etc. 3. (Mus.)  A metronome. Box chronometer. See under Box. -- Pocket chronometer, a chronometer in the form of a large watch. -- To rate a chronometer. See Rate, v. t.
chronometric |Pertaining to a chronometer; measured by a chronometer.
chronometrical |Pertaining to a chronometer; measured by a chronometer.
chronometry |The art of measuring time; the measuring of time by periods or divisions.
chronopher |An instrument signaling the correct time to distant points by electricity.
chronophotograph |One of a set of photographs of a moving object, taken for the purpose of recording and exhibiting successive phases of the motion. --Chron`o*pho*tog\"ra*phy, n.
chronoscope |An instrument for measuring minute intervals of time; used in determining the velocity of projectiles, the duration of short-lived luminous phenomena, etc.
chrysalid |Pertaining to a chrysalis; resembling a chrysalis.\n\nSee Chrysalis.
chrysalis |The pupa state of certain insects, esp. of butterflies, from which the perfect insect emerges. See Pupa, and Aurelia (a).
chrysaniline |A yellow substance obtained as a by-product in the manufacture of rosaniline. It dyes silk a fine golden-yellow color.
chrysanthemum |A genus of composite plants, mostly perennial, and of many species including the many varieties of garden chrysanthemums (annual and perennial), and also the feverfew and the oxeye daisy.
chrysarobin |A bitter, yellow substance forming the essential constituent of Goa powder, and yielding chrysophanic acid proper; hence formerly called also chrysphanic acid.
chrysaurin |An orange-colored dyestuff, of artificial production.
chryselephantine |Composed of, or adorned with, gold and ivory. Note: The chryselephantine statues of the Greeks were built up with inferior materials, veneered, as it were, with ivory for the flesh, and gold decorated with color for the hair and garments.
chrysene |One of the higher aromatic hydrocarbons of coal tar, allied to napthalene and anthracene. It is a white crystalline substance, C18H12, of strong blue fluorescence, but generally colored yellow by impurities.
chrysoberyl |A mineral, found in crystals, of a yellow to green or brown color, and consisting of aluminia and glucina. It is very hard, and is often used as a gem.
chrysochlore |A South African mole of the genus Chrysochloris; the golden mole, the fur of which reflects brilliant metallic hues of green and gold.
chrysocolla |A hydrous silicate of copper, occurring massive, of a blue or greenish blue color.
chrysogen |A yellow crystalline substance extracted from crude anthracene.
chrysography |1. The art of writing in letters of gold. 2. A writing executed in letters of gold.
chrysoidine |An artificial, yellow, crystalline dye, C6H5N2.C6H3(NH2)2. Also, one of a group of dyestuffs resembling chrysoïdine proper.
chrysolite |A mineral, composed of silica, magnesia, and iron, of a yellow to green color. It is common in certain volcanic rocks; -- called also olivine and peridot. Sometimes used as a gem. The name was also early used for yellow varieties of tourmaline and topaz.
chrysology |That branch of political economy which relates to the production of wealth.
chrysopa |A genus of neuropterous insects. See Lacewing.
chrysophane |A glucoside extracted from rhubarb as a bitter, yellow, crystalline powder, and yielding chrysophanic acid on decomposition.
chrysophanic |Pertaining to, or derived from, or resembling, chrysophane. Chrysophanic acid (Chem.), a yellow crystalline substance extracted from rhubarb, yellow dock, sienna, chrysarobin, etc., and shown to be a derivative of an anthracene. It is used in the treatment of skin diseases; -- called also rhein, rheic acid, rhubarbarin, etc.
chrysoprase |An apple-green variety of chalcedony, colored by nickel. It has a dull flinty luster, and is sometimes used in jewelry.
chrysoprasus |See Chrysoprase. Rev. xxi. 20.
chrysosperm |The seed of gold; a means of creating gold. [Obs.] B. Jonson.
chrysotype |1. A photographic picture taken upon paper prepared by the use of a sensitive salt of iron and developed by the application of chloride of gold. Abney. 2. 2process, invented by Sir J.Herschel.
chthonian |Designating, or pertaining to, gods or spirits of the underworld; esp., relating to the underworld gods of the Greeks, whose worship is widely considered as more primitive in form than that of the Olympian gods. The characteristics of chthonian worship are propitiatory and magical rites and generalized or euphemistic names of the deities, which are supposed to have been primarily ghosts.
chthonic |Pertaining to the earth; earthy; as, chthonic religions. [The] chthonic character of the wife of Zeus. Max Müller.
chthonophagia |A disease characterized by an irresistible desire to eat earth, observed in some parts of the southern United States, the West Indies, etc.
chthonophagy |A disease characterized by an irresistible desire to eat earth, observed in some parts of the southern United States, the West Indies, etc.
chub |A species to fresh-water fish of the Cyprinidæ or Carp family. The common European species is Leuciscus cephalus; the cheven. In America the name is applied to various fishes of the same family, of the genera Semotilus, Squalius, Ceratichthys, etc., and locally to several very different fishes, as the tautog, black bass, etc. Chub mackerel (Zoöl.), a species of mackerel (Scomber colias) in some years found in abundance on the Atlantic coast, but absent in others; -- called also bull mackerel, thimble-eye, and big-eye mackerel. -- Chub sucker (Zoöl.), a fresh-water fish of the United States (Erimyzon sucetta); -- called also creekfish.
chub-faced |Having a plump, short face.
chubbed |Chubby. [R.] H. Brooke.
chubbedness |The state of being chubby.
chubby |Like a chub; plump, short, and thick. \"Chubby faces.\" I. Taylor.
chuck |1. To make a noise resembling that of a hen when she calls her chickens; to cluck. 2. To chuckle; to laugh. [R.] Marston.\n\nTo call, as a hen her chickens. Dryden.\n\n1. The chuck or call of a hen. 2. A sudden, small noise. 3. A word of endearment; -- corrupted from chick. \"Pray, chuck, come hither.\" Shak.\n\n1. To strike gently; to give a gentle blow to. Chucked the barmaid under the chin. W. Irving. 2. To toss or throw smartly out of the hand; to pitch. [Colloq.] \"Mahomet Ali will just be chucked into the Nile.\" Lord Palmerson. 3. (Mech.)  To place in a chuck, or hold by means of a chuck, as in turning; to bore or turn (a hole) in a revolving piece held in a chuck.\n\n1. A slight blow or pat under the chin. 2. A short throw; a toss. 3. (Mach.)  A contrivance or machine fixed to the mandrel of a lathe, for holding a tool or the material to be operated upon. Chuck farthing, a play in which a farthing is pitched into a hole; pitch farthing. -- Chuck hole, a deep hole in a wagon rut. -- Elliptic chuck, a chuck having a silder and an eccentric circle, which, as the work turns round, give it a sliding motion across the center which generates an ellipse. Knight.\n\n1. A small pebble; -- called also chuckstone and chuckiestone. [Scot.] 2. pl.  A game played with chucks, in which one or more are tossed up and caught; jackstones. [Scot.]\n\nA piece of the backbone of an animal, from between the neck and the collar bone, with the adjoining parts, cut for cooking; as, a chuck steak; a chuck roast. [Colloq.]
chuckle |1. To call, as a hen her chickens; to cluck. [Obs.] Dryden. 2. To fondle; to cocker. [Obs.] Dryden.\n\nA short, suppressed laugh; the expression of satisfaction, exultation, or derision.\n\nTo laugh in a suppressed or broken manner, as expressing inward satisfaction, exultation, or derision.
chucklehead |A person with a large head; a numskull; a dunce. [Low] Knowles.
chuckleheaded |Having a large head; thickheaded; dull; stupid. Smart. CHUCK-WILL'S-WIDOW Chuck`-Will's-wid\"ow, n. (Zool.)  A species of goatsucker (Antrostomus Carolinensis), of the southern United States; -- so called from its note.
chud |To champ; to bite. [Obs.] A. Stafford.
chuet |Minced meat. [Obs.] Bacon.
chufa |A sedgelike plant (Cyperus esculentus) producing edible tubers, native about the Mediterranean, now cultivated in many regions; the earth almond.
chuff |A coarse or stupid fellow. Shak.\n\nStupid; churlish. [Prov. Eng.] Wright.
chuffily |Clownishly; surlily.
chuffiness |The quality of being chuffy.
chuffy |1. Fat or puffed out in the cheeks. 2. Rough; clownish; surly.
chulan |The fragrant flowers of the Chloranthus inconspicuus, used in China for perfuming tea.
chum |A roommate, especially in a college or university; an old and intimate friend.\n\nTo occupy a chamber with another; as, to chum together at college. [U. S.]\n\nChopped pieces of fish used as bait. [U. S.]
chump |A short, thick, heavy piece of wood. Morton. Chump end, the thick end; as, the chump end of a joint of meat. Dickens.
chunam |Quicklime; also, plaster or mortar. [India] Whitworth.
chunk |A short, thick piece of anything. [Colloq. U. S. & Prov. Eng.]
chunky |Short and thick. [U. S.] Kane.
chupatty |A kind of griddlecake of unleavened bread, used among the natives of India. [Anglo-Indian]
chuprassie |A messenger or servant wearing an official badge. [Anglo- Indian]
chuprassy |A messenger or servant wearing an official badge. [Anglo- Indian]
church |1. A building set apart for Christian worship. 2. A Jewish or heathen temple. [Obs.] Acts xix. 37. 3. A formally organized body of Christian believers worshiping together. \"When they had ordained them elders in every church.\" Acts xiv. 23. 4. A body of Christian believers, holding the same creed, observing the same rites, and acknowledging the same ecclesiastical authority; a denomination; as, the Roman Catholic church; the Presbyterian church. 5. The collective body of Christians. 6. Any body of worshipers; as, the Jewish church; the church of Brahm. 7. The aggregate of religious influences in a community; ecclesiastical influence, authority, etc.; as, to array the power of the church against some moral evil. Remember that both church and state are properly the rulers of the people, only because they are their benefactors. Bulwer. Note: Church is often used in composition to denote something belonging or relating to the church; as, church authority; church history; church member; church music, etc. Apostolic church. See under Apostolic. -- Broad church. See Broad Church. -- Catholic or Universal church, the whole body of believers in Christ throughout the world. -- Church of England, or English church, the Episcopal church established and endowed in England by law. -- Church living, a benefice in an established church. -- Church militant. See under Militant. -- Church owl (Zoöl.), the white owl. See Barn owl. -- Church rate, a tax levied on parishioners for the maintenance of the church and its services. -- Church session. See under Session. -- Church triumphant. See under Triumphant. -- Church work, work on, or in behalf of, a church; the work of a particular church for the spread of religion. -- Established church, the church maintained by the civil authority; a state church.\n\nTo bless according to a prescribed form, or to unite with in publicly returning thanks in church, as after deliverance from the dangers of childbirth; as, the churching of women.
church modes |The modes or scales used in ancient church music. See Gregorian.
church-ale |A church or parish festival (as in commemoration of the dedication of a church), at which much ale was used. Wright. Nares.
church-bench |A seat in the porch of a church. Shak.
church-haw |Churchyard. [Obs.] Chaucer.
churchdom |The institution, government, or authority of a church. [R.] Bp. Pearson.
churchgoer |One who attends church.
churchgoing |1. Habitually attending church. 2. Summoning to church. The sound of the churchgoing bell. Cowper.
churchism |Strict adherence to the forms or principles of some church organization; sectarianism.
churchless |Without a church. T. Fuller.
churchlike |Befitting a church or a churchman; becoming to a clergyman. Shak.
churchliness |Regard for the church.
churchly |Pertaining to, or suitable for, the church; ecclesiastical.
churchman |1. An ecclesiastic or clergyman. 2. An Episcopalian, or a member of the Established Church of England. \"A zealous churchman.\" Macaulay. 3. One was is attached to, or attends, church.
churchmanly |Pertaining to, or becoming, a churchman. Milman.
churchmanship |The state or quality of being a churchman; attachment to the church.
churchship |State of being a church. South.
churchwarden |1. One of the officers (usually two) in an Episcopal church, whose duties vary in different dioceses, but always include the provision of what is necessary for the communion service. 2. A clay tobacco pipe, with a long tube. [Slang, Eng.] There was a small wooden table placed in front of the smoldering fire, with decanters, a jar of tobacco, and two long churchwardens. W. Black.
churchwardenship |The office of a churchwarden.
churchy |Relating to a church; unduly fond of church forms. [Colloq.]
churchyard |The ground adjoining a church, in which the dead are buried; a cemetery. Like graves in the holy churchyard. Shak. Syn. -- Burial place; burying ground; graveyard; necropolis; cemetery; God's acre.
churl |1. A rustic; a countryman or laborer. \"A peasant or churl.\" Spenser. Your rank is all reversed; let men of cloth Bow to the stalwart churls in overalls. Emerson. 2. A rough, surly, ill-bred man; a boor. A churl's courtesy rarely comes, but either for gain or falsehood. Sir P. Sidney. 3. A selfish miser; an illiberal person; a niggard. Like to some rich churl hoarding up his pelf. Drayton.\n\nChurlish; rough; selfish. [Obs.] Ford.
churlish |1. Like a churl; rude; cross-grained; ungracious; surly; illiberal; niggardly. \"Churlish benefits.\" Ld. Burleigh. Half mankind maintain a churlish strife. Cowper. 2. Wanting pliancy; unmanageable; unyielding; not easily wrought; as, a churlish soil; the churlish and intractable nature of some minerals. Boyle.
churlishly |In a churlish manner.
churlishness |Rudeness of manners or temper; lack of kindness or courtesy.
churly |Rude; churlish; violent. Longfellow.
churme |Clamor, or confused noise; buzzing. [Obs.] The churme of a thousand taunts and reproaches. Bacon.
churn |A vessel in which milk or cream is stirred, beaten, or otherwise agitated (as by a plunging or revolving dasher) in order to separete the oily globules from the other parts, and obtain butter.\n\n1. To stir, beat, or agitate, as milk or cream in a churn, in order to make butter. 2. To shake or agitate with violence. Churned in his teeth, the foamy venom rose. Addison.\n\nTo perform the operation of churning.
churning |1. The act of one who churns. 2. The quantity of butter made at one operation.
churr |A vibrant or whirring noise such as that made by some insects, as the cockchafer, or by some birds, as the nightjar, the partridge, etc.\n\nTo make a churr, as a cockchafer. That's the churring of the nightjar. Hall Caine.\n\nTo utter by churring.
churrus |A powerfully narcotic and intoxicating gum resin which exudes from the flower heads, seeds, etc., of Indian hemp.
churrworm |An insect that turns about nimbly; the mole cricket; -- called also fan cricket. Johnson.
chuse |See Choose. [Obs.]
chute |1. A framework, trough, or tube, upon or through which objects are made to slide from a higher to a lower level, or through which water passes to a wheel. 2. See Shoot.
chutnee |A warm or spicy condiment or pickle made in India, compounded of various vegetable substances, sweets, acids, etc.
chutney |A warm or spicy condiment or pickle made in India, compounded of various vegetable substances, sweets, acids, etc.
chylaceous |Possessed of the properties of chyle; consisting of chyle.
chylaqueous |Consisting of chyle much diluted with water; -- said of a liquid which forms the circulating fluid of some inferior animals.
chyle |A milky fluid containing the fatty matter of the food in a state of emulsion, or fine mechanical division; formed from chyme by the action of the intestinal juices. It is absorbed by the lacteals, and conveyed into the blood by the thoracic duct.
chylifaction |The act or process by which chyle is formed from food in animal bodies; chylification, -- a digestive process.
chylifactive |Producing, or converting into, chyle; having the power to form chyle.
chyliferous |[Chyle + -ferous: cf. F. chylifère.] (Physiol.) Transmitting or conveying chyle; as, chyliferous vessels.
chylific |Chylifactive.
chylification |The formation of chyle. See Chylifaction.
chylificatory |Chylifactive.
chylify |To make chyle of; to be converted into chyle.
chylopoetic |Concerned in the formation of chyle; as, the chylopoetic organs.
chylous |Consisting of, or similar to, chyle.
chyluria |A morbid condition in which the urine contains chyle or fatty matter, giving it a milky appearance.
chyme |The pulpy mass of semi-digested food in the small intestines just after its passage from the stomach. It is separated in the intestines into chyle and excrement. See Chyle.
chymic |See Chemic, Chemist, Chemistry.
chymiferous |Bearing or containing chyme.
chymification |The conversion of food into chyme by the digestive action of gastric juice.
chymify |To form into chyme.
chymist |See Chemic, Chemist, Chemistry.
chymistry |See Chemic, Chemist, Chemistry.
chymous |Of or pertaining to chyme.
chyometer |An instrument for measuring liquids. It consists of a piston moving in a tube in which is contained the liquid, the quantity expelled being indicated by the graduation upon the piston rod.
ci-devant |Former; previous; of times gone by; as, a cidevant governor.
cibarious |Pertaining to food; edible. Johnson.
cibation |1. The act of taking food. 2. (Alchemy)  The process or operation of feeding the contents of the crucilbe with fresh material. B. Jonson.
cibol |A perennial alliaceous plant (Allium fistulosum), sometimes called Welsh onion. Its fistular leaves areused in cookery.
ciborium |1. (Arch.)  A canopy usually standing free and supported on four columns, covering the high altar, or, very rarely, a secondary altar. 2. (R. C. Ch.)  The coffer or case in which the host is kept; the pyx.
cicada |Any species of the genus Cicada. They are large hemipterous insects, with nearly transparent wings. The male makes a shrill sound by pecular organs in the under side of the abdomen, consisting of a pair of stretched membranes, acted upon by powerful muscles. A noted American species (C. septendecim) is called the seventeen year locust. Another common species is the dogday cicada.
cicala |A cicada. See Cicada. \"At eve a dry cicala sung.\" Tennison.
cicatrice |A cicatrix.
cicatricial |Relating to, or having the character of, a cicatrix. Dunglison.
cicatricle |The germinating point in the embryo of a seed; the point in the yolk of an egg at which development begins.
cicatrisive |Tending to promote the formation of a cicatrix; good for healing of a wound.
cicatrix |The pellicle which forms over a wound or breach of continuity and completes the process of healing in the latter, and which subsequently contracts and becomes white, forming the scar.
cicatrizant |A medicine or application that promotes the healing of a sore or wound, or the formation of a cicatrix.
cicatrization |The process of forming a cicatrix, or the state of being cicatrized.
cicatrize |To heal or induce the formation of a cicatrix in, as in wounded or ulcerated flesh. Wiseman.\n\nTo heal; to have a new skin.
cicatrose |Full of scars. Craig.
cicely |Any one of several umbelliferous plants, of the genera Myrrhis, Osmorrhiza, etc.
cicero |Pica type; -- so called by French printers.
cicerone |One who shows strangers the curiosities of a place; a guide. Every glib and loquacious hireling who shows strangers about their picture galleries, palaces, and ruins, is termed by them [the Italians] a cicerone, or a Cicero. Trench.
ciceronian |Resembling Cicero in style or action; eloquent.
ciceronianism |Imitation of, or resemblance to, the style or action Cicero; a Ciceronian phrase or expression. \"Great study in Ciceronianism, the chief abuse of Oxford.\" Sir P. Sidney.
cich-pea |The chick-pea. Holland.
cichoraceous |Belonging to, or resembling, a suborder of composite plants of which the chicory (Cichorium) is the type.
cicisbeism |The state or conduct of a cicisbeo.
cicisbeo |1. A professed admirer of a married woman; a dangler about women. 2. A knot of silk or ribbon attached to a fan, walking stick, etc. [Obs.]
ciclatoun |A costly cloth, of uncertain material, used in the Middle Ages. [Obs.] [Written also checklaton, chekelatoun.] His robe was of ciclatoun, That coste many a Jane. Chaucer.
cicurate |To tame. [Obs.] Sir T. Browne.
cicuration |The act of taming. [Obs.] Ray.
cicuta |a genus of poisonous umbelliferous plants, of which the water hemlock or cowbane is best known. Note: The name cicuta is sometimes erroneously applied to Conium maculatum, or officinal hemlock.
cicutoxin |The active principle of the water hemlock (Cicuta) extracted as a poisonous gummy substance.
cid |1. Chief or commander; in Spanish literature, a title of Ruy Diaz, Count of Bivar, a champion of Christianity and of the old Spanish royalty, in the 11th century. 2. An epic poem, which celebrates the exploits of the Spanish national hero, Ruy Diaz.
cider |The expressed juice of apples. It is used as a beverage, for making vinegar, and for other purposes. Note: Cider was formerly used to signify the juice of other fruits, and other kinds of strong liquor, but was not applied to wine. Cider brandy, a kind of brandy distilled from cider. -- Cider mill, a mill in which cider is made. -- Cider press, the press of a cider mill.
ciderist |A maker of cider. [Obs.] Mortimer.
ciderkin |A kind of weak cider made by steeping the refuse pomace in water. Ciderkin is made for common drinking, and supplies the place of small beer. Mortimer.
cierge |A wax candle used in religous rites.
cigar |A small roll of tobacco, used for smoking. Cigar fish (Zoöl.), a fish (Decapterus punctatus), allied to the mackerel, found on the coast of the Gulf of Mexico.
cigarette |A little cigar; a little fine tobacco rolled in paper for smoking.
cilia |1. (Anat.)  The eyelashes. 2. (Biol.)  Small, generally microscopic, vibrating appendages lining certain organs, as the air passages of the higher animals, and in the lower animals often covering also the whole or a part of the exterior. They are also found on some vegetable organisms. In the Infusoria, and many larval forms, they are locomotive organs. 3. (Bot.)  Hairlike processes, commonly marginal and forming a fringe like the eyelash. 4. (Zoöl.)  Small, vibratory, swimming organs, somewhat resembling true cilia, as those of Ctenophora.
ciliary |1. (Anat.)  Pertaining to the cilia, or eyelashes. Also applied to special parts of the eye itself; as, the ciliary processes of the choroid coat; the ciliary muscle, etc. 2. (Biol.)  Pertaining to or connected with the cilia in animal or vegetable organisms; as, ciliary motion.
ciliata |One of the orders of Infusoria, characterized by having cilia. In some species the cilia cover the body generally, in others they form a band around the mouth.
ciliate |Provided with, or surrounded by, cilia; as, a ciliate leaf; endowed with vibratory motion; as, the ciliated epithelium of the windpipe.
ciliated |Provided with, or surrounded by, cilia; as, a ciliate leaf; endowed with vibratory motion; as, the ciliated epithelium of the windpipe.
cilice |A kind of haircloth undergarment. Southey.
cilician |Of or pertaining to Cilicia in Asia Minor. -- n.  A native or inhabitant of Cilicia.
cilicious |Made, or consisting, of hair. [Obs.] A Cilicious or sackcloth habit. Sir T. Browne.
ciliform |Having the form of cilia; very fine or slender.
ciliiform |Having the form of cilia; very fine or slender.
ciliograde |Moving by means of cilia, or cilialike organs; as, the ciliograde Medusæ.
cilium |See Cilia.
cill |See Sill., n. a foundation.
cillosis |A spasmodic trembling of the upper eyelid.
cima |A kind of molding. See Cyma.
cimar |See Simar.
cimbal |A kind of confectionery or cake. [Obs.] Nares.
cimbia |A fillet or band placed around the shaft of a column as if to strengthen it. [Written also cimia.]
cimbrian |Of or pertaining to the Cimbri. -- n.  One of the Cimbri. See Cimbric.
cimbric |Pertaining to the Cimbri, an ancient tribe inhabiting Northern Germany. -- n.  The language of the Cimbri.
cimeliarch |A superintendent or keeper of a church's valuables; a churchwarden. [Obs.] Bailey.
cimeter |See Scimiter.
cimex |A genus of hemipterous insects of which the bedbug is the best known example. See Bedbug.
cimia |See Cimbia.
cimiss |The bedbug. [Obs.] Wright.
cimmerian |1. Pertaining to the Cimmerii, a fabulous people, said to have lived, in very ancient times, in profound and perpetual darkness. 2. Without any light; intensely dark. In dark Cimmerian desert ever dwell. Milton.
cimolite |A soft, earthy, clayey mineral, of whitish or grayish color.
cinch |1. A strong saddle girth, as of canvas. [West. U. S.] 2. A tight grip. [Colloq.]
cinchona |1. (Bot.)  A genus of trees growing naturally on the Andes in Peru and adjacent countries, but now cultivated in the East Indies, producing a medicinal bark of great value. 2. (Med.)  The bark of any species of cinchona containing three per cent. or more of bitter febrifuge alkaloids; Peruvian bark; Jesuits' bark.
cinchonaceous |Allied or pertaining to cinchona, or to the plants that produce it.
cinchonic |Belonging to, or obtained from, cinchona. Mayne.
cinchonidine |One of the quinine group of alkaloids, found especially in red cinchona bark. It is a white crystalline substance, C19H22N2O, with a bitter taste and qualities similar to, but weaker than, quinine; -- sometimes called also cinchonidia.
cinchonine |One of the quinine group of alkaloids isomeric with and resembling cinchonidine; -- called also cinchonia.
cinchonism |A condition produced by the excessive or long-continued use of quinine, and marked by deafness, roaring in the ears, vertigo, etc.
cinchonize |To produce cinchonism in; to poison with quinine or with cinchona.
cincinnati epoch |An epoch at the close of the American lower Silurian system. The rocks are well developed near Cincinnati, Ohio. The group includes the Hudson River and Lorraine shales of New york.
cincinnus |A form of monochasium in which the lateral branches arise alternately on opposite sides of the false axis; -- called also scorpioid cyme. --Cin*cin\"nal (#), a.
cincture |1. A belt, a girdle, or something worn round the body, -- as by an ecclesiastic for confining the alb. 2. That which encompasses or incloses; an inclosure. \"Within the cincture of one wall.\" Bacon. 3. (Arch.)  The fillet, listel, or band next to the apophyge at the extremity of the shaft of a column.
cinctured |Having or wearing a cincture or gridle.
cinder |1. Partly burned or vitrified coal, or other combustible, in which fire is extinct. 2. A hot coal without flame; an ember. Swift. 3. A scale thrown off in forging metal. 4. The slag of a furnace, or scoriaceous lava from a volcano. Cinder frame, a framework of wire in front of the tubes of a locomotive, to arrest the escape of cinders. -- Cinder notch (Metal.), the opening in a blast furnace, through which melted cinder flows out.
cindery |Resembling, or composed of, cinders; full of cinders.
cinefaction |Cineration; reduction to ashes. [Obs.]
cinematic |See Kinematic.
cinematical |See Kinematic.
cinematics |See Kinematics.
cinematograph |1.  A machine, combining magic lantern and kinetoscope features, for projecting on a screen a series of pictures, moved rapidly (25 to 50 a second) and intermittently before an objective lens, and producing by persistence of vision the illusion of continuous motion; a moving-picture machine; also, any of several other machines or devices producing moving pictorial effects. Other common names for the cinematograph are animatograph, biograph, bioscope, electrograph, electroscope, kinematograph, kinetoscope, veriscope, vitagraph, vitascope, zoögyroscope, zoöpraxiscope, etc. The cinematograph, invented by Edison in 1894, is the result of the introduction of the flexible film into photography in place of glass. Encyc. Brit. 2.  A camera for taking chronophotographs for exhibition by the instrument described above.
cinematographer |One who exhibits moving pictures or who takes chronophotographs by the cinematograph. -- Cin`e*mat`o*graph\"ic (#), a. -- Cin`e*mat`o*graph\"ic*al*ly (#), adv.
cinemograph |An integrating anemometer.
cineraceous |Like ashes; ash-colored; cinerous.
cineraria |A Linnæan genus of free-flowering composite plants, mostly from South Africa. Several species are cultivated for ornament.
cinerary |Pertaining to ashes; containing ashes. Cinerary urns, vessels used by the ancients to preserve the ashes of the dead when burned.
cineration |The reducing of anything to ashes by combustion; cinefaction.
cinereous |Like ashes; ash-colored; grayish.
cinerescent |Somewhat cinereous; of a color somewhat resembling that of wood ashes.
cineritious |Like ashes; having the color of ashes, -- as the cortical substance of the brain.
cinerulent |Full of ashes. [Obs.]
cingalese |A native or natives of Ceylon descended from its primitive inhabitants; also (sing.),  the language of the Cingalese. -- a.  Of or pertaining to the Cingalese. [Written also Singhalese.] Note: Ceylonese is applied to the inhabitants of the island in general.
cingle |A girth. [R.] See Surcingle.
cingulum |(a) A distinct girdle or band of color; a raised spiral line as seen on certain univalve shells. (b) The clitellus of earthworms. (c) The base of the crown of a tooth.
cinnabar |1. (Min.)  Red sulphide of mercury, occurring in brilliant red crystals, and also in red or brown amorphous masses. It is used in medicine. 2. The artificial red sulphide of mercury used as a pigment; vermilion. Cinnabar Græcorum (. Etym: [L. Graecorum, gen. pl., of the Greeks.] (Med.) Same as Dragon's blood. -- Green cinnabar, a green pigment consisting of the oxides of cobalt and zinc subjected to the action of fire. -- Hepatic cinnabar (Min.), an impure cinnabar of a liver-brown color and submetallic luster.
cinnabarine |Pertaining to, or resembling, cinnabar; consisting of cinnabar, or containing it; as, cinnabarine sand.
cinnamene |Styrene (which was formerly called cinnamene because obtained from cinnamic acid). See Styrene.
cinnamic |Pertaining to, or obtained from, cinnamon. Cinnamic acid (Chem.), a white, crystalline, odorless substance. C6H5.C2H2C2H2.CO2H, formerly obtained from storax and oil of cinnamon, now made from certain benzene derivatives in large quantities, and used for the artificial production of indigo.
cinnamomic |See Cinnamic.
cinnamon |(a) The inner bark of the shoots of Cinnamomum Zeylanicum, a tree growing in Ceylon. It is aromatic, of a moderately pungent taste, and is one of the best cordial, carminative, and restorative spices. (b) Cassia. Cinnamon stone (Min.), a variety of garnet, of a cinnamon or hyacinth red color, sometimes used in jewelry. -- Oil of cinnamon, a colorless aromatic oil obtained from cinnamon and cassia, and consisting essentially of cinnamic aldehyde, C6H5.C2H2.CHO. -- Wild cinnamon. See Canella.
cinnamone |A yellow crystalline substance, (C6H5.C2H2)2CO, the ketone of cinnamic acid.
cinnamyl |The hypothetical radical, (C6H5.C2H2)2C, of cinnamic compounds. [Formerly written also cinnamule.]
cinnoline |A nitrogenous organic base, C8H6N2, analogous to quinoline, obtained from certain complex diazo compounds.
cinque |Five; the number five in dice or cards.
cinque ports |Five English ports, to which peculiar privileges were anciently accorded; -- viz., Hastings, Romney, Hythe, Dover, and Sandwich; afterwards increased by the addition of Winchelsea, Rye, and some minor places. Baron of the Cinque Ports. See under Baron.
cinque-pace |A lively dance (called also galliard), the steps of which were regulated by the number five. [Obs.] Nares. Shak.
cinque-spotted |Five-spotted. [R.] Shak.
cinquecentist |1. An Italian of the sixteenth century, esp. a poet or artist. 2.  A student or imitator of the art or literature of the Cinquecento.
cinquecento |The sixteenth century, when applied to Italian art or literature; as, the sculpture of the Cinquecento; Cinquecento style.
cinquefoil |1. (Bot.)  The name of several different species of the genus Potentilla; -- also called five-finger, because of the resemblance of its leaves to the fingers of the hand. 2. (Arch.)  An ornamental foliation having five points or cups, used in windows, panels, etc. Gwilt. Marsh cinquefoil, the Potentilla palustris, a plant with purple flowers which grows in fresh-water marshes.
cinter |See Center.
cinura |The group of Thysanura which includes Lepisma and allied forms; the bristletails. See Bristletail, and Lepisma.
cion |See Scion. The cion overruleth the stock; and the stock is but passive, and giveth aliment, but no motion, to the graft. Bacon.
cipher |1. (Arith.)  A character [0] which, standing by itself, expresses nothing, but when placed at the right hand of a whole number, increases its value tenfold. 2. One who, or that which, has no weight or influence. Here he was a mere cipher. W. Irving. 3. A character in general, as a figure or letter. [Obs.] This wisdom began to be written in ciphers and characters and letters bearing the forms of creatures. Sir W. Raleigh. 4. A combination or interweaving of letters, as the initials of a name; a device; a monogram; as, a painter's cipher, an engraver's cipher, etc. The cut represents the initials N. W. 5. A private alphabet, system of characters, or other mode of writing, contrived for the safe transmission of secrets; also, a writing in such characters. His father . . . engaged him when he was very young to write all his letters to England in cipher. Bp. Burnet. Cipher key, a key to assist in reading writings in cipher.\n\nOf the nature of a cipher; of no weight or influence. \"Twelve cipher bishops.\" Milton.\n\nTo use figures in a mathematical process; to do sums in arithmetic. \"T was certain he could write and cipher too. Goldsmith.\n\n1. To write in occult characters. His notes he ciphered with Greek characters. Hayward. 2. To get by ciphering; as, to cipher out the answer. 3. To decipher. [Obs.] Shak. 4. To designate by characters. [Obs.] Shak.
cipherer |One who ciphers.
cipherhood |Nothingness. [R.] Goodwin.
cipolin |A whitish marble, from Rome, containiing pale greenish zones. It consists of calcium carbonate, with zones and cloudings of talc.
cippus |A small, low pillar, square or round, commonly having an inscription, used by the ancients for various purposes, as for indicating the distances of places, for a landmark, for sepulchral inscriptions, etc. Gwilt.
circ |An amphitheatrical circle for sports; a circus. [R.] T. Warton.
circar |A district, or part of a province. See Sircar. [India]
circassian |Of or pertaining to Circassia, in Asia. -- n.  A native or inhabitant of Circassia.
circean |Having the characteristics of Circe, daughter of Sol and Perseis, a mythological enchantress, who first charmed her victims and then changed them to the forms of beasts; pleasing, but noxious; as, a Circean draught.
circensial |Of or pertaining to, or held in, the Circus, In Rome. The pleasure of the Circensian shows. Holyday.
circensian |Of or pertaining to, or held in, the Circus, In Rome. The pleasure of the Circensian shows. Holyday.
circinal |Circinate.
circinate |Rolled together downward, the tip occupying the center; -- a term used in reference to foliation or leafing, as in ferns. Gray.\n\nTo make a circle around; to encompass. [Obs.] Bailey.
circination |1. An orbicular motion. [Obs.] bailey. 2. A circle; a concentric layer. [Obs.] \"The circinations and spherical rounds of onions.\" Sir T. Browne.
circle |1. A plane figure, bounded by a single curve line called its circumference, every part of which is equally distant from a point within it, called the center. 2. The line that bounds sush a figure; a circumference; a ring. 3. (Astron.)  An instrument of observation, the graduated limb of which consists of an entire circle. Note: When it is fixed to a wall in an observatory, it is called a mural circle; when mounted with a telescope on an axis and in Y's, in the plane of the meridian, a meridian or transit circle; when involving the principle of reflection, like the sextant, a reflecting circle; and when that of repeating an angle several times continuously along the graduated limb, a repeating circle. 4. A round body; a sphere; an orb. It is he that sitteth upon the circle of the earth. Is. xi. 22. 5. Compass; circuit; inclosure. In the circle of this forest. Shak. 6. A company assembled, or conceived to assemble, about a central point of interest, or bound by a common tie; a class or division of society; a coterie; a set. As his name gradually became known, the circle of his acquaintance widened. Macaulay. 7. A circular group of persons; a ring. 8. A series ending where it begins, and repeating itself. Thus in a circle runs the peasant's pain. Dryden. 9. (Logic)  A form of argument in which two or more unproved statements are used to prove each other; inconclusive reasoning. That heavy bodies descend by gravity; and, again, that gravity is a quality whereby a heavy body descends, is an impertinent circle and teaches nothing. Glanvill. 10. Indirect form of words; circumlocution. [R.] Has he given the lie, In circle, or oblique, or semicircle. J. Fletcher. 11. A territorial division or district. Note: The Circles of the Holy Roman Empire, ten in number, were those principalities or provinces which had seats in the German Diet. Azimuth circle. See under Azimuth. -- Circle of altitude (Astron.), a circle parallel to the horizon, having its pole in the zenith; an almucantar. -- Circle of curvature. See Osculating circle of a curve (Below). -- Circle of declination. See under Declination. -- Circle of latitude. (a) (Astron.) A great circle perpendicular to the plane of the ecliptic, passing through its poles. (b) (Spherical Projection) A small circle of the sphere whose plane is perpendicular to the axis. -- Circles of longitude, lesser circles parallel to the ecliptic, diminishing as they recede from it. -- Circle of perpetual apparition, at any given place, the boundary of that space around the elevated pole, within which the stars never set. Its distance from the pole is equal to the latitude of the place. -- Circle of perpetual occultation, at any given place, the boundary of the space around the depressed pole, within which the stars never rise. -- Circle of the sphere, a circle upon the surface of the sphere, called a great circle when its plane passes through the center of the sphere; in all other cases, a small circle. -- Diurnal circle. See under Diurnal. -- Dress circle, a gallery in a theater, generally the one containing the prominent and more expensive seats. -- Druidical circles (Eng. Antiq.), a popular name for certain ancient inclosures formed by rude stones circularly arranged, as at Stonehenge, near Salisbury. -- Family circle, a gallery in a theater, usually one containing inexpensive seats. -- Horary circles (Dialing), the lines on dials which show the hours. -- Osculating circle of a curve (Geom.), the circle which touches the curve at some point in the curve, and close to the point more nearly coincides with the curve than any other circle. This circle is used as a measure of the curvature of the curve at the point, and hence is called circle of curvature. -- Pitch circle. See under Pitch. -- Vertical circle, an azimuth circle. -- Voltaic circle or circuit. See under Circuit. -- To square the circle. See under Square. Syn. -- Ring; circlet; compass; circuit; inclosure.\n\n1. To move around; to revolve around. Other planets circle other suns. Pope. 2. To encompass, as by a circle; to surround; to inclose; to encircle. Prior. Pope. Their heads are circled with a short turban. Dampier. So he lies, circled with evil. Coleridge. To circle in, to confine; to hem in; to keep together; as, to circle bodies in. Sir K. Digby.\n\nTo move circularly; to form a circle; to circulate. Thy name shall circle round the gaping through. Byron.
circled |Having the form of a circle; round. \"Monthly changes in her circled orb.\" Shak.
circler |A mean or inferior poet, perhaps from his habit of wandering around as a stroller; an itinerant poet. Also, a name given to the cyclic poets. See under Cyclic, a. [Obs.] B. Jonson.
circlet |1. A little circle; esp., an ornament for the person, having the form of a circle; that which encircles, as a ring, a bracelet, or a headband. Her fair locks in circlet be enrolled. Spenser. 2. A round body; an orb. Pope. Fairest of stars . . . that crown'st the smiling morn With thy bright circlet. Milton. 3. A circular piece of wood put under a dish at table. [Prov. Eng.] Halliwell.
circocele |See Cirsocele.
circuit |1. The act of moving or revolving around, or as in a circle or orbit; a revolution; as, the periodical circuit of the earth round the sun. Watts. 2. The circumference of, or distance round, any space; the measure of a line round an area. The circuit or compass of Ireland is 1,800 miles. J. Stow. 3. That which encircles anything, as a ring or crown. The golden circuit on my head. Shak. 4. The space inclosed within a circle, or within limits. A circuit wide inclosed with goodliest trees. Milton. 5. A regular or appointed journeying from place to place in the exercise of one's calling, as of a judge, or a preacher. 6. (a) (Law) A certain division of a state or country, established by law for a judge or judges to visit, for the administration of justice. Bouvier. (b) (Methodist Church) A district in which an itinerant preacher labors. 7. Circumlocution. [Obs.] \"Thou hast used no circuit of words.\" Huloet. Circuit court (Law), a court which sits successively in different places in its circuit (see Circuit, 6). In the United States, the federal circuit courts are commonly presided over by a judge of the supreme court, or a special circuit judge, together with the judge of the district court. They have jurisdiction within statutory limits, both in law and equity, in matters of federal cognizance. Some of the individual States also have circuit courts, which have general statutory jurisdiction of the same class, in matters of State cognizance. -- Circuit or Circuity of action (Law), a longer course of proceedings than is necessary to attain the object in view. -- To make a circuit, to go around; to go a roundabout way. -- Voltaic or Galvanic circuit or circle, a continous electrical communication between the two poles of a battery; an arrangement of voltaic elements or couples with proper conductors, by which a continuous current of electricity is established.\n\nTo move in a circle; to go round; to circulate. [Obs.] J. Philips.\n\nTo travel around. [Obs.] \"Having circuited the air.\" T. Warton.
circuiteer |A circuiter. Pope.
circuiter |One who travels a circuit, as a circuit judge. [R.] R. Whitlock.
circuition |The act of going round; circumlocution. [R.]
circuitous |Going round in a circuit; roundabout; indirect; as, a circuitous road; a circuitous manner of accompalishing an end. -- Cir*cu\"i*tous*ly, adv. -- Cir*cu\"i*tous*ness, n. Syn. -- Tortuous; winding; sinuous; serpentine.
circuity |A going round in a circle; a course not direct; a roundabout way of proceeding.
circulable |That may be circulated.
circular |1. In the form of, or bounded by, a circle; round. 2. repeating itself; ending in itself; reverting to the point of beginning; hence, illogical; inconclusive; as, circular reasoning. 3. Adhering to a fixed circle of legends; cyclic; hence, mean; inferior. See Cyclic poets, under Cyclic. Had Virgil been a circular poet, and closely adhered to history, how could the Romans have had Dido Dennis. 4. Addressed to a circle, or to a number of persons having a common interest; circulated, or intended for circulation; as, a circular letter. A proclamation of Henry III., . . . doubtless circular throughout England. Hallam. 5. Perfect; complete. [Obs.] A man so absolute and circular In all those wished-for rarities that may take A virgin captive. Massinger. Circular are, any portion of the circumference of a circle. -- Circular cubics (Math.), curves of the third order which are imagined to pass through the two circular points at infinity. -- Circular functions. (Math.) See under Function. -- Circular instruments, mathematical instruments employed for measuring angles, in which the graduation extends round the whole circumference of a circle, or 360º. -- Circular lines, straight lines pertaining to the circle, as sines, tangents, secants, etc. -- Circular note or letter. (a) (Com.) See under Credit. (b) (Diplomacy) A letter addressed in identical terms to a number of persons. -- Circular numbers (Arith.), those whose powers terminate in the same digits as the roots themselves; as 5 and 6, whose squares are 25 and 36. Bailey. Barlow. -- Circular points at infinity (Geom.), two imaginary points at infinite distance through which every circle in the plane is, in the theory of curves, imagined to pass. -- Circular polarization. (Min.) See under Polarization. -- Circular or Globular sailing (Naut.), the method of sailing by the arc of a great circle. -- Circular saw. See under Saw.\n\n1. A circular letter, or paper, usually printed, copies of which are addressed or given to various persons; as, a business circular. 2. A sleeveless cloak, cut in circular form.
circularise |1. to canvass by distributing letters. Syn. -- circularize. [WordNet 1.5] 2. to distribute circulars to. Syn. -- circularize. [WordNet 1.5] 3. to to pass around, as information. Syn. -- circulate, circularize, distribute, disseminate, propagate, broadcast, spread, diffuse, disperse. [WordNet 1.5]
circularity |The quality or state of being circular; a circular form.
circularly |In a circular manner.
circulary |Circular; illogical. [Obs. & .] \"Cross and circulary speeches.\" Hooker.
circulate |1. To move in a circle or circuitously; to move round and return to the same point; as, the blood circulates in the body. Boyle. 2. To pass from place to place, from person to person, or from hand to hand; to be diffused; as, money circulates; a story circulates. Circulating decimal. See Decimal. -- Circulating library, a library whose books are loaned to the public, usually at certain fixed rates. -- Circulating medium. See Medium.\n\nTo cause to pass from place to place, or from person to person; to spread; as, to circulate a report; to circulate bills of credit. Circulating pump. See under Pump. Syn. -- To spread; diffuse; propagate; disseminate.
circulation |1. The act of moving in a circle, or in a course which brings the moving body to the place where its motion began. This continual circulation of human things. Swift. 2. The act of passing from place to place or person to person; free diffusion; transmission. The true doctrines of astronomy appear to have had some popular circulation. Whewell. 3. Currency; circulating coin; notes, bills, etc., current for coin. 4. The extent to which anything circulates or is circulated; the measure of diffusion; as, the circulation of a newspaper. 5. (Physiol.)  The movement of the blood in the blood-vascular system, by which it is brought into close relations with almost every living elementary constituent. Also, the movement of the sap in the vessels and tissues of plants.
circulative |Promoting circulation; circulating. [R.] Coleridge.
circulator |One who, or that which, circulates.
circulatorious |Travelling from house to house or from town to town; itinerant. [Obs.] \"Circulatorious jugglers.\" Barrow.
circulatory |1. Circular; as, a circulatory letter. Johnson. 2. Circulating, or going round. T. Warton. 3. (Anat.)  Subserving the purposes of circulation; as, circulatory organs; of or pertaining to the organs of circulation; as, circulatory diseases.\n\nA chemical vessel consisting of two portions unequally exposed to the heat of the fire, and with connecting pipes or passages, through which the fluid rises from the overheated portion, and descends from the relatively colder, maintaining a circulation.
circulet |A circlet. [Obs.] Spenser.
circuline |Proceeding in a circle; circular. [Obs.] \"With motion circuline\". Dr. H. More.
circum- |A Latin preposition, used as a prefix in many English words, and signifying around or about.
circumagitate |To agitate on all sides. Jer. Taylor.
circumambage |A roundabout or indirect course; indirectness. [Obs.] S. Richardson.
circumambiency |The act of surrounding or encompassing. Sir T. Browne.
circumambient |Surrounding; inclosing or being on all sides; encompassing. \"The circumambient heaven.\" J. Armstrong.
circumambulate |To walk round about. -- Cir`cum*am`bu*la\"tion, n.
circumbendibus |A roundabout or indirect way. [Jocular] Goldsmith.
circumcenter |The center of a circle that circumscribes a triangle.
circumcise |1. To cut off the prepuce of foreskin of, in the case of males, and the internal labia of, in the case of females. 2. (Script.)  To purify spiritually.
circumciser |One who performs circumcision. Milton.
circumcision |1. The act of cutting off the prepuce or foreskin of males, or the internal labia of females. Note: The circumcision of males is practiced as a religious rite by the Jews, Mohammedans, etc. 2. (Script.) (a) The Jews, as a circumcised people. (b) Rejection of the sins of the flesh; spiritual purification, and acceptance of the Christian faith.
circumclusion |Act of inclosing on all sides. [R.]
circumcursation |The act of running about; also, rambling language. [Obs.] Barrow.
circumdenudation |Denudation around or in the neighborhood of an object. Hills of circumdenudation, hills which have been produced by surface erosion; the elevations which have been left, after denudation of a mass of high ground. Jukes.
circumduce |To declare elapsed, as the time allowed for introducing evidence. Sir W. Scott.
circumduct |1. To lead about; to lead astray. [R.] 2. (Law)  To contravene; to nullify; as, to circumduct acts of judicature. [Obs.] Ayliffe.
circumduction |1. A leading about; circumlocution. [R.] Hooker. 2. An annulling; cancellation. [R.] Ayliffe. 3. (Phisiol.)  The rotation of a limb round an imaginary axis, so as to describe a concial surface.
circumesophagal |Surrounding the esophagus; -- in Zool. said of the nerve commissures and ganglia of arthropods and mollusks.
circumesophageal |Circumesophagal.
circumfer |To bear or carry round. [Obs.] Bacon.
circumference |1. The line that goes round or encompasses a circular figure; a periphery. Millon. 2. A circle; anything circular. His ponderous shield . . . Behind him cast. The broad circumference Hung on his shoulders like the moon. Milton. 3. The external surface of a sphere, or of any orbicular body.\n\nTo include in a circular space; to bound. [Obs.] Sir T. Browne.
circumferential |Pertaining to the circumference; encompassing; encircling; circuitous. Parkhurst.
circumferentially |So as to surround or encircle.
circumferentor |1. A surveying instrument, for taking horizontal angles and bearings; a surveyor's compass. It consists of a compass whose needle plays over a circle graduated to 360º, and of a horizontal brass bar at the ends of which are standards with narrow slits for sighting, supported on a tripod by a ball and socket joint. 2. A graduated wheel for measuring tires; a tire circle.
circumflant |Blowing around. [Obs.] Evelyn.
circumflect |1. To bend around. 2. To mark with the circumflex accent, as a vowel. [R.]
circumflection |See Circumflexion.
circumflex |1. A wave of the voice embracing both a rise and fall or a fall and a rise on the same a syllable. Walker. 2. A character, or accent, denoting in Greek a rise and of the voice on the same long syllable, marked thus [~ or Accent, n., 2.\n\nTo mark or pronounce with a circumflex. Walker.\n\n1. Moving or turning round; circuitous. [R.] Swift. 2. (Anat.)  Curved circularly; -- applied to several arteries of the hip and thigh, to arteries, veins, and a nerve of the shoulder, and to other parts.
circumflexion |1. The act of bending, or causing to assume a curved form. 2. A winding about; a turning; a circuity; a fold.
circumfluence |A flowing round on all sides; an inclosing with a fluid.
circumfluent |Flowing round; surrounding in the manner of a fluid. \"The deep, circumfluent waves.\" Pope.
circumfluous |Flowing round; surrounding in the manner of a fluid. \"The deep, circumfluent waves.\" Pope.
circumforanean |Going about or abroad; walking or wandering from house to house. Addison.
circumforaneous |Going about or abroad; walking or wandering from house to house. Addison.
circumfulgent |Shining around or about.
circumfuse |To pour round; to spread round. His army circumfused on either wing. Milton.
circumfusile |Capable of being poured or spread round. \"Circumfusile gold.\" Pope.
circumfusion |The act of pouring or spreading round; the state of being spread round. Swift.
circumgestation |The act or process of carrying about. [Obs.] Circumgestation of the eucharist to be adored. Jer. Taylor.
circumgyrate |To roll or turn round; to cause to perform a rotary or circular motion. Ray.
circumgyration |The act of turning, rolling, or whirling round. A certain turbulent and irregular circumgyration. Holland.
circumgyratory |Moving in a circle; turning round. Hawthorne.
circumgyre |To circumgyrate. [Obs.]
circumincession |The reciprocal existence in each other of the three persons of the Trinity.
circumjacence |Condition of being circumjacent, or of bordering ou every side.
circumjacent |Lying round; borderong on every side. T. Fuller.
circumjovial |One of the moons or satellites of the planet Jupiter. [Obs.] Derham.
circumlittoral |Adjointing the shore.
circumlocution |The use of many words to express an idea that might be expressed by few; indirect or roundabout language; a periphrese. the plain Billingagate way of calling names . . . would save abundance of time lost by circumlocution. Swift. Circumlocution office, a term of riducle for a governmental office where business is delayed by passing through the hands of different officials.
circumlocutional |Relating to, or consisting of, circumlocutions; periphrastic; circuitous.
circumlocutory |Characterised by circumlocution; periphrastic. Shenstone. The officials set to work in regular circumlocutory order. Chambers's Journal.
circummeridian |About, or near, the meridian.
circummure |To encompass with a wall. Shak.
circumnavigable |Capable of being sailed round. Ray.
circumnavigate |To sail completely round. Having circumnavigated the whole earth. T. Fuller.
circumnavigation |The act of circumnavigating, or sailing round. Arbuthnot.
circumnavigator |One who sails round. W. Guthrie.
circumnutate |To pass through the stages of circumnutation.
circumnutation |The successive bowing or bending in different directions of the growing tip of the stems of many plants, especially seen in climbing plants.
circumpolar |About the pole; -- applied to stars that revolve around the pole without setting; as, circumpolar stars.
circumposition |The act of placing in a circle, or round about, or the state of being so placed. Evelyn.
circumrotary |turning, rolling, or whirling round.
circumrotate |To rotate about. [R.]
circumrotation |The act of rolling or revolving round, as a wheel; circumvolution; the state of being whirled round. J. Gregory.
circumrotatory |turning, rolling, or whirling round.
circumscissile |Dehiscing or opening by a transverse fissure extending around (a capsule or pod). See Illust. of Pyxidium.
circumscribable |Capable of being circumscribed.
circumscribe |1. to write or engare around. [R.] Thereon is circumscribed this epitaph. Ashmole. 2. To inclose within a certain limit; to hem in; to surround; to bound; to confine; to restrain. To circumscribe royal power. Bancroft. 3. (Geom.)  To draw a line around si as to touch at certain points without cutting. See Inscribe, 5. Syn. -- To bound; limit; restrict; confine; abridge; restrain; environ; encircle; inclose; encompass.
circumscriber |One who, or that which, circumscribes.
circumscriptible |Capable of being circumscribed or limited by bounds.
circumscription |1. An inscription written around anything. [R.] Ashmole. 2. The exterior line which determines the form or magnitude of a body; outline; periphery. Ray. 3. The act of limiting, or the state of being limited, by conditions or restraints; bound; confinement; limit. The circumscriptions of terrestrial nature. Johnson. I would not my unhoused, free condition Put into circumscription and confine. Shak.
circumscriptive |Circumscribing or tending to circumscribe; marcing the limits or form of.
circumscriptively |In a limited manner.
circumscriptly |In a literal, limited, or narrow manner. [R.] Milton.
circumspect |Attentive to all the circustances of a case or the probable consequences of an action; cautious; prudent; wary. Syn. -- See Cautious.
circumspection |Attention to all the facts and circumstances of a case; caution; watchfulness. With silent circumspection, unespied. Milton. Syn. -- Caution; prudence; watchfulness; deliberation; thoughtfulness; wariness; forecast.
circumspective |Looking around everi way; cautious; careful of consequences; watchful of danger. \"Circumspective eyes.\" Pope.
circumspectively |Circumspectly.
circumspectly |In a circumspect manner; cautiously; warily.
circumspectness |Vigilance un guarding against evil from every quarter; caution. [Travel] forces circumspectness on those abroad, who at home are nursed in security. Sir H. Wotton.
circumstance |1. That which attends, or relates to, or in some way affects, a fact or event; an attendant thing or state of things. The circumstances are well known in the country where they happened. W. Irving. 2. An event; a fact; a particular incident. The sculptor had in his thoughts the conqoeror weeping for new worlds, or the like circumstances in histery. Addison. 3. Circumlocution; detail. [Obs.] So without more circumstance at all I hold it fit that shake hands and part. Shak. 4. pl.  Condition in regard to worldly estate; state of property; situation; surroundings. When men are easy in their circumstances, they are naturally enemies to innovations. Addison. Not a circumstance, of no account. [Colloq.] -- Under the circumstances, taking all things into consideration. Syn. -- Event; occurrence; incident; situation; condition; position; fact; detail; item. See Event.\n\nTo place in a particular situation; to suppy relative incidents. The poet took the matters of fact as they came down to him and circumstanced them, after his own manner. Addison.
circumstanced |1. Placed in a particular position or condition; situated. The proposition is, that two bodies so circumstanced will balance each other. Whewell. 2. Governed by events or circumstances. [Poetic & R.] \"I must be circumstanced.\" Shak.
circumstant |Standing or placed around; surrounding. [R.] \"Circumstant bodies.\" Sir K. Digby.
circumstantiable |Capable of being circumstantiated. [Obs.] Jer Taylor.
circumstantial |1. Consisting in, or pertaining to, circumstances or particular incidents. The usual character of human testimony is substantial truth under circumstantial variety. Paley. 2. Incidental; relating to, but not essential. We must therefore distinguish between the essentials in religious worship . . . and what is merely circumstantial. Sharp. 3. Abounding with circumstances; detailing or exhibiting all the circumstances; minute; particular. Tedious and circumstantial recitals. Prior. Circumstantial evidence (Law), evidence obtained from circumstances, which necessarily or usually attend facts of a particular nature, from which arises presumption. According to some authorities circumstantial is distinguished from positive evidence in that the latter is the testimony of eyewitnesses to a fact or the admission of a party; but the prevalent opinion now is that all such testimony is dependent on circumstances for its support. All testimony is more or less circumstantial. Wharton. Syn. -- See Minute.\n\nSomething incidental to the main subject, but of less importance; opposed to an essential; -- generally in the plural; as, the circumstantials of religion. Addison.
circumstantiality |The state, characteristic, or quality of being circumstantial; particularity or minuteness of detail. \"I will endeavor to describe with sufficient circumstantiality.\" De Quincey.
circumstantially |1. In respect to circumstances; not essentially; accidentally. Of the fancy and intellect, the powers are only circumstantially different. Glanvill. 2. In every circumstance or particular; minutely. To set down somewhat circumstantially, not only the events, but the manner of my trials. Boyle.
circumstantiate |1. To place in particular circumstances; to invest with particular accidents or adjuncts. [R.] If the act were otherwise circumstantiated, it might will that freely which now it wills reluctantly. Bramhall. 2. To prove or confirm by circumstances; to entr into details concerning. Neither will time permint to circumstantiate these particulars, which I have only touched in the general. State Trials (1661).
circumterraneous |Being or dwelling around the earth. \"Circumterraneous demouns.\" H. Hallywell.
circumundulate |To flow round, as waves. [R.]
circumvallate |To surround with a rampart or wall. Johnson.\n\n1. Surrounded with a wall; inclosed with a rampart. 2. (Anat.)  Surrounded by a ridle or elevation; as, the circumvallate papillæ, near the base of the tongue.
circumvallation |(a) The act of surrounding with a wall or rampart. (b) A line of field works made around a besieged place and the besieging army, to protect the camp of the besiegers against the attack of an enemy from without.
circumvection |The act of carrying anything around, or the state of being so carried.
circumvent |To gain advantage over by arts, stratagem, or deception; to decieve; to delude; to get around. I circumvented whom I could not gain. Dryden.
circumvention |The act of prevailing over another by arts, address, or fraud; deception; fraud; imposture; delusion. A school in which he learns sly circumvention. Cowper.
circumventive |Tending to circumvent; deceiving by artifices; deluding.
circumventor |One who circumvents; one who gains his purpose by cunning.
circumvest |To cover round, as woth a garment; to invest. [Obs.] Circumvested with much prejudice. Sir H. Wotton.
