concuss |1. To shake or agitate. \"Concussed with uncertainty.\" Daniel. 2. (Law)  To force (a person) to do something, or give up something, by intimidation; to coerce. Wharton.
concussation |A violent shock or agitation. [Obs.] Bp. Hall.
concussion |1. A shaking or agitation; a shock; caused by the collision of two bodies. It is believed that great ringing of bells, in populous cities, hath dissipated pestilent air; which may be from the concussion of the air. Bacon. 2. (Med.)  A condition of lowered functional activity, without visible structural change, produced in an organ by a shock, as by fall or blow; as, a concussion of the brain. 3. (Civil Law)  The unlawful forcing of another by threats of violence to yield up something of value. Then concussion, rapine, pilleries, Their catalogue of accusations fill. Daniel. Concussion fuse (Mil.), one that is ignited by the concussion of the shell when it strikes. Syn. -- See Shock.
concussive |Having the power or quality of shaking or agitating. Johnson.
cond |To con, as a ship.
condemn |1. To pronounce to be wrong; to disapprove of; to censure. Condemn the fault, and not the actor of it! Why, every fault's condemned ere it be done. Shak. Wilt thou condemn him that is most just Job xxxiv. 17. 2. To declare the guilt of; to make manifest the faults or unworthiness of; to convict of guilt. The queen of the south shall rise up in the judgment with this generation, and shall condemn it. Matt. xii. 42. 3. To pronounce a judicial sentence against; to sentence to punishment, suffering, or loss; to doom; -- with to before the penalty. Driven out from bliss, condemned In this abhorred deep to utter woe. Milton. To each his sufferings; all are men, Condemned alike to groan. Gray. And they shall condemn him to death. Matt. xx. 18. The thief condemned, in law already dead. Pope. No flocks that range the valley free, To slaughter I condemn. Goldsmith. 4. To amerce or fine; -- with in before the penalty. The king of Egypt . . . condemned the land in a hundred talents of silver. 2 Cron. xxxvi. 3. 5. To adjudge or pronounce to be unfit for use or service; to adjudge or pronounce to be forfeited; as, the ship and her cargo were condemned. 6. (Law)  To doom to be taken for public use, under the right of eminent domain. Syn. -- To blame; censure; reprove; reproach; upbraid; reprobate; convict; doom; sentence; adjudge.
condemnable |Worthy of condemnation; blamable; culpable.
condemnation |1. The act of condemning or pronouncing to be wrong; censure; blame; disapprobation. In every other sense of condemnation, as blame, censure, reproof, private judgment, and the like. Paley. 2. The act of judicially condemning, or adjudging guilty, unfit for use, or forfeited; the act of dooming to punishment or forfeiture. A legal and judicial condemnation. Paley. Whose condemnation is pronounced. Shak. 3. The state of being condemned. His pathetic appeal to posterity in the hopeless hour of condemnation. W. Irving. 4. The ground or reason of condemning. This is the condemnation, that light is come into the world, and men loved darkness rather light, because their deeds were evil. John iii. 19.
condemnatory |Condemning; containing or imposing condemnation or censure; as, a condemnatory sentence or decree.
condemned |1. Pronounced to be wrong, guilty, worthless, or forfeited; adjudged or sentenced to punishment, destruction, or confiscation. 2. Used for condemned persons. Richard Savage . . . had lain with fifty pounds weight of irons on his legs in the condemned ward of Newgate. Macaulay.
condemner |One who condemns or censures.
condensability |Capability of being condensed.
condensable |Capable of being condensed; as, vapor is condensable.
condensate |Made dense; condensed. Water . . . thickened or condensate. Peacham.\n\nTo condense. [R.] Hammond.
condensation |1. The act or process of condensing or of being condensed; the state of being condensed. He [Goldsmith] was a great and perhaps an unequaled master of the arts of selection and condensation. Macaulay. 2. (Physics)  The act or process of reducing, by depression of temperature or increase of pressure, etc., to another and denser form, as gas to the condition of a liquid or steam to water. 3. (Chem.)  A rearrangement or concentration of the different constituents of one or more substances into a distinct and definite compound of greater complexity and molecular weight, often resulting in an increase of density, as the condensation of oxygen into ozone, or of acetone into mesitylene. Condensation product (Chem.), a substance obtained by the polymerization of one substance, or by the union of two or more, with or without separation of some unimportant side products. -- Surface condensation, the system of condensing steam by contact with cold metallic surfaces, in distinction from condensation by the injection of cold water.
condensative |Having the property of condensing.
condense |1. To make more close, compact, or dense; to compress or concentrate into a smaller compass; to consolidate; to abridge; to epitomize. In what shape they choose, Dilated or condensed, bright or obscure. Milton. The secret course pursued at Brussels and at Madrid may be condensed into the usual formula, dissimulation, procrastination, and again dissimulation. Motley. 2. (Chem. & Physics)  To reduce into another and denser form, as by cold or pressure; as, to condense gas into a liquid form, or steam into water. Condensed milk, milk reduced to the consistence of very thick cream by evaporation (usually with addition of sugar) for preservation and transportation. -- Condensing engine, a steam engine in which the steam is condensed after having exerted its force on the piston. Syn. -- To compress; contract; crowd; thicken; concentrate; abridge; epitomize; reduce.\n\n1. To become more compact; to be reduced into a denser form. Nitrous acid is gaseous at ordinary temperatures, but condenses into a very volatile liquid at the zero of Fahrenheit. H. Spencer. 2. (Chem.) (a) To combine or unite (as two chemical substances) with or without separation of some unimportant side products. (b) To undergo polymerization.\n\nCondensed; compact; dense. [R.] The huge condense bodies of planets. Bentley.
condenser |1. One who, or that which, condenses. 2. (Physic) (a) An instrument for condensing air or other elastic fluids, consisting of a cylinder having a movable piston to force the air into a receiver, and a valve to prevent its escape. (b) An instrument for concentrating electricity by the effect of induction between conducting plates separated by a nonconducting plate. (c) A lens or mirror, usually of short focal distance, used to concentrate light upon an object. 3. (Chem.)  An apparatus for receiving and condensing the volatile products of distillation to a liquid or solid form, by cooling. 4. (Steam Engine)  An apparatus, separate from the cylinder, in which the exhaust steam is condensed by the action of cold water or air. See Illust. of Steam engine. Achromatic condenser (Optics), an achromatic lens used as a condenser. -- Bull's-eye condenser, or Bull's-eye (Optics), a lens of short focal distance used for concentrating rays of light. -- Injection condenser, a vessel in which steam is condensed by the direct contact of water. -- Surface condenser, an apparatus for condensing steam, especially the exhaust of a steam engine, by bringing it into contact with metallic surface cooled by water or air.
condensible |Capable of being condensed; as, a gas condensible to a liquid by cold.
conder |One who watches shoals of fish; a balker. See Balker.
condescend |1. To stoop or descend; to let one's self down; to submit; to waive the privilege of rank or dignity; to accommodate one's self to an inferior. \"Condescend to men of low estate.\" Rom. xii. 16. Can they think me so broken, so debased With corporal servitude, that my mind ever Will condescend to such absurd commands Milton. Spain's mighty monarch, In gracious clemency, does condescend, On these conditions, to become your friend. Dryden. Note: Often used ironically, implying an assumption of superiority. Those who thought they were honoring me by condescending to address a few words to me. F. W. Robinson. 2. To consent. [Obs.] All parties willingly condescended heruento. R. Carew. Syn. -- To yield; stoop; descend; deign; vouchsafe.
condescendence |Condescension. [Obs.]
condescendency |Condescension. [Obs.]
condescendingly |In a condescending manner. Atterbury.
condescension |The act of condescending; voluntary descent from one's rank or dignity in intercourse with an inferior; courtesy toward inferiors. It forbids pride . . . and commands humility, modesty, and condescension to others. Tillotson. Such a dignity and condescension . . . as are suitable to a superior nature. Addison. Syn. -- Complaisance; courtesy; affability.
condescent |An act of condescension. [Obs.] Dr. H. More.
condign |1. Worthy; suitable; deserving; fit. [Obs.] Condign and worthy praise. Udall. Herself of all that rule she deemend most condign. Spenser. 2. Deserved; adequate; suitable to the fault or crime. \"Condign censure.\" Milman. Unless it were a bloody murderer . . . I never gave them condign punishment. Shak.
condignity |Merit, acguired by works, which can claim reward on the score of general benevolence. Such a worthiness of condignity, and proper merit of the heavenly glory, cannot be found in any the best, most perfect, and excellent of created beings. Bp. Bull.
condignly |According to merit.
condignness |Agreeableness to deserts; suitableness.
condiment |Something used to give relish to food, and to gratify the taste; a pungment and appetizing substance, as pepper or mustard; seasoning. As for radish and the like, they are for condiments, and not for nourishment. Bacon.
condisciple |A schoolfellow; a fellow-student. [R.]
condite |Preserved; pickled. [Obs.] Burton.\n\nTo pickle; to preserve; as, to condite pears, quinces, etc. [Obs.] Jer. Taylor.
condition |1. Mode or state of being; state or situation with regard to external circumstances or influences, or to physical or mental integrity, health, strength, etc.; predicament; rank; position, estate. I am in my condition A prince, Miranda; I do think, a king. Shak. And O, what man's condition can be worse Than his whom plenty starves and blessings curse Cowley. The new conditions of life. Darwin. 2. Essential quality; property; attribute. It seemed to us a condition and property of divine powers and beings to be hidden and unseen to others. Bacon. 3. Temperament; disposition; character. [Obs.] The condition of a saint and the complexion of a devil. Shak. 4. That which must exist as the occasion or concomitant of something else; that which is requisite in order that something else should take effect; an essential qualification; stipulation; terms specified. I had as lief take her dowry with this condition, to be whipped at the high cross every morning. Shak. Many are apt to believe remission of sins, but they believe it without the condition of repentance. Jer. Taylor. 5. (Law)  A clause in a contract, or agreement, which has for its object to suspend, to defeat, or in some way to modify, the principal obligation; or, in case of a will, to suspend, revoke, or modify a devise or bequest. It is also the case of a future uncertain event, which may or may not happen, and on the occurrence or non-occurrence of which, the accomplishment, recission, or modification of an obligation or testamentary disposition is made to depend. Blount. Tomlins. Bouvier. Wharton. Equation of condition. (Math.) See under Equation. -- On or Upon condition (that), used for if in introducing conditional sentences. \"Upon condition thou wilt swear to pay him tribute . . . thou shalt be placed as viceroy under him.\" Shak. -- Conditions of sale, the terms on which it is proposed to sell property by auction; also, the instrument containing or expressing these terms. Syn. -- State; situation; circumstances; station; case; mode; plight; predicament; stipulation; qualification; requisite; article; provision; arrangement. See State.\n\n1. To make terms; to stipulate. Pay me back my credit, And I'll condition with ye. Beau. & Fl. 2. (Metaph.)  To impose upon an object those relations or conditions without which knowledge and thought are alleged to be impossible. To think of a thing is to condition. Sir W. Hamilton.\n\n1. To invest with, or limit by, conditions; to burden or qualify by a condition; to impose or be imposed as the condition of. Seas, that daily gain upon the shore, Have ebb and flow conditioning their march. Tennyson. 2. To contract; to stipulate; to agree. It was conditioned between Saturn and Titan, that Saturn should put to death all his male children. Sir W. Raleigh. 3. (U. S. Colleges)  To put under conditions; to require to pass a new examination or to make up a specified study, as a condition of remaining in one's class or in college; as, to condition a student who has failed in some branch of study. 4. To test or assay, as silk (to ascertain the proportion of moisture it contains). McElrath.  train; acclimate.
conditional |1. Containing, implying, or depending on, a condition or conditions; not absolute; made or granted on certain terms; as, a conditional promise. Every covenant of God with man . . . may justly be made (as in fact it is made) with this conditional punishment annexed and declared. Bp. Warburton. 2. (Gram. & Logic)  Expressing a condition or supposition; as, a conditional word, mode, or tense. A conditional proposition is one which asserts the dependence of one categorical proposition on another. Whately. The words hypothetical and conditional may be . . . used synonymously. J. S. Mill.\n\n1. A limitation. [Obs.] Bacon. 2. A conditional word, mode, or proposition. Disjunctives may be turned into conditionals. L. H. Atwater.
conditionality |The quality of being conditional, or limited; limitation by certain terms.
conditionally |In a conditional manner; subject to a condition or conditions; not absolutely or positively. Shak.
conditionate |Conditional. [Obs.] Barak's answer is faithful, though conditionate. Bp. Hall.\n\n1. To qualify by conditions; to regulate. [Obs.] 2. To put under conditions; to render conditional.
conditioned |1. Surrounded; circumstanced; in a certain state or condition, as of property or health; as, a well conditioned man. The best conditioned and unwearied spirit. Shak. 2. Having, or known under or by, conditions or relations; not independent; not absolute. Under these, thought is possible only in the conditioned interval. Sir W. Hamilton.
conditionly |Conditionally. [Obs.]
conditory |A repository for holding things; a hinding place.
condog |To concur; to agree. [Burlesque] Note: This word appears in early dictionaries as a synonym for the word agree; thus. \"Agree; concurre, cohere, condog, condescend.\" Cockeram.
condolatory |Expressing condolence. Smart.
condole |To express sympathetic sorrow; to grieve in sympathy; -- followed by with. Your friends would have cause to rejoice, rather than condole with you. Sir W. Temple.\n\nTo lament or grieve over. [R.] I come not, Samson, to condole thy chance. Milton.
condolement |1. Condolence. \"A pitiful condolement.\" Milton. 2. Sorrow; mourning; lamentation. Shak.
condolence |Expression of sympathy with another in sorrow or grief. Their congratulations and their condolences. Steele. A special mission of condolence. Macaulay.
condoler |One who condoles.
condonation |1. The act of condoning or pardoning. 2. (Law)  Forgiveness, either express or implied, by a husband of his wife or by a wife of her husband, for a breach of marital duty, as adultery, with an implied condition that the offense shall not be repeated. Bouvier. Wharton.
condone |1. To pardon; to forgive. A fraud which he had either concocted or condoned. W. Black. It would have been magnanimous in the men then in power to have overlooked all these things, and, condoning the politics, to have rewarded the poetry of Burns. J. C. Shairp. 2. (Law)  To pardon; to overlook the offense of; esp., to forgive for a violation of the marriage law; -- said of either the husband or the wife.
condor |A very large bird of the Vulture family (Sarcorhamphus gryphus), found in the most elevated parts of the Andes.
condottiere |A military adventurer of the fourteenth and fifteenth centuries, who sold his services, and those of his followers, to any party in any contest.
conduce |To lead or tend, esp. with reference to a favorable or desirable result; to contribute; -- usually followed by to or toward. He was sensible how much such a union would conduce to the happiness of both. Macaulay. The reasons you allege do more conduce To the hot passion of distemper'd blood. Shak. Syn. -- To contribute; aid; assist; tend; subserve.\n\nTo conduct; to lead; to guide. [Obs.] He was sent to conduce hither the princess. Sir H. Wotton.
conducent |Conducive; tending. Conducent to the good success of this business. Abp. Laud.
conducibility |The state or quality of being conducible; conducibleness. Bp. Wilkins.
conducible |Conducive; tending; contributing. Bacon. All his laws are in themselves conducible to the temporal interest of them that observe them. Bentley.
conducibleness |Quality of being conducible.
conducibly |In a manner to promote. [R.]
conducive |Loading or tending; helpful; contributive; tending to promote. However conducive to the good or our country. Addison.
conduciveness |The quality of conducing.
conduct |1. The act or method of conducting; guidance; management. Christianity has humanized the conduct of war. Paley. The conduct of the state, the administration of its affairs. Ld. Brougham. 2. Skillful guidance or management; generalship. Conduct of armies is a prince's art. Waller. Attacked the Spaniards . . . with great impetuosity, but with so little conduct, that his forces were totally routed. Robertson. 3. Convoy; escort; guard; guide. [Archaic] I will be your conduct. B. Jonson. In my conduct shall your ladies come. Shak. 4. That which carries or conveys anything; a channel; a conduit; an instrument. [Obs.] Although thou been conduct of my chame. Shak. 5. The manner of guiding or carrying one's self; personal deportment; mode of action; behavior. All these difficulties were increased by the conduct of Shrewsbury. Macaulay. What in the conduct of our life appears So well designed, so luckily begun, But when we have our wish, we wish undone Dryden. 6. Plot; action; construction; manner of development. The book of Job, in conduct and diction. Macaulay. Conduct money (Naut.), a portion of a seaman's wages retained till the end of his engagement, and paid over only if his conduct has been satisfactory. Syn. -- Behavior; deportment; demeanor; bearing; management; guidance. See Behavior.\n\n1. To lead, or guide; to escort; to attend. I can conduct you, lady, to a low But loyal cottage, where you may be safe. Milton. 2. To lead, as a commander; to direct; to manage; to carry on; as, to conduct the affairs of a kingdom. Little skilled in the art of conducting a siege. Prescott. 3. To behave; -- with the reflexive; as, he conducted himself well. 4. (Physics)  To serve as a medium for conveying; to transmit, as heat, light, electricity, etc. 5. (Mus.)  To direct, as the leader in the performance of a musical composition.\n\n1. To act as a conductor (as of heat, electricity, etc.); to carry. 2. To conduct one's self; to behave. [U. S.]
conductance |Conducting power; -- the reciprocal of resistance. A suggested unit is the mho, the reciprocal of the ohm. Conductance is an attribute of any specified conductor, and refers to its shape, length, and other factors. Conductivity is an attribute of any specified material without direct reference to its shape or other factors. Sloane's Elec. Dict.
conductibility |1. Capability of being conducted; as, the conductibility of heat or electricity. 2. Conductivity; capacity for receiving and transmitting.
conductible |Capable of being conducted.
conduction |1. The act of leading or guiding. Sir W. Raleigh. 2. The act of training up. [Obs.] B. Jonson. 3. (Physics)  Transmission through, or by means of, a conductor; also, conductivity. [The] communication [of heat] from one body to another when they are in contact, or through a homogenous body from particle to particle, constitutes conduction. Amer. Cyc.
conductive |Having the quality or power of conducting; as, the conductive tissue of a pistil. The ovarian walls . . . are seen to be distinctly conductive. Goodale (Gray's Bot. ).
conductivity |The quality or power of conducting, or of receiving and transmitting, as, the conductivity of a nerve. Thermal conductivity (Physics), the quantity of heat that passes in unit time through unit area of plate whose thickness is unity, when its opposite faces differ in temperature by one degree. J. D. Everett. -- Thermometic conductivity (Physics), the thermal conductivity when the unit of heat employed is the heat required to raise unit volume of the substance one degree.
conductor |1. One who, or that which, conducts; a leader; a commander; a guide; a manager; a director. Zeal, the blind conductor of the will. Dryden. 2. One in charge of a public conveyance, as of a railroad train or a street car. [U. S.] 3. (Mus.)  The leader or director of an orchestra or chorus. 4. (Physics)  A substance or body capable of being a medium for the transmission of certain forces, esp. heat or electricity; specifically, a lightning rod. 5. (Surg.)  A grooved sound or staff used for directing instruments, as lithontriptic forceps, etc.; a director. 6. (Arch.)  Same as Leader. Prime conductor (Elec.), the largest conductor of an electrical machine, serving to collect, accumulate, or retain the electricity.
conductory |Having the property of conducting. [R.]
conductress |A woman who leads or directs; a directress.
conduit |1. A pipe, canal, channel, or passage for conveying water or fluid. All the conduits of my blood froze up. Shak. This is the fountain of all those bitter waters, of which, through a hundred different conduits, we have drunk. Burke. 2. (Arch.) (a) A structure forming a reservoir for water. Oxf. Gloss. (b) A narrow passage for private communication.
conduit railway |A system of electric traction, esp. for light railways, in which the actuating current passes along a wire or rail laid in an underground conduit, from which the current is \"picked up\" by a plow or other device fixed to the car or electric locomotive.  Hence Conduit railway.
conduit system |A system of electric traction, esp. for light railways, in which the actuating current passes along a wire or rail laid in an underground conduit, from which the current is \"picked up\" by a plow or other device fixed to the car or electric locomotive.  Hence Conduit railway.
conduplicate |Folded lengthwise along the midrib, the upper face being within; -- said of leaves or petals in vernation or æstivation.
conduplication |A doubling together or folding; a duplication. [R.]
condurango |See Cundurango.
condurrite |A variety of the mineral domeykite, or copper arsenide, from the Condurra mine in Cornwall, England.
condylar |Of or pertaining to a condyle. Condylar foramen (Anat.), a formen in front of each condyle of the occipital bone; -- sometimes called the anterior condylar foramen when a second, or posterior, foramen is present behind the condyle, as often happens in man.
condyle |A bony prominence; particularly, an eminence at the end of a bone bearing a rounded articular surface; -- sometimes applied also to a concave articular surface.
condyloid |Shaped like or pertaining to a condyle.
condyloma |A wartlike new growth on the outer skin or adjoining mucous membrance. Note: There are two kinds of condylomata, the pointed and the broad, the latter being of syphilitic origin.
condylome |A wartlike new growth on the outer skin or adjoining mucous membrance. Note: There are two kinds of condylomata, the pointed and the broad, the latter being of syphilitic origin.
condylopod |An arthropod.
cone |1. (Geom.)  A solid of the form described by the revolution of a right- angled triangle about one of the sides adjacent to the right angle; - - called also a right cone. More generally, any solid having a vertical point and bounded by a surface which is described by a straight line always passing through that vertical point; a solid having a circle for its base and tapering to a point or vertex. 2. Anything shaped more or less like a mathematical cone; as, a volcanic cone, a collection of scoriæ around the crater of a volcano, usually heaped up in a conical form. Now had Night measured with her shadowy cone Half way up hill this vast sublunar vault. Milton. 3. (Bot.)  The fruit or strobile of the Coniferæ, as of the pine, fir, cedar, and cypress. It is composed of woody scales, each one of which has one or two seeds at its base. 4. (Zoöl.)  A shell of the genus Conus, having a conical form. Cone of rays (Opt.), the pencil of rays of light which proceed from a radiant point to a given surface, as that of a lens, or conversely. -- Cone pulley. See in the Vocabulary. -- Oblique or Scalene cone, a cone of which the axis is inclined to the plane of its base. -- Eight cone. See Cone, 1.\n\nTo render coneshaped; to bevel like the circular segment of a cone; as, to cone the tires of car wheels.
cone clutch |A friction clutch with conical bearing surfaces.
cone pulley |A pulley for driving machines, etc., having two or more parts or steps of different diameters; a pulley having a conical shape.
cone-in-cone |Consisting of a series of parallel cones, each made up of many concentric cones closely packed together; -- said of a kind of structure sometimes observed in sedimentary rocks.
cone-nose |A large hemipterous insect of the family Reduviidæ, often found in houses, esp. in the southern and western United States. It bites severely, and is one of the species called kissing bugs. It is also called big bedbug.
coneflower |Any plant of the genus Rudbeckia; -- so called from the cone- shaped disk of the flower head. Also, any plant of the related genera Ratibida and Brauneria, the latter usually known as purple coneflower.
coneine |See Conine.
conepate |The skunk.
conepatl |The skunk.
conestoga wagon |A kind of large broad-wheeled wagon, usually covered, for traveling in soft soil and on prairies.
conestoga wain |A kind of large broad-wheeled wagon, usually covered, for traveling in soft soil and on prairies.
coney |1. (Zoöl.)  A rabbit. See Cony. 2. (Zoöl.)  A fish. See Cony.
confab |Familiar talk or conversation. [Colloq.]
confabulate |To talk familiarly together; to chat; to prattle. I shall not ask Jean Jaques Rousseau If birds confabulate or no. Cowper.
confabulation |Familiar talk; easy, unrestrained, unceremonious conversation. Friends' confabulations are comfortable at all times, as fire in winter. Burton.
confabulatory |Of the nature of familiar talk; in the form of a dialogue. Weever.
confalon |One of a fraternity of seculars, also called Penitents.
confarreation |A form of marriage among the Romans, in which an offering of bread was made, in presence of the high priest and at least ten witnesses.
confated |Fated or decreed with something else. [R.] A. Tucker.
confect |1. To prepare, as sweetmeats; to make a confection of. [Obs.] Saffron confected in Cilicia. W. Browne. 2. To construct; to form; to mingle or mix. [Obs.] Of this were confected the famous everlasting lamps and tapers. Sir T. Herbert. [My joys] are still confected with some fears. Stirling.\n\nA comfit; a confection. [Obs.] At supper eat a pippin roasted and sweetened with sugar of roses and caraway confects. Harvey.
confection |1. A composition of different materials. [Obs.] A new confection of mold. Bacon. 2. A preparation of fruits or roots, etc., with sugar; a sweetmeat. Certain confections . . . are like to candied conserves, and are made of sugar and lemons. Bacon. 3. A composition of drugs. Shak. 4. (Med.)  A soft solid made by incorporating a medicinal substance or substances with sugar, sirup, or honey. Note: The pharmacopoeias formerly made a distinction between conserves (made of fresh vegetable substances and sugar) and electuaries (medicinal substances combined with sirup or honey), but the distinction is now abandoned and all are called confections.
confectionary |A confectioner. [Obs.] He will take your daughters to be confectionaries, and to be cooks. 1 Sam. viii. 13.\n\nPrepared as a confection. The biscuit or confectionary plum. Cowper.
confectioner |1. A compounder. [Obs.] Canidia Neapolitana was confectioner of unguents. Haywood. 2. One whose occupation it is to make or sell confections, candies, etc. CONFECTIONERS' SUGAR Con*fec\"tion*ers' sug`ar.  A highly refined sugar in impalpable powder, esp. suited to confectioners' uses.
confectionery |1. Sweetmeats, in general; things prepared and sold by a confectioner; confections; candies. 2. A place where candies, sweetmeats, and similar things are made or sold.
confectory |Pertaining to the art of making sweetmeats. [Obs.] Beaumont.
confecture |Same as Confiture. [Obs.]
confeder |To confederate. [Obs.] Sir T. North.
confederacy |1. A league or compact between two or more persons, bodies of men, or states, for mutual support or common action; alliance. The friendships of the world are oft Confederacies in vice or leagues of pleasure. Addison. He hath heard of our confederacy. Shak. Virginia promoted a confederacy. Bancroft. 2. The persons, bodies, states, or nations united by a league; a confederation. The Grecian common wealth, . . . the most heroic confederacy that ever existed. Harris. Virgil has a whole confederacy against him. Dryden. 3. (Law)  A combination of two or more persons to commit an unlawful act, or to do a lawful act by unlawful means. See Conspiracy. Syn. -- League; compact; alliance; association; union; combination; confederation.
confederate |1. United in a league; allied by treaty; engaged in a confederacy; banded together; allied. All the swords In Italy, and her confederate arms, Could not have made this peace. Shak. 2. (Amer. Hist.)  Of or pertaining to the government of the eleven Southern States of the United States which (1860-1865) attempted to establish an independent nation styled the Confederate States of America; as, the Confederate congress; Confederate money.\n\n1. One who is united with others in a league; a person or a nation engaged in a confederacy; an ally; also, an accomplice in a bad sense. He found some of his confederates in gaol. Macaulay. 2. (Amer. Hist.)  A name designating an adherent to the cause of the States which attempted to withdraw from the Union (1860-1865).\n\nTo unite in a legue or confederacy; to ally. With these the Piercies them confederate. Daniel.\n\nTo unite in a league; to join in a mutual contract or covenant; to band together. By words men . . . covenant and confederate. South.
confederater |A confederate.
confederation |1. The act of confederating; a league; a compact for mutual support; alliance, particulary of princes, nations, or states. The three princes enter into some strict league and confederation among themselves. Bacon. This was no less than a political confederation of the colonies of New England. Palfrey. 2. The parties that are confederated, considered as a unit; a confederacy. Articles of confederation. See under Article.
confederative |Of or pertaining to a confederation.
confederator |A confederate. Grafton.
confer |1. To bring together for comparison; to compare. [Obs.] If we confer these observations with others of the like nature, we may find cause to rectify the general opinion. Boyle. 2. To grant as a possession; to bestow. The public marks of honor and reward Conferred upon me. Milton. 3. To contribute; to conduce. [Obs.] The closeness and compactness of the parts resting together doth much confer to the strength of the union. Glanvill.\n\nTo have discourse; to consult; to compare views; to deliberate. Festus, when he had conferred with the council, answered. Acts xxv. 12. You shall hear us confer of this. Shak. Syn. -- To counsel; advise; discourse; converse.
conferee |1. One who is conferred with, or who takes part in a conference; as, the conferees on the part of the Senate. 2. One upon whom something is conferred.
conference |1. The act of comparing two or more things together; comparison. [Obs.] Helps and furtherances which . . . the mutual conference of all men's collections and observations may afford. Hocker. 2. The act of consulting together formally; serious conversation or discussion; interchange of views. Nor with such free and friendly conference As he hath used of old. Shak. 3. A meeting for consultation, discussion, or an interchange of opinions. 4. A meeting of the two branches of a legislature, by their committees, to adjust between them. 5. (Methodist Church)  A stated meeting of preachers and others, invested with authority to take cognizance of ecclesiastical matters. 6. A voluntary association of Congregational churches of a district; the district in which such churches are. Conference meeting, a meeting for conference. Specifically, a meeting conducted (usually) by laymen, for conference and prayer. [U. S.] -- Conference room, a room for conference and prayer, and for the pastor's less formal addresses. [U. S.]
conferential |Relating to conference. [R.] Clarke.
conferrable |Capable of being conferred.
conferree |Same as Conferee.
conferrer |1. One who confers; one who converses. Johnson. 2. One who bestows; a giver.
conferruminate |Closely united by the coalescence, or sticking together, of contiguous faces, as in the case of the cotyledons of the live-oak acorn.
conferruminated |Closely united by the coalescence, or sticking together, of contiguous faces, as in the case of the cotyledons of the live-oak acorn.
conferva |Any unbranched, slender, green plant of the fresh-water algae. The word is frequently used in a wider sense.
confervaceous |Belonging to the confervae.
confervoid |Like, or related to, the confervae. Loudon.
confervous |Pertaining to confervae; consisting of, or resembling, the confervae. Yon exiguous pool's confervous scum. O. W. Holmes.
confess |1. To make acknowledgment or avowal in a matter pertaining to one's self; to acknowledge, own, or admit, as a crime, a fault, a debt. And there confess Humbly our faults, and pardon beg. Milton. I must confess I was most pleased with a beautiful prospect that none of them have mentioned. Addison. 2. To acknowledge faith in; to profess belief in. Whosoever, therefore, shall confess me before men, him will I confess, also, before my Father which is in heaven. Matt. x. 32. For the Sadducees say that there is no resurrection, neither angel, nor spirit; but the Pharisees confess both. Acts xxiii. 8. 3. To admit as true; to assent to; to acknowledge, as after a previous doubt, denial, or concealment. I never gave it him. Send for him hither, And let him confess a truth. Shak. As I confess it needs must be. Tennyson. As an actor confessed without rival to shine. Goldsmith. 4. (Eccl.) (a) To make known or acknowledge, as one's sins to a priest, in order to receive absolution; -- sometimes followed by the reflexive pronoun. Our beautiful votary took an opportunity of confessing herself to this celebrated father. Addison. (b) To hear or receive such confession; -- said of a priest. He . . . heard mass, and the prince, his son, with him, and the most part of his company were confessed. Ld. Berners. 5. To disclose or reveal, as an effect discloses its cause; to prove; to attest. Tall thriving trees confessed the fruitful mold. Pope. Syn. -- Admit; grant; concede; avow; own; assent; recognize; prove; exhibit; attest. -- To Confess, Acknowledge, Avow. Acknowledge is opposed to conceal. We acknowledge what we feel must or ought to be made known. (See Acknowledge.) Avow is opposed to withhold. We avow when we make an open and public declaration, as against obloquy or opposition; as, to avow one's principles; to avow one's participation in some act. Confess is opposed to deny. We confess (in the ordinary sense of the word) what we feel to have been wrong; as, to confess one's errors or faults. We sometimes use confess and acknowledge when there is no admission of our being in the wrong; as, this, I confess, is my opinion; I acknowledge I have always thought so; but in these cases we mean simply to imply that others may perhaps think us in the wrong, and hence we use the words by way of deference to their opinions. It was in this way that the early Christians were led to use the Latin confiteor and confessio fidei to denote the public declaration of their faith in Christianity; and hence the corresponding use in English of the verb confess and the noun confession.\n\n1. To make confession; to disclose sins or faults, or the state of the conscience. Every tongue shall confess to God. Rom. xiv. 11. 2. To acknowledge; to admit; to concede. But since (And I confess with right) you think me bound. Tennyson.
confessant |One who confesses to a priest. [Obs.] Bacon.
confessary |One who makes a confession. [Obs.] Bp. Hall.
confessedly |By confession; without denial. [Written also confessly.]
confesser |One who makes a confession.
confession |1. Acknowledgment; avowal, especially in a matter pertaining to one's self; the admission of a debt, obligation, or crime. With a crafty madness keeps aloof, When we would bring him on to some confession Of his true state. Shak. 2. Acknowledgment of belief; profession of one's faith. With the mouth confession is made unto salvation. Rom. x. 10. 3. (Eccl.)  The act of disclosing sins or faults to a priest in order to obtain sacramental absolution. Auricular confession . . . or the private and special confession of sins to a priest for the purpose of obtaining his absolution. Hallam. 4. A formulary in which the articles of faith are comprised; a creed to be assented to or signed, as a preliminary to admission to membership of a church; a confession of faith. 5. (Law)  An admission by a party to whom an act is imputed, in relation to such act. A judicial confession settles the issue to which it applies; an extrajudical confession may be explained or rebutted. Wharton. Confession and avoidance (Law), a mode of pleading in which the party confesses the facts as stated by his adversary, but alleges some new matter by way of avoiding the legal effect claimed for them. Mozley & W. Confession of faith, a formulary containing the articles of faith; a creed. -- General confession, the confession of sins made by a number of persons in common, as in public prayer. -- Westminster Confession. See Westminster Assembly, under Assembly.
confessional |The recess, seat, or inclosed place, where a priest sits to hear confessions; often a small structure furnished with a seat for the priest and with a window or aperture so that the penitent who is outside may whisper into the priest's ear without being seen by him or heard by others.\n\nPertaining to a confession of faith. Confessional equality, equality before the law of persons confessing different creeds.
confessionalism |An exaggerated estimate of the importance of giving full assent to any particular formula of the Christian faith. Shaff.
confessionalist |A priest hearing, or sitting to hear, confession. [R.] Boucher
confessionary |A confessional. [Obs.] Johnson.\n\nPertaining to auricular confession; as, a confessionary litany.
confessionist |One professing a certain faith. Bp. Montagu.
confessor |1. One who confesses; one who acknowledges a fault, or the truth of a charge, at the risk of suffering; specifically, one who confesses himself a follower of Christ and endures persecution for his faith. He who dies for religion is a martyr; he who suffers for it is a confessor. Latham. Our religion which hath been sealed with the blood of so many martyrs and confessors. Bacon. 2. A priest who hears the confessions of others and is authorized to grant them absolution.
confessorship |The act or state of suffering persecution for religious faith. Our duty to contend even to confessorship. J. H. Newman.
confestly |See Cofessedly.
confetti |Bonbons; sweetmeats; confections; also, plaster or paper imitations of, or substitutes for, bonbons, often used by carnival revelers, at weddings, etc.
confidant |One to whom secrets, especially those relating to affairs of love, are confided or intrusted; a confidential or bosom friend. You love me for no other end Than to become my confidant and friend; As such I keep no secret from your sight. Dryden.
confidante |One to whom secrets, especially those relating to affairs of love, are confided or intrusted; a confidential or bosom friend. You love me for no other end Than to become my confidant and friend; As such I keep no secret from your sight. Dryden.
confide |To put faith (in); to repose confidence; to trust; -- usually followed by in; as, the prince confides in his ministers. By thy command I rise or fall, In thy protection I confide. Byron. Judge before friendships, then confide till death. Young.\n\nTo intrust; to give in charge; to commit to one's keeping; -- followed by to. Congress may . . . confide to the Circuit jurisdiction of all offenses against the United States. Story.
confidence |1. The act of confiding, trusting, or putting faith in; trust; reliance; belief; -- formerly followed by of, now commonly by in. Society is built upon trust, and trust upon confidence of one another's integrity. South. A cheerful confidence in the mercy of God. Macaulay. 2. That in which faith is put or reliance had. The Lord shall be thy confidence. Prov. iii. 26. 3. The state of mind characterized by one's reliance on himself, or his circumstamces; a feeling of self-sufficiency; such assurance as leads to a feeling of security; self-reliance; -- often with self prefixed. Your wisdom is consumed in confidence; Do not go forth to-day. Shak. But confidence then bore thee on secure Either to meet no danger, or to find Matter of glorious trial. Milton. 4. Private conversation; (pl.) secrets shared; as, there were confidences between them. Sir, I desire some confidence with you. Shak. Confidence game, any swindling operation in which advantage is taken of the confidence reposed by the victim in the swindler. -- Confidence man, a swindler. -- To take into one's confidence, to admit to a knowledge of one's feelings, purposes, or affairs. Syn. -- Trust; assurance; expectation; hope. I am confident that very much be done. Boyle. 2. Trustful; without fear or suspicion; frank; unreserved. Be confident to speak, Northumberland; We three are but thyself. Shak. 3. Having self-reliance; bold; undaunted. As confident as is the falcon's flight Against a bird, do I with Mowbray fight. Shak. 4. Having an excess of assurance; bold to a fault; dogmatical; impudent; presumptuous. The fool rageth and is confident. Prov. xiv. 16. 5. Giving occasion for confidence. [R.] The cause was more confident than the event was prosperious. Jer. Taylor.
confident |See Confidant. South. Dryden.
confidential |1. Enjoying, or treated with, confidence; trusted in; trustworthy; as, a confidential servant or clerk. 2. Communicated in confidence; secret. \"Confidential messages.\" Burke. Confidential communication (Law) See Privileged communication, under Privileged. -- Confidential creditors, those whose claims are of such a character that they are entitled to be paid before other creditors. -- Confidential debts, debts incurred for borrowed money, and regarded as having a claim to be paid before other debts. McElrath.
confidentially |In confidence; in reliance on secrecy.
confidently |With confidence; with strong assurance; positively.
confidentness |The quality of being confident.
confider |One who confides.
confiding |That confides; trustful; unsuspicious. -- Con*fid\"ing*ly, adv. -- Con*fid\"ing*ness, n.
configurate |To take form or position, as the parts of a complex structure; to agree with a pattern. Known by the name of uniformity; Where pyramids to pyramids relate And the whole fabric doth configurate. Jordan.
configuration |1. Form, as depending on the relative disposition of the parts of a thing' shape; figure. It is the variety of configurations [of the mouth] . . . which gives birth and origin to the several vowels. Harris. 2. (Astrol.)  Relative position or aspect of the planets; the face of the horoscope, according to the relative positions of the planets at any time. They [astrologers] undertook . . . to determine the course of a man's character and life from the configuration of the stars at the moment of his birth. Whewell.
configure |To arrange or dispose in a certain form, figure, or shape. Bentley.
confinable |Capable of being confined, restricted, or limited. Not confinable to any limits. Bp. Hall.
confine |To restrain within limits; to restrict; to limit; to bound; to shut up; to inclose; to keep close. Now let not nature's hand Keep the wild flood confined! let order die! Shak. He is to confine himself to the compass of numbers and the slavery of rhyme. Dryden. To be confined, to be in childbed. Syn. -- To bound; limit; restrain; imprison; immure; inclose; circumscribe; restrict.\n\n(v. i. To have a common boundary; to border; to lie contiguous; to touch; -- followed by on or with. [Obs.] Where your g;oomy bounds Confine with heaven. Milton. Beywixt hezven and earth and skies there stands a place. Confuining on all three. Dryden.\n\n1. Common boundary; border; limit; -- used chiefly in the plural. Events that came to pass within the confines of Judea. Locke. And now in little space The confines met of emryrean heaven, And of this world. Milton. On the confines of the city and the Temple. Macaulay. 2. Apartment; place of restraint; prison. [Obs.] Confines, wards, and dungeons. Shak. The extravagant and erring spirit hies To his confine. Shak.
confineless |Without limitation or end; boundless. Shak.
confinement |1. Restraint within limits; imprisonment; any restraint of liberty; seclusion. The mind hates restraint, and is apt to fancy itself under confinement when the sight is pent up. Addison. 2. Restraint within doors by sickness, esp. that caused by childbirth; lying-in.
confiner |One who, or that which, limits or restrains.\n\nOne who lives on confines, or near the border of a country; a borderer; a near neighbor. [Obs.] Bacon. Happy confiners you of other lands, That shift your soil, and oft 'scape tyrants' hands. Daniel.
confinity |Community of limits; contiguity. [R.] Bailey.
confirm |1. To make firm or firmer; to add strength to; to establish; as, health is confirmed by exercise. Confirm the crown to me and to mine heirs. Shak. Annd confirmed the same unto Jacob for a law. Ps. cv. 10. 2. To strengthen in judgment or purpose. Confirmed, then, I resolve Adam shall share with me in bliss or woe. Milton. 3. To give new assurance of the truth of; to render certain; to verify; to corroborate; as, to confirm a rumor. Your eyes shall witness and confirm my tale. Pope. These likelihoods confirm her flight. Shak. 4. To render valid by formal assent; to complete by a necessary sanction; to ratify; as, to confirm the appoinment of an official; the Senate confirms a treaty. That treaty so prejudicial ought to have been remitted rather than confimed. Swift. 5. (Eccl.)  To administer the rite of confirmation to. See Confirmation, 3. Those which are thus confirmed are thereby supposed to be fit for admission to the sacrament. Hammond. Syn. -- To strengthen; corroborate; substantiate; establish; fix; ratify; settle; verify; assure.
confirmable |That may be confirmed.
confirmance |Confirmation. [Obs.]
confirmation |1. The act of confirming or strengthening; the act of establishing, ratifying, or sanctioning; as, the confirmation of an appointment. Their blood is shed In confirmation of the noblest claim. Cowper. 2. That which confirms; that which gives new strength or assurance; as to a statement or belief; additional evidence; proof; convincing testimony. Trifles light as air Are to the jealous confirmations strong As proofs of holy writ. Shak. 3. (Eccl.)  A rite supplemental to baptism, by which a person is admitted, through the laying on of the hands of a bishop, to the full privileges of the church, as in the Roman Catholic, the Episcopal Church, etc. This ordinance is called confirmation, because they who duly receive it are confirmed or strengthened for the fulfillment of their Christian duties, by the grace therein bestowed upon them. Hook. 4. (Law)  A conveyance by which a voidable estate is made sure and not voliable, or by which a particular estate is increased; a contract, express or implied, by which a person makes that firm and binding which was before voidable.
confirmative |Tending confirm or establish. Sherwood. -- Con*firm\"a*tive*ly, adv.
confirmator |One who, or that which, confirms; a confirmer. Sir T. Browne.
confirmatory |Serving to confirm; corroborative. A fact confirmatory of the conclusion. I. Taylor. 2. Pertaining to the rite of confirmation. Compton.
confirmedly |With confirmation.
confirmedness |A fixed state.
confirmee |One to whom anuthing is confirmed.
confirmer |One who, or that which, confirms, establishes, or ratifies; one who corroborates. Shak.
confirmingly |In a confirming manner.
confiscable |Capable of being confiscated; liable to forfeiture.
confiscate |Seized and appropriated by the government to the public use; forfeited. Lest that your goods too soon be confiscate. Shak.\n\nTo seize as forfeited to the public treasury; to appropriate to the public use. It was judged that he should be banished and his whole estate confiscated and seized. Bacon.
confiscation |The act or process of taking property or condemning it to be taken, as forfeited to the public use. The confiscations following a subdued rebellion. Hallam.
confiscator |One who confiscates. Burke.
confiscatory |Effecting confiscation; characterized by confiscations. \"Confiscatory and exterminatory periods.\" Burke.
confit |Same as Comfit. [Obs.]
confitent |One who confesses his sins and faults. [Obs.]
confiteor |A form of prayer in which public confession of sins is made.
confiture |The state or quality of being congenial; natural affinity; adaptation; suitableness. Sir J. Reynolds. If congeniality of tastes could have made a marriage happy, that union should have been thrice blessed. Motley.
confix |To fix; to fasten. [Obs.]  Shak.
confixure |Act of fastening. [Obs.]
conflagrant |Burning together in a common flame. [R.] \"The conflagrant mass.\"  Milton.
conflagration |A fire extending to many objects, or over a large space; a general burning. Till one wide conflagration swallows all. Pope.
conflate |To blow together; to bring together; to collect;  to fuse together; to join or weld; to consolidate. The State-General, created and conflated by the passionate effort of the whole nation. Carlyle.
conflation |A blowing together, as of many instruments in a concert, or of many fires in a foundry. [R.]  Bacon.
conflict |1. A striking or dashing together; violent collision; as, a conflict of elements or waves. 2.  A strife for the mastery; hostile contest; battle; struggle; fighting. As soon as he [Atterbury] was himself again, he became eager for action and conflict. Macaulay. An irrepressible conflict between opposing and enduring forces. W. H. Seward. Conflict of laws, that branch of jurisprudence which deals with individual litigation claimed to be subject to the conflicting laws of two or more states or nations; -- often used as synonymous with Private international law. Syn. -- Contest; collision; struggle; combat; strife; contention; battle; fight; encounter. See Contest.\n\n1. To strike or dash together; to meet in violent collision; to collide. Shak. Fire and water conflicting together. Bacon. 2.  To maintain a conflict; to contend; to engage in strife or opposition; to struggle. A man would be content to . . . conflict with great difficulties, in hopes of a mighty reward. Abp. Tillotson. 3.  To be in opposition; to be contradictory. The laws of the United States and of the individual States may, in some cases, conflict with each other. Wheaton. Syn. -- To fight; contend; contest; resist; struggle; combat; strive; battle.
conflicting |Being in conflict or collision, or in opposition; contending; contradictory; incompatible; contrary; opposing. Torn with sundry conflicting passions. Bp. Hurd.
conflictive |Tending to conflict; conflicting.  Sir W. Hamilton.
confluence |1. The act of flowing together; the meeting or junction of two or more streams; the place of meeting. New York stood at the confluence of two rivers. Bancroft. 2.  Any running together of separate streams or currents; the act of meeting and crowding in a place; hence, a crowd; a concourse; an assemblage. You see this confluence, this great flood of vistors. Shak. The confluence . . . of all true joys. Boyle.
confluent |1. Flowing together; meeting in their course; running one into another. These confluent steams make some great river's head. Blackmore. 2.  (Bot.) Blended into one; growing together, so as to obliterate all distinction. 3.  (Med.) (a) Running together or uniting, as pimples or pustules. (b) Characterized by having the pustules, etc., run together or unite, so as to cover the surface; as, confluent smallpox. Dunglison.\n\n1. A small steam which flows into a large one. 2.  The place of meeting of steams, currents, etc. [Obs.]  Holland.
conflux |1. A flowing together; a meeting of currents. \"The conflux of meeting sap.\"  Shak. The general conflux and concourse of the whole people. Clarendon. 2.  A large assemblage; a passing multitude. To the gates cast round thine eye, and see What conflux issuing forth, or entering in. Milton.
confluxibility |The  tendency of fluids to run together. [R.] Boyle.
confluxible |Inclined to flow or run together. --Con*flux\"i*ble*ness, n.
confocal |Having the same foci; as, confocal quadrics.
conform |Of the same form; similar in import; conformable.  Bacon. Care must be taken that the interpretation be every way conform to the analogy of faith. Bp.Hall.\n\n1. To be in accord or harmony; to comply; to be obedient; to submit; -- with to or with. A rule to which experience must conform. Whewell. 2.  (Eng. Eccl. Hist.) To comply with the usages of the Established Church; to be a conformist. About two thousand ministers whose consciences did not suffer them to conform were driven from their benefices in a day. Macaulay.\n\nTo shape in accordance with; to make like; to bring into harmony or agreement with; -- usually with to or unto. Demand of them wherefore they conform not themselves unto the order of the church. Hooker.
conformability |1. The state of being conformable. 2.  (Geol.) The parallelism of two sets of strata which are in contact.
conformable |1. Corresponding in form, character, opinions, etc.; similar; like; consistent; proper or suitable; --usually followed by to. The fragments of Sappho give us a taste of her way of writing perfectly conformable with that character. Addison. Conformable to Scripture as well as to philosophy. Whewell. To make matters somewhat conformable for the old knight. Sir W. Scott. 2. Disposed to compliance or obedience; ready to follow directions; submissive; compliant. I have been to you a true and humble wife, At all times to your will conformable. Shak. 3.  (Geol.) Parallel, or nearly so; -- said of strata in contact.
conformableness |The quality of being conformable; conformability.
conformably |With conformity or in conformity; suitably; agreeably. Conformably to the law and nature of God. Bp. Beveridge.
conformance |Conformity. [R.]  Marston.
conformate |Having the same form. [R.]
conformation |1. The act of conforming; the act of producing conformity. The conformation of our hearts and lives to the duties of true religion and morality. I. Watts. 2.  The state of being conformed; agreement; hence; structure, as depending on the arrangement of parts; form; arrangement. In Hebrew poetry, there may be observed a certain conformation of the sentences. Lowth. A structure and conformation of the earth. Woodward.
conformator |An apparatus for taking the conformation of anything, as of the head for fitting a hat, or, in craniometry, finding the largest horizontal area of the head.
conformer |One who conforms; one who complies with established forms or doctrines.
conformist |One who conforms or complies; esp., one who conforms to the Church of England, or to the Established Church, as distinguished from a dissenter or nonconformist. A cheeful conformist to your judgment. Jer.Taylor.
conformity |1. Correspondence in form, manner, or character; resemblance; agreement; congruity; -- followed by to, with, or between. By our conformity to God. Tillotson. The end of all religion is but to draw us to a conformity with God. Dr. H.More. A conformity between the mental taste and the sensitive taste. Addison. 2.  (Eng. Eccl. Hist.) Compliance with the usages of the Established Church. The king [James I.] soon afterward put forth a proclamation requiring all ecclesiastical and civil officers to do their duty by enforcing conformity. Hallam.
confortation |The act of strengthening. [Obs.]  Bacon.
confound |1. To mingle and blend, so that different elements can not be distinguished; to confuse. They who strip not ideas from the marks men use for them, but confound them with words, must have endless dispute. Locke. Let us go down, and there confound their language. Gen. xi. 7. 2.  To mistake for another; to identify falsely. They [the tinkers] were generally vagrants and pilferers, and were often confounded with the gypsies. Macaulay. 3.  To throw into confusion or disorder; to perplex; to strike with amazement; to dismay. The gods confound... The Athenians both within and out that wall. Shak. They trusted in thee and were not confounded. Ps. xxii. 5. So spake the Son of God, and Satan stood A while as mute, confounded what to say. Milton. 4.  To destroy; to ruin; to waste. [Obs.] One man's lust these many lives confounds. Shak. How couldst thou in a mile confound an hour Shak. Syn. -- To abash; confuse; baffle; dismay; astonish; defeat; terrify; mix; blend; intermingle. See Abash.
confounded |1. Confused; perplexed. A cloudy and confounded philosopher. Cudworth. 2.  Excessive; extreme; abominable. [Colloq.] He was a most confounded tory. Swift. The tongue of that confounded woman. Sir. W. Scott.
confoundedly |Extremely; odiously; detestably. [Colloq.] \"Confoundedly sick.\" Goldsmith.
confoundedness |The state of being confounded. Their witty descant of my confoundedness. Milton.
confounder |One who confounds.
confract |Broken in pieces; severed. [Obs.]
confragose |Broken; uneven. [Obs.] \"Confragose cataracts.\"  Evelyn.
confraternity |A society or body of men united for some purpose, or in some profession; a brotherhood. These live in one society and confraternity. Stow.
confrere |Fellow member of a fraternity; intimate associate.
confrication |A rubbing together; friction. [Obs.] Bacon.
confrier |A confrère. [Obs.]  Weever.
confront |1. To stand facing or in front of; to face; esp. to face hostilely; to oppose with firmness. We four, indeed, confronted were with four In Russian habit. Shak. He spoke and then confronts the bull. Dryden. Hester caught hold of Pearl, and drew her forcibly into her arms, confronting the old Puritan magistrate with almost a fierce expression. Hawthorne. It was impossible at once to confront the might of France and to trample on the liberties of England. Macaulay. 2.  To put face to face; to cause to face or to meet; as, to confront one with the proofs of his wrong doing. 3.  To set in opposition for examination; to put in contrast; to compare. When I confront a medal with a verse, I only show you the same design executed by different hands. Addison.
confrontation |Act of confronting.  H. Swinburne.
confronte |Same as Affronté.
confronter |One who confronts. A confronter in authority. Speed.
confronting |dealing with (a person or problem) directly; taking the bull by the horns. Syn. -- braving, coping with, grappling, tackling. [WordNet 1.5 +PJC]
confrontment |The act of confronting; the state of being face to face.\n\nThe act of confronting; the state of being face to face.
confucian |Of, or relating to, Confucius, the great Chinese philosopher and teacher. -- n.  A Confucianist.
confucianism |The political morality taught by Confucius and his disciples, which forms the basis of the Chinese jurisprudence and education. It can hardly be called a religion, as it does not inculcate the worship of any god.  S. W. Williams.
confucianist |A follower of Confucius; a Confucian.  S. W. Williams.
confus |Confused, disturbed. [Obs.]  Chaucer.
confusability |Capability of being confused.
confusable |Capable of being confused.
confuse |Mixed; confounded. [Obs.] Baret.\n\n1. To mix or blend so that things can not be distinguished; to jumble together; to confound; to render indistinct or obscure; as, to confuse accounts; to confuse one's vision. A universal hubbub wild Of stunning sounds and voices all confused. Milton. 2.  To perplex; to disconcert; to abash; to cause to lose self- possession. Nor thou with shadowed hint confuse A life that leads melodious days. Tennyson. Confused and sadly she at length replied. Pope. Syn. -- To abash; disorder; disarrange; disconcert; confound; obscure; distract. See Abash.
confusedly |In a confused manner.
confusedness |A state of confusion.  Norris.
confusely |Confusedly; obscurely. [Obs.]
confusion |1. The state of being mixed or blended so as to produce indistinctness or error; indistinct combination; disorder; tumult. The confusion of thought to which the Aristotelians were liable. Whewell. Moody beggars starving for a time Of pellmell havoc and confusion. Shak. 2.  The state of being abashed or disconcerted; loss self-possession; perturbation; shame. Confusion dwelt in every face And fear in every heart. Spectator. 3.  Overthrow; defeat; ruin. Ruin seize thee, ruthless king, Confusion on thy banners wait. Gray. 4.  One who confuses; a confounder. [Obs.]  Chapmen. Confusion of goods (Law), the intermixture of the goods of two or more persons, so that their respective portions can no longer be distinguished. Blackstone.  Bouvier.
confusive |Confusing; having a tendency to confusion.  Bp. Hall.
confutable |That may be confuted. A conceit . . . confutable by daily experience. Sir T.Browne.
confutant |One who undertakes to confute.  Milton.
confutation |The act or process of confuting; refutation.  \"For the edification of some and the confutation of others.\"  Bp. Horne.
confutative |Adapted or designed to confute.  Bp. Warburton
confute |To overwhelm by argument; to refute conclusively; to prove or show to be false or defective; to overcome; to silence. Satan stood . . . confuted and convinced Of his weak arguing fallacious drift. Milton. No man's error can be confuted who doth not . . . grant some true principle that contradicts his error. Chillingworth. I confute a good profession with a bad conversation. Fuller. Syn. -- To disprove; overthrow; sed aside; refute; oppugn. -- To Confute, Refute. Refute is literally to and decisive evidence; as, to refute a calumny, charge, etc. Confute is literally to check boiling, as when cold water is poured into hot, thus serving to allay, bring down, or neutralize completely. Hence, as applied to arguments (and the word is never applied, like refute, to charges), it denotes, to overwhelm by evidence which puts an end to the case and leaves an opponent nothing to say; to silence; as, \"the atheist is confuted by the whole structure of things around him.\",
  "prescapula |The part of the scapula in front of, or above, the spine, or mesoscapula.
confutement |Confutation. [Obs.]  Milton.
confuter |One who confutes or disproves.
cong |An abbreviation of Congius.
conge |To take leave with the customary civilities; to bow or courtesy. I have congeed with the duke, done my adieu with his  nearest. Shak.\n\n1. The act of taking leave; parting ceremony; farewell; also, dismissal. Should she pay off old Briggs and give her her congé Thackeray. 2.  The customary act of civility on any occasion; a bow or a courtesy. The captain salutes you with congé profound. Swift. 3.  (Arch.) An apophyge. Gwilt. Congé d'élire [F., leave to choose] (Eccl.), the sovereign's license or permission to a dean and chapter to choose as bishop the person nominated in the missive.
congeable |Permissible; done lawfully; as, entry congeable.
congeal |1. To change from a fluid to a solid state by cold; to freeze. A vapory deluge lies to snow congealed. Thomson. 2.  To affect as if by freezing; to check the flow of, or cause to run cold; to chill. As if with horror to congeal his blood. Stirling.\n\nTo grow hard, stiff, or thick, from cold or other causes; to become solid; to freeze; to cease to flow; to run cold; to be chilled. Lest zeal, now melted . . . Cool and congeal again to what it was. Shak.
congealable |Capable of being congealed. --Con*geal\"a*ble*ness, n.
congealedness |The state of being congealed.  Dr. H.More.
congealment |1. The act or the process of congealing; congeliation. 2.  That which is formed by congelation; a clot. [Obs.] Wash the congealment from your wounds. Shak.
congee |See Congé, Conge. [Obs.] And unto her his congee came to take. Spenser.\n\n1. [Tamil kashi boilings.]  Boiled rice; rice gruel. [India] 2.  A jail; a lockup. [India] Congee discharges, rice water discharges. Dunglison. -- Congee water, water in which rice has been boiled.
congelation |1. The act or process of passing, or causing to pass, from a fluid to a solid state, as by the abstraction of heat; the act or process of freezing. The capillary tubes are obstructed either by outward compression or congelation of the fluid. Arbuthnot. 2.  The state of being congealed. 3.  That which is congealed. Sugar plums . . . with a multitude of congelations in jellies of various colors. Taller.
congener |A thing of the same genus, species, or kind; a thing allied in nature, character, or action. The cherry tree has been often grafted on the laurel, to which it is a congener. P. Miller. Our elk is more polygamous in his habits than any other deer except his congener, the red deer of Europe. Caton.
congeneracy |Similarity of origin; affinity. [Obs.]  Dr. H. More.
congeneric |Belonging to the same genus; allied in origin, nature, or action.  R. Owen.
congenerical |Belonging to the same genus; allied in origin, nature, or action.  R. Owen.
congenerous |Allied in origin or cause; congeneric; as, congenerous diseases. [Obs.]  Sir T. Browne. -- Con*gen\"er*ous*ness, n. [Obs.] Hallywell.
congenial |1. Partaking of the same nature; allied by natural characteristics; kindred; sympathetic. Congenial souls! whose life one avarice joins. Pope. 2.  Naturally adapted; suited to the disposition. \"Congenial clime.\" C. J. Fox. To defame the excellence with which it has no sympathy . . . is its congenial work. I. Taylor.
congeniality |The state or quality of being congenial; natural affinity; adaptation; suitableness.  Sir J. Reynolds. If congeniality of tastes could have made a marriage happy, that union should have been thrice blessed. Motley.
congenialize |To make congenial. [R.]
congenially |In a congenial manner; as, congenially married or employed.
congenialness |Congeniality.
congenious |Congeneric. [Obs.]
congenital |Existing at, or dating from, birth; pertaining to one from birth; born with one; connate; constitutinal; natural; as, a congenital deformity. See Connate.
congenitally |In a congenital manner.
congenite |Congenital; connate; inborn. See Congenital. [Obs.] Many conclusions, of moral and intellectual truths, seem . . . to be congenite with us. Sir M. Hale.
conger |The conger eel; -- called also congeree. Conger sea (Zoöl.), the sea eel; a large species of eel (Conger vulgaris), which sometimes grows to the length of ten feet.
congeries |A collection of particles or bodies into one mass; a heap; an aggregation.
congest |1. To collect or gather into a mass or aggregate; to bring together; to accumulate. To what will thy congested guilt amount Blackmore. 2. (Med.)  To cause an overfullness of the blood vessels (esp. the capillaries) of an organ or part.
congested |1. (Bot.)  Crowded together. Gray. 2. (Med.)  Containing an unnatural accumulation of blood; hyperæmic; -- said of any part of the body.
congestion |1. The act of gathering into a heap or mass; accumulation. [Obs.] The congestion of dead bodies one upon another. Evelyn. 2. (Med.)  Overfullness of the capillary and other blood vessels, etc., in any locality or organ (often producing other morbid symptoms); local hyperas, arterial congestion; venous congestion; congestion of the lungs.
congestive |Pertaining to, indicating, or attended with, congestion in some part of the body; as, a congestive fever.
congiary |A present, as of corn, wine, or oil, made by a Roman emperor to the soldiers or the people; -- so called because measured to each in a congius. Addison. Note: In later years, when gifts of money were distributed, the name congius was retained.
congius |1. (Roman Antiq.)  A liquid measure containing about three quarts. 2. (Med.)  A gallon, or four quarts. [Often abbreviated to cong.]
conglaciate |To turn to ice; to freeze. [Obs.] Sir T. Browne.
conglaciation |The act or process of changing into ice, or the state of being converted to ice; a freezing; congelation; also, a frost. Bacon.
conglobate |Collected into, or forming, a rounded mass or ball; as, the conglobate [lymphatic] glands; conglobate flowers.\n\nTo collect or form into a ball or rounded mass; to gather or mass together. Conglobated bubbles undissolved. Wordsworth.
conglobation |1. The act or process of forming into a ball. Sir T. Browne. 2. A round body.
conglobe |To gather into a ball; to collect into a round mass. Then founded, then conglobed Like things to like. Milton.\n\nTo collect, unite, or coalesce in a round mass. Milton.
conglobulate |To gather into a small round mass.
conglomerate |1. Gathered into a ball or a mass; collected together; concentrated; as, conglomerate rays of light. Beams of light when they are multiplied and conglomerate. Bacon. Fluids are separated in the liver and the other conglobate and conglomerate glands. Cheyne. 2. (Bot.)  Closely crowded together; densly clustered; as, conglomerate flowers. Gray. 3. (Geol.)  Composed of stones, pebbles, or fragments of rocks, cemented together.\n\n1. That which is heaped together in a mass or conpacted from various sources; a mass formed of fragments; collection; accumulation. A conglomerate of marvelous anecdotes, marvelously heaped together. Trench. 2. (Geol.)  A rock, composed or rounded fragments of stone cemented together by another mineral substance, either calcareous, siliceous, or argillaceous; pudding stone; -- opposed to agglomerate. See Breccia. A conglomerate, therefore, is simply gravel bound together by a cement. Lyell.\n\nTo gather into a ball or round body; to collect into a mass.
conglomeration |The act or process of gathering into a mass; the state of being thus collected; collection; accumulation; that which is conglomerated; a mixed mass. Bacon.
conglutin |A variety of vegetable casein, resembling legumin, and found in almonds, rye, wheat, etc.
conglutinant |Cementing together; uniting closely; causing to adhere; promoting healing, as of a wound or a broken bone, by adhesion of the parts.
conglutinate |Glued together; united, as by some adhesive substance.\n\nTo glue together; to unite by some glutinous or tenacious substance; to cause to adhere or to grow together. Bones . . . have had their broken parts conglutinated within three or four days. Boyle.\n\nTo unite by the intervention of some glutinous substance; to coalesce.
conglutination |A gluing together; a joining by means of some tenacious substance; junction; union. Conglutination of parts separated by a wound. Arbuthnot.
conglutinative |Conglutinant.
congo |Black tea, of higher grade (finer leaf and less dusty) than the present bohea. See Tea. Of black teas, the great mass is called Congou, or the \"well worked\| a name which took the place of the Bohea of 150 years ago| and is now itself giving way to the term \"English breakfast tea.\" S. W. Williams."
congo group |A group of artificial dyes with an affinity for vegetable fibers, so that no mordant is required. Most of them are azo compounds derived from benzidine or tolidine. Called also benzidine dyes.
congo red |An artificial red dye from which the Congo group received its name. It is also widely used either in aqueous solution or as test paper (Congo paper) for the detection of free acid, which turns it blue.
congo snake |An amphibian (Amphiuma means) of the order Urodela, found in the southern United States. See Amphiuma.
congou |Black tea, of higher grade (finer leaf and less dusty) than the present bohea. See Tea. Of black teas, the great mass is called Congou, or the \"well worked\| a name which took the place of the Bohea of 150 years ago| and is now itself giving way to the term \"English breakfast tea.\" S. W. Williams."
congratulant |Rejoicing together; congratulatory. With like joy Congratulant approached him. Milton.
congratulate |To address with expressions of sympathetic pleasure on account of some happy event affecting the person addressed; to wish joy to. It is the king's most sweet pleasure and affection to congratulate the princess at her pavilion. Shak. To congratulate one's self, to rejoice; to feel satisfaction; to consider one's self happy or fortunate. Syn. -- To Congratulate, Felicitate. To felicitate is simply to wish a person joy. To congratulate has the additional signification of uniting in the joy of him whom we congratulate. Hence they are by no means synonymous. One who has lost the object of his affections by her marriage to a rival, might perhaps felicitate that rival on his success, but could never be expected to congratulate him on such an event. Felicitations are little better than compliments; congratulations are the expression of a genuine sympathy and joy. Trench.\n\nTo express of feel sympathetic joy; as, to congratulate with one's country. [R.] Swift. The subjects of England may congratulate to themselves. Dryden.
congratulation |The act of congratulating; an expression of sympathetic pleasure. With infinite congratulations for our safe arrival. Dr. J. Scott.
congratulator |One who offers congratulation. Milton.
congratulatory |Expressive of sympathetic joy; as, a congratulatory letter.
congree |To agree. [bs.] Shak.
congreet |To salute mutually. [Obs.]
congregate |Collected; compact; close. [R.] Bacon.\n\nTo collect into an assembly or assemblage; to assemble; to bring into one place, or into a united body; to gather together; to mass; to compact. Any multitude of Christian men congregated may be termed by the name of a church. Hooker. Cold congregates all bodies. Coleridge. The great receptacle Of congregated waters he called Seas. Milton.\n\nTo come together; to assemble; to meet. Even there where merchants most do congregate. Shak.
congregation |1. The act of congregating, or bringing together, or of collecting into one aggregate or mass. The means of reduction in the fire is but by the congregation of homogeneal parts. Bacon. 2. A collection or mass of separate things. A foul and pestilent congregation of vapors. Shak. 3. An assembly of persons; a gathering; esp. an assembly of persons met for the worship of God, and for religious instruction; a body of people who habitually so meet. He [Bunyan] rode every year to London, and preached there to large and attentive congregations. Macaulay. 4. (Anc. Jewish Hist.)  The whole body of the Jewish people; -- called also Congregation of the Lord. It is a sin offering for the congregation. Lev. iv. 21. 5. (R. C. Ch.) (a) A body of cardinals or other ecclesiastics to whom as intrusted some departament of the church business; as, the Congregation of the Propaganda, which has charge of the missions of the Roman Catholic Church. (b) A company of religious persons forming a subdivision of a monastic order. 6. The assemblage of Masters and Doctors at Oxford or Cambrige University, mainly for the granting of degrees. [Eng.] 7. (Scotch Church Hist.)  the name assumed by the Protestant party under John Knox. The leaders called themselves (1557) Lords of the Congregation.
congregational |1. Of or pertaining to a congregation; conducted, or participated in, by a congregation; as, congregational singing. 2. Belonging to the system of Congregationalism, or to Congregationalist; holding to the faith and polity of Congregationalism; as, a Congregational church.
congregationalism |1. That system of church organization which vests all ecclesiastical power in the assembled brotherhood of each local church. 2. The faith and polity of the Congregational churches, taken collectively. Note: In this sense (which is its usual signification) Congregationalism is the system of faith and practice common to a large body of evangelical Trinitarian churches, which recognize the local brotherhood of each church as independent of all dictation in ecclesiastical matters, but are united in fellowship and joint action, as in councils for mutual advice, and in consociations, conferences, missionary organizations, etc., and to whose membership the designation \"Congregationalists\" is generally restricted; but Unitarian and other churches are Congregational in their polity.
congregationalist |One who belongs to a Congregational church or society; one who holds to Congregationalism.
congress |1. A meeting of individuals, whether friendly or hostile; an encounter. [Obs.] Here Pallas urges on, and Lausus there;congress in the field great Jove withstands. Dryden. 2. A sudden encounter; a collision; a shock; -- said of things. [Obs.] From these laws may be deduced the rules of the congresses and reflections of two bodies. Cheyne. 3. The coming together of a male and female in sexual commerce; the act of coition. Pennant. 4. A gathering or assembly; a conference. 5. A formal assembly, as of princes, deputies, representatives, envoys, or commissioners; esp., a meeting of the representatives of several governments or societies to consider and determine matters of common interest. The European powers strove to . . . accommodate their differences at the congress of Vienna. Alison. 6. The collective body of senators and representatives of the people of a nation, esp. of a republic, constituting the chief legislative body of the nation. Note: In the Congress of the United States (which took the place of the Federal Congress, March 4, 1789), the Senate consists of two Senators from each State, chosen by the State legislature for a term of six years, in such a way that the terms of one third of the whole number expire every year; the House of Representatives consists of members elected by the people of the several Congressional districts, for a term of two years, the term of all ending at the same time. The united body of Senators and Representatives for any term of two years for which the whole body of Representatives is chosen is called one Congress. Thus the session which began in December, 1887, was the first (or long) session, and that which began in December, 1888, was the second (or short) session, of the Fiftieth Congress. When an extra session is had before the date of the first regular meeting of a Congress, that is called the first session, and the following regular session is called the second session. 7. The lower house of the Spanish Cortes, the members of which are elected for three years. The Continental Congress, an assembly of deputies from the thirteen British colonies in America, appointed to deliberate in respect to their common interests. They first met in 1774, and from time thereafter until near the close of the Revolution. -- The Federal Congress, the assembly of representatives of the original States of the American Union, who met under the Articles of Confederation from 1781 till 1789. -- Congress boot or gaiter, a high shoe or half-boot, coming above the ankle, and having the sides made in part of some elastic material which stretches to allow the boot to be drawn on and off. [U.S.] -- Congress water, a saline mineral water from the Congress spring at Saratoga, in the State of New York. Syn. -- Assembly; meeting; convention; convocation; council; diet; conclave; parliament; legislature.
congression |A coming or bringing together, as in a public meeting, in a dispute, in the act of comparing, or in sexual intercourse. [R.] Jer. Taylor.
congressional |Of or pertaining to a congress, especially, to the Congress of the United States; as, congressional debates. Congressional and official labor. E. Everett. Congressional District, one of the divisions into which a State is periodically divided (according to population), each of which is entitled to elect a Representative to the Congress of the United States.
congressive |Encountering, or coming together. Sir T. Browne.
congressman |A member of the Congress of the United States, esp. of the House of Representatives.
congreve rocket |See under Rocket.
congrue |To agree; to be suitable. [Obs.] Shak.
congruence |Suitableness of one thing to another; agreement; consistency. Holland.
congruency |Congruence. Congruency of lines. (Geom.) See Complex of lines, under Complex, n.
congruent |Possessing congruity; suitable; agreeing; corresponding. The congruent and harmonious fitting of parts in a sentence. B. Jonson. Congruent figures (Geom.), concurring figures.
congruism |See Congruity.
congruity |1. The state or quality of being congruous; the relation or agreement between things; fitness; harmony; correspondence; consistency. With what congruity doth the church of Rome deny that her enemies do at all appertain to the church of Christ Hooker. A whole sentence may fail of its congruity by wanting one particle. Sir P. Sidney. 2. (Geom.)  Coincidence, as that of lines or figures laid over one another. 3. (Scholastic Theol.)  That, in an imperfectly good persons, which renders it suitable for God to bestow on him gifts of grace.
congruous |Suitable or concordant; accordant; fit; harmonious; correspondent; consistent. Not congruous to the nature of epic poetry. Blair. It is no ways congruous that God should be always frightening men into an acknowledgment of the truth. Atterbury.
congruously |In a congruous manner.
conhydrine |A vegetable alkaloid found with conine in the poison hemlock (Conium maculatum). It is a white crystalline substance, C8H17NO, easily convertible into conine.
conia |Same as Conine.
conic |1. Having the form of, or resembling, a geometrical cone; round and tapering to a point, or gradually lessening in circumference; as, a conic or conical figure; a conical vessel. 2. Of or pertaining to a cone; as, conic sections. Conic section (Geom.), a curved line formed by the intersection of the surface of a right cone and a plane. The conic sections are the parabola, ellipse, and hyperbola. The right lines and the circle which result from certain positions of the plane are sometimes, though not generally included. -- Conic sections, that branch of geometry which treats of the parabola, ellipse, and hyperbola. -- Conical pendulum. See Pendulum. -- Conical projection, a method of delineating the surface of a sphere upon a plane surface as if projected upon the surface of a cone; -- much used by makers of maps in Europe. -- Conical surface (Geom.), a surface described by a right line moving along any curve and always passing through a fixed point that is not in the plane of that curve.\n\nA conic section.
conical |1. Having the form of, or resembling, a geometrical cone; round and tapering to a point, or gradually lessening in circumference; as, a conic or conical figure; a conical vessel. 2. Of or pertaining to a cone; as, conic sections. Conic section (Geom.), a curved line formed by the intersection of the surface of a right cone and a plane. The conic sections are the parabola, ellipse, and hyperbola. The right lines and the circle which result from certain positions of the plane are sometimes, though not generally included. -- Conic sections, that branch of geometry which treats of the parabola, ellipse, and hyperbola. -- Conical pendulum. See Pendulum. -- Conical projection, a method of delineating the surface of a sphere upon a plane surface as if projected upon the surface of a cone; -- much used by makers of maps in Europe. -- Conical surface (Geom.), a surface described by a right line moving along any curve and always passing through a fixed point that is not in the plane of that curve.
conicality |Conicalness.
conically |In the form of a cone.
conicalness |State or quality of being conical.
conico- |A combining form, meaning somewhat resembling a cone; as, conico-cylindrical, resembling a cone and a cylinder; conico- hemispherical; conico-subulate.
conicoid |Same as Conoidal.
conics |1. That branch of geometry which treats of the cone and the curves which arise from its sections. 2. Conic sections.
conidium |A peculiar kind of reproductive cell found in certain fungi, and often containing zoöspores.
conifer |A tree or shrub bearing cones; one of the order Coniferae, which includes the pine, cypress, and (according to some) the yew.
coniferin |A glucoside extracted from the cambium layer of coniferous trees as a white crystalline substance.
coniferous |(a) Bearing cones, as the pine and cypress. (b) Pertaining to the order Coniferae, of which the pine tree is the type.
coniform |Cone-shaped; conical.
coniine |See Conine.
conimene |Same as Olibene.
conine |A powerful and very poisonous vegetable alkaloid found in the hemlock (Conium maculatum) and extracted as a colorless oil, C8H17N, of strong repulsive odor and acrid taste. It is regarded as a derivative of piperidine and likewise of one of the collidines. It occasions a gradual paralysis of the motor nerves. Called also coniine, coneine, conia, etc. See Conium, 2.
coniroster |One of the Conirostres.
conirostral |Belonging to the Conirostres.
conirostres |A tribe of perching birds, including those which have a strong conical bill, as the finches.
conisor |See Cognizor.
conistra |Originally, a part of the palestra, or gymnasium among the Greeks; either the place where sand was stored for use in sprinkling the wrestlers, or the wrestling ground itself. Hence, a part of the orchestra of the Greek theater.
conite |A magnesian variety of dolomite.
conium |1. (Bot.)  A genus of biennial, poisonous, white-flowered, umbelliferous plants, bearing ribbed fruit (\"seeds\") and decompound leaves. 2. (Med.)  The common hemlock (Conium maculatum, poison hemlock, spotted hemlock, poison parsley), a roadside weed of Europe, Asia, and America, cultivated in the United States for medicinal purpose. It is an active poison. The leaves and fruit are used in medicine.
conject |To throw together, or to throw. [Obs.] Bp. Montagu.\n\nTo conjecture; also, to plan. [Obs.]
conjector |One who guesses or conjectures. [Obs.] A great conjector at other men by their writings. Milton.
conjecturable |Capable of being conjectured or guessed.
conjectural |Dependent on conjecture; fancied; imagined; guessed at; undetermined; doubtful. And mak'st conjectural fears to come into me. Shak. A slight expense of conjectural analogy. Hugh Miller. Who or what such editor may be, must remain conjectural. Carlyle.
conjecturalist |A conjecturer. [R.] Month. rev.
conjecturally |That which depends upon guess; guesswork. [R.] Sir T. Browne.\n\nIn a conjectural manner; by way of conjecture. Boyle.
conjecture |An opinion, or judgment, formed on defective or presumptive evidence; probable inference; surmise; guess; suspicion. He [Herodotus] would thus have corrected his first loose conjecture by a real study of nature. Whewell. Conjectures, fancies, built on nothing firm. Milton.\n\nTo arrive at by conjecture; to infer on slight evidence; to surmise; to guess; to form, at random, opinions concerning. Human reason can then, at the best, but conjecture what will be. South.\n\nTo make conjectures; to surmise; to guess; to infer; to form an opinion; to imagine.
conjecturer |One who conjectures. Hobbes.
conjoin |To join together; to unite. The English army, that divided was Into two parties, is now conjoined in one. Shak. If either of you know any inward impediment why you should not be conjoined. Shak. Let that which he learns next be nearly conjoined with what he knows already. Locke.\n\nTo unite; to join; to league. Shak.
conjoined |Joined together or touching.
conjoint |United; connected; associated. \"Influence conjoint.\" Glover. Conjoint degrees (Mus.), two notes which follow each other immediately in the order of the scale, as ut and re. Johnson. Conjoint tetrachords (Mus.), two tetrachords or fourths, where the same note is the highest of one and the lowest of the other; -- also written conjunct.
conjointly |In a conjoint manner; untitedly; jointly; together. Sir T. Browne.
conjointness |The qquality of being conjoint.
conjubilant |Shouting together for joy; rejoicing together. [R.] Neale.
conjugal |Belonging to marriage; suitable or appropriate to the marriage state or to married persons; matrimonial; connubial. \"Conjugal affection.\" Milton.
conjugality |The conjugal state; sexual intercourse. [R.] Milton.
conjugally |In a conjugal manner; matrimonially; connubially.
conjugate |1. United in pairs; yoked together; coupled. 2. (Bot.)  In single pairs; coupled. 3. (Chem.)  Containing two or more radicals supposed to act the part of a single one. [R.] 4. (Gram.)  Agreeing in derivation and radical signification; -- said of words. 5. (Math.)  Presenting themselves simultaneously and having reciprocal properties; -- frequently used in pure and applied mathematics with reference to two quantities, points, lines, axes, curves, etc. Conjugate axis of a hyperbola (Math.), the line through the center of the curve, perpendicular to the line through the two foci. -- Conjugate diameters (Conic Sections), two diameters of an ellipse or hyperbola such that each bisects all chords drawn parallel to the other. -- Conjugate focus (Opt.) See under Focus. -- Conjugate mirrors (Optics), two mirrors so placed that rays from the focus of one are received at the focus of the other, especially two concave mirrors so placed that rays proceeding from the principal focus of one and reflected in a parallel beam are received upon the other and brought to the principal focus. -- Conjugate point (Geom.), an acnode. See Acnode, and Double point. -- Self-conjugate triangle (Conic Sections), a triangle each of whose vertices is the pole of the opposite side with reference to a conic.\n\n1. A word agreeing in derivation with another word, and therefore generally resembling it in signification. We have learned, in logic, that conjugates are sometimes in name only, and not in deed. Abp. Bramhall. 2. (Chem.)  A complex radical supposed to act the part of a single radical. [R.]\n\n1. To unite in marriage; to join. [Obs.] Sir H. Wotton. 2. (Gram.)  To inflect (a verb), or give in order the forms which it assumed in its several voices, moods, tenses, numbers, and persons.\n\nTo unite in a kind of sexual union, as two or more cells or individuals among the more simple plants and animals.
conjugation |1. the act of uniting or combining; union; assemblage. [Obs.] Mixtures and conjugations of atoms. Bentley. 2. Two things conjoined; a pair; a couple. [Obs.] The sixth conjugations or pair of nerves. Sir T. Browne. 3. (Gram.) (a) The act of conjugating a verb or giving in order its various parts and inflections. (b) A scheme in which are arranged all the parts of a verb. (c) A class of verbs conjugated in the same manner. 4. (Biol.)  A kind of sexual union; -- applied to a blending of the contents of two or more cells or individuals in some plants and lower animals, by which new spores or germs are developed.
conjugational |relating to conjugation. Ellis.
conjugial |Conjugal. [R.] Swedenborg.
conjugium |The marriage tie.
conjunct |1. United; conjoined; concurrent. [Archaic] 2. (Her.)  Same as Conjoined.
conjunction |1. The act of conjoining, or the state of being conjoined, united, or associated; union; association; league. He will unite the white rose and the red: Smille heaven upon his fair conjunction. Shak. Man can effect no great matter by his personal strength but as he acts in society and conjunction with others. South. 2. (Astron.)  The meeting of two or more stars or planets in the same degree of the zodiac; as, the conjunction of the moon with the sun, or of Jupiter and Saturn. See the Note under Aspect, n., 6. Note: Heavenly bodies are said to be in conjunction when they are seen in the same part of the heavens, or have the same longitude or right ascension. The inferior conjunction of an inferior planet is its position when in conjunction on the same side of the sun with the earth; the superior conjunction of a planet is its position when on the side of the sun most distant from the earth. 3. (Gram.)  A connective or connecting word; an indeclinable word which serves to join together sentences, clauses of a sentence, or words; as, and, but, if. Though all conjunctions conjoin sentences, yet, with respect to the sense, some are conjunctive and some disjunctive. Harris.
conjunctional |Relating to a conjunction.
conjunctiva |The mucous membrane which covers the external surface of the ball of the eye and the inner surface of the lids; the conjunctival membrance.
conjunctival |1. Joining; connecting. 2. (Anat.)  Of or pertaining to the conjunctiva.
conjunctive |1. Serving to unite; connecting together. 2. Closely united. [Obs.] Shak. Conjunctive mood (Gram.), the mood which follows a conjunction or expresses contingency; the subjunctive mood. -- Conjunctive tissue (Anat.), the tissue found in nearly all parts of most animals. It yields gelatin on boiling, and consists of vriously arranged fibers which are imbedded protoplasmic cells, or corpuscles; -- called also cellular tissue and connective tissue. Adipose or fatty tissue is one of its many forms, and cartilage and bone are sometimes included by the phrase.
conjunctively |In conjunction or union; together. Sir T. Browne.
conjunctiveness |The state or quality of being conjunctive. Johnson.
conjunctivitis |Inflammation of the conjunctiva.
conjunctly |In union; conjointly; unitedly; together. Sir W. Hamilton.
conjuncture |1. The act of joining, or state of being joined; union; connection; combination. The conjuncture of philosophy and divinity. Hobbes. A fit conjuncture or circumstances. Addison. 2. A crisis produced by a combination of circumstances; complication or combination of events or circumstances; plight resulting from various conditions. He [Chesterfield] had recently governed Ireland, at a momentous conjuncture, with eminent firmness, wisdom, and humanity. Macaulay.
conjuration |1. The act of calling or summoning by a sacred name, or in solemn manner; the act of binding by an oath; an earnest entreaty; adjuration. We charge you, in the name of God, take heed; . . . Under this conjuration speak, my lord. Shak. 2. The act or process of invoking supernatural aid by the use of a magical form of words; the practice of magic arts; incantation; enchantment. Pretended conjurations and prophecies of that event. Hallam. 3. A league for a criminal purpose; conspiracy. [Obs.] \"The conjuration of Catiline.\" Sir T. Elyot.
conjurator |One who swears or is sworn with others; one bound by oath with others; a compurgator. Burrill.
conjure |To call on or summon by a sacred name or in solemn manner; to implore earnestly; to adjure. I conjure you, let him know, Whate'er was done against him, Cato did it. Addison.\n\nTo combine together by an eath; to conspire; to confederate. [A Latinism] Drew after him the third part of Heaven's sons Conjured against the Highest. Milton.\n\nTo affect or effect by conjuration; to call forth or send away by magic arts; to excite or alter, as if by magic or by the aid of supernatural powers. The habitation which your prophet . . . conjured the devil into. Shak. To conjure up, or make visible, as a spirit, by magic arts; hence, to invent; as, to conjure up a story; to conjure up alarms.\n\nTo practice magical arts; to use the tricks of a conjurer; to juggle; to charm. She conjures; away with her. Shak.
conjurement |Serious injunction; solemn demand or entreaty. [Obs.] Milton.
conjurer |One who conjures; one who calls, entreats, or charges in a solemn manner.\n\n1. One who practices magic arts; one who pretends to act by the aid super natural power; also, one who performs feats of legerdemain or sleight of hand. Dealing with witches and with conjurers. Shak. From the account the loser brings, The conjurer knows who stole the things. Prior. 2. One who conjectures shrewdly or judges wisely; a man of sagacity. [Obs.] Addison.
conjuror |One bound by a common cath with others. [Obs.]
conjury |The practice of magic; enchantment. Motley.
conn |See Con, to direct a ship.
connascence |1. The common birth of two or more at the same tome; production of two or more together. Johnson. 2. That which is born or produced with another. 3. The act of growing together. [Obs.] Wiseman.
connascency |1. The common birth of two or more at the same tome; production of two or more together. Johnson. 2. That which is born or produced with another. 3. The act of growing together. [Obs.] Wiseman.
connascent |Born together; produced at the same time. Craig.
connate |1. Born with another; being of the same birth. 2. Congenital; existing from birth. \"Connate notions.\" South. A difference has been made by some; those diseases or conditions which are dependent on original conformation being called congenital; while the diseases of affections that may have supervened during gestation or delivery are called connate. Dunglison. 3. (Bot.)  Congenitally united; growing from one base, or united at their bases; united into one body; as, connate leaves or athers. See Illust. of Connate-perfoliate.
connate-perfoliate |Connate or coalescent at the base so as to produce a broad foliaceous body through the center of which the stem passes; -- applied to leaves, as the leaves of the boneset.
connation |Connection by birth; natural union. [Obs.] Dr. H. More.
connatural |1. Connected by nature; united in nature; inborn; inherent; natural. These affections are connatural to us. L'Estrange. 2. Partaking of the same nature. And mix with our connatural dust. Milton.
connaturality |Participation of the same nature; natural union or connection. [R.] A congruity and connaturality between them. Sir M. Hale.
connaturalize |To bring to the same nature as something else; to adapt. [Obs.] Dr. J. Scott.
connaturally |By the act of nature; originally; from birth. Sir M. Hale.
connaturalness |Participation of the same nature; natural union. I. Walton.
connature |Participation in a common nature or character. [R.] Connature was defined as likeness in kind between either two changes in consciousness, or two states of consciousness. H. Spencer.
connect |1. To join, or fasten together, as by something intervening; to associate; to combine; to unite or link together; to establish a bond or relation between. He fills, he bounds, connect and equals all. Pope. A man must the connection of each intermediate idea with those that it connects before he can use it in a syllogism. Locke. 2. To associate (a person or thing, or one's self) with another person, thing, business, or affair. Connecting rod (Mach.), a rod or bar joined to, and connecting, two or more moving parts; esp. a rod connecting a crank wrist with a beam, crosshead, piston rod, or piston, as in a steam engine.\n\nTo join, unite, or cohere; to have a close relation; as, one line of railroad connects with another; one argument connect with another.
connectedly |In a connected manner.
connection |1. The act of connecting, or the state of being connected; junction; union; alliance; relationship. He [Algazel] denied the possibility of a known connection between cause and effect. Whewell. The eternal and inserable connection between virtue and hapiness. Atterbury. 2. That which connects or joins together; bond; tie. Any sort of connection which is perceived or imagined between two or more things. I. Taylor. 3. A relation; esp. a person connected with another by marriage rather than by blood; -- used in a loose and indefinite, and sometimes a comprehensive, sense. 4. The persons or things that are connected; as, a business connection; the Methodist connection. Men elevated by powerful connection. Motley. At the head of a strong parliamentary connection. Macaulay. Whose names, forces, connections, and characters were perfectly known to him. Macaulay. In this connection, in connection with this subject. Note: [A phrase objected to by some writers.] Note: This word was formerly written, as by Milton, with x instead of t in the termination, connexion, and the same thing is true of the kindred words inflexion, reflexion, and the like. But the general usage at present is to spell them connection, inflection, reflection, etc. Syn. -- Union; coherence; continuity; junction; association; dependence; intercourse; commerce; communication; affinity; relationship.
connective |Connecting, or adapted to connect; involving connection. Connection tissue (Anat.) See Conjunctive tissue, under Conjunctive.\n\nThat which connects. Specifically: (a) (Gram.) A word that connect words or sentences; a conjunction or preposition. (b) (Bot.) That part of an anther which connects its thecæ, lobes, or cells.
connectively |In connjunction; jointly.
connector |One who, or that which, connects; as: (a) A flexible tube for connecting the ends of glass tubes in pneumatic experiments. (b) A device for holding two parts of an electrical conductor in contact.
conner |A marine European fish (Crenilabrus melops); also, the related American cunner. See Cunner.
connex |To connect. Sir M. Hale.
connexion |Connection. See Connection.
connexive |See Connective.
conning tower |The shotproof pilot house of a war vessel.
connivance |1. Intentional failure or forbearance to discover a fault or wrongdoing; voluntary oversight; passive consent or co 2. (Law)  Corrupt or guilty assent to wrongdoing, not involving actual participation in, but knowledge of, and failure to prevent or oppose it. Syn. -- See Collusion.
connive |1. To open and close the eyes rapidly; to wink. [Obs.] The artist is to teach them how to nod judiciously, and to connive with either eye. Spectator. 2. To close the eyes upon a fault; to wink (at); to fail or forbear by intention to discover an act; to permit a proceeding, as if not aware of it; -- usually followed by at. To connive at what it does not approve. Jer. Taylor. In many of these, the directors were heartily concurring; in most of them, they were encouraging, and sometimes commanding; in all they were conniving. Burke. The government thought it expedient, occasionally, to connive at the violation of this rule. Macaulay.\n\nTo shut the eyes to; to overlook; to pretend not to see. [R. & Obs.] \"Divorces were not connived only, but with eye open allowed.\" Milton.
connivency |Connivance. [Obs.]
connivent |1. Forbearing to see; designedly inattentive; as, connivent justice. [R.] Milton. 2. (Biol.)  Brought close together; arched inward so that the points meet; converging; in close contact; as, the connivent petals of a flower, wings of an insect, or folds of membrane in the human system, etc.
conniver |One who connives.
connoisseur |One well versed in any subject; a skillful or knowing person; a critical judge of any art, particulary of one of the fine arts. The connoisseur is \"one who knows,\" as opposed to the dilettant, who only \"thinks he knows.\" Fairholt.
connoisseurship |State of being a connoisseur.
connotate |To connote; to suggest or designate (something) as additional; to include; to imply. Hammond.
connotation |The act of connoting; a making known or designating something additional; implication of something more than is asserted.
connotative |1. Implying something additional; illative. 2. (Log.)  Implying an attribute. See Connote. Connotative term, one which denotes a subject and implies an attribute. J. S. Mill.
connotatively |In a connotative manner; expressing connotation.
connote |1. To mark along with; to suggest or indicate as additional; to designate by implication; to include in the meaning; to imply. Good, in the general notion of it, connotes also a certain suitableness of it to some other thing. South. 2. (Logic)  To imply as an attribute. The word \"white\" denotes all white things, as snow, paper, the foam of the sea, etc., and ipmlies, or as it was termed by the schoolmen, connotes, the attribute \"whiteness.\" J. S. Mill.
connubial |Of or pertaining to marriage, or the marriage state; conjugal; nuptial. Nor Eve the rites Mysterious of connubial love refused. Milton. Kind, connubial tenderness. Goldsmith.
connubiality |The quality of being connubial; something characteristics of the conjugal state; an expression of connubial tenderness. Some connubialities which had begun to pass between Mr. and Mrs. B. Dickens.
connumeration |A reckoning together. [R.] Porson.
connusance |See Cognizance. [Obs.]
connusant |See Cognizant. [Obs.]
connusor |See Cognizor. [Obs.]
connutritious |Nutritious by force of habit; -- said of certain kinds of food. [Obs.] Crabb.
conny |Brave; fine; canny. [Prov. Eng.] Grose.
conodont |A peculiar toothlike fossil of many forms, found especially in carboniferous rocks. Such fossils are supposed by some to be the teeth of marsipobranch fishes, but they are probably the jaws of annelids.
conoid |1. Anything that has a form resembling that of a cone. 2. (Geom.) (a) A solid formed by the revolution of a conic section about its axis; as, a parabolic conoid, elliptic conoid, etc.; -- more commonly called paraboloid, ellipsoid, etc. (b) A surface which may be generated by a straight line moving in such a manner as always to meet a given straight line and a given curve, and continue parallel to a given plane. Math. Dict.\n\n, Resembling a cone; conoidal.
conoidal |Nearly, but not exactly, conical. Lindley.
conoidic |Pertaining to a conoid; having the form of a conoid.
conoidical |Pertaining to a conoid; having the form of a conoid.
conominee |One nominated in conjunction with another; a joint nominee. Kirby.
conquadrate |To bring into a square. [R.] Ash.
conquassate |To shake; to agitate. [Obs.] Harvey. -- Con`quas*sa\"tion, n. [Obs.]
conquer |1. To gain or acquire by force; to take possession of by violent means; to gain dominion over; to subdue by physical means; to reduce; to overcome by force of arms; to cause to yield; to vanquish. \"If thou conquer Rome.\" Shak. If we be conquer'd, let men conquer us. Shak. We conquered France, but felt our captive's charms. Pope. 2. To subdue or overcome by mental or moral power; to surmount; as, to conquer difficulties, temptatin, etc. By winning words to conquer hearts, And make persuasion do the work of fear. Milton. 3. To gain or obtain, overcoming obstacles in the way; to win; as, to conquer freedom; to conquer a peace. Syn. -- To subdue; vanquish; overcome; overpower; overthrow; defeat; rout; discomfit; subjugate; reduce; humble; crush; surmount; subject; master. -- To Conquer, Vanquish, Subdue, Subjugate, Overcome. These words agree in the general idea expressed by overcome, -- that of bringing under one's power by the exertion of force. Conquer is wider and more general than vanquish, denoting usually a succession of conflicts. Vanquish is more individual, and refers usually to a single conflict. Thus, Alexander conquered Asia in a succession of battles, and vanquished Darius in one decisive engagement. Subdue implies a more gradual and continual pressure, but a surer and more final subjection. We speak of a nation as subdued when its spirit is at last broken, so that no further resistance is offered. Subjugate is to bring completely under the yoke of bondage. The ancient Gauls were never finally subdued by the Romans until they were completely subjugated. These words, when used figuratively, have correspondent meanings. We conquer our prejudices or aversions by a succesion of conflicts; but we sometimes vanquish our reluctance to duty by one decided effort: we endeavor to subdue our evil propensities by watchful and persevering exertions. Subjugate is more commonly taken in its primary meaning, and when used figuratively has generally a bad sense; as, his reason was completely subjugated to the sway of his passions.\n\nTo gain the victory; to overcome; to prevail. He went forth conquering and to conquer. Rev. vi. 2. The champions resolved to conquer or to die. Waller.
conquerable |Capable of being conquered or subdued. South. -- Con\"quer*a*ble*ness, n.
conqueress |A woman who conquers. Fairfax.
conqueror |One who conquers. The Conqueror (Eng. Hist.). William the Norman (1027-1067) who invaded England, defeated Harold in the battle of Hastings, and was crowned king, in 1066.
conquest |1. The act or process of conquering, or acquiring by force; the act of overcoming or subduing opposition by force, whether physical or moral; subjection; subjugation; victory. In joys of conquest he resigns his breath. Addison. Three years sufficed for the conquest of the country. Prescott. 2. That which is conquered; possession gained by force, physical or moral. Wherefore rejoice What conquest brings he home Shak. 3. (Feudal Law)  The acquiring of property by other means than by inheritance; acquisition. Blackstone. 4. The act of gaining or regaining by successful strugle; as, the conquest of liberty or peace. The Conquest (Eng. Hist.), the subjugation of England by William of Normandy in 1066. Syn. -- Victory; triumph; mastery; reduction; subjugation; subjection.
conquian |A game for two, played with 40 cards, in which each player tries to form three or four of a kind or sequences.
consanguineal |Of the same blood; related by birth. Sir T. Browne.
consanguined |Of kin blood; related. [R.] Johnson.
consanguineous |Of the same blood; related by birth; descended from the same parent or ancestor. Shak.
consanguinity |The relation of person by blood, is distinction from affinity or relation by marriage; blood relationship; as, lineal consanguinity; collateral consanguinity. Invoking aid by the ties of consanguinity. Prescott.
consarcination |A patching together; patchwork. [Obs.] Bailey.
conscience |1. Knowledge of one's own thoughts or actions; consciousness. [Obs.] The sweetest cordial we receive, at last, Is conscience of our virtuous actions past. Denham. 2. The faculty, power, or inward principle which decides as to the character of one's own actions, purposes, and affections, warning against and condemning that which is wrong, and approving and prompting to that which is right; the moral faculty passing judgment on one's self; the moral sense. My conscience hath a thousand several tongues, And every tongue brings in a several tale, And every tale condemns me for a villain. Shak. As science means knowledge, conscience etymologically means self- knowledge . . . But the English word implies a moral standard of action in the mind as well as a consciousness of our own actions. . . . Conscience is the reason, employed about questions of right and wrong, and accompanied with the sentiments of approbation and condemnation. Whewell. 3. The estimate or determination of conscience; conviction or right or duty. Conscience supposes the existence of some such [i.e., moral] faculty, and properly signifies our consciousness of having acted agreeably or contrary to its directions. Adam Smith. 4. Tenderness of feeling; pity. [Obs.] Chaucer. Conscience clause, a clause in a general law exempting persons whose religious scruples forbid compliance therewith, -- as from taking judicial oaths, rendering military service, etc. -- Conscience money, stolen or wrongfully acquired money that is voluntarily restored to the rightful possessor. Such money paid into the United States treasury by unknown debtors is called the Conscience fund. -- Court of Conscience, a court established for the recovery of small debts, in London and other trading cities and districts. [Eng.] Blackstone. -- In conscience, In all conscience, in deference or obedience to conscience or reason; in reason; reasonably. \"This is enough in conscience.\" Howell. \"Half a dozen fools are, in all conscience, as many as you should require.\" Swift. -- To make conscience of, To make a matter of conscience, to act according to the dictates of conscience concerning (any matter), or to scruple to act contrary to its dictates.
conscienced |Having a conscience. [R.] \"Soft-conscienced men.\" Shak.
conscienceless |Without conscience; indifferent to conscience; unscrupulous. Conscienceless and wicked patrons. Hookre.
conscient |Conscious. [R.] Bacon.
conscientious |1. Influenced by conscience; governed by a strict regard to the dictates of conscience, or by the known or supposed rules of right and wrong; -- said of a person. The advice of wise and conscientious men. Prescott. 2. Characterized by a regard to conscience; conformed to the dictates of conscience; -- said of actions. A holy and conscientious course. Abp. Tillotson. Syn. -- Scrupulous; exact; faithful; just; upright.
conscientiously |In a conscientious manner; as a matter of conscience; hence; faithfully; accurately; completely.
conscientiousness |The quality of being conscientious; a scrupulous regard to the dictates of conscience.
conscionable |Governed by, or according to, conscience; reasonable; just. Let my debtors have conscionable satisfaction. Sir H. Wotton.
conscionableness |The quality of being conscionable; reasonableness. Johnson.
conscionably |Reasonably; justly.
conscious |1. Possessing the faculty of knowing one's own thoughts or mental operations. Some are thinking or conscious beings, or have a power of thought. I. Watts. 2. Possessing knowledge, whether by internal, conscious experience or by external observation; cognizant; aware; sensible. Her conscious heart imputed suspicion where none could have been felt. Hawthorne. The man who breathes most healthilly is least conscious of his own breathing. De Quincey. 3. Made the object of consciousness; known to one's self; as, conscious guilt. With conscious terrors vex me round. Milton. Syn. -- Aware; apprised; sensible; felt; known.
consciously |In a conscious manner; with knowledge of one's own mental operations or actions.
consciousness |1. The state of being conscious; knowledge of one's own existence, condition, sensations, mental operations, acts, etc. Consciousness is thus, on the one hand, the recognition by the mind or \"ego\" of its acts and affections; -- in other words, the self- affirmation that certain modifications are known by me, and that these modifications are mine. Sir W. Hamilton. 2. Immediate knowledge or perception of the presence of any object, state, or sensation. See the Note under Attention. Annihilate the consciousness of the object, you annihilate the consciousness of the operation. Sir W. Hamilton. And, when the steam Which overflowed the soul had passed away, A consciousness remained that it had left. . . . images and precious thoughts That shall not die, and can not be destroyed. Wordsworth. The consciousness of wrong brought with it the consciousness of weakness. Froude. 3. Feeling, persuasion, or expectation; esp., inward sense of guilt or innocence. [R.] An honest mind is not in the power of a dishonest: to break its peace there must be some guilt or consciousness. Pope.
conscribe |To enroll; to enlist. [Obs.] E. Hall.
conscript |Enrolled; written; registered. Conscript fathers (Rom. Antiq.), the senators of ancient Rome. When certain new senators were first enrolled with the \"fathers\" the body was called Patres et Conscripti; afterward all were called Patres conscripti.\n\nOne taken by lot, or compulsorily enrolled, to serve as a soldier or sailor.\n\nTo enroll, by compulsion, for military service.
conscription |1. An enrolling or registering. The conscription of men of war. Bp. Burnet. 2. A compulsory enrollment of men for military or naval service; a draft.\n\nBelonging to, or of the nature of, a conspiration.
consecrate |Consecrated; devoted; dedicated; sacred. They were assembled in that consecrate place. Bacon.\n\n1. To make, or declare to be, sacred; to appropriate to sacred uses; to set apart, dedicate, or devote, to the service or worship of God; as, to consecrate a church; to give (one's self) unreservedly, as to the service of God. One day in the week is . . . consecrated to a holy rest. Sharp. 2. To set apart to a sacred office; as, to consecrate a bishop. Thou shalt consecrate Aaron and his sons. Ex. xxix. 9. 3. To canonize; to exalt to the rank of a saint; to enroll among the gods, as a Roman emperor. 4. To render venerable or revered; to hallow; to dignify; as, rules or principles consecrated by time. Burke. Syn. -- See Addict.
consecrater |Consecrator.
consecration |The act or ceremony of consecrating; the state of being consecrated; dedication. Until the days of your consecration be at an end. Lev. viii. 33. Consecration makes not a place sacred, but only solemny declares it so. South.
consecrator |One who consecrates; one who performs the rites by which a person or thing is devoted or dedicated to sacred purposes. [Written also consecrater.]
consecratory |Of or pertaining to the act of consecration; dedicatory. The consecratory prayer. Bp. Burnet.
consectaneous |Following as a matter of course. Blount.
consectary |Following by consequence; consequent; deducible. [R.] \"Consectary impieties.\" Sir T. Browne.\n\nThat which follows by consequence or is logically deducible; deduction from premises; corollary. [R.] Milton.
consecute |To follow closely; to endeavor to overtake; to pursue. [Obs.] Bp. Burnet.
consecution |1. A following, or sequel; actual or logical dependence. Sir M. Hale. 2. A succession or series of any kind. [Obs.] Sir I. Newton. Month of consecution (Astron.), a month as reckoned from one conjunction of the moon with the sun to another.
consecutive |1. Following in a train; suceeding one another in a regular order; successive; uninterrupted in course or succession; with no interval or break; as, fifty consecutive years. 2. Following as a consequence or result; actually or logically dependent; consequential; succeeding. The actions of a man consecutive to volition. Locke. 3. (Mus.)  Having similarity of sequence; -- said of certain parallel progressions of two parts in a piece of harmony; as, consecutive fifths, or consecutive octaves, which are forbidden. Consecutive chords (Mus.), chords of the same kind suceeding one another without interruption.
consecutively |In a consecutive manner; by way of sequence; successively.
consecutiveness |The state or quality of being consecutive.
consension |Agreement; accord. Bentley.
consensual |1. (Law)  Existing, or made, by the mutual consent of two or more parties. 2. (Physiol.)  Excited or caused by sensation, sympathy, or reflex action, and not by conscious volition; as, consensual motions. Consensual contract (Law), a contract formed merely by consent, as a marriage contract.
consensus |Agreement; accord; consent. That traditional consensus of society which we call public opinion. Tylor.
consent |1. To agree in opinion or sentiment; to be of the same mind; to accord; to concur. And Saul was consenting unto his death. Acts. viii. 1. Flourishing many years before Wyclif, and much consenting with him in jugdment. Fuller. 2. To indicate or express a willingness; to yield to guidance, persuasion, or necessity; to give assent or approval; to comply. My poverty, but not my will, consents. Shak. And whispering \"I will ne'er consent,\" -- consented. Byron. Syn. -- To accede; yield; assent; comply; agree; allow; concede; permit; admit; concur; acquiesce.\n\nTo grant; to allow; to assent to; to admit. [Obs.] Interpreters . . . will not consent it to be a true story. Milton.\n\n1. Agreement in opinion or sentiment; the being of one mind; accord. All with one consent began to make exuse. Luke xiv. 18. They feil together all, as by consent. Shak. 2. Correspondence in parts, qualities, or operations; agreement; harmony; coherence. The melodious consent of the birds. Holland. Such is the world's great harmony that springs From union, order, full consent of things. Pope. 3. Voluntary accordance with, or concurrence in, what is done or proposed by another; acquiescence; compliance; approval; permission. Thou wert possessed of David's throne By free consent of all. Milton. 4. (Law)  Capable, deliberate, and voluntary assent or agreement to, or concurrence in, some act or purpose, implying physical and mental power and free action. 5. (Physiol.)  Sympathy. See Sympathy, 4. Syn. -- Assent; acquiescence; concurrence; agreement; approval; permission. See Assent. Age of consent (Law), an age, fixed by statute and varying in different jurisdictions, at which one is competent to give consent. Sexual intercourse with a female child under the age of consent is punishable as rape.
consentaneity |Mutual agreement. [R.]
consentaneous |Consistent; agreeable; suitable; accordant to; harmonious; concurrent. A good law and consentaneous to reason. Howell. -- Con`sen*ta\"ne*ous*ly, adv. -- Con`sen*ta\"ne*ous*ness, n.
consentant |Consenting. [Obs.] Chaucer.
consenter |One who consents.
consentient |Agreeing in mind; accordant. The consentient judgment of the church. Bp. Pearson.
consentingly |With consent; in a compliant manner. Jer. Taylor.
consequence |1. That which follows something on which it depends; that which is produced by a cause; a result. Shun to taste, And shun the bitter consequence. Milton. 2. (Logic)  A proposition collected from the agreement of other previous propositions; any conclusion which results from reason or argument; inference. 3. Chain of causes and effects; consecution. Such fatal consequence unites us three. Milton. Link follows link by necessary consequence. Coleridge. 4. Importance with respect to what comes after; power to influence or produce an effect; value; moment; rank; distinction. It is a matter of small consequence. Shak. A sense of your own worth and consequence. Cowper. In consequence, hence; for this cause. -- In consequence of, by reason of; as the effect of. Syn. -- Effect; result; end. See Effect.
consequencing |Drawing inference. [R.] Milton.
consequent |1. Following as a result, inference, or natural effect. The right was consequent to, and built on, an act perfectly personal. Locke. 2. (Logic)  Following by necessary inference or rational deduction; as, a proposition consequent to other propositions. Consequent points, Consequent poles (Magnetism), a number of poles distributed under certain conditions, along the axis of a magnetized steel bar, which regularly has but the two poles at the extremities.\n\n1. That which follows, or results from, a cause; a result or natural effect. They were ill-governed, which is always a consequent of ill payment. Sir J. Davies. 2. (Logic)  That which follows from propositions by rational deduction; that which is deduced from reasoning or argumentation; a conclusion, or inference. 3. (Math.)  The second term of a ratio, as the term b in the ratio a:b, the first a, being the antecedent.
consequential |1. Following as a consequence, result, or logical inference; consequenment. All that is revealed in Scripture has a consequential necessity of being believed . . . because it is of divine authority. Locke. These kind of arguments . . . are highly consequential and concludent to my purpose. Sir M. Hale. 2. Assuming or exhibiting an air of consequence; pretending to importance; pompous; self-important; as, a consequential man. See Consequence, n., 4. His stately and consequential pace. Sir W. Scott. Consequential damage (Law) (a) Damage so remote as not to be actionable (b) Damage which although remote is actionable. (c) Actionable damage, but not following as an immediate result of an act.
consequentially |1. With just deduction of consequence; with right connection of ideas; logically. The faculty of writing consequentially. Addison. 2. By remote consequence; not immediately; eventually; as, to do a thing consequentially. South. 3. In a regular series; in the order of cause and effect; with logical concatenation; consecutively; continuously. 4. With assumed importance; pompously.
consequentialness |The quality of being consequential.
consequently |By consequence; by natural or logical sequence or connection. Syn. -- See Accordingly.
consertion |Junction; adaptation [R.] Consertion of design, how exquisite. Young.
conservable |Capable of being preserved from decay or injury.
conservancy |Conservation, as from injury, defilement, or irregular use. [An act was] passed in 1866, for vesting in the Conservators of the River Thames the conservancy of the Thames and Isis. Mozley & W.
conservant |Having the power or quality of conservation.
conservation |The act of preserving, guarding, or protecting; the keeping (of a thing) in a safe or entire state; preservation. A step necessary for the conservation of Protestantism. Hallam. A state without the means of some change is without the means of its conservation. Burke. Conservation of areas (Astron.), the principle that the radius vector drawn from a planet to the sun sweeps over equal areas in equal times. -- Conservation of energy, or Conservation of force (Mech.), the principle that the total energy of any material system is a quantity which can neither be increased nor diminished by any action between the parts of the system, though it may be transformed into any of the forms of which energy is susceptible. Clerk Maxwell.
conservational |Tending to conserve; preservative.
conservatism |The disposition and tendency to preserve what is established; opposition to change; the habit of mind; or conduct, of a conservative.
conservative |1. Having power to preserve in a safe of entire state, or from loss, waste, or injury; preservative. 2. Tending or disposed to maintain existing institutions; opposed to change or innovation. 3. Of or pertaining to a political party which favors the conservation of existing institutions and forms of government as the Conservative party in england; -- contradistinguished from Liberal and Radical. We have always been conscientuously attached to what is called the Tory, and which might with more propierty be called the Conservative, party. Quart. Rev. (1830). Conservative system (Mech.), a material sustem of such a nature that after the system has undergone any series of changes, and been brought back in any manner to its original state, the whole work done by external agents on the system is equal to the whole work done by the system overcoming external forces. Clerk Maxwell.\n\n1. One who, or that which, preserves from ruin, injury, innovation, or radical change; a preserver; a conserver. The Holy Spirit is the great conservative of the new life. Jer. Taylor. 2. One who desires to maintain existing institutions and customs; also, one who holds moderate opinions in politics; -- opposed to revolutionary or radical. 3. (Eng. Hist.)  A member of the Conservative party.
conservativeness |The quality of being conservative.
conservatoire |A public place of instruction in any special branch, esp. music and the arts. [See Conservatory, 3].
conservator |1. One who preserves from injury or violation; a protector; a preserver. The great Creator and Conservator of the world. Derham. 2. (Law) (a) An officer who has charge of preserving the public peace, as a justice or sheriff. (b) One who has an official charge of preserving the rights and privileges of a city, corporation, community, or estate. The lords of the secret council were likewise made conservators of the peace of the two kingdoms. Clarendon. The conservator of the estate of an idiot. Bouvier. Conservators of the River Thames, a board of comissioners instituted by Parliament to have the conservancy of the Thames.
conservatory |Having the quality of preserving from loss, decay, or injury.\n\n1. That which preserves from injury. [Obs.] \"A conservatory of life.\" Jer. Taylor. 2. A place for preserving anything from loss, decay, waste, or injury; particulary, a greenhouse for preserving exotic or tender plants. 3. A public place of instruction, designed to preserve and perfect the knowledge of some branch of science or art, esp. music.
conservatrix |A woman who preserves from loss, injury, etc.
conserve |1. To keep in a safe or sound state; to save; to preserve; to protect. The amity which . . . they meant to conserve and maintain with the emperor. Strype. 2. To prepare with sugar, etc., for the purpose of preservation, as fruits, etc.; to make a conserve of.\n\n1. Anything which is conserved; especially, a sweetmeat prepared with sugar; a confection. I shall . . . study broths, plasters, and conserves, till from a fine lady I become a notable woman. Tatler. 2. (Med.)  A medicinal confection made of freshly gathered vegetable substances mixed with finely powdered refined sugar. See Confection. 3. A conservatory. [Obs.] Evelyn.
conserver |One who conserves.
