consider |1. To fix the mind on, with a view to a careful examination; to thank on with care; to ponder; to study; to meditate on. I will consider thy testimonies. Ps. cxix. 95. Thenceforth to speculations high or deep I turned my thoughts, and with capacious mind Considered all things visible. Milton. 2. To look at attentively; to observe; to examine. She considereth a field, and buyeth it. Prov. xxxi. 16. 3. To have regard to; to take into view or account; to pay due attention to; to respect. Consider, sir, the chance of war: the day Was yours by accident. Shak. England could grow into a posture of being more united at home, and more considered abroad. Sir W. Temple. 4. To estamate; to think; to regard; to view. Considered as plays, his works are absurd. Macaulay. Note: The proper sense of consider is often blended with an idea of the result of considering; as, \"Blessed is he that considereth the poor.\" Ps. xli. 1. ; i.e., considers with sympathy and pity. \"Which [services] if I have not enough considered.\" Shak. ; i.e., requited as the sufficient considering of them would suggest. \"Consider him liberally.\" J. Hooker. Syn. -- To ponder; weigh; revolve; study; reflect or meditate on; contemplate; examine. See Ponder.\n\n1. To think seriously; to make examination; to reflect; to deliberate. We will consider of your suit. Shak. 'T were to consider too curiously, to consider so. Shak. She wished she had taken a moment to consider, before rushing down stairs. W. Black 2. To hesitate. [Poetic & R.] Dryden.
considerable |1. Worthy of consideration, borne in mind, or attended to. It is considerable, that some urns have had inscriptions on them expressing that the lamps were burning. Bp. Wilkins. Eternity is infinitely the most considerable duration. Tillotson. 2. Of some distinction; noteworthy; influential; respectable; -- said of persons. You are, indeed, a very considerable man. Junius. 3. Of importance or value. In painting, not every action, nor every person, is considerable enough to enter into the cloth. Dryden. A considerable sum of money. Prescott.
considerableness |Worthiness of consideration; dignity; value; size; amount.
considerably |In a manner or to a degree not trifling or unimportant; greatly; much. The breeds . . . differ considerably from each other. Darwin.
considerance |Act of considering; consideration. [Obs.] Shak.
considerate |1. Given to consideration or to sober reflection; regardful of consequences or circumstances; circumspect; careful; esp. careful of the rights, claims, and feelings of other. Of dauntless courage and considerate pride. Milton. considerate, and careful of his people. Dryden. The wisest and most considerate men in the world. Sharp. 2. Having respect to; regardful. [R.] They may be . . . more considerate of praise. Dr. H. More. Syn. -- Thoughtful; reflective; careful; discreet; prudent; deliberate; serious. See Thoughtful. -- Con*sid\"er*ate*ly, adv. -- Con*sid\"er*ate*ness, n.
consideration |1. The act or process of considering; continuous careful thought; examination; contemplation; deliberation; attention. Let us think with consideration. Sir P. Sidney. Consideration, like an angel, came. Shak. 2. Attentive respect; appreciative regard; -- used especially in diplomatic or stately correspondence. The undersigned has the honor to repeat to Mr. Hulseman the assurance of his high consideration. D. Webster. The consideration with which he was treated. Whewell. 3. Thoughtful or sympathetic regard or notice. Consideration for the poor is a doctrine of the church. Newman. 4. Claim to notice or regard; some degree of importance or consequence. Lucan is the only author of consideration among the Latin poets who was not explained for . . . the Dauphin. Addison. 5. The result of delibration, or of attention and examonation; matured opinion; a reflection; as, considerations on the choice of a profession. 6. That which is, or should be, taken into account as a ground of opinion or action; motive; reason. He was obliged, antecedent to all other considerations, to search an asylum. Dryden. Some considerations which are necessary to the forming of a correct judgment. Macaulay. 7. (Law)  The cause which moves a contracting party to enter into an agreement; the material cause of a contract; the price of a stripulation; compensation; equivalent. Bouvier. Note: Consideration is what is done, or promised to be done, in exchange for a promise, and \"as a mere advantage to the promisor without detriment to the promisee would not avail, the proper test is detriment to the promisee.\" Wharton.
considerative |Considerate; careful; thoughtful. [Archaic] I love to be considerative. B. Jonson.
considerator |One who considers. [Obs.] Sir T. Browne.
considerer |One who considers; a man of reflection; a thinker. Milton.
consideringly |With consideration or deliberation.
consign |1. To give, transfer, or deliver, in a formal manner, as if by signing over into the possession of another, or into a different state, with the sense of fixedness in that state, or permanence of possession; as, to consign the body to the grave. At the day of general account, good men are to be consigned over to another state. Atterbury. 2. To give in charge; to commit; to intrust. Atrides, parting for the Trojan war, Consigned the youthful consort to his care. Pope. The four evangelists consigned to writing that history. Addison. 3. (Com.)  To send or address (by bill of lading or otherwise) to an agent or correspondent in another place, to be cared for or sold, or for the use of such correspondent; as, to cosign a cargo or a ship; to set apart. 4. To assign; to devote; to set apart. The French commander consigned it to the use for which it was intended by the donor. Dryden. 5. To stamp or impress; to affect. [Obs.] Consign my spirit with great fear. Jer. Taylor. Syn. -- To commit; deliver; intrust; resign. See Commit.\n\n1. To submit; to surrender or yield one's self. [Obs.] All lovers young, all lovers must Consign to thee, and come to dust. Shak. 2. To yield consent; to agree; to acquiesce. [Obs.] Augment or alter . . . And we'll consign thereto. Shak.
consignatary |A consignee. [Obs.] Jenkins.
consignation |1. The act of consigning; the act of delivering or committing to another person, place, or state. [Obs.] So is despair a certain consignation to eternal ruin. Jer. Taylor. 2. The act of ratifying or establishing, as if signing; confirmation; ratuficator. A direct consignation of pardon. Jer. Taylor. 3. A stamp; an indication; a sign. [Obs.] The most certain consignations of an excellent virtue. Jer. Taylor.
consignatory |One of several that jointly sign a written instrument, as a treaty. Fallows.
consignature |Joint signature. [R.] Colgrave.
consigne |(a) A countersign; a watchword. (b) One who is orders to keep within certain limits.
consignee |The person to whom goods or other things are consigned; a factor; -- correlative to consignor. Consigner and consignee are used by merchants to express generally the shipper of merchandise, and the person to whom it is addressed, by bill of lading or otherwise. De Colange.
consigner |One who consigns. See Consignor.
consignificant |Having joint or equal signification; synonymous. [R.] Spelman.
consignification |Joint signification. [R.]
consignificative |Consignificant; jointly significate. [R.]
consignify |To signify or denote in combination with something else. The cipher . . . only serves to connote and consignify, and to change the value or the figures. Horne Tooke.
consignment |1. The act of consigning; consignation. 2. (Com.)  The act of consigning or sending property to an agent or correspondent in another place, as for care, sale, etc. 3. (Com.)  That which is consigned; the goods or commodities sent or addressed to a consignee at one time or by one conveyance. To increase your consignments of this valuable branch of national commerce. Burke. 4. The writing by which anything is consigned.
consignor |One who consigns something to another; -- opposed to consignee. [Written also consigner.]
consilience |Act of concurring; coincidence; concurrence. The consilience of inductions takes place when one class of facts coincides with an induction obtained from another different class. Whewell.
consimilitude |Common resemblance. [Obs.] Aubrey.
consimility |Common resemblance. [Obs.] Aubrey.
consist |1. To stand firm; to be in a fixed or permanent state, as a body composed of parts in union or connection; to hold together; to be; to exist; to subsist; to be supported and maintained. He is before all things, and by him all things consist. Col. i. 17. 2. To be composed or made up; -- followed by of. The land would consist of plains and valleys. T. Burnet. 3. To have as its substance or character, or as its foundation; to be; -- followed by in. If their purgation did consist in words. Shak. A man's life consisteth not in the abudance of the things which he possesseth. Luke xii. 15. 4. To be cosistent or harmonious; to be in accordance; -- formerly used absolutely, now followed by with. This was a consisting story. Bp. Burnet. Health consists with temperance alone. Pope. For orders and degrees Jar not with liberty, but well consist. Milton. 5. To insist; -- followed by on. [Obs.] Shak. Syn. -- To Consist, Consist of, Consist in. The verb consist is employed chiefly for two purposes, which are marked and distinguished by the prepositions used. When we wish to indicate the parts which unite to compose a thing, we use of; as when we say, \"Macaulay's Miscellanies consist chiefly of articles which were first published in the Edinburgh Review.\" When we wish to indicate the true nature of a thing, or that on which it depends, we use in; as, \"There are some artists whose skill consists in a certain manner which they have affected.\" \"Our safety consists in a strict adherence to duty.\",
  "soul |Sole. [Obs.] Chaucer.\n\nSole. [Obs.] Chaucer.\n\nTo afford suitable sustenance. [Obs.] Warner.\n\n1. The spiritual, rational, and immortal part in man; that part of man which enables him to think, and which renders him a subject of moral government; -- sometimes, in distinction from the higher nature, or spirit, of man, the so-called animal soul, that is, the seat of life, the sensitive affections and phantasy, exclusive of the voluntary and rational powers; -- sometimes, in distinction from the mind, the moral and emotional part of man's nature, the seat of feeling, in distinction from intellect; -- sometimes, the intellect only; the understanding; the seat of knowledge, as distinguished from feeling. In a more general sense, \"an animating, separable, surviving entity, the vehicle of individual personal existence.\" Tylor. The eyes of our souls only then begin to see, when our bodily eyes are closing. Law. 2. The seat of real life or vitality; the source of action; the animating or essential part. \"The hidden soul of harmony.\" Milton. Thou sun, of this great world both eye and soul. Milton. 3. The leader; the inspirer; the moving spirit; the heart; as, the soul of an enterprise; an able gemeral is the soul of his army. He is the very soul of bounty! Shak. 4. Energy; courage; spirit; fervor; affection, or any other noble manifestation of the heart or moral nature; inherent power or goodness. That he wants algebra he must confess; But not a soul to give our arms success. Young. 5. A human being; a person; -- a familiar appellation, usually with a qualifying epithet; as, poor soul. As cold waters to a thirsty soul, so is good news from a far country. Prov. xxv. 25. God forbid so many simple souls Should perish by the aword! Shak. Now mistress Gilpin (careful soul). Cowper. 6. A pure or disembodied spirit. That to his only Son . . . every soul in heaven Shall bend the knee. Milton. Note: Soul is used in the formation of numerous compounds, most of which are of obvious signification; as, soul-betraying, soul- consuming, soul-destroying, soul-distracting, soul-enfeebling, soul- exalting, soul-felt, soul-harrowing, soul-piercing, soul-quickening, soul-reviving, soul-stirring, soul-subduing, soul-withering, etc. Syn. -- Spirit; life; courage; fire; ardor. Cure of souls. See Cure, n., 2. -- Soul bell, the passing bell. Bp. Hall. -- Soul foot. See Soul scot, below. [Obs.] -- Soul scot or Soul shot. Etym: [Soul + scot, or shot; cf. AS. sawelsceat.] (O. Eccl. Law) A funeral duty paid in former times for a requiem for the soul. Ayliffe.\n\nTo indue with a soul; to furnish with a soul or mind. [Obs.] Chaucer.
consistence |1. The condition of standing or adhering together, or being fixed in union, as the parts of a body; existence; firmness; coherence; solidity. Water, being divided, maketh many circles, till it restore itself to the natural consistence. Bacon. We are as water, weak, and of no consistence. Jer. Taylor. The same form, substance, and consistency. T. Burned. 2. A degree of firmness, density, or spissitude. Let the expressed juices be boiled into the consistence of a sirup. Arbuthnot. 3. That which stands together as a united whole; a combination. The church of God, as meaning whole consistence of orders and members. Milton. 4. Firmness of constitution or character; substantiality; durability; persistency. His friendship is of a noble make and a lasting consistency. South. 5. Agreement or harmony of all parts of a complex thing among themselves, or of the same thing with itself at different times; the harmony of conduct with profession; congruity; correspondence; as, the consistency of laws, regulations, or judicial decisions; consistency of opinions; consistency of conduct or of character. That consistency of behavior whereby he inflexibly pursues those measures which appear the most just. Addison. Consistency, thou art a jewel. Popular Saying.
consistency |1. The condition of standing or adhering together, or being fixed in union, as the parts of a body; existence; firmness; coherence; solidity. Water, being divided, maketh many circles, till it restore itself to the natural consistence. Bacon. We are as water, weak, and of no consistence. Jer. Taylor. The same form, substance, and consistency. T. Burned. 2. A degree of firmness, density, or spissitude. Let the expressed juices be boiled into the consistence of a sirup. Arbuthnot. 3. That which stands together as a united whole; a combination. The church of God, as meaning whole consistence of orders and members. Milton. 4. Firmness of constitution or character; substantiality; durability; persistency. His friendship is of a noble make and a lasting consistency. South. 5. Agreement or harmony of all parts of a complex thing among themselves, or of the same thing with itself at different times; the harmony of conduct with profession; congruity; correspondence; as, the consistency of laws, regulations, or judicial decisions; consistency of opinions; consistency of conduct or of character. That consistency of behavior whereby he inflexibly pursues those measures which appear the most just. Addison. Consistency, thou art a jewel. Popular Saying.
consistent |1. Possessing firmness or fixedness; firm; hard; solid. The humoral and consistent parts of the body. Harvey. 2. Having agreement with itself or with something else; having harmony among its parts; possesing unity; accordant; harmonious; congruous; compatible; uniform; not contradictory. Show me one that has it in his power To act consistent with himself an hour. Pope. With reference to such a lord, to serve and to be free are terms not consistent only, but equivalent. South. 3. Living or acting in conformity with one's belief or professions. It was utterly to be at once a consistent Quaker and a conspirator. Macaulay.
consistently |In a consistent manner.
consistorial |Of or pertaining to a consistory. \"Consistorial laws.\" Hooker. \"Consistorial courts.\" Bp. Hoadley.
consistorian |Pertaining to a Presbyterian consistory; -- a contemptuous term of 17th century controversy. You fall next on the consistorian schismatics; for so you call Presbyterians. Milton.
consistory |1. Primarily, a place of standing or staying together; hence, any solemn assembly or council. To council summons all his mighty peers, Within thick clouds and dark tenfold involved, A gloomy consistory. Milton. 2. (Eng. Ch.)  The spiritual court of a diocesan bishop held before his chancellor or commissioner in his cathedral church or elsewhere. Hook. 3. (R. C. Ch.)  An assembly of prelates; a session of the college of cardinals at Rome. Pius was then hearing of causes in consistory. Bacon. 4. A church tribunal or governing body. Note: In some churches, as the Dutch Reformed in America, a consistory is composed of the minister and elders of an individual church, corresponding to a Presbyterian church session, and in others, as the Reformed church in France, it is composed of ministers and elders, corresponding to a presbytery. In some Lutheran countries it is a body of clerical and lay officers appointed by the sovereign to superintend ecclesiastical affairs. 5. A civil court of justice. [Obs.] Chaucer.\n\nOf the nature of, or pertaining to, a consistory. \"To hold consistory session.\" Strype.
consociate |An associate; an accomplice. [Archaic] \"Wicked consociates.\" Bp. Hall.\n\n1. To bring into alliance, confederacy, or relationship; to bring together; to join; to unite. [R.] Join pole to pole, consociate severed worlds. Mallet. 2. To unite in an ecclesiastical consociation. [U.S.]\n\n1. To be allied, confederated, or associated; to coalescence. [R.] Bentley. 2. To form an ecclesiastical consociation. [U.S.]
consociation |1. Intimate union; fellowship; alliance; companionship; confederation; association; intimacy. A friendly consociation with your kindred elements. Warburton. 2. A voluntary and permanent council or union of neighboring Congregational churches, for mutual advice and co Note: In Connecticut some of the Congregational churhes are associated in consociations and the others in conferences.
consociational |Of or pertaining to a consociation. [U.S.]
consol |A consolidated annuity (see Consols); -- chiefly in combination or attributively.
consolable |Capable of receiving consolation.
consolate |To console; to comfort. [Obs.] Shak.
consolation |The act of consoling; the state of being consoled; allevation of misery or distress of mind; refreshment of spirit; comfort; that which consoles or comforts the spirit. Against such cruelties With inward consolations recompensed. Milton. Are the consolations of God small with thee Job xv. 11. Syn. -- Comfort; solace; allevation. See Comfort.
consolato del mare |A collection of maritime laws of disputed origin, supposed to have been first published at Barcelona early in the 14th century. It has formed the basis of most of the subsequent collections of maritime laws. Kent. Bouvier.
consolator |One who consoles or comforts. Johnson.
consolatory |Of a consoling or comforting nature. The punishment of tyrants is a noble and awful act of justice; and it has with truth been said to be consolatory to the human mind. Burke.\n\nThat which consoles; a speech or writing intended for consolation. [R.] Milton.
console |To cheer in distress or depression; to alleviate the grief and raise the spirits of; to relieve; to comfort; to soothe. And empty heads console with empty sound. Pope. I am much consoled by the reflection that the religion of Christ has been attacked in vain by all the wits and philosophers, and its triumph has been complete. P. Henry. Syn. -- To comfort; solace; soothe; cheer; sustain; encourage; support. See Comfort.\n\n(a) A bracket whose projection is not more than half its height. (b) Any small bracket; also, a console table. Console table, a table whose top is supported by two or more consoles instead of legs.
consoler |One who gives consolation.
consolidant |Serving to unite or consolidate; having the quality of consolidating or making firm.
consolidate |Formed into a solid mass; made firm; consolidated. [R.] A gentleman [should learn to ride] while he is tender and the brawns and sinews of his thighs not fully consolidate. Elyot.\n\n1. To make solid; to unite or press together into a compact mass; to harden or make dense and firm. He fixed and consolidated the earth. T. Burnet. 2. To unite, as various particulars, into one mass or body; to bring together in close union; to combine; as, to consolidate the armies of the republic. Consolidating numbers into unity. Wordsworth. 3. (Surg.)  To unite by means of applications, as the parts of a broken bone, or the lips of a wound. [R.] Syn. -- To unite; combine; harden; compact; condense; compress.\n\nTo grow firm and hard; to unite and become solid; as, moist clay consolidates by drying. In hurts and ulcers of the head, dryness maketh them more apt to consolidate. Bacon.
consolidated |1. Made solid, hard, or compact; united; joined; solidified. The Aggregate Fund . . . consisted of a great variety of taxes and surpluses of taxes and duties which were [in 1715] consolidated. Rees. A mass of partially consolidated mud. Tyndall. 2. (Bot.)  Having a small surface in proportion to bulk, as in the cactus. Consolidated plants are evidently adapted and designed for very dry regions; in such only they are found. Gray. The Consolidated Fund, a British fund formed by consolidating (in 1787) three public funds (the Aggregate Fund, the General Fund, and the South Sea Fund). In 1816, the larger part of the revenues of Great Britian and Ireland was assigned to what has been known as the Consolidated Fund of the United Kingdom, out of which are paid the interest of the national debt, the salaries of the civil list, etc.
consolidation |1. The act or process of consolidating, making firm, or uniting; the state of being consolidated; solidification; combination. The consolidation of the marble and of the stone did not fall out at random. Woodward. The consolidation of the great European monarchies. Hallam. 2. (Bot.)  To organic cohesion of different circled in a flower; adnation. 3. (Law)  The combination of several actions into one.
consolidative |Tending or having power to consolidate; healing.
consoling |Adapted to console or comfort; cheering; as, this is consoling news.
consols |The leading British funded government security. Note: A considerable part of the public debt of Great Britian, which had been contracted in the form of annuities yielding various rates of interest, was, in 1757, consolidated into one fund at 3 per cent interest, the account of which is kept at the Bank of England. This debt has been diminished and increased at different times, and now constitutes somewhat more than half of the entire national debt. The stocks are transferable, and Their value in the market constantly fluctuates; the price at any time being regarded as a gauge of the national prosperity and public confidence.
consomme |A clear soup or bouillion boiled down so as to be very rich.
consonance |1. (Mus.)  Accord or agreement of sounds produced simultaneously, as a note with its third, fifth, and eighth. 2. Agreement or congruity; harmony; accord; consistency; suitableness. The perfect consonancy of our persecuted church to the doctrines of Scripture and antiquity. Hammond. The optic nerve responds to the waves with which it is in consonance. Tyndall. 3. Friendship; concord. [Obs.] By the consonancy of our youth. Shak. Syn. -- Agreement; accord; consistency; unison; harmony; congruity; suitableness; agreeableness.
consonancy |1. (Mus.)  Accord or agreement of sounds produced simultaneously, as a note with its third, fifth, and eighth. 2. Agreement or congruity; harmony; accord; consistency; suitableness. The perfect consonancy of our persecuted church to the doctrines of Scripture and antiquity. Hammond. The optic nerve responds to the waves with which it is in consonance. Tyndall. 3. Friendship; concord. [Obs.] By the consonancy of our youth. Shak. Syn. -- Agreement; accord; consistency; unison; harmony; congruity; suitableness; agreeableness.
consonant |1. Having agreement; congruous; consistent; according; -- usually followed by with or to. Each one pretends that his opinion . . . is consonant to the words there used. Bp. Beveridge. That where much is given shall be much required is a thing consonant with natural equity. Dr. H. More. 2. Having like sounds. Consonant words and syllables. Howell. 3. (Mus.)  harmonizing together; accordant; as, consonant tones, consonant chords. 4. Of or pertaining to consonants; made up of, or containing many, consonants. No Russian whose dissonant consonant name Almost shatters to fragments the trumpet of fame. T. Moore.\n\nAn articulate sound which in utterance is usually combined and sounded with an open sound called a vowel; a member of the spoken alphabet other than a vowel; also, a letter or character representing such a sound. Note: Consonants are divided into various classes, as mutes, spirants, sibilants, nasals, semivowels, etc. All of them are sounds uttered through a closer position of the organs than that of a vowel proper, although the most open of them, as the semivowels and nasals, are capable of being used as if vowels, and forming syllables with other closer consonants, as in the English feeble (taken ( Note: \"A consonant is the result of audible friction, squeezing, or stopping of the breath in some part of the mouth (or occasionally of the throath.) The main distinction between vowels and consonants is, that while in the former the mouth configuration merely modifies the vocalized breath, which is therefore an essential element of the vowels, in consonants the narrowing or stopping of the oral passage is the foundation of the sound, and the state of the glottis is something secondary.\" H. Sweet.
consonantal |,
consonantize |To change into, or use as, a consonant. \"The vowel is consonantized, that is, made closer in position.\" Peile.
consonantly |In a consonant, consistent, or congruous manner; agreeably.
consonantness |The quality or condition of being consonant, agreeable, or consistent.
consonous |Agreeing in sound; symphonious.
consopiation |The act of sleeping, or of lulling, to sleep. [Obs.] Pope.
consopite |Lulled to sleep. [Obs.] Dr. H. More.\n\nTo lull to sleep; to quiet; to compose. [Obs.] The operation of the masculine faculties of the soul were, for a while, well slacked and consopited. Dr. H. More.
consort |1. One who shares the lot of another; a companion; a partner; especially, a wife or husband. Milton. He single chose to live, and shunned to wed, Well pleased to want a consort of his bed. Dryden. The consort of the queen has passed from this troubled sphere. Thakeray. The snow-white gander, invariably accompanied by his darker consort. Darwin. 2. (Naut.)  A ship keeping company with another. 3. Concurrence; conjunction; combination; association; union. \"By Heaven's consort.\" Fuller. \"Working in consort.\" Hare. Take it singly, and is carries an air of levity; but, in consort with the rest, has a meaning quite different. Atterbury. 4. Etym: [LL. consortium.]  An assembly or association of persons; a company; a group; a combination. [Obs.] In one consort there sat Cruel revenge and rancorious despite, Disloyal treason, and heart-burning hate. Spenser. Lord, place me in thy consort. Herbert. 5. Etym: [Perh. confused with concert.]  Harmony of sounds; concert, as of musical instruments. [Obs.] Milton. To make a sad consort`; Come, let us join our mournful song with theirs. Spenser. Prince consort, the husband of a queen regnant. -- Queen consort, the wife of a king, as distinguished from a queen regnant, who rules alone, and a queen dowager, the window of a king.\n\nTo unite or to keep company; to associate; -- used with with. Which of the Grecian chiefs consorts with thee Dryden.\n\n1. To unite or join, as in affection, harmony, company, marriage, etc.; to associate. He with his consorted Eve. Milton. For all that pleasing is to living ears Was there consorted in one harmony. Spenser. He begins to consort himself with men. Locke. 2. To attend; to accompany. [Obs.] Thou, wretched boy, that didst consort him here, Shalt with him hence. Shak.
consortable |Suitable for association or companionship. [Obs.] Sir H. Wotton.
consortion |Fellowship; association; companionship. [Obs.] Sir T. Browne.
consortship |The condition of a consort; fellowship; partnership. Hammond.
consound |A name applied loosely to several plants of different genera, esp. the comfrey.
conspecific |Of the same species.
conspectuity |The faculty of seeing; sight; eye. Note: [A word of Menenius's making. Coriolanus ii. 1] Shak.
conspectus |A general sketch or outline of a subject; a synopsis; an epitome.
conspersion |The act of sprinkling. [Obs.] The conspersion washing the doorposts. Jer. Taylor.
conspicuity |The state or quality of being clear or bright; brightness; conspicuosness. [R.] Chapman.
conspicuous |1. Open to the view; obvious to the eye; easy to be seen; plainly visible; manifest; attracting the eye. It was a rock Of alabaster, piled up to the clouds, Conspicious far. Milton. Conspicious by her veil and hood, Signing the cross, the abbess stood. Sir W. Scott. 2. Obvious to the mental eye; easily recognized; clearly defined; notable; prominent; eminent; distinguished; as, a conspicuous exellence, or fault. A man who holds a conspicuous place in the political, eccesiastical, and literary history of England. Macaulay. Syn. -- Distinguished; eminent; famous; illustrious; prominent; celebrated. See Distinguished. -- Con*spic\"u*ous*ly, adv. -- Con*spic\"u*ous*ness, n.
conspiracy |1. A combination of men for an evil purpose; as agreement, between two or more persons, to commit a crime in concert, as treason; a plot. When shapen was all his conspiracy From point to point. Chaucer. They made a conspiracy against [Amaziah]. 2 Kings xiv. 19. I had forgot that foul conspiracy Of the beast Caliban and his confederates. Shak. 2. A concurence or general tendency, as of circumstances, to one event, as if by agreement. A conspiracy in all heavenly and earthly things. Sir P. Sidney. 3. (Law)  An agreement, manifesting itself in words or deeds, by which two or more persons confederate to do an unlawful act, or to use unlawful to do an act which is lawful; confederacy. Syn. -- Combination; plot; cabal.
conspirant |Engaging in a plot to commit a crime; conspiring. [Obs.] Shak.
conspiration |Agreement or concurrence for some end or purpose; conspiracy. [R.] As soon as it was day, certain Jews made a conspiration. Udall. In our natural body every part has a nacassary sympathy with every other, and all together form, by their harmonious onspiration, a healthy whole. Sir W. Hamilton.
conspirator |One who engages in a conspiracy; a plotter. 2 Sam. xv. 31.
conspire |1. To make an agreement, esp. a secret agreement, to do some act, as to commit treason or a crime, or to do some unlawful deed; to plot together. They conspired against [Joseph] to slay him. Gen. xxxvii. 18. You have conspired against our royal person, Joined with an enemy proclaimed. Shak. 2. To concur to one end; to agree. The press, the pulpit, and the stage Conspire to censure and expose our age. Roscommon. Syn. -- To unite; concur; complot; confederate; league.\n\nTo plot; to plan; to combine for. Angry clouds conspire your overthrow. Bp. Hall.
conspirer |One who conspires; a conspirator.
conspiringly |In the manner of a conspirator; by conspiracy. Milton.
conspissation |A making thick or viscous; thickness; inspissation. [R.] Dr. H. More.
conspurcate |To pollute; to defile. [Obs.] Cockeram.
conspurcation |This act of defiling; defilement; pollution. Bp. Hall.
constable |1. A high officer in the monarhical establishments of the Middle Ages. Note: The constable of France was the first officer of the crown, and had the chief ommand of the army. It was also his duty to regulate all matters of chivalry. The office was suppressed in 1627. The constable, or lord high constable, of England, was one of the highest officers of the crown, commander in chief of the forces, and keeper of the peace of the nation. He also judicial cognizance of many important matters. The office was as early as the Conquest, but has been disused (except on great and solemn occasions), since the attainder of Stafford, duke of Buckingham, in the reign of Henry VIII. 2. (Law)  An officer of the peace having power as a conservator of the public peace, and bound to exeute the warrants of judicial offiers. Bouvier. Note: In England, at the present time, the constable is a conservator of the peace within his district, and is also charged by various statutes with other duties, such as serving summons, precepts, warrants, etc. In the United States, constables are town or its officers of the peace, with powers similar to those of the constables of England. In addition to their duties as conservators of the peace, they are invested with others by statute, such as to execute civil as well as criminal process in certain cases, to attend courts, keep juries, etc. In some cities, there are officers called high constables, who act as shiefs of the constabulary or police force. In other cities the title of constable, as well as the office, is merged in that of the polie officer. High constable, a constable having certain duties and powers within a hundred. [Eng.] -- Petty constable, a conservator of the peace within a parish or tithing; a tithingman. [Eng.] -- Special constable, a person appointed to act as constable of special occasions. -- To overrun, or outrun, the constable, the spend more than one's income; to get into debt. [Colloq.] Smollett.
constablery |1. The constabulary. [Obs.] 2. The distrit or jurisdiction of a constable. [Obs.]
constableship |The office or functions of a constable.
constabless |The wife of a constable. [Obs.]
constablewick |The district to which a constable's power is limited. [Obs.] Sir M. Hale.
constabulary |Of or pertaining to constables; consisting of constables.\n\nThe collective body of constables in any town, district, or country.
constabulatory |A constabulary. [Obs.] Bp. Burnet.
constancy |1. The state or quality of being constant or steadfast; freedom from hange; stability; fixedness; immutabilitu; asm the constancy of God in his nature and attributes. 2. Fixedness or firmness of mind; persevering resolution; especially, firmness of mind under sufferings, steadiness in attashments, or perseverance in enterprise; stability; fidelity. A fellow of plain unoined constancy. Shak. Constancy and contempt of danger. Prescott. Syn. -- Fixedness; stability; firmness; steadiness; permanence; steadfastness; resolution. See Firmness.
constant |1. Firm; solid; fixed; immovable; -- opposed to fluid. [Obs.] If . . . you mix them, you may turn these two fluid liquors into a constant body. Boyle. 2. Not liable, or given, to change; permanent; regular; continuous; continually recurring; steadfast; faithful; not fickle. Both loving one fair maid, they yet remained constant friends. Sir P. Sidney. I am constant to my purposes. Shak. His gifts, his constant ourtship, nothing gained. Dryden. Onward the constant current sweeps. Longfellow. 3. (Math. & Physics)  Remaining unchanged or invariable, as a quantity, forc, law, etc. 4. Consistent; logical. [Obs.] Shak. Syn. -- Fixed; steadfast; unchanging; permanent; unalterable; immutable; perpetual; continual; resolute; firm; unshaken; determined. -- Constant, Continual, Perpetual. These words are sometimes used in an absolute and sometimes in a qualified sense. Constant denotes, in its absolute sense, unchangeably fixed; as, a constant mind or purpose. In its qualified sense, it marks something as a \"standing\" fact or occurence; as, liable to constant interruptions; constantly called for. Continual, in its absolute sense, coincides with continuous. See Continuous. In its qualified sense, it describes, a thing as occuring in steady and rapid succession; as, a round of continual calls; continually changing. Perpetual denotes, in its absolute sense, what literally never ceases or comes to an end; as, perpetual motion. In its qualified sense, it is used hyperbolically, and denotes that which rarely ceases; as, perpetual disturbance; perpetual noise; perpetual intermeddling.\n\n1. That which is not subject to change; that which is invariable. 2. (Math.)  A quantity that does not change its value; -- used in countradistinction variable. Absolute costant (Math.), one whose value is absolutely the same under all cirumstanes, as the number 10, or any numeral. -- Arbitrary constant, an undetermined constant in a differential equation having the same value during all changes in the values of the variables.
constantia |A superior wine, white and red, from Constantia, in Cape Colony.
constantly |With constancy; steadily; continually; perseveringly; without cessation; uniformly. But she constantly affirmed that it was even so. Acts. xii. 15.
constat |A certificate showing what appears upon record touching a matter in question.
constate |To ascertain; to verify; to establish; to prove. F. P. Cobbe.
constellate |To join luster; to shine with united radiance, or one general light. [R.] The several things which engage our affections . . . shine forth and constellate in God. Boule.\n\n1. To unite in one luster or radiane, as stars. [R.] Whe know how to constellate these lights. Boyle. 2. To set or adorn with stars or constellations; as, constellated heavens. J. Barlow.
constellation |1. A cluster or group of fixed stars, or dvision of the heavens, designated in most cases by the name of some animal, or of some mythologial personage, within whose imaginary outline, as traced upon the heavens, the group is included. The constellations seem to have been almost purposely named and delineated to cause as much confusion and inconvenience as possible. Sir J. Herschel. Note: In each of the constellations now recognized by astronomers (about 90 in number) the brightest stars, both named and unnamed are designated nearly in the order of brilliancy by the letters of the Greek alphabet; as, 2. An assemblage of splendors or excellences. The constellations of genius had already begun to show itself . . . which was to shed a glory over the meridian and close of Philip's reign. Prescott. 3. Fortune; fate; destiny. [Obs.] It is constellation, which causeth all that a man doeth. Gower.
consternation |Amazement or horror that confounds the faculties, and incapacitates for refletion; terror, combined with amaxement; dismay. The chiefs around, In silence wrapped, in onsternation downed. Attend the stern reply. Pope. Syn. -- Alarm; fright; amazement; astonishment; surprise; panic; returbation. See Alarm.
constipate |1. To crowd or cram into a narrow compass; to press together or condense. [Obs.] Of cold the property is to condense and constipate. Bacon. 2. To stop (a channel) by filling it, and preventing passage through it; as, to constipate the capillary vessels. 3. (Med.)  To render costive; to cause constipation in.
constipation |1. Act of crowding anything into a less compass, or the state of being crowded or pressed together; condensation. [Obs.] Fullness of matter, or a pretty close constipation . . . of its particles. Boyle. 2. A state of the bowels in which the evacuations are infrequent and difficult, or the intestines become filled with hardened faces; costiveness.
constituency |A body of constituents, as the body of citizens or voters in a representative district.
constituent |1. Serving to form, compose, or make up; elemental; component. Body, soul, and reason are the three parts necessarily constituent of a man. Dryden. 2. Having the power of electing or appointing. A question of right arises between the constituent and representative body. Junius.\n\n1. The person or thing which constitutes, determines, or constructs. Their first composure and origination require a higher and nobler constituent than chance. Sir M. Hale 2. That which constitutes or composes, as a part, or an essential part; a component; an element. We know how to bring these constituents together, and to cause them to form water. Tyndall. 3. One for whom another acts; especially, one who is represented by another in a legislative assembly; -- correlative to representative. The electors in the district of a representative in Congress, or in the legislature of a State, are termed his constituents. Abbot. To appeal from the representatives to the constituents. Macaulay. 4. (Law)  A person who appoints another to act for him as attorney in fact. Burrill.
constitute |1. To cause to stand; to establish; to enact. Laws appointed and constituted by lawful authority. Jer. Taylor. 2. To make up; to compose; to form. Truth and reason constitute that intellectual gold that defies destruction. Johnson. 3. To appoint, depute, or elect to an offie; to make and empower. Me didst Thou constitute a priest of thine. Wordsworth. Constituted authorities, the officers of government, collectively, as of a nation, city, town, etc. Bartlett.\n\nAn established law. [Obs.] T. Preston.
constituter |One who constitutes or appoints.
constitution |1. The act or process of constituting; the action of enacting, establishing, or appointing; enactment; establishment; formation. 2. The state of being; that form of being, or structure and connection of parts, which constitutes and characterizes a system or body; natural condition; structure; texture; conformation. The physical constitution of the sun. Sir J. Herschel. 3. The agregate of all one's inherited physical qualities; the aggregate of the vital powers of an individual, with refernce to ability to endure hardship, resist disease, etc.; as, a robust constitution. Our constitutions have never been enfeebled by the vices or luxuries of the oid world. Story. 4. The aggregate of mental qualities; temperament. He defended himself with . . . less passion than was expected from his constitution. Clarendon. 5. The fundamental, organic law or principles of government of men, embodied in written documents, or implied in the institutions and usages of the country or society; also, a written instrument embodying such organic law, and laying down fundamental rules and principles for the conduct of affairs. Our constitution had begun to exist in times when statesmen were not much accustomed to frame exact definitions. Macaulay. Note: In England the constitution is unwritten, and may be modified from time to time by act of Parliament. In the United States a constitution cannot ordinarily be modified, exept through such processes as the constitution itself ordains. 6. An authoritative ordinance, regulation or enactment; especially, one made by a Roman emperor, or one affecting ecclesiastical doctrine or disipline; as, the constitutions of Justinian. The positive constutions of our own churches. Hooker. A constitution of Valentinian addressed to Olybrius, then prefect of Rome, for the regulation of the conduct of advocates. George Long. Apostolic constitutions. See under Apostolic.
constitutional |1. Belonging to, or inherent in, the constitution, or in the structure of body or mind; as, a constitutional infirmity; constitutional ardor or dullness. 2. In accordance with, or authorized by, the constitution of a state or a society; as, constitutional reforms. 3. Regulated by, dependent on, or secured by, a constitution; as, constitutional government; constitutional rights. Hallam. 4. Relating to a constitution, or establishment form of government; as, a constitutional risis. The anient constitutional traditions of the state. Macaulay. 5. For the benefit or one's constitution or health; as, a constitutional walk. [Colloq.] Constitutional law, law that relates to the constitution, as a permanent system of political and juridical government, as distinguished from statutory and common law, which relate to matters subordinate to such constitution.\n\nA walk or other exercise taken for one's health or constitution. [Colloq.] Thackeray. The men trudged diurnal constitutionals along the different roads. Compton Reade.
constitutionalism |The theory, principles, or authority of constitutional government; attachment or adherene to a constitution or constitutional government. Carlyle.
constitutionalist |One who advocates a constitutional form of government; a constitutionalist.
constitutionality |1. The quality or state of being constitutional, or inherent in the natural frame. 2. The state of being consistent with the constitution or frame of government, or of being authorized by its provisions. Burke. Constitutionalities, bottomless cavilings and questionings about written laws. Carlyle.
constitutionally |1. In accordance with the constitution or natural disposition of the mind or body; naturally; as, he was constitutionally timid. The English were constitutionally humane. Hallam. 2. In accordance with the constitution or fundamental law; legally; as, he was not constitutionally appointed. Nothing would indue them to acknowledge that [such] an assembly . . . was constitutionally a Parliament. Macaulay.
constitutionist |One who adheres to the constitution of the country. Bolingbroke.
constitutive |1. Tending or assisting to constitute or compose; elemental; essential. An ingredient and constitutive part of every virtue. Barrow. 2. Having power to enact, establish, or create; instituting; determining. Sir W. Hamilton.
constitutively |In a constitutive manner.
constrain |1. To secure by bonds; to chain; to bond or con He binds in hains The droway prophet, and his limbs constrains. Dryden. When winter frosts constrain the fields with old. Dryden. 2. To bring into a narrow compass; to compress. How the strait stays the slender waist constrain. Gay. 3. To hold back by force; to restrain; to repress. My sire in caves constrains the winds. Dryden. 4. To compel; to force; to necessiate; to oblige. The love of Christ constraineth us. 2. Cor. v. 14. I was constrained to appeal unto CActs xxviii. 19. 5. To violate; to ravish. [Obs.] Shak. 6. To produce in such a manner as to give an unnatural effet; as, a constrained voice. Syn. -- To compel; force; drive; impel; urge; press.
constrainable |Capable of being constrained; liable to constraint, or to restraint. Hooker.
constrained |Marked by constraint; not free; not voluntary; embarrassed; as, a constrained manner; a constrained tone.
constrainedly |By constraint or compulsion; in a constrained manner. Hooker.
constrainer |One who constrains.
constraint |The act of constraining, or the state of being constrained; that which compels to, or restrains from, action; compulsion; restraint; necessity. Long imprisonment and hard constraint. Spenser. Not by constraint, but bDryden. Syn. -- Compulsion; violence; necessity; urgency. -- Constraint, Compulsion. Constraint implies strong binding force; as, the constraint of necessity; the constraint of fear. Compulsion implies the exertion of some urgent impelling force; as, driven by compulsion. The former prevents us from acting agreeably to our wishes; the latter forces us to act contrary to our will. Compulsion is always produced by some active agent; a constraint may be laid upon us by the forms of civil society, or by other outward circumstances. Crabb.
constraintive |Constraining; compulsory. [R.] \"Any constraintive vow.\" R. Carew.
constrict |To draw together; to render narrower or smaller; to bind; to cramp; to contract or ause to shrink. Such things as constrict the fibers. Arbuthnot. Membranous organs inclosing a cavity which their contraction constrict. Todd & Bowman.
constricted |1. Drawn together; bound; contracted; cramped. 2. (Bot.)  Contracted or compressed so as to be smaller in certain places or parts than in others.
constriction |1. The act of constricting by means of some inherent power or by movement or change in the thing itself, as distinguished from compression. 2. The state of being constricted; the point where a thing is constricted; a narrowing or binding. A constriction of the parts inservient to speech. Grew.
constrictive |Serving or tending to bind or constrict.
constrictor |1. That which constricts, draws together, or contracts. 2. (Anat.)  A muscle which contracts or closes an orifice, or which compresses an organ; a sphincter. 3. (Zo√∂l.)  A serpent that kills its prey by inclosing and crushing it with its folds; as, the boa constrictor.
constringe |To dawn together; to contract; to force to contract itself; to constrict; to cause to shrink. [R.] Strong liquors . . . intoxicate, constringe, harden the fibers, and coagulate the fluids. Arbuthnot.
constringent |Having the quality of contracting, binding, or compressing. Thomson.
construct |1. To put together the constituent parts of (something) in their proper place and order; to build; to form; to make; as, to construct an edlifice. 2. To devise; to invent; to set in order; to arrange; as, to construct a theory of ethics. Syn. -- To build; erect; form; compile; make; fabricate; originate; invent.\n\nFormed by, or relating to, construction, interpretation, or inference. Construct form or state (Heb. Gram.), that of a noun used before another which has the genitive relation to it.
constructer |One who, or that which, constructs or frames.
construction |1. The process or art of constructing; the act of building; erection; the act of devising and forming; fabrication; composition. 2. The form or manner of building or putting together the parts of anything; structure; arrangement. An astrolabe of peculiar construction. Whewell. 3. (Gram.)  The arrangement and connection of words in a sentence; syntactical arrangement. Some particles . . . in certain constructions have the sense of a whole sentence contained in them. Locke. 4. The method of construing, interpreting, or explaining a declaration or fact; an attributed sense or meaning; understanding; explanation; interpretation; sense. Any person . . . might, by the sort of construction that would be put on this act, become liable to the penalties of treason. Hallam. Strictly, the term [construction] signifies determining the meaning and proper effect of language by a consideration of the subject matter and attendant circumstances in connection with the words employed. Abbott. Interpretation properly precedes construction, but it does not go beyond the written text. Parsons. Construction of an equation (Math.), the drawing of such lines and figures as will represent geometrically the quantities in the equation, and their relations to each other. -- Construction train (Railroad), a train for transporting men and materials for construction or repairs.
constructional |Pertaining to, or deduced from, construction or interpretation.
constructionist |One who puts a certain construction upon some writing or instrument, as the Constitutions of the United States; as, a strict constructionist; a broad constructionist.
constructive |1. Having ability to construct or form; employed in construction; as, to exhibit constructive power. The constructive fingers of Watts. Emerson. 2. Derived from, or depending on, construction or interpretation; not directly expressed, but inferred. Constructive crimes (Law), acts having effects analogous to those of some statutory or common law crimes; as, constructive treason. Constructive crimes are no longer recognized by the courts. -- Constructive notice, notice imputed by construction of law. -- Constructive trust, a trust which may be assumed to exist, though no actual mention of it be made.
constructively |In a constructive manner; by construction or inference. A neutral must have notice of a blockade, either actually by a formal information, or constructively by notice to his government. Kent.
constructiveness |1. Tendency or ability to form or construct. 2. (Phren.)  The faculty which enables one to construct, as in mechanical, artistic, or literary matters.
constructor |A constructer.
constructure |That which is constructed or formed; an edifice; a fabric. [Obs.]
construe |1. To apply the rules of syntax to (a sentence or clause) so as to exhibit the structure, arrangement, or connection of, or to discover the sense; to explain the construction of; to interpret; to translate. 2. To put a construction upon; to explain the sense or intention of; to interpret; to understand. Thus we are put to construe and paraphrase our own words to free ourselves either from the ignorance or malice of our enemies. Bp. Stilingfleet. And to be dull was construed to be good. Pope.
constuprate |To ravish; to debauch. Burton.
constupration |The act of ravishing; violation; defilement. Bp. Hall.
consubstantial |Of the same kind or nature; having the same substance or essence; coessential. Christ Jesus . . . coeternal and consubstantial with the Father and with the Holy Ghost. Foxe.
consubstantialism |The doctrine of consubstantiation.
consubstantialist |One who believes in consubstantiation. Barrow.
consubstantiality |Participation of the same nature; coexistence in the same substance. \"His [the Son's] . . . consubstantiality with the Father.\" Hammend.
consubstantially |In a consubstantial manner; with identity of substance or nature.
consubstantiate |To cause to unite, or to regard as united, in one common substance or nature. [R.] His soul must be consubstantiated with reason. Jer. Taylor.\n\nTo profess or belive the doctrine of consubstantion. The consubstantiating church and priest. Dryden.\n\nPartaking of the same substance; united; consubstantial. We must love her [the wife] that is thus consubstantiate with us. Feltham.
consubstantiation |1. An identity or union of substance. 2. (Theol.)  The actual, substantial presence of the body of Christ with the bread and wine of the sacrament of the Lord's Supper; impanation; -- opposed to transubstantiation. Note: This view, held by Luther himself, was called consubstantiation by non Lutheran writers in contradistinction to transsubstantiation, the Catholic view.
consuetude |Custom, habit; usage. [R.] To observe this consuetude or law. Barnes .
consuetudinal |According to custom; customary; usual. [R.]
consuetudinary |Customary.\n\nA manual or ritual of customary devotional exercises.
consul |1. (Rom. Antiq.)  One of the two chief magistrates of the republic. Note: They were chosen annually, originally from the patricians only, but later from the plebeians also. 2. A senator; a counselor. [Obs.] Many of the consuls, raised and met, Are at the duke's already. Shak. With kings and consuls of the earth. Job. iii. 14 (Douay Ver. ) 3. (Fr. Hist.)  One of the three chief magistrates of France from 1799 to 1804, who were called, respectively, first, second, and third consul. 4. An official comissioned to reside in some foreign country, to care for the commercial interests of the citizens of the appointing government, and to protect its seamen. Consul general, a consul of the first rank, stationed in an important place, or having jurisdiction in several places or over several consula. -- Vice consul, a consular officer holding the place of a consul during the consul's absence or after he has been relieved.
consulage |A duty or tax paid by merchants for the protection of their connerce by means of a consul in a foreign place.
consular |Of or pertaining to a consul; performing the duties of a consul; as, consular power; consular dignity; consular officers.
consulary |Consular. [Obs.] Holland.
consulate |1. The office of a consul. Addison. 2. The jurisdiction or residence of a consul. Kent. 3. Consular government; term of office of a consul.
consulship |1. The office of a consul; consulate. 2. The term of office of a consul.
consult |To seek the opinion or advice of another; to take consel; to deliberate together; to confer. Let us consult upon to-morrow's business. Shak. All the laws of England have been made by the kings England, consulting with the nobility and commons. Hobbes.\n\n1. To ask advice of; to seek the opinion of; to apply to for information or instruction; to refer to; as, to consult a physician; to consult a dictionary. Men fergot, or feared, to consult . . . ; they were content to consult liberaries. Whewell. 2. To have reference to, in judging or acting; to have regard to; to consider; as, to consult one's wishes. We are . . . to consult the necessities of life, rather than matters of ornament and delight. L'Estrange. 3. To deliberate upon; to take for. [Obs.] Manythings were there consulted for the future, yet nothing was positively resolved. Clarendon. 4. To bring about by counsel or contrivance; to devise; to contrive. [Obs.] Thou hast consulted shame to thy Hab. ii. 10.\n\n1. The act of consulting or deliberating; consultation; also, the result of consulation; determination; decision. [Obs.] The council broke; And all grave consults dissolved in smoke. Dryden. 2. A council; a meeting for consultation. [Obs.] \"A consult of coquettes.\" Swift. 3. Agreement; concert [Obs.] Dryden.
consultary |Formed by consultation; resulting from conference. Consultary response (Law), the opinion of a court on a special case. Wharton.
consultation |1. The act of consulting or conferring; deliberation of two or more persons on some matter, with a view to a decision. Thus they doubtful consultations dark Ended. Milton. 2. A council or conference, as of physicians, held to consider a special case, or of lawyers restained in a cause. Writ of consultation (Law), a writ by which a cause, improperly removed by prohibition from one court to another, is returned to the court from which it came; -- so called because the judges, on consultation, find the prohibition ill-founded.
consultative |Pertaining to consultation; having the privilege or right of conference. \"A consultative . . . power.\" Abp. Bramhall.
consultatory |Formed by, or resulting from, consultation; advisory. Bancroft.
consulter |One who consults, or asks counsel or information.
consulting |That consults. Consulting physician (Med.), a physician who consults with the attending practitioner regarding any case of disease.
consultive |Determined by, or pertaining to, consultation; deliberate; consultative. He that remains in the grace of God sins not by any deliberative, consultive, knowing act. Jer. Taylor.
consumable |Capable of being consumed; that may be destroyed, dissipated, wasted, or spent. \"Consumable commodities.\" Locke.
consume |To destroy, as by decomposition, dissipation, waste, or fire; to use up; to expend; to waste; to burn up; to eat up; to devour. If he were putting to my house the brand That shall consume it. Shak. Lay up for yourselves treasures in heaven, where neither moth nor rust doth consume. Matt. vi. 20 (Rev. Ver. ). Let me alone . . . that I may consume them. Ex. xxxii. 10. Syn. -- To destroy; swallow up; ingulf; absorb; waste; exhaust; spend; expend; squander; lavish; dissipate.\n\nTo waste away slowly. Therefore, let Renedick, like covered fire, Consume away in sighs. Shak.
consumedly |Excessively. [Low] He's so consumedly pround of it. Thackeray.
consumer |One who, or that which, consumes; as, the consumer of food. CONSUMER'S GOODS Con*sum\"er's goods. (Polit. Econ.)  Economic goods that directly satisfy human wants or desires, such as food, clothes, pictures, etc.; -- called also consumption goods, or goods of the first order, and opposed to producer's goods. CONSUMER'S SURPLUS Consumer's surplus. (Polit. econ.)  The excess that a purchaser would be willing to pay for a commodity over that he does pay, rather than go without the commodity; -- called also consumer's rent. The price which a person pays for a thing can never exceed, and seldom comes up to, that which he would be willing to pay rather than go without it. . . . The excess of the price which he would be willing to pay rather than go without it, over that which he actually does pay, is the economic measure of this surplus satisfaction.  It has some analogies to a rent; but is perhaps best called simply consumer's surplus. Alfred Marshall.
consumingly |In a consuming manner.
consummate |Carried to the utmost extent or degree; of the highest quality; complete; perfect. \"A man of perfect and consummate virtue.\" Addison. The little band held the post with consummate tenacity. Motley\n\nTo bring to completion; to raise to the highest point or degree; to complete; to finish; to perfect; to achieve. To consummate this business happily. Shak.
consummately |In a consummate manner; completely. T. Warton.
consummation |The act of consummating, or the state of being consummated; completed; completion; perfection; termination; end (as of the world or of life). \"Tis a consummation Devoutly to be wished. Shak. From its original to its consummation. Addison. Quiet consummation have, And renownShak. Consummation of marrige, completion of the connubial relation by actual cohabition.
consummative |Serving to consummate; completing. \"The final, the consummative procedure of philosophy.\" Sir W. Hamilton.
consumption |1. The act or process of consuming by use, waste, etc.; decay; destruction. Every new advance of the price to the consumer is a new incentive to him to retrench the quality of his consumption. Burke. 2. The state or process of being consumed, wasted, or diminished; waste; diminution; loss; decay. 3. (Med.)  A progressive wasting away of the body; esp., that form of wasting, attendant upon pulmonary phthisis and associated with cough, spitting of blood, hectic fever, etc.; pulmonary phthisis; -- called also pulmonary consumption. Consumption of the bowels (Med.), inflammation and ulceration of the intestines from tubercular disease. Syn. -- Decline; waste; decay. See Decline.
consumptive |1. Of or pertaining to consumption; having the quality of consuming, or dissipating; destructive; wasting. It [prayer] is not consumptive or our time. Sharp. A long consumptive war. Addison. 2. (Med.)  Affected with, or inclined to, consumption. The lean, consumptive wench, with coughs decayed. Dryden.\n\nOne affected with consumption; as, a resort for consumptives.
consumptively |In a way tending to or indication consumption. Beddoes.
consumptiveness |A state of being consumptive, or a tendency to a consumption.
contabescent |Wasting away gradually. Darwin. - Con*ta*bes\"cence, n.
contact |1. A close union or junction of bodies; a touching or meeting. 2. (Geom.)  The property of two curves, or surfaces, which meet, and at the point of meeting have a common direction. 3. (Mining)  The plane between two adjacent bodies of dissimilar rock. Raymond. Contact level, a delicate level so pivoted as to tilt when two parts of a measuring apparatus come into contact with each other; -- used in precise determinations of lengths and in the accurate graduation of instruments.
contaction |Act of touching. [Obs.]
contagion |1. (Med.)  The transmission of a disease from one person to another, by direct or indirect contact. Note: The term has been applied by some to the action of miasmata arising from dead animal or vegetable matter, bogs, fens, etc., but in this sense it is now abandoned. Dunglison. And will he steal out of his wholesome bed To dare the vile contagion of the night Shak. 2. That which serves as a medium or agency to transmit disease; a virus produced by, or exhalation proceeding from, a diseased person, and capable of reproducing the disease. 3. The act or means of communicating any influence to the mind or heart; as, the contagion of enthusiasm. \"The contagion of example.\" Eikon Basilike. When lust . . . Lets in defilement to the inward parts, The soul grows clotted by contagion. Milton. 4. Venom; poison. [Obs.] \"I'll touch my point with this contagion.\" Shak. Syn. -- See Infection.
contagioned |Affected by contagion.
contagionist |One who believes in the contagious character of certain diseases, as of yellow fever.
contagious |1. (Med.)  Communicable by contact, by a virus, or by a bodily exhalation; catching; as, a contagious disease. 2. Conveying or generating disease; pestilential; poisonous; as, contagious air. 3. Spreading or communicable from one to another; exciting similar emotions or conduct in others. His genius rendered his courage more contagious. Wirt. The spirit of imitation is contagious. Ames. Syn. -- Contagious, Infectious. These words have been used in very diverse senses; but, in general, a contagious disease has considered as one which is caught from another by contact, by the breath, by bodily effluvia, etc.; while an infectious disease supposes some entirely different cause acting by a hidden influence, like the miasma of prison ships, of marshes, etc., infecting the system with disease. \"This distinction, though not universally admitted by medical men, as to the literal meaning, of the words, certainly applies to them in their figurative use. Thus we speak of the contagious influence of evil associates; their contagion of bad example, the contagion of fear, etc., when we refer to transmission by proximity or contact. On the other hand, we speak of infection by bad principles, etc., when we consider anything as diffused by some hidden influence.
contagious disease |A disease communicable by contact with a patient suffering from it, or with some secretion of, or object touched by, such a patient. Most such diseases have already been proved to be germ diseases, and their communicability depends on the transmission of the living germs.  Many germ diseases are not contagious, some special method of transmission or inoculation of the germs being required.
contagiously |In a contagious manner.
contagiousness |Quality of being contagious.
contagium |Contagion; contagious matter. \"Contagium of measles.\" Tyndall.
contain |1. To hold within fixed limits; to comprise; to include; to inclose; to hold. Behold, heaven and the heaven of heavens can not contain thee; how much less this house! 2 Chron. vi. 18. When that this body did contain a spirit. Shak. What thy stores contain bring forth. Milton. 2. To have capacity for; to be able to hold; to hold; to be equivalent to; as, a bushel contains four pecks. 3. To put constraint upon; to restrain; to confine; to keep within bounds. [Obs., exept as used reflexively.] The king's person contains the unruly people from evil occasions. Spenser. Fear not, my lord: we can contain ourselves. Shak.\n\nTo restrain desire; to live in continence or chastity. But if they can not contain, let them marry. 1 Cor. vii. 9.
containable |Capable of being contained or comprised. Boyle.
containant |A container.
container |One who, or that which, contains.
containment |That which is contained; the extent; the substance. [Obs.] The containment of a rich man's estate. Fuller.
contaminable |Capable of being contaminated.
contaminate |To soil, stain, or corrupt by contact; to tarnish; to sully; to taint; to pollute; to defile. Shall we now Contaminate our figures with base bribes Shak. I would neither have simplicity imposed upon, nor virtue contaminated. Goldsmith. Syn. -- To pollute; defile; sully; taint; tarnish; soil; stain; corrupt.\n\nContaminated; defiled; polluted; tainted. \"Contaminate drink.\" Daniel.
contamination |The act or process of contaminating; pollution; defilement; taint; also, that which contaminates.
contamitive |Tending or liable to contaminate.
contango |1. (Stock Exchange)  The premium or interest paid by the buyer to the seller, to be allowed to defer paying for the stock purchased until the next fortnightly settlement day. [Eng.] 2. (Law)  The postponement of payment by the buyer of stock on the payment of a premium to the seller. See Backwardation. N. Biddle.
conte |A short narrative or tale, esp. one dealing with surprising or marvelous events. The conte (sic) is a tale something more than a sketch, it may be, and something less than a short story. . . . The \"Canterbury Tales\" are contes, most of them, if not all, and so are some of the \"Tales of a Wayside Inn.\" Brander Matthews.
contection |A covering. [Obs.] Sir T. Browne.
contek |1. Quarrel; contention; contest. [Obs.] Contek with bloody knife. Chaucer. 2 2  Contumely; reproach. [Obs.] Wyclif.
contemn |To view or treat with contempt, as mean and despicable; to reject with disdain; to despise; to scorn. Thy pompous delicacies I contemn. Milton. One who contemned divine and human laws. Dryden. Syn. -- To despise; scorn; disdain; spurn; slight; neglect; underrate; overlook. -- To Contemn, Despise, Scorn, Disdain. Contemn is the generic term, and is applied especially to objects, qualities, etc., which are deemed contemptible, and but rarely to individuals; to despise is to regard or treat as mean, unbecoming, or worthless; to scorn is stronger, expressing a quick, indignant contempt; disdain is still stronger, denoting either unwarrantable pride and haughtiness or an abhorrence of what is base.
contemner |One who contemns; a despiser; a scorner. \"Contemners of the gods.\" South.
contemningly |Contemptuously. [R.]
contemper |To modify or temper; to allay; to qualify; to moderate; to soften. [Obs.] The antidotes . . . have allayed its bitterness and contempered its malignancy. Johnson.
contemperate |To temper; to moderate. [Obs.] Moisten and contemperate the air. Sir T. Browne.
contemperation |1. The act of tempering or moderating. [Obs.] Sir T. Browne. 2. Proportionate mixture or combination. \"Contemperation of light and shade.\" Boyle.
contemperature |The condition of being tempered; proportionate mixture; temperature. [Obs.] The different contemperature of the elements. SDouth.
contemplance |Contemplation. [Obs.] Chaucer.
contemplant |Given to contemplation; meditative. [R.] Coleridge.
contemplate |1. To look at on all sides or in all its bearings; to view or consider with continued attention; to regard with deliberate care; to meditate on; to study. To love, at least contemplate and admire, What I see excellent. Milton. We thus dilate Our spirits to the size of that they contemplate. Byron. 2. To consider or have in view, as contingent or probable; to look forward to; to purpose; to intend. There remain some particulars to complete the information contemplated by those resolutions. A. Hamilton. If a treaty contains any stipulations which contemplate a state of future war. Kent. Syn. -- To view; behold; study; ponder; muse; meditate on; reflect on; consider; intend; design; plan; propose; purpose. See Meditate.\n\nTo consider or think studiously; to ponder; to reflect; to muse; to meditate. So many hours must I contemplate. Shak.
contemplation |1. The act of the mind in considering with attention; continued attention of the mind to a particular subject; meditation; musing; study. In contemplation of created things, By steps we may ascend to God. Milton. Contemplation is keeping the idea which is brought into the mind for some time actually in view. Locke. 2. Holy meditation. [Obs.] To live in prayer and contemplation. Shak. 3. The act of looking forward to an event as about to happen; expectation; the act of intending or purposing. In contemplation of returning at an early date, he left. Reid. To have in contemplation, to inted or purpose, or to have under consideration.
contemplatist |A contemplator. [R.] I. Taylor.
contemplative |1. Pertaining to contemplation; addicted to, or employed in, contemplation; meditative. Fixed and contemplative their looks. Denham. 2. Having the power of contemplation; as, contemplative faculties. Ray.\n\nA religious or either sex devoted to prayer and meditation, rather than to active works of charity.
contemplatively |With contemplation; in a contemplative manner.
contemplativeness |The state of being contemplative; thoughtfulness.
contemplator |One who contemplates. Sir T. Browne.
contemporaneity |The state of being contemporaneous. The lines of contemporaneity in the o√∂litic system. J. Philips.
contemporaneous |Living, existing, or occurring at the same time; contemporary. The great age of Jewish philosophy, that of Aben Esra, Maimonides, and Kimchi, had been contemporaneous with the later Spanish school of Arabic philosophy. Milman - Con*tem`po*ra\"ne*ous*ness, n.
contemporaneously |At the same time with some other event.
contemporariness |Existence at the same time; contemporaneousness. Howell.
contemporary |1. Living, occuring, or existing, at the same time; done in, or belonging to, the same times; contemporaneous. This king [Henry VIII.] was contemporary with the greatest monarchs of Europe. Strype. 2. Of the same age; coeval. A grove born with himself he sees, And loves his old contemporary trees. Cowley.\n\nOne who lives at the same time with another; as, Petrarch and Chaucer were contemporaries.
contempt |1. The act of contemning or despising; the feeling with which one regards that which is esteement mean, vile, or worthless; disdain; scorn. Criminal contempt of public feeling. Macaulay. Nothing, says Longinus, can be great, the contempt of which is great. Addison. 2. The state of being despised; disgrace; shame. Contempt and begarry hangs upon thy back. Shaks. 3. An act or expression denoting contempt. Little insults and contempts. Spectator. The contempt and anger of his lip. Shak. 4. (Law)  Disobedience of the rules, orders, or process of a court of justice, or of rules or orders of a legislative body; disorderly, contemptuous, or insolent language or behavior in presence of a court, tending to disturb its proceedings, or impair the respect due to its authority. Note: Contempt is in some jurisdictions extended so as to include publications reflecting injuriously on a court of justice, or commenting unfairly on pending proceedings; in other jurisdictions the courts are prohibited by statute or by the constitution from thus exercising this process. Syn. -- Disdain; scorn; derision; mockery; contumely; neglect; disregard; slight.
contemptibility |The quality of being contemptible; contemptibleness. Speed.
contemptible |1. Worthy of contempt; deserving of scorn or disdain; mean; vile; despicable. Milton. The arguments of tyranny are ascontemptible as its force is dreadful. Burke. 2. Despised; scorned; neglected; abject. Locke. 3. Insolent; scornful; contemptuous. [Obs.] If she should make tender of her love, 't is very possible he 'll scorn it; for the man . . . hath a contemptible spirit. Shak. Syn. -- Despicable; abject; vile; mean; base; paltry; worthless; sorry; pitiful; scurrile. See Contemptuous. -- Contemptible, Despicable, Pitiful, Paltry. Despicable is stronger than contemptible, as despise is stronger than contemn. It implies keen disapprobation, with a mixture of anger. A man is despicable chiefly for low actions which mark his life, such as servility, baseness, or mean adulation. A man is contemptible for mean qualities which distinguish his character, especially those which show him to be weak, foolish, or worthless. Treachery is despicable, egotism is contemptible. Pitiful and paltry are applied to cases which are beneath anger, and are simply contemptible in a high degree.
contemptibleness |The state or quality of being contemptible, or of being despised.
contemptibly |In a contemptible manner.
contemptuous |Manifecting or expressing contempt or disdain; scornful; haughty; insolent; disdainful. A proud, contemptious behavior. Hammond. Savage invectiveand contemptuous sarcasm. Macaulay. Rome . . . entertained the most contemptuous opinion of the Jews. Atterbury. Syn. -- Scornful; insolent; haughty; disdainful; supercilious; insulting; contumelious. -- Contemptuous, Contemptible. These words, from their similarity of sound, are sometimes erroneously interchanged, as when a person speaks of having \"a very contemptible opinion of another.\" Contemptible is applied to that which is the object of contempt; as, contemptible conduct; acontemptible fellow. Contemptuous is applied to that which indicates contempts; as, a contemptuous look; a contemptuous remark; contemptuous treatment. A person, or whatever is personal, as an action, an expression, a feeling, an opinion, may be either contemptuous or contemptible; a thing may be contemptible, but can not be contemptuous.
contemptuously |In a contemptuous manner; with scorn or disdain; despitefully. The apostles and most eminent Christians were poor, and used contemptuously. Jer. Taylor.
contemptuousness |Disposition to or manifestion of contempt; insolence; haughtiness.
contend |1. To strive in opposition; to contest; to dispute; to vie; to quarrel; to fight. For never two such kingdoms did content Without much fall of blood. Shak. The Lord said unto me, Distress not the Moabites, neither contend with them in battle. Deut. ii. 9. In ambitious strength I did Contend against thy valor. Shak. 2. To struggle or exert one's self to obtain or retain possession of, or to defend. You sit above, and see vain men below Contend for what you only can bestow. Dryden. 3. To strive in debate; to engage in discussion; to dispute; to argue. The question which our author would contend for. Locke. Many things he fiercely contended about were trivial. Dr. H. More. Syn. -- To struggle; fight; combat; vie; strive; oppose; emulate; contest; litigate; dispute; debate.\n\nTo struggle for; to contest. [R.] Carthage shall contend the world with Rome.Dryden.
contendent |n antagonist; a contestant. [Obs.] In all notable changes and revolutions the contendents have been still made a prey to the third party. L'Estrange.
contender |One who contends; a contestant.
contendress |A female contestant. [R.]
contenement |That which is held together with another thing; that which is connected with a tenetment, or thing holden, as a certin quantity of land a Burrill.
content |Contained within limits; hence, having the desires limited by that which one has; not disposed to repine or grumble; satisfied; contented; at rest. Having food rainment, let us be therewith content. 1 Tim. vi. 8.\n\n1. That which is contained; the thing or things held by a receptacle or included within specified limits; as, the contents of a cask or bale or of a room; the contents of a book. I shall prove these writings . . . authentic, and the contents true, and worthy of a divine original. Grew. 2. Power of containing; capacity; extent; size. [Obs.] Strong ship's, of great content. Bacon. 3. (Geom.)  Area or quantity of space or matter contained within certain limits; as, solid contents; superficial contents. The geometrical content, figure, and situation of all the lands of a kingdom. Graunt. Table of contents, or Contents, a table or list of topics in a book, showing their order and the place where they may be found: a summary.\n\n1. To satisfy the desires of; to make easy in any situation; to appease or quiet; to gratify; to please. Do not content yourselves with obscure and confused ideas, where clearer are to be attained. I. Watts. Pilate, willing to content the people, released Barabbas unto them. Mark xv. 15. 2. To satisfy the expectations of; to pay; to requite. Come the next Sabbath, and I will content you. Shak. Syn. -- To satisfy; appease; plese. See Satiate.\n\n1. Rest or quietness of the mind in one's present condition; freedom from discontent; satisfaction; contentment; moderate happiness. Such is the fullness of my heart's content. Shak. 2. Acquiescence without examination. [Obs.] The sense they humbly take upon content. Pope. 3. That which contents or satisfies; that which if attained would make one happy. So will I in England work your grace's full content. Shak. 4. (Eng. House of Lords)  An expression of assent to a bill or motion; an affirmate vote; also, a member who votes \"Content.\". Supposing the number of \"Contents\" and \"Not contents\" strictly equal in number and consequence.Burke.
contentation |Content; satisfaction. [Obs.] Bacon.
contented |Content; easy in mind; satisfied; quiet; willing. -- Con*tent\"ed*ly, adv. -- Con*tent\"ed*ness, n.
contentful |Full of content. [Obs.] Barrow.
contention |1. A violent effort or struggle to obtain, or to resist, something; contest; strife. I would my arcontenion. Shak. 2. Strife in words; controversy; altercation quarrel; dispute; as, a bone of contention. Contentions and strivings about the law. Titus iii. 9. 3. Vehemence of endeavor; eagerness; ardor; zeal. An end . . . worthy our utmost contenion to obtain. Rogers. 4. A point maintained in an argument, or a line of argument taken in its support; the subject matter of discussion of strife; a position taken or contended for. All men seem agreed what is to be done; the contention is how the subject is to be divided and defined. Bagehot. This was my original contention, and I still maintain that you should abide by your former decision. Jowett. Syn. -- Struggle; strife; contest; quarrel; combat; conflict; feud; litigation; controversy; dissension; variance; disagreement; debate; competition; emulation. -- Contention, Strife. A struggle between two parties is the idea common to these two words. Strife is a struggle for mastery; contention is a struggle for the possession of some desired object, or the accomplishment of some favorite end. Neither of the words is necessairly used in a bad sense, since there may be a generous strife or contention between two friends as to which shall incur danger or submit to sacrifices. Ordinarily, however, these words denote a struggle arising from bad passions. In that case, strife usually springs from a quarrelsome temper, and contention from, a selfish spirit which seeks its own aggrandizement, or is fearful lest others should obtain too such. Strife has more reference to the manner than to the object of a struggle, while contention takes more account of the end to be gained.
contentious |1. Fond of contention; given to angry debate; provoking dispute or contention; quarrelsome. Despotic and contentious temper. Macaulay. 2. Relating to contention or strife; involving or characterized by contention. Spenser. More cheerfull; though not less contentious, regions. Brougham. 3. (Law)  Contested; litigated; litigious; having power to decide controversy. Contentious jurisdiction (Eng. Eccl. Law), jurisdiction over matters in controversy between parties, in contradistinction to voluntary jurisdiction, or that exercised upon matters not opposed or controverted. Syn. -- Quarrelsome; pugnacious; dissentious; wrangling; litigious; perverse; peevish. - Con*ten\"tious*ly, adv. -- Con*ten\"tious*ness, n.
contentless |Discontented; dissatisfied. [R.] Shak.
contently |In a contented manner. [Obs.]
contentment |1. The state of being contented or satisfied; content. Contentment without external honor is humility. Grew. Godliness with contentment is great gain. 1 Tim. vi. 6. 2. The act or process of contenting or satisfying; as, the contentment of avarice is impossible. 3. Gratification; pleasure; satisfaction. [Obs.] At Paris the prince spent one whole day to give his mind some contentment in viewing of a famous city. Sir H. Wotton.
contents |See Content, n.
conterminable |Having the same bounds; terminating at the same time or place; conterminous. Love and life not conterminable. Sir H. Wotton.
conterminal |Conterminous.
conterminant |Having the same limits; ending at the same time; conterminous. Lamb.
conterminate |Having the same bounds; conterminous. [Obs.] B. Jonson.
conterminous |Having the same bounds, or limits; bordering upon; contiguous. This conformed so many of them as were conterminous to the colonies and garrisons, to the Roman laws. Sir M. Hale.
conterranean |Of or belonging to the same country. Howell.
conterraneous |Of or belonging to the same country. Howell.
contesseration |An assemblage; a collection; harmonious union. [Obs.] That person of his [George Herbert], which afforded so unusual a contesseration of elegancies. Oley.
contest |1. To make a subject of dispute, contention, litigation, or emulation; to contend for; to call in question; to controvert; to oppose; to dispute. The people . . . contested not what was done. Locke. Few philosophical aphorisms have been more frequenty repeated, few more contested than this. J. D. Morell. 2. To strive earnestly to hold or maintain; to struggle to defend; as, the troops contested every inch of ground. 3. (Law)  To make a subject of litigation; to defend, as a suit; to dispute or resist; as a claim, by course of law; to controvert. To contest an election. (Polit.) (a) To strive to be elected. (b) To dispute the declared result of an election. Syn. -- To dispute; controvert; debate; litigate; oppose; argue; contend.\n\nTo engage in contention, or emulation; to contend; to strive; to vie; to emulate; -- followed usually by with. The difficulty of an argument adds to the pleasure of contesting with in, when there are hopes of victory. Bp. Burnet. Of man, who dares in pomp with Jove contest Pope.\n\n1. Earnest dispute; strife in argument; controversy; debate; altercation. Leave all noisy contests, all immodest clamors and brawling language. I. Watts. 2. Earnest struggle for superiority, victory, defense, etc.; competition; emulation; strife in arms; conflict; combat; encounter. The late battle had, in effect, been a contest between one usurper and another. Hallam. It was fully expected that the contest there would be long and fierce. Macaulay. Syn. -- Conflict; combat; battle; encounter; shock; struggle; dispute; altercation; debate; controvesy; difference; disagreement; strife. -- Contest, Conflict, Combat, Encounter. Contest is the broadest term, and had originally no reference to actual fighting. It was, on the contrary, a legal term signifying to call witnesses, and hence came to denote first a struggle in argument, and then a struggle for some common object between opposing parties, usually one of considerable duration, and implying successive stages or acts. Conflict denotes literally a close personal engagement, in which sense it is applied to actual fighting. It is, however, more commonly used in a figurative sense to denote strenuous or direct opposition; as, a mental conflict; conflicting interests or passions; a conflict of laws. An encounter is a direct meeting face to face. Usually it is a hostile meeting, and is then very nearly coincident with conflict; as, an encounter of opposing hosts. Sometimes it is used in a looser sense; as, \"this keen encounter of our wits.\" Shak. Combat is commonly applied to actual fighting, but may be used figuratively in reference to a strife or words or a struggle of feeling.
contestable |Capable of being contested; debatable.
contestant |One who contests; an opponent; a litigant; a disputant; one who claims that which has been awarded to another.
contestation |1. The act of contesting; emulation; rivalry; strife; dispute. \"Loverlike contestation.\" Milton. After years spent in domestic, unsociable contestations, she found means to withdraw. Clarendon. 2. Proof by witness; attestation; testimony. [Obs.] A solemn contestation ratified on the part of God. Barrow.
contestingly |In a contending manner.
contex |To context. [Obs.] Boyle.
context |Knit or woven together; close; firm. [Obs.] The coats, without, are context and callous. Derham.\n\nThe part or parts of something written or printed, as of Scripture, which precede or follow a text or quoted sentence, or are so intimately associated with it as to throw light upon its meaning. According to all the light that the contexts afford. Sharp.\n\nTo knit or bind together; to unite closely. [Obs.] Feltham. The whole world's frame, which is contexted only by commerce and contracts. R. Junius.
contextural |Pertaining to contexture or arrangement of parts; producing contexture; interwoven. Dr. John Smith (1666).
contexture |The arrangement and union of the constituent parts of a thing; a weaving together of parts; structural character of a thing; system; constitution; texture. That wonderful contexture of all created beings. Dryden. He was not of any delicate contexture; his limbs rather sturdy than dainty. Sir H. Wotton.
contextured |Formed into texture; woven together; arranged; composed. [R.] Carlyle.
conticent |Silent. [R.] \"The guests sit conticent.\" Thackeray.
contignation |1. The act or process of framing together, or uniting, as beams in a fabric. Burke. 2. A framework or fabric, as of beams. Sir H. Wotton.
contiguate |Contiguous; touching. [Obs.] Holland.
contiguity |The state of being contiguous; intimate association; nearness; proximity. The convicinity and contiguity of the two parishes. T. Warton.
contiguous |In actual contact; touching; also, adjacent; near; neighboring; adjoining. The two halves of the paper did not appear fully divided . . . but seemed contiguous at one of their angles. Sir I. Newton. Sees no contiguous palace rear its head. Goldsmith. Contiguous angles. See Adjacent angles, under Angle. Syn. -- Adjoining; adjacent. See Adjacent. - Con*tig\"u*ous*ly, adv. -- Con*tig\"u*ous*ness, n.
continence |1. Self-restraint; self-command. He knew what to say; he knew also, when to leave off, -- a continence which is practiced by few writers. Dryden. 2. The restraint which a person imposes upon his desires and passions; the act or power of refraining from indulgence of the sexual appetite, esp. from unlawful indulgence; sometimes, moderation in sexual indulgence. If they [the unmarried and widows] have not continency, let them marry. 1 Cor. vii. 9 (Rev. Ver. ). Chastity is either abstinence or continence: abstinence is that of virgins or widows; continence, that of married persons. Jer. Taylor. 3. Uninterrupted course; continuity. [Obs.] Ayliffe.
continency |1. Self-restraint; self-command. He knew what to say; he knew also, when to leave off, -- a continence which is practiced by few writers. Dryden. 2. The restraint which a person imposes upon his desires and passions; the act or power of refraining from indulgence of the sexual appetite, esp. from unlawful indulgence; sometimes, moderation in sexual indulgence. If they [the unmarried and widows] have not continency, let them marry. 1 Cor. vii. 9 (Rev. Ver. ). Chastity is either abstinence or continence: abstinence is that of virgins or widows; continence, that of married persons. Jer. Taylor. 3. Uninterrupted course; continuity. [Obs.] Ayliffe.
continent |1. Serving to restrain or limit; restraining; opposing. [Obs.] Shak. 2. Exercising restraint as to the indulgence of desires or passions; temperate; moderate. Have a continent forbearance till the speed of his rage goes slower. Shak. 3. Abstaining from sexual intercourse; exercising restraint upon the sexual appetite; esp., abstaining from illicit sexual intercourse; chaste. My past life Hath been as continent, as chaste, as true, As I am now unhappy. Shak. 4. Not interrupted; connected; continuous; as, a continent fever. [Obs.] The northeast part of Asia is, if not continent with the west side of America, yet certainly it is the least disoined by sea of all that coast. Berrewood.\n\n1. That which contains anything; a receptacle. [Obs.] The smaller continent which we call a pipkin. Bp. Kennet. 2. One of the grand divisions of land on the globe; the main land; specifically (Phys. Geog.), a large body of land differing from an island, not merely in its size, but in its structure, which is that of a large basin bordered by mountain chains; as, the continent of North America. Note: The continents are now usually regarded as six in number: North America, South America, Europe, Asia, Africa, and Australia. But other large bodies of land are also reffered to as continents; as, the Antarctic continent; the continent of Greenland. Europe, Asia, and Africa are often grouped together as the Eastern Continent, and North and South America as the Western Continent. The Continent, the main land of Europe, as distinguished from the islands, especially from England.
continental |1. Of or pertaining to a continent. 2. Of or pertaining to the main land of Europe, in distinction from the adjacent islands, especially England; as, a continental tour; a continental coalition. Macaulay. No former king had involved himself so frequently in the labyrinth of continental alliances. Hallam. 3. (Amer. Hist.)  Of or pertaining to the confederated colonies collectively, in the time of the Revolutionary War; as, Continental money. The army before Boston was designated as the Continental army, in contradistinction to that under General Gage, which was called the \"Ministerial army.\" W. Irving. Continental Congress. See under Congress. -- Continental system (Hist.), the blockade of Great Britain ordered by Napoleon by the decree of Berlin, Nov. 21, 1806; the object being to strike a blow at the maritime and commercial supremacy of Great Britain, by cutting her off from all intercourse with the continent of Europe.\n\nA soldier in the Continental army, or a piece of the Continental currency. See Continental, a., 3.
continental drive |A transmission arrangement in which the longitudinal crank shaft drives the rear wheels through a clutch, change-speed gear, countershaft, and two parallel side chains, in order.
continental glacier |A broad ice sheet resting on a plain or plateau and spreading outward from a central n√©v√©, or region of accumulation.
continental pronunciation |A method of pronouncing Latin and Greek in which the vowels have their more familiar Continental values, as in German and Italian, the consonants being pronounced mostly as in English. The stricter form of this method of pronouncing Latin approaches the Roman, the modified form the English, pronunciation. The Continental method of Greek pronunciation is often called Erasmian.
continental system |The system of commercial blockade aiming to exclude England from commerce with the Continent instituted by the Berlin decree, which Napoleon I. issued from Berlin Nov. 21, 1806, declaring the British Isles to be in a state of blockade, and British subjects, property, and merchandise subject to capture, and excluding British ships from all parts of Europe under French dominion. The retaliatory measures of England were followed by the Milan decree, issued by Napoleon from Milan Dec. 17, 1807, imposing further restrictions, and declaring every ship going to or from a port of England or her colonies to be lawful prize.
continently |In a continent manner; chastely; moderately; temperately.
contingence |See Contingency.
contingency |1. Union or connection; the state of touching or contact. \"Point of contingency.\" J. Gregory. 2. The quality or state of being contingent or casual; the possibility of coming to pass. Aristotle says we are not to build certain rules on the contingency of human actions. South. 3. An event which may or may not occur; that which is possible or probable; a fortuitous event; a chance. The remarkable position of the queen rendering her death a most important contingency. Hallam. 4. An adjunct or accessory. Wordsworth. 5. (Law)  A certain possible event that may or may not happen, by which, when happening, some particular title may be affected. Syn. -- Casualty; accident; chance.
contingent |1. Possible, or liable, but not certain, to occur; incidental; casual. Weighing so much actual crime against so much contingent advantage. Burke. 2. Dependent on that which is undetermined or unknown; as, the success of his undertaking is contingent upon events which he can not control. \"Uncertain and contingent causes.\" Tillotson. 3. (Law)  Dependent for effect on something that may or may not occur; as, a contingent estate. If a contingent legacy be left to any one when he attains, or if he attains, the age of twenty-one. Blackstone.\n\n1. An event which may or may not happen; that which is unforeseen, undetermined, or dependent on something future; a contingency. His understanding could almost pierce into future contingets. South. 2. That which falls to one in a division or apportionment among a number; a suitable share; proportion; esp., a quota of troops. From the Alps to the border of Flanders, contingents were required . . . 200,000 men were in arms. Milman.
contingently |In a contingent manner; without design or foresight; accidentally.
contingentness |The state of being contingent; fortuitousness.
continuable |Capable of being continued [R.]
continual |1. Proceeding without interruption or cesstaion; continuous; unceasing; lasting; abiding. He that is of a merry heart hath a continual feast. Prov. xv. 15. 2. Occuring in steady and rapid succession; very frequent; often repeated. The eye is deligh by a continental succession of small landscapes. W. Irwing. Continual proportionals (Math.), quantities in continued proportion. Brande & C. Syn. -- Constant; prepetual; incessant; unceasing; uninterrupted; unintermitted; continuous. See Constant, and Continuous.
continually |1. Without cessation; unceasingly; continuously; as, the current flows continually. Why do not all animals continually increase in bigness Bentley. 2. In regular or repeated succession; very often. Thou shalt eat bread at my table continually. 2 Sam. ix. 7.
continuance |1. A holding on, or remaining in a particular state; permanence, as of condition, habits, abode, etc.; perseverance; constancy; duration; stay. Great plagues, and of long continuence. Deut. xxviii. 59. Patient continuance i well-doing. Rom. ii. 7. 2. Uninterrupted succession; continuation; constant renewell; perpetuation; propagation. The brute immedistely regards his own preservation or the continuance of his species. Addison. 3. A holding together; continuity. [Obs.] Bacon. 4. (Law) (a) The adjournment of the proceedings in a cause from one day, or from one stated term of a court, to another. (b) The entry of such adjuornment and the grounds thereof on the record.
continuant |Continuing; prolonged; sustained; as, a continuant sound. -- n.  A continuant sound; a letter whose sound may be prolonged.
continuate |1. Immediately united together; intimately connocted. [R.] We are of Him and in Him, even as though our very flesh and bones should be made continuate with his. Hooker. 2. Uninterrupted; unbroken; continual; continued. An untirable and continuate goodness. Shak.
continuation |1. That act or state of continuing; the state of being continued; uninterrupted extension or succession; prolongation; propagation. Preventing the continuation of the royal line. Macaulay. 2. That which extends, increases, supplements, or carries on; as, the continuation of a story. My continuation of the version of Statius. Pope.
continuative |1. (Logic)  A term or expression denoting continuance. [R.] To these may be added continuatives; as, Rome remains to this day; which includes, at least, two propositions, viz., Rome was, and Rome is. I. Watts. 2. (Gram.)  A word that continues the connection of sentences or subjects; a connective; a conjunction. Continuatives . . . consolidate sentences into one continuous whole. Harris.
continuator |One who, or that which, continues; esp., one who continues a series or a work; a continuer. Sir T. Browne.
continue |1. To remain ina given place or condition; to remain in connection with; to abide; to stay. Here to continue, and build up here A growing empire. Milton. They continue with me now three days, and have nothing to eat. Matt. xv. 32. 2. To be permanent or durable; to endure; to last. But now thy kingdom shall not continue. 1 Sam. xiii. 14. 3. To be steadfast or constant in any course; to persevere; to abide; to endure; to persist; to keep up or maintain a particular condition, course, or series of actions; as, the army continued to advance. If ye continue in my word, then are ye my disciples indeed. John viii. 31. Syn. -- To persevere; persist. See Persevere.\n\n1. To unite; to connect. [Obs.] the use of the navel is to continue the infant unto the mother. Sir T. browne. 2. To protract or extend in duration; to preserve or persist in; to cease not. O continue thy loving kindness unto them that know thee. Ps. xxxvi. 10. You know how to make yourself happy by only continuing such a life as you have been long acustomed to lead. Pope. 3. To carry onward or extend; to prolong or produce; to add to or draw out in length. A bridge of wond'rous length, From hell continued, reaching th' utmost orb of this frall world. Milton. 4. To retain; to suffer or cause to remain; as, the trustees were continued; also, to suffer to live. And how shall we continue Claudio. Shak.
continued |Having extension of time, space, order of events, exertion of energy, etc.; extended; protacted; uninterrupted; also, resumed after interruption; extending through a succession of issues, session, etc.; as, a continued story. \"Continued woe.\" Jenyns. \"Continued succession.\" Locke. Continued bass (Mus.), a bass continued through an entire piece of music, while the other parts of the harmony are indicated by figures beneath the bass; the same as thorough bass or figured bass; basso continuo. [It.] -- Continued fever (Med.), a fever which presents no interruption in its course. -- Continued fraction (Math.), a fraction whose numerator is 1, and whose denominator is a whole number plus a fraction whose numerator is 1 and whose denominator is a whole number, plus a fraction, and so on. -- Continued proportion (Math.), a proportion composed of two or more equal ratios, in which the consequent of each preceding ratio is the same with the antecedent of the folowing one; as, 4 : 8 : 8 : 16 :: 16 : 32.
continuedly |Continuously.
continuer |One who continues; one who has the power of perseverance or persistence. \"Indulgent continuers in sin.\" Hammond. I would my horse had the speed of your tongue, and so good a continuer. Shak.
continuity |the state of being continuous; uninterupted connection or succession; close union of parts; cohesion; as, the continuity of fibers. Grew. The sight would be tired, if it were attracted by a continuity of glittering objects. Dryden. Law of continuity (Math. & Physics), the principle that nothing passes from one state to another without passing through all the intermediate states. -- Solution of continuity. (Math.) See under Solution.
continuo |Basso continuo, or continued bass.
continuous |1. Without break, cessation, or interruption; without intervening space or time; uninterrupted; unbroken; continual; unceasing; constant; continued; protracted; extended; as, a continuous line of railroad; a continuous current of electricity. he can hear its continuous murmur. Longfellow. 2. (Bot.)  Not deviating or varying from uninformity; not interrupted; not joined or articulated. Continuous brake (Railroad), a brake which is attached to each car a train, and can be caused to operate in all the cars simultaneously from a point on any car or on the engine. -- Continuous impost. See Impost. Syn. -- Continuous, Continual. Continuous is the stronger word, and denotes that the continuity or union of parts is absolute and uninterrupted; as, a continuous sheet of ice; a continuous flow of water or of argument. So Daniel Webster speaks of \"a continuous and unbroken strain of the martial airs of England.\" Continual, in most cases, marks a close and unbroken succession of things, rather than absolute continuity. Thus we speak of continual showers, implying a repetition with occasional interruptions; we speak of a person as liable to continual calls, or as subject to continual applications for aid, etc. See Constant.
continuously |In a continuous maner; without interruption. -- Con*tin\"u*ous*ness, n.
contline |1. (Ropemaking)  The space between the strands on the outside of a rope. Knight. 2. (Naut.)  The space between the bilges of two casks stowed side by side.
contorniate |A species of medal or medallion of bronze, having a deep furrow on the contour or edge; -- supposed to have been struck in the days of Constantine and his successors. R. S. Poole.\n\nA species of medal or medallion of bronze, having a deep furrow on the contour or edge; -- supposed to have been struck in the days of Constantine and his successors. R. S. Poole.
contorsion |See Contortion.
contort |To twist, or twist together; to turn awry; to bend; to distort; to wrest. The vertebral arteries are variously contorted. Ray. Kant contorted the term category from the proper meaning of attributed. Sir W. Hamilton.
contorted |1. Twisted, or twisted together. \"A contorted chain of icicles.\" Massinger. 2. (Bot.) (a) Twisted back upon itself, as some parts of plants. (b) Arranged so as to overlap each other; as, petals in contorted or convolute √¶stivation.
contortion |A twisting; a writhing; wry motion; a twist; as, the contortion of the muscles of the face. Swift. All the contortions of the sibyl, without the inspiration. Burke.
contortionist |One who makes or practices contortions.
contortive |Expressing contortion.
contortuplicate |Plaited lengthwise and twisted in addition, as the bud of the morning-glory. Gray.
contour |1. The outline of a figure or body, or the line or lines representing such an outline; the line that bounds; periphery. Titian's coloring and contours. A. Drummond. 2. (Mil.)  The outline of a horizontal section of the ground, or of works of fortification. Contour feathers (Zo√∂l.), those feathers that form the general covering of a bird. -- Contour of ground (Surv.), the outline of the surface of ground with respect to its undulation, etc. -- Contour line (Topographical Suv.), the line in which a horizontal plane intersects a portion of ground, or the corresponding line in a map or chart.
contourne |Turned in a direction which is not the usual one; -- said of an animal turned to the sinister which is usually turned to the dexter, or the like.
contourniated |Having furrowed edges, as if turned in a lathe.
contra |A Latin adverb and preposition, signifying against, contrary, in opposition, etc., entering as a prefix into the composition of many English words. Cf. Counter, adv. & pref.
contraband |1. Illegal or prohobited traffic. Persons the most bound in duty to prevent contraband, and the most interested in the seizures. Burke. 2. Goods or merchandise the importation or exportation of which is forbidden. 3. A negro slave, during the Civil War, escaped to, or was brought within, the Union lines. Such slave was considered contraband of war. [U.S.] Contraband of war, that which, according to international law, cannot be supplied to a hostile belligerent except at the risk of seizure and condemnation by the aggrieved belligerent. Wharton.\n\nProhibited or excluded by law or treaty; forbidden; as, contraband goods, or trade. The contraband will always keep pace, in some measure, with the fair trade. Burke.\n\n1. To import illegaly, as prohibited goods; to smuggle. [Obs.] Johnson. 2. To declare prohibited; to forbid. [Obs.] The law severly contrabands Our taking business of men's hands. Hudibras.
contrabandism |Traffic in contraband gods; smuggling.
contrabandist |One who traffic illegaly; a smuggler.
contrabass |, n. (Mus.) Double bass; -- applied to any instrument of the same deep range as the stringed double bass; as, the contrabass ophicleide; the cotrabass tuba or bombardon.
contrabasso |The largest kind of bass viol. See Violone.
contract |1. To draw together or nearer; to reduce to a less compass; to shorten, narrow, or lesen; as, to contract one's shpere of action. In all things desuetude doth contract and narrow our faculties. Dr. H. More. 2. To draw together so as to wrinkle; to knit. Thou didst contract and purse thy brow. Shak. 3. To bring on; to incur; to acquire; as, to contract a habit; to contract a debt; to contract a disease. Each from each contract new strength and light. Pope. Such behavior we contract by having much conversed with persons of high statiSwift. 4. To enter into, with mutual obligations; to make a bargain or covenant for. We have contracted an inviolable amity, peace, and lague with the aforesaid queen. Hakluyt. Many persons . . . had contracted marriage within the degrees of consanguinity . . . prohibited by law. Strype. 5. To betroth; to affiance. The truth is, she and I, long since contracted, Are now so sure, that nothing can dissolve us. Shak. 6. (Gram.)  To shorten by omitting a letter or letters or by reducing two or more vowels or syllables to one. Syn. -- To shorten; abridge; epitomize; narrow; lessen; condense; reduce; confine; incur; assume.\n\n1. To be drawn together so as to be diminished in size or extent; to shrink; to be reduced in compass or in duration; as, iron contracts in cooling; a rope contracts when wet. Years contracting to a moment. Wordsworth. 2. To make an agreement; to covenant; to agree; to bargain; as, to contract for carrying the mail.\n\nContracted: as, a contract verb. Goodwin.\n\nContracted; affianced; betrothed. [Obs.] Shak.\n\n1. (Law)  The agreement of two or more persons, upon a sufficient consideration or cause, to do, or to abstain from doing, some act; an agreement in which a party undertakes to do, or not to do, a particular thing; a formal bargain; a compact; an interchange of legal rights. Wharton. 2. A formal writing which contains the agreement of parties, with the terms and conditions, and which serves as a proof of the obligation. 3. The act of formally betrothing a man and woman. This is the the night of the contract. Longwellow. Syn. -- Covenant; agreement; compact; stipulation; bargain; arrangement; obligation. See Covenant.
contract system |1. The sweating system. 2.  The system of employing convicts by selling their labor (to be performed inside the prison) at a fixed price per day to contractors who are allowed to have agents in the prison to superintend the work.
contract tablet |A clay tablet on which was inscribed a contract, for safe keeping.  Such tablets were inclosed in an outer case (often called the envelope), on which was inscribed a duplicate of the inscription on the inclosed tablet.
contracted |1. Drawn together; shrunken; wrinkled; narrow; as, a contracted brow; a contracted noun. 2. Narrow; illiberal; selfish; as, a contracted mind; contracted views. 3. Bargained for; betrothed; as, a contracted peace. Inquire me out contracted bachelors. Shak.
contractedness |The state of being contracted; narrowness; meannes; selfishness.
contractibility |Capability of being contracted; quality of being contractible; as, the contractibiliy and dilatability of air. Arbuthnot.
contractible |Capable of contraction. Small air bladders distable and contractible. Arbuthnot.
contractibleness |Contractibility.
contractile |tending to contract; having the power or property of contracting, or of shrinking into shorter or smaller dimensions; as, the contractile tissues. The heart's contractile force. H. Brooke. Each cilium seems to be composed of contractile substance. Hixley. Contractile vacuole (Zo√∂l.), a pulsating cavity in the interior of a protozoan, supposed to be excretory in function. There may be one, two, or more.
contractility |1. The quality or property by which bodies shrink or contract. 2. (Physiol.)  The power possessed by the fibers of living muscle of contracting or shortening. Note: When subject to the will, as in the muscles of locomotion, such power is called voluntary contractility; when not controlled by the will, as in the muscles of the heart, it is involuntary contractility.
contraction |1. The act or process of contracting, shortening, or shrinking; the state of being contracted; as, contraction of the heart, of the pupil of the eye, or of a tendion; the contraction produced by cold. 2. (Math.)  The process of shortening an operation. 3. The act of incurring or becoming subject to, as liabilities, obligation, debts, etc.; the process of becoming subject to; as, the contraction of a disease. 4. Something contracted or abbreviated, as a word or phrase; -- as, plenipo for plenipotentiary; crim. con. for criminal conversation, etc. 5. (Gram.)  The shortening of a word, or of two words, by the omission of a letter or letters, or by reducing two or more vowels or syllables to one; as, ne'er for never; can't for can not; don't for do not; it's for it is. 6. A marriage contract. [Obs.] Shak.
contractive |Tending to contract; having the property or power or power of contracting.
contractor |One who contracts; one of the parties to a bargain; one who covenants to do anything for another; specifically, one who contracts to perform work on a rather large scale, at a certain price or rate, as in building houses or making a railroad.
contracture |A state of permanent rigidity or contraction of the muscles, generally of the flexor muscles.
contradance |A dance in which the partners are arranged face to face, or in opposite lines.
contradict |1. To assert the contrary of; to oppose in words; to take issue with; to gainsay; to deny the truth of, as of a statement or a speaker; to impugn. Dear Duff, I prithee, contradict thyself, And say it is not so. Shak. The future can not contradict the past. Wordsworth. 2. To be contrary to; to oppose; to resist. [Obs.] No truth can contradict another truth. Hooker. A greater power than we can contradict Hath thwarted our intents. Shak.\n\nTo oppose in words; to gainsay; to deny, or assert the contrary of, something. They . . . spake against those things which were spoken by Paul, contradicting and blaspheming. Acts xiii. 45.
contradictable |Capable of being contradicting.
contradicter |one who contradicts. Swift.
contradiction |1. An assertion of the contrary to what has been said or affirmed; denial of the truth of a statement or assertion; contrary declaration; gainsaying. His fair demands Shall be accomplished without contradiction. Shak. 2. Direct opposition or repugnancy; inconsistency; incongruity or contrariety; one who, or that which, is inconsistent. can be make deathless death That were to make Strange contradiction. Milton. We state our experience and then we come to a manly resolution of acting in contradiction to it. Burke. Both parts of a contradiction can not possibly be true. Hobbes. Of contradictions infinite the slave. Wordsworth. Principle of contradiction (Logic), the axiom or law of thought that a thing cannot be and not be at the same time, or a thing must either be or not be, or the same attribute can not at the same time be affirmed and and denied of the same subject. It develops itself in three specific forms which have been called the \"Three Logical Axioms.\" First. \"A is A.\" Second, \"A is not Not-A\" Third, \"Everything is either A or Not-A.\",
  "smith |1. One who forgess with the hammer; one who works in metals; as, a blacksmith, goldsmith, silversmith, and the like. Piers Plowman. Nor yet the smith hath learned to form a sword. Tate. 2. One who makes or effects anything. [R.] Dryden.\n\nTo beat into shape; to fprge. [Obs.] Chaucer. What smith that any [weapon] smitheth. Piers Plowman.
contradictional |Contradictory; inconsistent; opposing. [R.] Milton.
contradictious |1. Filled with contradictions; inconsistent. [Obs.] 2. Inclined to contradict or cavil [Obs.] Sharp. -- Con`tra*dic\"tious*ness, n. Norris.
contradictive |Contradictory; inconsistent. -- Con`tra*dict\"ive*ly, adv..
contradictor |A contradicter.
contradictorily |In a contradictory manner. Sharp.
contradictoriness |The quality of being contradictory; opposition; inconsistency. J. Whitaker.
contradictory |1. Affirming the contrary; implying a denial of what has been asserted; also, mutually contradicting; inconsistent. \"Contradictory assertions.\" South. 2. Opposing or opposed; repugnant. Schemes . . . contradictory to common sense. Addisn.\n\n1. A proposition or thing which denies or opposes another; contrariety. It is common with princes to will contradictories. Bacon. 2. pl. (Logic)  propositions with the same terms, but opposed to each other both in quality and quantity.
contradistinct |Distinguished by opposite qualities. J. Goodwin.
contradistinction |Distinction by contrast. That there are such things as sins of infirmity in contradistinction to those of presumption is not to be questioned. South.
contradistinctive |having the quality of contradistinction; distinguishing by contrast. -- Con`tra*dis*tinc\"tive, n.
contradistinguish |To distinguish by a contrast of opposite qualities. These are our complex ideas of soul and body, as contradistinguished. Locke.
contrafagetto |The double bassoon, an octave deeper than the bassoon.
contrafissure |A fissure or fracture on the side opposite to that which received the blow, or at some distance from it. Coxe.
contrahent |Entering into covenant; contracting; as, contrahent parties. [Obs.] Mede.
contraindicant |Something, as a symptom, indicating that the usual mode of treatment is not to be followed. Burke.
contraindicate |To indicate, as by a symptom, some method of treatment contrary to that which the general tenor of the case would seem to require. Contraindicating symptoms must be observed. Harvey.
contraindication |An indication or symptom which forbids the method of treatment usual in such cases.
contralto |(a) The part sung by the highest male or lowest female voices; the alto or counter tenor. (b) the voice or singer performing this part; as, her voice is a contralto; she is a contralto. Note: The usual range of the contralto voice is from G, below middle C, to the C above that; though exceptionally it embraces two octaves.\n\nOf or pertaining to a contralto, or to the part in music called contralto; as, a contralto voice.
contramure |An outer wall. [Obs.] Chambers.
contranatural |Opposed to or against nature; unnatural. [R.] Bp. Rust.
contraplex |Pertaining to the sending of two messages in opposite directions at the same time.
contraposition |1. A placing over against; opposite position. [Obs.] F. Potter. 2. (Logic)  A so-called immediate inference which consists in denying the original subject of the contradictory predicate; e.g.: Every S is P; therefore, no Not-P is S.
contraption |A contrivance; a new-fangled device; -- used scornfully. [Colloq. or Dial.] -- Con*trap\"tious (#), a. We all remember some of the extraordinary contraptions which have been thus evolved and put upon the market. F. M. Ware.
contrapuntal |Pertaining to, or according to the rules of, counterpoint.
contrapuntist |One skilled in counterpoint. L. Mason.
contraremonstrant |One who remonstrates in opposition or answer to a remonstraint. [R.] They did the synod wrong to make this distinction of contraremonstrants and remonstrants. Hales.
contrariant |Contrary; opposed; antagonistic; inconsistent; contradictory. [R.] The struggles of contrariant factions. Coleridge.
contrariantly |Contrarily. [Obs.]
contraries |Propositions which directly and destructively contradict each other, but of which the falsehood of one does not establish the truth of the other. If two universals differ in quality, they are contraries; as, every vine is a tree; no vine is a tree. These can never be both true together; but they may be both false. I. Watts.
contrariety |1. The state or quality of being contrary; opposition; repugnance; disagreement; antagonism. There is a contrariety between those things that conscience inclines to, and those that entertain the senses. South. 2. Something which is contrary to, or inconsistent with, something else; an inconsistency. How can these contrarieties agree Shak. Syn. -- Inconsistency; discrepancy; repugnance.
contrarily |(adv. In a contrary manner; in opposition; on the other side; in opposite ways.
contrariness |state or quality of being contrary; opposition; inconsistency; contrariety; perverseness; obstinancy.
contrarious |Showing contrariety; repugnant; perverse. [Archaic] Milton. She flew contrarious in the face of God. Mrs. Browning.
contrariously |Contrarily; oppositely. Shak.
contrariwise |1. On the contrary; oppositely; on the other hand. Not rendering evil for evil, or railing for railing; but contrariwise, blessing. 1 Pet. iii. 9. 2. In a contrary order; conversely. Everything that acts upon the fluids must, at the same time, act upon the solids, and contrariwise. Arbuthnot.
contrarotation |Circular motion in a direction contrary to some other circular motion.
contrary |1. Opposite; in an opposite direction; in opposition; adverse; as, contrary winds. And if ye walk contrary unto me, and will not hearken unto me. Lev. xxvi. 21. We have lost our labor; they are gone a contrary way. Shak. 2. Opposed; contradictory; repugnant; inconsistent. Fame, if not double-faced, is double mouthed, And with contrary blast proclaims most deeds. Milton. The doctrine of the earth's motion appeared to be contrary to the sacred Scripture. Whewell. 3. Given to opposition; perverse; forward; wayward; as, a contrary disposition; a contrary child. 4. (Logic)  Affirming the opposite; so opposed as to destroy each other; as, contrary propositions. Contrary motion (Mus.), the progression of parts in opposite directions, one ascending, the other descending. Syn. -- Adverse; repugnant; hostile; inimical; discordant; inconsistent.\n\n1. A thing that is of contrary or opposite qualities. No contraries hold more antipathy Than I and such a knave. Shak. 2. An opponent; an enemy. [Obs.] Chaucer. 3. the opposite; a proposition, fact, or condition incompatible with another; as, slender proofs which rather show the contrary. See Converse, n., 1. Locke. 4. (Logic)  See Contraries. On the contrary, in opposition; on the other hand. Swift. -- To the contrary, to an opposite purpose or intent; on the other side. \"They did it, not for want of instruction to the contrary.\" Bp. Stillingfleet.\n\nTo contradict or oppose; to thwart. [Obs.] I was advised not to contrary the king. Bp. Latimer.
contrast |To stand in opposition; to exhibit difference, unlikeness, or opposition of qualities. The joints which divide the sandstone contrast finely with the divisional planes which separate the basalt into pillars. Lyell.\n\n1. To set in opposition, or over against, in order to show the differences between, or the comparative excellences and defects of; to compare by difference or contrariety of qualities; as, to contrast the present with the past. 2. (Fine Arts)  To give greater effect to, as to a figure or other object, by putting it in some relation of opposition to another figure or object. the figures of the groups must not be all on side . . . but must contrast each other by their several position. Dryden.\n\n1. The act of contrasting, or the state of being contrasted; comparison by contrariety of qualities. place the prospect of the soul In sober contrast with reality. Wordsworth. 2. Opposition or dissimilitude of things or qualities; unlikeness, esp. as shown by juxtaposition or comparison. The contrasts and resemblances of the seasons. Whewell. 3. (Fine Arts)  The opposition of varied forms, colors, etc., which by such juxtaposition more vividly express each other's pecularities. Fairholt.
contrastimulant |Counteracting the effects of stimulants; relating to a course of medical treatment based on a theory of contrastimulants. -- n. (Med.)  An agent which counteracts the effect of a stimulant.
contrate |Having cogs or teeth projecting parallel to the axis, instead of radiating from it. [R.] Contrate wheel. See Crown wheel.
contratenor |Counter tenor; contralto.
contravallation |A trench guarded with a parapet, constructed by besiegers, to secure themselves and check sallies of the besieged.
contravene |1. To meet in the way of opposition; to come into conflict with; to oppose; to contradict; to obstruct the operation of; to defeat. So plain a proposition . . . was not likely to be contravened. Southey. 2. To violate; to nullify; to be inconsistent with; as, to contravene a law. Laws that place the subjects in such a state contravene the first principles of the compact of authority. Johnson. Syn. -- To contradict; set aside; nullify; defeat; cross; obstruct; baffle; thwart.
contravener |One who contravenes.
contravention |The act of contravening; opposition; obstruction; transgression; violation. Warrants in contravention of the acts of Parliament. Macaulay. In contravention of all his marriage stipulations. Motley.
contraversion |A turning to the opposite side; antistrophe. Congreve.
contrayerva |A species of Dorstenia (D. Contrayerva), a South American plant, the aromatic root of which is sometimes used in medicine as a gentle stimulant and tonic.
contrecoup |A concussion or shock produced by a blow or other injury, in a part or region opposite to that at which the blow is received, often causing rupture or disorganisation of the parts affected.
contredanse |1. (a) A dance in which the partners are arranged face to face, or in opposite lines. (b) The quadrille. [Obs.] 2.  (Music) A piece of music in the rhythm of such a dance.
contretemps |An unexpected and untoward accident; something inopportune or embarassing; a hitch. In this unhappy contretemps. De Quincey.
contributable |Capable of being contributed.
contributary |1. Contributory. [R.] 2. Tributary; contributing. [R.] It was situated on the Ganges, at the place where this river received a contributary stream. D'Anville (Trans. ).
contribute |To give or grant i common with others; to give to a common stock or for a common purpose; to furnish or suply in part; to give (money or other aid) for a specified object; as, to contribute food or fuel for the poor. England contributes much more than any other of the allies. Addison.\n\n1. To give a part to a common stock; to lend assistance or aid, or give something, to a common purpose; to have a share in any act or effect. We are engaged in war; the secretary of state calls upon the colonies to contribute. Burke. 2. To give or use one's power or influence for any object; to assist. These men also contributed to obstruct the progress of wisdom. Goldsmith.
contribution |1. The act of contributing. 2. That which is contributed; -- either the portion which an individual furnishes to the common stock, or the whole which is formed by the gifts of individuals. A certain contribution for the poor saints which are at jerusalem. Rom. xv. 26. Aristotle's actual contributions to the physical sciences. Whewell. 3. (Mil.)  An irregular and arbitrary imposition or tax leved on the people of a town or country. These sums, . . . and the forced contributions paid by luckless peasants, enabled him to keep his straggling troops together. Motley. 4. (Law)  Payment, by each of several jointly liable, of a share in a loss suffered or an amount paid by one of their number for the common benefit.
contribution plan |A plan of distributing surplus by giving to each policy the excess of premiums and interest earned thereon over the expenses of management, cost of insurance, and the policy value at the date of computation. This excess is called the contribution of the policy.
contributional |Pertaining to, or furnishing, a contribution.
contributive |Contributing, or tending to contribute. Fuller.
contributor |One who, or that which, contributes; specifically, one who writes articles for a newspaper or magazine.
contributory |Contributing to the same stock or purpose; promoting the same end; bringing assistance to some joint design, or increase to some common stock; contributive. Milton. Bonfires of contributory wood. Chapman. Contributory negligence (Law), negligence by an injured party, which combines with the negligence of the injurer in producing the injury, and which bars recovery when it is the proximate cause of the injury. Wharton.\n\nOne who contributes, or is liable to be called upon to contribute, as toward the discharge of a common indebtedness. Abbott.
contrist |To make sad. [Obs.] To deject and contrist myself. Sterne.
contristate |To make sorrowful. [Obs.] Bacon.
contrite |1. Thoroughly bruised or broken. [Obs.] 2. Broken down with grief and penitence; deeply sorrowful for sin because it is displeasing to God; humbly and thoroughly penitent. A contrite heart, O God, thou wilt not despise. Ps. li. 17. Be penitent, and for thy fault contrite. Milton. Syn. -- Penitent; repentant; humble; sorrowful.\n\nA contrite person. Hooker.\n\nIn a contrite manner.
contriteness |Deep sorrow and penitence for sin; contrition.
contrition |1. The act of grinding or ribbing to powder; attrition; friction; rubbing. [Obs.] The breaking of their parts into less parts by contrition. Sir I. Newton. 2. The state of being contrite; deep sorrow and repentance for sin, because sin is displeasing to God; humble penitence; through repentance. My future days shall be one whole contrition. Dryden. Syn. -- repentance; penitence; humiliation; compunction; self-reproach; remorse. -- Contrition, Attrition, repentance. -- Contrition is deep sorrow and self-condemnation, with through repetance for sin because it is displeasing to God, and implies a feeling of love toward God. Attrition is sorrow for sin, or imperfect repentance produced by fear of punishment or a sense of the baseness of sin. Repentance is a penitent renunciation of, and turning from, sin; thorough repentance produces a new life. Repentance is often used as synonymous with contrition. See Compunction.
contriturate |To triturate; to pulverize. [R.]
contrivable |Capable of being contrived, planned, invented, or devised. A perpetual motion may seem easily contrivable. Bp. Wilkins.
contrivance |1. The act or faculty of contriving, inventing, devising, or planning. The machine which we are inspecting demonstrates, by its construction, contrivance and design. Contrivance must have had a contriver. Paley. 2. The thing contrived, invented, or planned; disposition of parts or causes by design; a scheme; plan; atrifice; arrangement. Government is a contrivance of human wisdom to provide for human wants. Burke. Syn. -- Device; plan; scheme; invention; machine; project; design; artifice; shift. See Device.
contrive |To form by an exercise of ingenuity; to devise; to invent; to design; to plan. What more likely to contrive this admirable frame of the universe than infinite wisdom. Tillotson. neither do thou imagine that I shall contrive aught against his life. Hawthorne. Syn. -- To invent; discover; plan; design; project; plot; concert; hatch.\n\nTo make devices; to form designs; to plan; to scheme; to plot. The Fates with traitors do contrive. Shak. Thou hast contrived against th very life Of the defendant. Shak.
contrivement |Contrivance; invention; arrangement; design; plan. [Obs.] Consider the admirable contrivement and artifice of this great fabric. Glanvill. Active to meet their contrivements. Sir G. Buck.
contriver |One who contrives, devises, plans, or schemas. Swift.
control |1. A duplicate book, register, or account, kept to correct or check another account or register; a counter register. [Obs.] Johnson. 2. That which serves to check, restrain, or hinder; restraint. \"Speak without control.\" Dryden. 3. Power or authority to check or restrain; restraining or regulating influence; superintendence; government; as, children should be under parental control. The House of Commons should exercise a control over all the departments of the executive administration. Macaulay. Board of control. See under Board.\n\n1. To check by a counter register or duplicate account; to prove by counter statements; to confute. [Obs.] This report was controlled to be false. Fuller. 2. To exercise restraining or governing influence over; to check; to counteract; to restrain; to regulate; to govern; to overpower. Give me a staff of honor for mine age, But not a scepter to control the world. Shak. I feel my virtue struggling in my soul: But stronger passion does its power control. Dryden. Syn. -- To restrain; rule; govern; manage; guide; regulate; hinder; direct; check; curb; counteract; subdue.
controllability |Capability of being controlled; controllableness.
controllable |Capable of being controlled, checked, or restrained; amenable to command. Passion is the drunkeness of the mind, and, therefore, . . . not always controllable by reason. South.
controllableness |Capability of being controlled.
controller |1. One who, or that which, controls or restraines; one who has power or authority to regulate or control; one who governs. The great controller of our fate Deigned to be man, and lived in low estate. Dryden. 2. An officer appointed to keep a counter register of accounts, or to examine, rectify, or verify accounts. [More commonly written controller.] 3. (Naut.)  An iron block, usually bolted to a ship's deck, for controlling the running out of a chain cable. The links of the cable tend to drop into hollows in the block, and thus hold fast until disengaged.
controllership |The office of a controller.
controlment |1. The power or act of controlling; the state of being rstrained; control; restraint; regulation; superintendence. You may do it without controlment. Shak. 2. Opposition; resistance; hostility. [Obs.] Here have we war for war, and blood for blood, Controlment for controlment. Shak.
controversal |1. Turning or looking opposite ways. [Obs.] The temple of Janus, with his two controversal faces. Milton. 2. Controversal. [Obs.] Boyle.
controversary |Controversial. [Obs.] Bp. Hall.
controverse |Controversy. [Obs.] Spenser.\n\nTo dispute; to controvert. [Obs.] \"Controversed causes.\" Hooker.
controverser |A disputant. [Obs.]
controversial |Relating to, or consisting of, controversy; disputatious; polemical; as, controversial divinity. Whole libraries of controversial books. Macaulay.
controversialist |One who carries on a controversy; a disputant. He [Johnson] was both intellectually and morally of the stuff of which controversialists are made. Macaulay.
controversially |In a controversial manner.
controversion |Act of controverting; controversy. [Obs.] Hooker.
controversor |A controverser. [Obs.]
controversy |1. Contention; dispute; debate; discussion; agitation of contrary opinions. This left no room for controversy about the title. Locke. A dispute is commonly oral, and a controversy in writing. Johnson. 2. Quarrel; strife; cause of variance; difference. The Lord hath a controversy with the nations. Jer. xxv. 31. 3. A suit in law or equity; a question of right. [Obs.] When any man that had a controversy came to the king for judgment. 2 Sam. xv. 2. Syn. -- Dispute; debate; disputation; disagreement; altercation; contention; wrangle; strife; quarrel.
controvert |To make matter of controversy; to dispute or oppose by reasoning; to contend against in words or writings; to contest; to debate. Some controverted points had decided according to the sense of the best jurists. Macaulay.
controverter |One who controverts; a controversial writer; a controversialist. Some controverters in divinity are like swaggerers in a tavern. B. Jonson.
controvertible |Capable of being controverted; disputable; admitting of question. -- Con`tro*ver\"ti*bly, adv.
controvertist |One skilled in or given to controversy; a controversialist. How unfriendly is the controvertist to the discernment of the critic! Campbell.
contubernal |Living or messing together; familiar; in companionship. Humble folk ben Christes friends: they ben contubernial with the Lord, thy King. Chaucer.
contubernial |Living or messing together; familiar; in companionship. Humble folk ben Christes friends: they ben contubernial with the Lord, thy King. Chaucer.
contumacious |1. Exhibiting contumacy; contemning authority; obstinate; perverse; stubborn; disobedient. There is another very, efficacious method for subding the most obstinate, contumacious sinner. Hammond. 2. (Law)  Willfully disobedient to the summous or prders of a court. Blackstone. Syn. -- Stubborn; obstinate; obdurate; disobedient; perverse; unyielding; headstrong. -- Con`tu*ma\"cious*ly, adv. -- Con`tu*ma\"cious*ness, n.
contumacy |1. Stubborn perverseness; pertinacious resistance to authority. The bishop commanded him . . . to be thrust into the stocks for his manifest and manifold contumacy. Strype. 2. (Law)  A willful contempt of, and disobedience to, any lawful summons, or to the rules and orders of court, as a refusal to appear in court when legally summoned. Syn. -- Stubbornness; perverseness; obstinacy.
contumelious |1. Exhibiting contumely; rudely contemptuous; insolent; disdainful. Scoffs, and scorns, and contumelious taunts. Shak. Curving a contumelious lip. Tennyson. 2. Shameful; disgraceful. [Obs.] Dr. H. More. -- Con`tu*me\"li*ous*ly, adv. -- Con`tu*me\"li*ous*ness, n.
contumely |Rudeness compounded of haughtiness and contempt; scornful insolence; despiteful treatment; disdain; contemptuousness in act or speech; disgrace. The oppressor's wrong, the proud man's contumely. Shak. Nothing aggravates tyranny so much as contumely. Burke.
contuse |1. To beat, pound, or together. Roots, barks, and seeds contused together. Bacon. 2. To bruise; to injure or disorganize a part without breaking the skin. Contused wound, a wound attended with bruising.
contusion |1. The act or process of beating, bruising, or pounding; the state of being beaten or bruised. 2. (Med.)  A bruise; an injury attended with more or less disorganization of the subcutaneous tissue and effusion of blood beneath the skin, but without apparent wound.
conundrum |1. A kind of riddle based upon some fanciful or fantastic resemblance between things quite unlike; a puzzling question, of which the answer is or involves a pun. Or pun ambiguous, or conundrum quaint. J. Philips. 2. A question to which only a conjectural answer can be made. Do you think life is long enough to let me speculate on conundrums like that W. Black.
conure |An American parrakeet of the genus Conurus. Many species are known. See Parrakeet.
conus |1. A cone. 2. (Zo√∂l.)  A Linnean genus of mollusks having a conical shell. See Cone, n., 4.
conusable |Cognizable; liable to be tried or judged. [Obs.] Bp. Barlow.
conusant |See Cognizant.
conusor |See Cognizor.
convalesce |To recover health and strength gradually, after sickness or weakness; as, a patient begins to convalesce.
convalesced |Convalescent. [R.] He found the queen somewhat convalesced. J. Knox.
convalescence |The recovery of heath and strength after disease; the state of a body renewing its vigor after sickness or weakness; the time between the subsidence of a disease and complete restoration to health.
convalescency |The recovery of heath and strength after disease; the state of a body renewing its vigor after sickness or weakness; the time between the subsidence of a disease and complete restoration to health.
convalescent |1. Recovering from siclness or debility; partially restored to health or strength. 2. Of or pertaining to convalescence.\n\nOne recovering from sickness.
convalescently |In the manner of a convalescent; with increasing strength or vigor.
convallamarin |A white, crystalline, poisonous substance, regarded as a glucoside, extracted from the lily of the valley (Convallaria Majalis). Its taste is first bitter, then sweet.
convallaria |The lily of the valley.
convallarin |A white, crystalline glucoside, of an irritating taste, extracted from the convallaria or lily of the valley.
convection |1. The act or process of conveying or transmitting. 2. (Physics)  A process of transfer or transmission, as of heat or electricity, by means of currents in liquids or gases, resulting from changes of temperature and other causes. Liquids are generally heated by convection -- when heat is applied from bellow. Nichol.
convective |Caused or accomplished by convection; as, a convective discharge of electricity. Faraday.
convectively |In a convective manner. Hare.
convellent |Tending to tear or pull up. [Obs.] The ends of the fragment . . . will not yield to the convellent force. Todd & Bowman.
convenable |Capable of being convened or assembled.\n\nConsistent; accordant; suitable; proper; as, convenable remedies. [Obs.] With his wod his work is convenable. Spenser.
convenance |That which is suitable, agreeable, or convenient. And they missed Their wonted convenance, cheerly hid the loss. Emerson.
convene |1. To come together; to meet; to unite. [R.] In shortsighted men . . . the rays converge and convene in the eyes before they come at the bottom. Sir I. Newton. 2. To come together, as in one body or for a public purpose; to meet; to assemble. Locke. The Parliament of Scotland now convened. Sir R. Baker. Faint, underneath, the household fowls convene. Thomson. Syn. -- To meet; to assemble; to congregate; to collect; to unite.\n\n1. To cause to assemble; to call together; to convoke. And now the almighty father of the gods Convenes a council in the blest abodes. Pope. 2. To summon judicially to meet or appear. By the papal canon law, clerks . . . can not be convened before any but an ecclesiastical judge. Ayliffe.
convener |1. One who convenes or meets with others. [Obs.] 2. One who calls an assembly together or convenes a meeting; hence, the chairman of a committee or other organized body. [Scot.]
convenience |1. The state or quality of being convenient; fitness or suitableness, as of place, time, etc.; propriety. Let's futher think of this; Weigh what convenience both of time and means May fit us to our shape. Shak. With all brief and plain conveniency, Let me have judgment. Shak. 2. Freedom from discomfort, difficulty, or trouble; commodiousness; ease; accommodation. Thus necessity invented stools, Convenience next suggested elbow chairs. Cowper. We are rather intent upon the end of God's glory than our own conveniency. Jer. Taylor. 3. That which is convenient; that which promotes comfort or advantage; that which is suited to one's wants; an accommodation. A pair of spectacles and several other little conveniences. Swift. 4. A convenient or fit time; opportunity; as, to do something at one's convenience.
conveniency |1. The state or quality of being convenient; fitness or suitableness, as of place, time, etc.; propriety. Let's futher think of this; Weigh what convenience both of time and means May fit us to our shape. Shak. With all brief and plain conveniency, Let me have judgment. Shak. 2. Freedom from discomfort, difficulty, or trouble; commodiousness; ease; accommodation. Thus necessity invented stools, Convenience next suggested elbow chairs. Cowper. We are rather intent upon the end of God's glory than our own conveniency. Jer. Taylor. 3. That which is convenient; that which promotes comfort or advantage; that which is suited to one's wants; an accommodation. A pair of spectacles and several other little conveniences. Swift. 4. A convenient or fit time; opportunity; as, to do something at one's convenience.
convenient |1. Fit or adapted; suitable; proper; becoming; appropriate. [Archaic] Feed me with food convenient for me. Prov. xxx. 8. Neither filthiness, nor foolish talking, nor jesting, which are not convenient. Eph. v. 4. 2. Affording accommodation or advantage; well adapted to use; handly; as, a convenient house; convenient implements or tools. 3. Seasonable; timely; opportune; as, a convenient occasion; a convenient season. Acts xxiv. 25. 4. Near at hand; easy of access. [Colloq.] Hereties used to be brought thither, convenient for burning. Thackeray. Syn. -- Fit; suitable; proper; adapted; fitted; suited; handly; commodious.
conveniently |In a convenient manner, form, or situation; without difficulty.
convent |1. A coming together; a meeting. [Obs.] A usual ceremony at their [the witches] convents or meetings. B. Jonson. 2. An association or community of recluses devoted to a religious life; a body of monks or nuns. One of our convent, and his [the duke's] confessor. Shak. 3. A house occupied by a community of religious recluses; a monastery or nunnery. One seldom finds in Italy a spot of ground more agreeable than ordinary that is not covered with a convent. Addison. Syn. -- Nunnery; monastery; abbey. See Cloister.\n\n1. To meet together; to concur. [obs.] Beau. & Fl. 2. To be convenient; to serve. [Obs.] When that is known and golden time convents. Shak.\n\nTo call before a judge or judicature; to summon; to convene. [Obs.] Shak.
conventical |Of or from, or pertaining to, a convent. \"Conventical wages.\" Sterne. Conventical prior. See Prior.
conventicle |1. A small assembly or gathering; esp., a secret assembly. They are commanded to abstain from all conventicles of men whatsoever. Ayliffe. 2. An assembly for religious worship; esp., such an assembly held privately, as in times of persecution, by Nonconformists or Dissenters in England, or by Covenanters in Scotland; -- often used opprobriously, as if those assembled were heretics or schismatics. The first Christians could never have had recourse to nocturnal or clandestine conventicles till driven to them by the violence of persecution. Hammond. A sort of men who . . . attend its [the curch of England's] service in the morning, and go with their wives to a conventicle in the afternoon. Swift.
conventicler |One who supports or frequents conventicles. Dryden.
conventicling |Belonging or going to, or resembling, a conventicle. [Obs.] Conventicling schools . . . set up and taught secretly by fanatics. South.
convention |1. The act of coming together; the state of being together; union; coalition. The conventions or associations of several particles of matter into bodies of any certain denomination. Boyle. 2. General agreement or concurrence; arbitrary custom; usage; conventionality. There are thousands now Such women, but convention beats them down. Tennyson. 3. A meeting or an assembly of persons, esp. of delegates or representatives, to accomplish some specific object, -- civil, social, political, or ecclesiastical. He set himself to the making of good laws in a grand convention of his nobles. Sir R. Baker. A convention of delegates from all the States, to meet in Philadelphia, for the sole and express purpose of reserving the federal system, and correcting its defects. W. Irving. 4. (Eng. Hist)  An extraordinary assembly of the parkiament or estates of the realm, held without the king's writ, -- as the assembly which restored Charles II. to the throne, and that which declared the throne to be abdicated by James II. Our gratitude is due . . . to the Long Parliament, to the Convention, and to William of Orange. Macaulay. 5. An agreement or contract less formal than, or preliminary to, a traety; an informal compact, as between commanders of armies in respect to suspension of hostilities, or between states; also, a formal agreement between governments or sovereign powers; as, a postal convetion between two governments. This convention, I think from my soul, is nothing but a stipulation for national ignominy; a truce without a suspension of hostilities. Ld. Chatham. The convention with the State of georgia has been ratified by their Legislature. T. Jefferson.
conventional |1. Formed by agreement or compact; stipulated. Conventional services reserved by tenures upon grants, made out of the crown or knights' service. Sir M. Hale. 2. Growing out of, or depending on, custom or tacit agreement; sanctioned by general concurrence or usage; formal. \"Conventional decorum.\" Whewell. The conventional language appropriated to monarchs. Motley. The ordinary salutations, and other points of social behavior, are conventional. Latham. 3. (Fine Arts) (a) Based upon tradition, whether religious and historical or of artistic rules. (b) Abstracted; removed from close representation of nature by the deliberate selection of what is to be represented and what is to be rejected; as, a conventional flower; a conventional shell. Cf. Conventionalize, v. t.
conventionalism |1. That which is received or established by convention or arbitrary agreement; that which is in accordance with the fashion, tradition, or usage. All the artifice and conventionalism of life. Hawthorne. They gaze on all with dead, dim eyes, -- wrapped in conventionalisms, . . . simulating feelings according to a received standart. F. W. Robertson. 2. (Fine Arts)  The principles or practice of conventionalizing. See Conventionalize, v. t.
conventionalist |1. One who adheres to a convention or treaty. 2. One who is governed by conventionalism.
conventionality |The state of being conventional; adherence to social formalities or usages; that which is established by conventional use; one of the customary usages of social life.
conventionalization |(a) The act of making conventional. (b) The state of being conventional.
conventionalize |1. To make conventional; to bring under the influence of, or cause to conform to, conventional rules; to establish by usage. 2. (Fine Arts) (a) To represent by selecting the important features and those which are expressible in the medium employed, and omitting the others. (b) To represent according to an established principle, whether religious or traditional, or based upon certain artistic rules of supposed importance.\n\nTo make designs in art, according to conventional principles. Cf. Conventionalize, v. t., 2.
conventionally |In a conventional manner.
conventionary |Acting under contract; settled by express agreement; as, conventionary tenants. [Obs.] R. Carew.
conventioner |One who belongs to a convention or assembly.
conventionist |One who enters into a convention, covenant, or contract.
conventual |Of or pertaining to a convent; monastic. \"A conventual garb.\" Macaulay. Conventual church, a church attached or belonging to a convent or monastery. Wordsworth.\n\nOne who lives in a convent; a monk or num; a recluse. Addison.
converge |To tend to one point; to incline and approach nearer together; as, lines converge. The mountains converge into a single ridge. Jefferson.\n\nTo cause to tend to one point; to cause to incline and approach nearer together. I converge its rays to a focus of dazzling brilliancy. Tyndall.
convergence |The condition or quality of converging; tendency to one point. The convergence or divergence of the rays falling on the pupil. Berkeley.
convergency |The condition or quality of converging; tendency to one point. The convergence or divergence of the rays falling on the pupil. Berkeley.
convergent |tending to one point of focus; tending to approach each other; converging. As many rays of light, as conveniently can be let in, and made convergent. Boyle. The vast dome of its cathedral . . . directing its convergent curves to heaven. Hallam.
converging |Tending to one point; approaching each other; convergent; as, converging lines. Whewell. Converging rays(Opt.), rays of light, which, proceeding from different points of an object, tend toward a single point. -- Converging series (Math.), a series in which if an indefinitely great number of terms be taken, their sum will become indefinitely near in value to a fixed quantity, which is called the sum of the series; -- opposed to a diverging series.
conversable |Qualified for conversation; disposed to converse; sociable; free in discourse. While young, humane, conversable, and kind. Cowper.
conversableness |The quality of being conversable; disposition to converse; sociability.
conversably |In a conversable manner.
conversance |The state or quality of being conversant; habit of familiarity; familiar acquaintance; intimacy. [R.]
conversancy |Conversance [R.]
conversant |1. Having frequent or customary intercourse; familiary associated; intimately acquainted. I have been conversant with the first persons of the age. Dryden. 2. Familiar or acquainted by use or study; well-informed; versed; -- generally used with with, sometimes with in. Deeply conversant in the Platonic philosophy. Dryden. he uses the different dialects as one who had been conversant with them all. Pope. Conversant only with the ways of men. Cowper. 3. Concerned; occupied. Education . . . is conversant about children. W. Wotton.\n\nOne who converses with another; a convenser. [R.]
conversantly |In a familiar manner.
conversation |1. General course of conduct; behavior. [Archaic] Let your conversation be as it becometh the gospel. Philip. i. 27. 2. Familiar intercourse; intimate fellowship or association; close acquaintance. \"Conversation with the best company.\" Dryden. I set down, out of long experience in business and much conversation in books, what I thought pertinent to this business. Bacon. 3. Commerce; intercourse; traffic. [Obs.] All traffic and mutual conversation. Hakluyt. 4. Colloqual discourse; oral interchange of sentiments and observations; informal dialogue. The influence exercised by his [Johnson's] conversation was altogether without a parallel. Macaulay. 5. Sexual intercourse; as, criminal conversation. Syn. -- Intercourse; communion; commerce; familiarity; discourse; dialogue; colloque; talk; chat. -- Conversation, Talk. There is a looser sense of these words, in which they are synonymous; there is a stricter sense, in which they differ. Talk is usually broken, familiar, and versatile. Conversation is more continuous and sustained, and turns ordinarily upon topics or higher interest. Children talk to their parents or to their companions; men converse together in mixed assemblies. Dr. Johnson once remarked, of an evening spent in society, that there had been a great deal of talk, but no conversation.
conversational |Pertaining to conversation; in the manner of one conversing; as, a conversational style. Thackeray.
conversationalist |A conversationist.
conversationed |Acquainted with manners and deportment; behaved. [Obs.] Till she be better conversationed, . . . I'll keep As far from her as the gallows. Beau. & Fl.
conversationism |A word or phrase used in conversation; a colloqualism.
conversationist |One who converses much, or who excels in conversation. Byron.
conversative |Relating to intercourse with men; social; -- opposed to contemplative. She chose . . . to endue him with the conversative qualities of youth. Sir H. Wotton.
conversazione |A meeting or assembly for conversation, particularly on literary or scientific subjects. Gray. These conversazioni [at Florence] resemble our card assemblies. A. Drummond.
converse |1. To keep company; to hold intimate intercourse; to commune; -- followed by with. To seek the distant hills, and there converse With nature. Thomson. Conversing with the world, we use the world's fashions. Sir W. Scott. But to converse with heaven -This is not easy. Wordsworth. 2. To engage, in familiar colloqui; to interchange thoughts and opinions in a free, informal manner; to chat; -- followed by with before a person; by on, about, concerning, etc., before a thing. Companions That do converse and waste the time together. Shak. We had conversed so often on that subject. Dryden. 3. To have knowledge of, from long intercourse or study; -- said of things. According as the objects they converse with afford greater or less variety. Locke. Syn. -- To associate; commune; discourse; talk; chat.\n\n1. Frequent intercourse; familiar communion; intimate association. Glanvill. \"T is but to hold Converse with Nature's charms, and view her stores unrolled. Byron. 2. Familiar discourse; free interchange of thoughts or views; conversation; chat. Formed by thy converse happily to steer From grave to gay, from lively to severe. Pope.\n\n, a. Etym: [L. conversus, p.p. of convertere. See Convert.] Turned about; reversed in order or relation; reciprocal; as, a converse proposition.\n\n1. (Logic)  A proposition which arises from interchanging the terms of another, as by putting the predicate for the subject, and the subject for the predicate; as, no virtue is vice, no vice is virtue. Note: It should not (as is often done) be confounded with the contrary or opposite of a proposition, which is formed by introducing the negative not or no. 2. (Math.)  A proposition in which, after a conclusion from something supposed has been drawn, the order is inverted, making the conclusion the supposition or premises, what was first supposed becoming now the conclusion or inference. Thus, if two sides of a sides of a triangle are equal, the angles opposite the sides are equal; and the converse is true, i.e., if these angles are equal, the two sides are equal.
conversely |In a converse manner; with change of order or relation; reciprocally. J. S. Mill.
converser |One who engages in conversation.
conversible |Capable of being converted or reversed. Hammond.
conversion |1. The act of turning or changing from one state or condition to another, or the state of being changed; transmutation; change. Artificial conversion of water into ice. Bacon. The conversion of the aliment into fat. Arbuthnot. 2. The act of changing one's views or course, as in passing from one side, party, or from of religion to another; also, the state of being so changed. \"Conversion to Christianity.\" Prescott. 3. (Law)  An appropriation of, and dealing with the property of another as if it were one's own, without right; as, the conversion of a horse. Or bring my action of conversion And trover for my goods. Hudibras. 4. (Logic)  The act of interchanging the terms of a proposition, as by putting the subject in the place of the predicate, or the contrary. 5. (Math.)  A change or reduction of the form or value of a proposition; as, the conversion of equations; the conversion of proportions. 6. (Mil.) (a) A change of front, as a body of troops attacked in the flank. (b) A change of character or use, as of smoothbore guns into rifles. 7. (Theol.)  A spiritual and moral change attending a change of belief with conviction; a change of heart; a change from the service of the world to the service of God; a change of the ruling disposition of the soul, involving a transformation of the outward life. He oft Frequented their assemblies, . . . and to them preached Conversion and repentance, as to souls In prison under judgments imminent. Milton.
conversive |1. Capable of being converted or changed. 2. Ready to converse; social. [Archaic] Feltham.
