cullionly |Mean; base. Shak.
cullis |A strong broth of meat, strained and made clear for invalids; also, a savory jelly. [Obs.] When I am exellent at caudles And cullises . . . you shall be welcome to me. Beau. & Fl.\n\nA gutter in a roof; a channel or groove.
culls |1. Refuse timber, from which the best part has been culled out. 2. Any refuse stuff, as rolls not properly baked.
cully |A person easily deceived, tricked, or imposed on; a mean dupe; a gull. I have learned that . . . I am not the first cully whom she has passed upon for a countess. Addison.\n\nTo trick, cheat, or impose on; to deceive. \"Tricks to cully fools.\" Pomfret.
cullyism |The state of being a cully. Less frequent instances of eminent cullyism. Spectator.
culm |The stalk or stem of grain and grasses (including the bamboo), jointed and usually hollow.\n\n(a) Mineral coal that is not bituminous; anthracite, especially when found in small masses. (b) The waste of the Pennsylvania anthracite mines, consisting of fine coal, dust, etc., and used as fuel. Raymond.
culmen |1. Top; summit; acme. R. North. 2. (Zo√∂l.)  The dorsal ridge of a bird's bill.
culmiferous |Having jointed stems or culms.\n\nContaining, or abounding in, culm or glance coal.
culminal |Pertaining to a culmen.
culminant |Being vertical, or at the highest point of altitude; hence, predominant. [R.]
culminate |1. To reach its highest point of altitude; to come to the meridian; to be vertical or directly overhead. As when his beams at noon Culminate from the equator. Milton. 2. To reach the highest point, as of rank, size, power, numbers, etc. The reptile race culminated in the secondary era. Dana. The house of Burgundy was rapidly culminating. Motley.\n\nGrowing upward, as distinguished from a laterral growth; -- applied to the growth of corals. Dana.
culmination |1. The attainment of the highest point of altitude reached by a heavently body; passage across the meridian; transit. 2. Attainment or arrival at the highest pitch of glory, power, etc.
culpa |Negligence or fault, as distinguishable from dolus (deceit, fraud), which implies intent, culpa being imputable to defect of intellect, dolus to defect of heart. Wharton.
culpability |The state of being culpable.
culpable |1. Deserving censure; worthy of blame; faulty; immoral; criminal. State Trials (1413). If he acts according to the best reason he hath, he is not culpable, though he be mistaken in his measures. Sharp. 2. Guilty; as, clpable of a crime. [Obs.] Spenser. -- Cul\"pa*ble*ness, n. -- Cul\"pa*bly, adv.
culpatory |Expressing blame; censuring; reprehensory; inculpating. Adjectives . . . commonly used by Latian authors in a culpatory sense. Walpole.
culpe |Blameworthiness. [Obs.] Banished out of the realme . . . without culpe. E. Hall.
culpon |A shered; a fragment; a strip of wood. [Obs.] Chaucer.
culprit |1. One accused of, or ar An author is in the condition of a culprit; the public are his judges. Prior. 2. One quilty of a fault; a criminal.
culrage |Smartweed (Polygonum Hydropiper).
cult |1. Attentive care; homage; worship. Every one is convinced of the reality of a better self, and of. thecult or homage which is due to it. Shaftesbury. 2. A system of religious belief and worship. That which was the religion of Moses is the ceremonial or cult of the religion of Christ. Coleridge.
cultch |Empty oyster shells and other substances laid down on oyster grounds to furnish points for the attachment of the spawn of the oyster. [Also written cutch.]
culter |A colter. See Colter.
cultirostral |Having a bill shaped like the colter of a plow, or like a knife, as the heron, stork, etc.
cultirostres |A tribe of wading birds including the stork, heron, crane, etc.
cultivable |Capable of being cultivated or tilled. Todd.
cultivatable |Cultivable.
cultivate |1. To bestow attention, care, and labor upon, with a view to valuable returns; to till; to fertilize; as, to cultivate soil. 2. To direct special attention to; to devote time and thought to; to foster; to cherish. Leisure . . . to cultivate general literature. Wordsworth. 3. To seek the society of; to court intimacy with. I ever looked on Lord Keppel as one of the greatest and best men of his age; and I loved and cultivated him accordingly. Burke. 4. To improve by labor, care, or study; to impart culture to; to civilize; to refine. To cultivate the wild, licentious savage. Addison. The mind of man hath need to be prepared for piety and virtue; it must be cultivated to the end. Tillotson. 5. To raise or produce by tillage; to care for while growing; as, to cultivate corn or grass.
cultivation |1. The art or act of cultivating; improvement for agricultural purposes or by agricultural processes; tillage; production by tillage. 2. Bestowal of time or attention for self-improvement or for the benefit of others; fostering care. 3. The state of being cultivated; advancement in physical, intellectual, or moral condition; refinement; culture. Italy . . . was but imperfectly reduced to cultivation before the irruption of the barbarians. Hallam.
cultivator |1. One who cultivates; as, a cultivator of the soil; a cultivator of literature. Whewell. 2. An agricultural implement used in the tillage of growing crops, to loosen the surface of the earth and kill the weeds; esp., a triangular frame set with small shares, drawn by a horse and by handles. Note: In a broader signification it includes any complex implement for pulverizing or stirring the surface of the soil, as harrows, grubbers, horse hoes, etc.
cultrate |Sharp-edged and pointed; shaped like a pruning knife, as the beak of certain birds.
cultrated |Sharp-edged and pointed; shaped like a pruning knife, as the beak of certain birds.
cultriform |Shaped like a pruning knife; cultrate.
cultrivorous |Devouring knives; swallowing, or pretending to swallow, knives; -- applied to persons who have swallowed, or have seemed to swallow, knives with impunity. Dunglison.
culturable |Capable of, or fit for, being cultivated; capable or becoming cultured. London Spectator.
cultural |Of or pertaining to culture.
culture |1. The act or practice of cultivating, or of preparing the earth for seed and raising crops by tillage; as, the culture of the soil. 2. The act of, or any labor or means employed for, training, disciplining, or refining the moral and intellectual nature of man; as. the culture of the mind. If vain our toil We ought to blame theculture, not the soil. Pepe. 3. The state of being cultivated; result of cultivation; physical improvement; enlightenment and discipline acquired by mental and moral training; civilization; refinement in manners and taste. What the Greeks expressed by their humanitas, we less happily try to express by the more artificial word culture. J. C. Shairp. The list of all the items of the general life of a people represents that whole which we call its culture. Tylor. Culture fluid, a fluid in which the germs of microscopic organisms are made to develop, either for purposes of study or as a means of modifying their virulence.\n\nTo cultivate; to educate. They came . . . into places well inhabited and cultured. Usher.
culture features |The artificial features of a district as distinguished from the natural.
culture myth |A myth accounting for the discovery of arts and sciences or the advent of a higher civilization, as in the Prometheus myth.
cultured |1. Under culture; cultivated. \"Cultured vales.\" Shenstone. 2. Characterized by mental and moral training; disciplined; refined; well-educated. The sense of beauty in nature, even among cultured people, is less often met with than other mental endowments. I. Taylor. The cunning hand and cultured brain. Whittier.
cultureless |Having no culture.
culturist |1. A cultivator. 2. One who is an advocate of culture. The culturists, by which term I mean not those who esteem culture (as what intelligent man does notJ. C. Shairp
cultus |Established or accepted religious rites or usages of worship; state of religious development. Cf.Cult, 2.
cultus cod |See Cod, and Buffalo cod, under Buffalo.
culver |A dove. \"Culver in the falcon's fist.\" Spenser.\n\nA culverin. Falcon and culver on each tower Stood prompt their deadly hail to shower. Sir W. Scott.
culverhouse |A dovecote.
culverin |A long cannon of the 16th century, usually an 18-pounder with serpent-shaped handles. Trump, and drum, and roaring culverin. Mac
culverkey |1. A bunch of the keys or samaras of the ash tree. Wright. 2. An English meadow plant, perhaps the columbine or the bluebell squill (Scilla nutans). [Obs.] A girl cropping culverkeys and cowslips to make garlands. Walton. CULVER'S PHYSIC; CULVER'S ROOT Cul\"ver's phys\"ic, or Cul\"ver's root`. [So called after a Dr. Culver, who used it.] (Bot.)  The root of a handsome erect herb (Leptandra, syn. Veronica, Virginica) common in most moist woods of North America , used as an active cathartic and emetic; also, the plant itself.
culvert |A transverse drain or waterway of masonry under a road, railroad, canal, etc.; a small bridge.
culvertail |Dovetail.
culvertailed |United or fastened by a dovetailed joint.
cumacea |An order of marine Crustacea, mostly of small size.
cumbent |Lying down; recumbent. J. Dyer.
cumber |To rest upon as a troublesome or useless weight or load; to be burdensome or oppressive to; to hinder or embarrass in attaining an object, to obstruct or occupy uselessly; to embarrass; to trouble. Why asks he what avails him not in fight, And would but cumber and retard his flight Dryden. Martha was cumbered about much serving. Luke x. 40. Cut it down; why cumbereth it the ground Luke xiii. 7. The multiplying variety of arguments, especially frivolous ones, . . . but cumbers the memory. Locke.\n\nTrouble; embarrassment; distress. [Obs.] [Written also comber.] A place of much distraction and cumber. Sir H. Wotton. Sage counsel in cumber. Sir W. Scott.
cumbersome |1. Burdensome or hindering, as a weight or drag; embarrassing; vexatious; cumbrous. To perform a cumbersome obedience. Sir. P. Sidney. 2. Not easily managed; as, a cumbersome contrivance or machine. He holds them in utter contempt, as lumbering, cumbersome, circuitous. I. Taylor. -- Cum\"ber*some*ly, adv. -- Cum\"ber*some*ness,n.
cumbrance |Encumbrance. [Obs.] Extol not riches then, the toil of fools, The wise man's cumbrance, if not snare. Milton.
cumbrian |Pertaining to Cumberland, England, or to a system of rocks found there. Cumbrian system (Geol.), the slate or graywacke system of rocks, now included in the Cambrian or Silurian system; -- so called because most prominent at Cumberland.
cumbrous |1. Rendering action or motion difficult or toilsome; serving to obstruct or hinder; burdensome; clogging. He sunk beneath the cumbrous weight. Swift. That cumbrousand unwieldy style which disfigures English composition so extensively. De Quincey. 2. Giving trouble; vexatious. [Obs.] A clud of cumbrous gnats. Spenser. -- Cum\"brous*ly, adv. -- Cum\"brous*ness, n.
cumene |A colorless oily hydrocarbon, C6H5.C3H7, obtained by the distillation of cuminic acid; -- called also cumol.
cumfrey |See Comfrey.
cumic |See Cuming.
cumidine |A strong, liquid, organic base, C3H7.C6H4.NH2, homologous with aniline.
cumin |A dwarf umbelliferous plant, somewhat resembling fennel (Cuminum Cyminum), cultivated for its seeds, which have a bitterish, warm taste, with an aromatic flavor, and are used like those of anise and caraway. [Written also cummin.] Rank-smelling rue, and cumin good for eyes. Spenser. Black cumin (Bot.), a plant (Nigella sativa) with pungent seeds, used by the Afghans, etc.
cuminic |Pertaining to, or derived from, cumin, or from oil of caraway; as, cuminic acid. Cuminic acid (Chem.), white crystalline substance, C3H7.C6H4.CO2H, obtained from oil of caraway.
cuminil |A substance, analogous to benzil, obtained from oil of caraway.
cuminol |A liquid, C3H7.C6H4.CHO, obtained from oil of caraway; -- called also cuminic aldehyde.
cummerbund |A sash for the waist; a girdle. [India]
cummin |Same as Cumin. Ye pay tithe of mint, and cummin. Matt. xxiii. 23.
cumquat |See Kumquat.
cumshaw |A present or bonus; -- originally applied to that paid on ships which entered the port of Canton. S. Wells Williams.\n\nTo give or make a present to.
cumu-cirro-stratus |Nimbus, or rain cloud. See Nimbus, and Cloud.
cumulate |To gather or throw into a heap; to heap together; to accumulate. Shoals of shells, bedded and cumulated heap upon heap. Woodward.
cumulation |The act of heaping together; a heap. See Accumulation.
cumulatist |One who accumulates; one who collects. [R.]
cumulative |1. Composed of parts in a heap; forming a mass; agregated. \"As for knowledge which man receiveth by teaching, it is cumulative, njt original.\" Bacon 2. Augmenting, gaining, or giving force, by successive additions; as, a cumulative argument, i. e., one whose force increases as the statement proceeds. The argument . . . is in very truth not logical and single, but moral and cumulative. Trench. 3. (Law) (a) Tending to prove the same point to which other evidence has been offered; -- said of evidence. (b) Given by same testator to the same legatee; -- said of a legacy. Bouvier. Wharton. Cumulative action (Med.), that action of certain drugs, by virtue of which they produce, when administered in small doses repeated at considerable intervals, the same effect as if given in a single large dose. -- Cumulative poison, a poison the action of which is cumulative. -- Cumulative vote or system of voting (Politics), that system which allows to each voter as many votes as there are persons to be voted for, and permits him to accumulate these votes upon one person, or to distribute them among the candidates as he pleases.
cumulose |Full of heaps.
cumulostratus |A form of cloud. See Cloud.
cumulus |One of the four principal forms of clouds. SeeCloud.
cun |To con (a ship). [Obs.]\n\nTo know. See Con. [Obs.]
cunabula |1. The earliest abode; original dwelling place; originals; as, the cunabula of the human race. 2. (Bibliography)  The extant copies of the first or earliest printed books, or of such as were printed in the 15th century.
cunctation |Delay; procrastination. [R.] Carlyle.
cunctative |Slow; tardy; dilatory; causing delay.
cunctator |One who delays or lingers. [R.]
cunctipotent |All-powerful; omnipotent. [R] \"God cunctipotent.\" Neale (Trans. Rhythm of St. Bernard).
cund |To con (a ship). [Obs.]
cundurango |The bark of a South American vine (Gonolobus Condurango) of the Milkweed family. It has been supposed, but erroneously, to be a cure for cancer. [Written also condurango.]
cuneal |Relating to a wedge; wedge-shaped.
cuneate |Wedge-shaped; (Bot.), wedge-shaped, with the point at the base; as, a cuneate leaf.
cuneated |Wedge-shaped; (Bot.), wedge-shaped, with the point at the base; as, a cuneate leaf.
cuneatic |Cuneiform. \"Cuneatic decipherment.\" Sayce.
cuneiform |1. Wedge-shaped; as, a cuneiform bone; -- especially applied to the wedge-shaped or arrowheaded characters of ancient Persian and Assyrian inscriptions. See Arrowheaded. 2. Pertaining to, or versed in, the ancient wedge-shaped characters, or the inscriptions in them. \"A cuneiform scholar.\" Rawlinson.\n\n1. The wedge-shaped characters used in ancient Persian and Assyrian inscriptions. I. Taylor (The Alphabet). 2. (Anat.) (a) One of the three tarsal bones supporting the first, second third metatarsals. They are usually designated as external, middle, and internal, or ectocuniform, mesocuniform, and entocuniform, respectively. (b) One of the carpal bones usually articulating wich the ulna; -- called also pyramidal and ulnare.
cunette |A drain trench, in a ditch or moat; -- called also cuvette.
cuniform |1. Wedge-shaped; as, a cuneiform bone; -- especially applied to the wedge-shaped or arrowheaded characters of ancient Persian and Assyrian inscriptions. See Arrowheaded. 2. Pertaining to, or versed in, the ancient wedge-shaped characters, or the inscriptions in them. \"A cuneiform scholar.\" Rawlinson.\n\n1. The wedge-shaped characters used in ancient Persian and Assyrian inscriptions. I. Taylor (The Alphabet). 2. (Anat.) (a) One of the three tarsal bones supporting the first, second third metatarsals. They are usually designated as external, middle, and internal, or ectocuniform, mesocuniform, and entocuniform, respectively. (b) One of the carpal bones usually articulating wich the ulna; -- called also pyramidal and ulnare.
cunner |(a) A small edible fish of the Atlantic coast (Ctenolabrus adspersus); -- called also chogset, burgall, blue perch, and bait stealer. [Written also conner.] (b) A small shellfish; the limpet or patella.
cunning |1. Knowing; skillfull; dexterous. \"A cunning workman.\" Ex. xxxviii. 23. \"Tis beauty truly blent, whose red and white Nature's own sweet and cunning hand laid on. Shak. Esau was a cunning hunter. Gen xxv. 27. 2. Wrought with, or exibiting, skill or ingenuity; ingenious; curious; as, cunning work. Over them Arachne high did lift Her cunning web. Spenser. 3. Crafty; sly; artful; designid; deceitful. They are resolved to be cunning; let others run the hazard of being sincere. South. 4. Pretty or pleasing; as, a cunning little boy. [Colloq. U.S.] Barlett. Syn. -- Cunning, Artful, Sly, Wily, Crafty. These epithets agree in expressing an aptitude for attaining some end by peculiar and secret means. Cunning is usually low; as, a cunning trick. Artful is more ingenious and inventive; as, an artful device. Sly implies a turn for what is double or concealed; as, sly humor; a sly evasion. Crafty denotes a talent for dexterously deceiving; as, a crafty manager. Wily describes a talent for the use of stratagems; as, a wily politician. \"Acunning man often shows his dexterity in simply concealing. An artful man goes further, and exerts his ingenuity in misleading. A crafty man mingles cunning with art, and so shapes his actions as to lull suspicions. The young may be cunning, but the experienced only can be crafty. Slyness is a vulgar kind of cunning; the sly man goes cautiously and silently to work. Wiliness is a species of cunning or craft applicable only to cases of attack and defence.\" Crabb.\n\n1. Knowledge; art; skill; dexterity. [Archaic] Let my right hand forget her cunning. Ps. cxxxvii. 5. A carpenter's desert Stands more in cunning than in power. Chapman. 2. The faculty or act of using stratagem to accomplish a purpose; fraudulent skill or dexterity; deceit; craft. Discourage cunning in a child; cunning is the ape of wisdom. Locke. We take cunning for a sinister or crooked wisdom. Bacon.
cunningly |In a cunning manner; with cunning.
cunningman |A fortune teller; one who pretends to reveal mysteries. [Obs.] Hudibras.
cunningness |Quality of being cunning; craft.
cup |1. A small vessel, used commonly to drink from; as, a tin cup, a silver cup, a wine cup; especially, in modern times, the pottery or porcelain vessel, commonly with a handle, used with a saucer in drinking tea, coffee, and the like. 2. The contents of such a vessel; a cupful. Give me a cup of sack, boy. Shak. 3. pl.  Repeated potations; social or exessive indulgence in intoxicating drinks; revelry. Thence from cups to civil broils. Milton. 4. That which is to be received or indured; that which is allotted to one; a portion. O my Father, if it be possible, let this cup pass from me. Matt. xxvi. 39. 5. Anything shaped like a cup; as, the cup of an acorn, or of a flower. The cowslip's golden cup no more I see. Shenstone. 6. (Med.)  A cupping glass or other vessel or instrument used to produce the vacuum in cupping. Cup and ball, a familiar toy of children, having a cup on the top of a piece of wood to which, a ball is attached by a cord; the ball, being thrown up, is to be caught in the cup; bilboquet. Milman.- Cup and can, familiar companions. -- Dry cup, Wet cup (Med.), a cup used for dry or wet cupping. See under Cupping. -- To be in one's cups, to be drunk.\n\n1. To supply with cups of wine. [R.] Cup us, till the world go round. Shak. 2. (Surg.)  To apply a cupping apparatus to; to subject to the operation of cupping. See Cupping. 3. (Mech.)  To make concave or in the form of a cup; as, to cup the end of a screw.
cup shake |A shake or fissure between the annual rings of a tree, found oftenest near the roots.
cup-gall |A kind of oak-leaf gall. See Gall.
cup-moss |A kind of lichen, of the genus Cladonia.
cup-rose |Red poppy. See Cop-rose.
cupbearer |1. One whose office it is to fill and hand the cups at an enterainment. 2. (Antiq.)  One of the attendants of a prince or noble, permanently charged with the performance of this office for his master. \"I was the king's cupbearer.\" Neh. i. 11.
cupboard |1. A board or shelf for cups and dishes. [Obs.] Bacon. 2. A small closet in a room, with shelves to receive cups, dishes, food, etc.; hence, any small closet. Cupboard love, interested love, or that which has an eye to the cupboard. \"A cupboard love is seldom true.\" Poor Robin. [Colloq.] -- To cry cupboard, to call for food; to express hunger. [Colloq.] \"My stomach cries cupboard.\" W. Irving.\n\nTo collect, as into a cupboard; to hoard. [R.] Shak.
cupel |A shallow porus cup, used in refining precious metals, commonly made of bone ashes (phosphate of lime). [Written also coppel.] Cupel dust, powder used in purifying metals.\n\nTo refine by means of a cupel.
cupellation |The act or process of refining gold or silver, etc., in a cupel. Note: The process consist in exposing the cupel containing the metal to be assayed or refined to a hot blast, by which the lead, copper, tin, etc., are oxidized, dissolved, and carried down into the porous cupel, leaving the unoxidizable precious metal. If lead is not already present in the alloy it must be added before cupellation.
cupful |As much as a cup will hold.
cupid |The god of love, son of Venus; usually represented as a naked, winged boy with bow and arrow. Pretty dimpled boys, like smiling cupids. Shak.
cupidity |1. A passionate desire; love. [Obs.] 2. Eager or inordinate desire, especially for wealth; greed of gain; avarice; covetousness. With the feelings of political distrust were mingled those of cupidity and envy, as the Spaniard saw the fairest provinces of the south still in the hands of the accursed race of Ishmael. Prescott.
cupola |1. (Arch.)  A roof having a rounded form, hemispherical or nearly so; also, a celing having the same form. When on a large scale it is usually called dome. 2. A small structure standing on the top of a dome; a lantern. 3. A furnace for melting iron or other metals in large quantity, -- used chiefly in foundries and steel works. 4. A revoling shot-proof turret for heavy ordnance. 5. (Anat.)  The top of the spire of the cochlea of the ear.
cupper |One who performs the operation of cupping.
cupping |The operation of drawing blood to or from the surface of the person by forming a partial vacuum over the spot. Also, sometimes, a similar operation for drawing pus from an abscess. Cupping glass, a glass cup in which a partial vacuum is produced by heat, in the process of cupping. -- Dry cupping, the application of a cupping instrument without scarification, to draw blood to the surface, produce counter irritation, etc. -- Wet cupping, the operation of drawing blood by the application of a cupping instrument after scarification.
cuppy |1. Hollow; cuplike; also, full of cups, or small depressions. 2.  Characterized by cup shakes; -- said of timber.
cupreous |Consisting of copper or resembling copper; coppery.
cupric |Of, pertaining to, or derived from, copper; containing copper; -- said of those compounds of copper in which this element is present in its lowest proportion.
cupriferous |Containing copper; as, cupriferous silver.
cuprite |The red oxide of copper; red copper; an important ore of copper, occurring massive and in isometric crystals.
cuproid |(Crystalloq.) A solid related to a tetrahedron, and contained under twelve equal triangles.
cuprous |Of, pertaining to, or derived from, copper; containing copper; -- said of those compounds of copper in which this element is present in its highest proportion.
cuprum |Copper.
cupulate |Having or bearing cupeles; cupuliferous.
cupule |1. (Bot.)  A cuplet or little cup, as the acorn; the husk or bur of the filbert, chestnut, etc. 2. (Zo√∂l.)  A sucker or acetabulum.
cupuliferous |Of, pertaining to, or resembling, the family of plants ot which the oak and the chestnut are examples, -- trees bearing a smooth, solid nut inclosed in some kind of cup or bur; bearing, or furnished with, a cupule.
cur |1. A mongrel or inferior dog. They . . . like to village curs, Bark when their fellows do. Shak. 2. A worthless, snarling fellow; -- used in contempt. What would you have, you curs, That like nor peace nor war Shak.
curability |The state of being curable; curableness.
curable |Capable of being cured; admitting remedy. \"Curable diseases.\" Harvey. -- Cur\"a*ble*ness, n. -- Cur`a*bly, adv.
curacao |A liqueur, or cordial, flavored with orange peel, cinnamon, and mace; -- first made at the island of Cura√ßcao.
curacoa |A liqueur, or cordial, flavored with orange peel, cinnamon, and mace; -- first made at the island of Cura√ßcao.
curacy |The office or employment of a curate.
curare |A black resinoid extract prepared by the South American Indians from the bark of several species of Strychnos (S. toxifera, etc.). It sometimes has little effect when taken internally, but is quickly fatal when introduced into the blood, and used by the Indians as an arrow poison. [Written also urari, woorali, woorari, etc.]
curari |A black resinoid extract prepared by the South American Indians from the bark of several species of Strychnos (S. toxifera, etc.). It sometimes has little effect when taken internally, but is quickly fatal when introduced into the blood, and used by the Indians as an arrow poison. [Written also urari, woorali, woorari, etc.]
curarine |A deadly alkaloid extracted from the curare poison and from the Strychnos toxifera. It is obtained in crystalline colorless salts.
curarize |To poison with curare.
curassow |A large gallinaceous bird of the American genera Crax, Ourax, etc., of the family Cracid√¶. Note: The crested curassow (Crax alector) is black, and about the size of a small hen-turkey, with an erectile crest of curled feathers. It ranges from Mexico to Brazil. The galeated curassow or cushew bird (Ourax Pauxi) is similar in size, and has a large, hollow, blue, pear-shaped protuberance on the head.
curat |A cuirass or breastplate. [Obs.] Spenser.
curate |One who has the cure souls; originally, any clergyman, but now usually limited to one who assist a rector or vicar Hook. All this the good old man performed alone, He spared no pains, for curate he had none. Dryden.
curateship |A curacy.
curation |Cure; healing. [Obs.] Chaucer.
curative |Relating to, or employed in, the cure of diseases; tending to cure. Arbuthnot.
curator |1. One who has the care and superintendence of anything, as of a museum; a custodian; a keeper. 2. One appointed to act as guardian of the estate of a person not legally competent to manage it, or of an absentee; a trustee; a guardian.
curatorship |The office of a curator.
curatrix |1. A woman who cures. 2. A woman who is a guardian or custodian. Burrill.
curb |1. To bend or curve [Obs.] Crooked and curbed lines. Holland. 2. To guide and manage, or restrain, as with a curb; to bend to one's will; to subject; to subdue; to restrain; to confine; to keep in check. Part wield their arms, part curb the foaming steed. Milton. Where pinching want must curbthy warm desires. Prior. 3. To furnish wich a curb, as a well; also, to restrain by a curb, as a bank of earth.\n\nTo bend; to crouch; to cringe. [Obs.] Virtue itself of vice must pardon beg, Yea, curb and woo for leave to do him good. Shak.\n\n1. That which curbs, restrains, or subdues; a check or hindbrance; esp., a chain or strap attached to the upper part of the branches of a bit, and capable of being drawn tightly against the lower jaw of the horse. He that before ran in the pastures wild Felt the stiff curb control his angry jaws. Drayton. By these men, religion,that should be The curb, is made the spur of tyranny. Denham. 2. (Arch.)  An assemblage of three or more pieces of timber, or a metal member, forming a frame around an opening, and serving to maintain the integrity of that opening; also, a ring of stone serving a similar purpose, as at the eye of a dome. 3. A frame or wall round the mouth of a well; also, a frame within a well to prevent the earth caving in. 4. A curbstone. 5. (Far.)  A swelling on the back part of the hind leg of a horse, just behind the lowest part of the hock joint, generally causing lameness. James Law. Curb bit, a stiff bit having branches by which a leverage is obtained upon the jaws of horse. Knight. -- Curb pins (Horology), the pins on the regulator which restrain the hairspring. -- Curb plate (Arch.), a plate serving the purpose of a curb. -- Deck curb. See under Deck.
curb roof |A roof having a double slope, or composed, on each side, of two parts which have unequal inclination; a gambrel roof.
curbless |Having no curb or restraint.
curbstone |A stone Curbstone broker.See under Broker.
curch |See Courche.
curculio |One of a large group of beetles (Rhynchophora) of many genera; -- called also weevils, snout beetles, billbeetles, and billbugs. Many of the species are very destructive, as the plum curculio, the corn, grain, and rice weevils, etc.
curculionidous |Pertaining to the Curculionide√¶, or weevil tribe.
curcuma |A genus of plants of the order Scitamine√¶, including the turmeric plant (Curcuma longa). Curcuma paper. (Chem.) See Turmeric paper, under Turmeric.
curcumin |The coloring principle of turmeric, or curcuma root, extracted as an orange yellow crystalline substance, C14H14O4, with a green fluorescence. Note: It possesses acid properties and with alkalies forms brownish salts. This change in color from yellow to brown is the characteristic reaction of tumeric paper. See Turmeric paper, under Turmeric.
curd |1. The coagulated or thickened part of milk, as distingushed from the whey, or watery part. It is eaten as food, especially when made into cheese. Curds and cream, the flower of country fare. Dryden. 2. The coagulated part of any liquid. 3. The edible flower head of certain brassicaceous plants, as the broccoli and cauliflower. Broccoli should be cut while the curd, as the flowering mass is termed, is entire. R. Thompson. Cauliflowers should be cut for use while the head, or curd, is still close and compact. F. Burr.\n\nTo cause to coagulate or thicken; to cause to congeal; to curdle. Does it curd thy blood To say I am thy mother Shak.\n\nTo become coagulated or thickened; to separate into curds and whey Shak.
curdiness |The state of being curdy.
curdle |1. To change into curd; to coagulate; as, rennet causes milk to curdle. Thomson. 2. To thicken; to congeal. Then Mary could feel her heart's blood curdle cold. Southey.\n\n1. To change into curd; to cause to coagulate. \"To curdle whites of eggs\" Boyle. 2. To congeal or thicken. My chill blood is curdled in my veins. Dryden.
curdless |Destitute of curd.
curdy |Like curd; full of curd; coagulated. \"A curdy mass.\" Arbuthnot.
cure |1. Care, heed, or attention. [Obs.] Of study took he most cure and most heed. Chaucer. Vicarages of greatcure, but small value. Fuller. 2. Spiritual charge; care of soul; the office of a parish priest or of a curate; hence, that which is committed to the charge of a parish priest or of a curate; a curacy; as, to resign a cure; to obtain a cure. The appropriator was the incumbent parson, and had the cure of the souls of the parishioners. Spelman. 3. Medical or hygienic care; remedial treatment of disease; a method of medical treatment; as, to use the water cure. 4. Act of healing or state of being healed; restoration to health from disease, or to soundness after injury. Past hope! pastcure! past help. Shak. I do cures to-day and to-morrow. Luke xii. 32. 5. Means of the removal of disease or evil; that which heals; a remedy; a restorative. Cold, hunger, prisons, ills without a cure. Dryden. The proper cure of such prejudices. Bp. Hurd.\n\n1. To heal; to restore to health, soundness, or sanity; to make well; -- said of a patient. The child was cured from that very hour. Matt. xvii. 18. 2. To subdue or remove by remedial means; to remedy; to remove; to heal; -- said of a malady. To cure this deadly grief. Shak. Then he called his twelve disciples together, and gave them power . . . to cure diseases. Luke ix. 1. 3. To set free from (something injurious or blameworthy), as from a bad habit. I never knew any man cured of inattention. Swift. 4. To prepare for preservation or permanent keeping; to preserve, as by drying, salting, etc.; as, to cure beef or fish; to cure hay.\n\n1. To pay heed; to care; to give attention. [Obs.] 2. To restore health; to effect a cure. Whose smile and frown, like to Achilles' spear, Is able with the change to kill and cure. Shak. 3. To become healed. One desperate grief cures with another's languish. Shak.\n\nA curate; a pardon.
cureall |A remedy for all diseases, o
cureless |Incapable of cure; incurable. With patience undergo A cureless ill, since fate will have it so. Dryden.
curer |1. One who cures; a healer; a physician. 2. One who prepares beef, fish, etc., for preservation by drying, salting, smoking, etc.
curette |A scoop or ring with either a blunt or a cutting edge, for removing substances from the walls of a cavity, as from the eye, ear, or womb.
curfew |1. The ringing of an evening bell, originally a signal to the inhabitants to cover fires, extinguish lights, and retire to rest, -- instituted by William the Conqueror; also, the bell itself. He begins at curfew, and walks till the first cock. Shak. The village curfew, as it tolled profound. Campbell. 2. A utensil for covering the fire. [Obs.] For pans, pots, curfews, counters and the like. Bacon.
curia |1. (Rom. Antiq.) (a) One of the thirty parts into which the Roman people were divided by Romulus. (b) The place of assembly of one of these divisions. (c) The place where the meetings of the senate were held; the senate house. 2. (Middle Ages)  The court of a sovereign or of a feudal lord; also; his residence or his household. Burrill. 3. (Law)  Any court of justice. 4. The Roman See in its temporal aspects, including all the machinery of administration; -- called also curia Romana.
curial |Of or pertaining to the papal curia; as, the curial etiquette of the Vatican. -- n.  A member of a curia, esp. of that of Rome or the later Italian sovereignties.
curialism |The wiew or doctrins of the ultramontane party in the Latin Church. Gladstone.
curialist |One who belongs to the ultramontane party in the Latin Church. Shipley.
curialistic |1. Pertaining to a court. 2. Relating or belonging to the ultramonate party in the Latin Church.
curiality |The privileges, prerogatives, or retinue of a court. [Obs.] Bacon.
curiet |A cuirass. [Obs.] Spenser.
curing |p. a. & vb. n. of Cure. Curing house, a building in which anything is cured; especially, in the West Indies, a building in which sugar is drained and dried.
curio |Any curiosity or article of virtu. The busy world, which does not hunt poets as collectors hunt for curios. F. Harrison.
curiologic |Pertaining to a rude kind of hieroglyphics, in which a thing is represented by its picture instead of by a symbol.
curiosity |1. The state or quality or being curious; nicety; accuracy; exactness; elaboration. [Obs.] Bacon. When thou wast in thy gilt and thy perfume, they mocked thee for too much curiosity. Shak. A screen accurately cut in tapiary work . . . with great curiosity. Evelin. 2. Disposition to inquire, investigate, or seek after knowledge; a desire to gratify the mind with new information or objects of interest; inquisitiveness. Milton. 3. That which is curious, or fitted to excite or reward attention. We took a ramble together to see the curiosities of this great town. Addison. There hath been practiced also a curiosity, to set a tree upon the north side of a wall, and, at a little hieght, to draw it through the wall, etc. Bacon.
curioso |A virtuoso.
curious |1. Difficult to please or satisfy; solicitous to be correct; careful; scrupulous; nice; exact. [Obs.] Little curious in her clothes. Fuller. How shall we, If he be curious, work upon his faith Bean & 2. Exhibiting care or nicety; artfully constructed; elaborate; wrought with elegance or skill. To devise curious works. Ex. xxxv. 32 His body couched in a curious bed. Shak. 3. Careful or anxious to learn; eager for knowledge; given to research or inquiry; habitually inquisitive; prying; -- sometimes with after or of. It is a picurious after things that were elegant and beatiful should not have been as curious as to their origin, their uses, and their natural history. Woodward. 4. Exciting attention or inquiry; awakening surprise; inviting and rewarding inquisitiveness; not simple or plain; strange; rare. \"Acurious tale\" Shak. A multitude of curious analogies. Mocaulay. Many a quaint and curiousvolume of forgotten lore. E. A. Poe. Abstruse investigations in recondite branches of learning or sciense often bring to light curious results. C. J. Smith. Curious arts, magic. [Obs.] Many . . . which used curious arts brought their books together, and burned them. Acts xix. 19. Syn. -- Inquisitive; prying. See Inquisitive.
curiously |In a curious manner.
curiousness |1. Carefulness; painstaking. [Obs.] My father's care With curiousness and cost did train me up. Massinger. 2. The state of being curious; exactness of workmanship; ingenuity of contrivance. 3. Inquisitiveness; curiosity.
curl |1. To twist or form into ringlets; to crisp, as the hair. But curl their locks with bodkins and with braid. Cascoigne. 2. To twist or make onto coils, as a serpent's body. Of his tortuous train, Curled many a wanton wreath in sight of Eve. Milton. 3. To deck with, or as with, curls; to ornament. Thicker than the snaky locks That curledMeg√¶ra. Milton. Curling with metaphors a plain intention. Herbert. 4. To raise in waves or undulations; to ripple. Seas would be pools without the brushing air To curl the waves. Dryden. 5. (Hat Making)  To shape (the brim) into a curve.\n\n1. To contract or bend into curis or ringlets, as hair; to grow in curls or spirals, as a vine; to be crinkled or contorted; to have a curly appearance; as, leaves lie curled on the ground. Thou seest it [hair] will not curl by nature. Shak. 2. To move in curves, spirals, or undulations; to contract in curving outlines; to bend in a curved form; to make a curl or curls. \"Cirling billows.\" Dryden. Then round her slender waist he curled. Dryden. Curling smokes from village tops are seen. Pope. Gayly curl the waves before each dashing prow. Byron. He smiled a king of sickly smile, and curled up on the floor. Bret Harte. . 358 3. To play at the game called curling. [Scot.]\n\n1. A ringlet, especially of hair; anything of a spiral or winding form. Under a coronet, his flowing hair In curls on either cheek played. Milton. 2. An undulating or waving line or streak in any substance, as wood, glass, etc.; flexure; sinuosity. If the glass of the prisms . . . be without those numberless waves or curls which usually arise from the sand holes. Sir I. Newton. 3. A disease in potatoes, in which the leaves, at their first appearance, seem curled and shrunken. Blue curls. (Bot.) See under Blue.
curled |Having curls; curly; sinuous; wavy; as, curled maple (maple having fibers which take a sinnuous course). Curled hair (Com.), the hair of the manes and tails of horses, prepared for upholstery purposes. McElrath.
curledness |State of being curled; curliness.
curler |1. One who, or that which, curls. 2. A player at the game called curling. Burns.
curlew |A wading bird of the genus Numenius, remarkable for its long, slender, curved bill. Note: The common European curlew is N. arquatus. The long-billed (N. longirostris), the Hudsonian (N. Hudsonicus), and the Eskimo curlew (N. borealis, are American species. The name is said to imitate the note of the European species. Curlew Jack (Zo√∂l.) the whimbrel or lesser curlew. -- Curlew sandpiper (Zo√∂l.), a sandpiper (Tringa ferruginea, or subarquata), common in Europe, rare in America, resembling a curlew in having a long, curved bill. See Illustation in Appendix.
curliness |State of being curly.
curling |1. The act or state of that which curls; as, the curling of smoke when it rises; the curling of a ringlet; also, the act or process of one who curls something, as hair, or the brim of hats. 2. A scottish game in which heavy weights of stone or iron are propelled by hand over the ice towards a mark. Curling . . . is an amusement of the winter, and played on the ice, by sliding from one mark to another great stones of 40 to 70 pounds weight, of a hemispherical form, with an iron or wooden handle at top. The object of the player is to lay his stone as near to the mark as possible, to guard that of his partner, which has been well laid before, or to strike off that of his antagonist. Pennant (Tour in Scotland. 1772). Curling irons, Curling tong, an instrument for curling the hair; -- commonly heated when used.
curlingly |With a curl, or curls.
curly |Curling or tending to curl; having curls; full of ripples; crinkled.
curlycue |Some thing curled or spiral,, as a flourish made with a pen on paper, or with skates on the ice; a trick; a frolicsome caper. [Sometimes written carlicue.] [ Colloq. U.S.] To cut a curlycue, to make a flourish; to cut a caper. I gave a flourishing about the room and cut a curlycue with my right foot. McClintock.
curmudgeon |An avaricious, grasping fellow; a miser; a niggard; a churl. A gray-headed curmudgeon of a negro. W. Irving.
curmudgeonly |Like a curmudgeon; niggardly; churlish; as, a curmudgeonly fellow.
curmurring |Murmuring; grumbling; -- sometimes applied to the rumbling produced by a slight attack of the gripes. [Scot.] Burns.
curr |To coo. [Scot.] The owlets hoot, the owlets curr. Wordsworth.
currant |1. A small kind of seedless raisin, imported from the Levant, chiefly from Zante and Cephalonia; -- used in cookery. 2. The acid fruit or berry of the Ribes rubrum or common red currant, or of its variety, the white currant. 3. (Bot.)  A shrub or bush of several species of the genus Ribes (a genus also including the gooseberry); esp., the Ribes rubrum. Black currant,a shrub or bush (Ribes nigrum and R. floridum) and its black, strong-flavored, tonic fruit. -- Cherry currant, a variety of the red currant, having a strong, symmetrical bush and a very large berry. -- Currant borer (Zo√∂l.), the larva of an insect that bores into the pith and kills currant bushes; specif., the larvae of a small clearwing moth (√Ügeria tipuliformis) and a longicorn beetle (Psenocerus supernotatus). -- Currant worm (Zo√∂l.), an insect larva which eats the leaves or fruit of the currant. The most injurious are the currant sawfly (Nematus ventricosus), introduced from Europe, and the spanworm (Eufitchia ribearia). The fruit worms are the larva of a fly (Epochra Canadensis), and a spanworm (Eupithecia). -- Flowering currant, Missouri currant, a species of Ribes (R. aureum), having showy yellow flowers.
currency |1. A continued or uninterrupted course or flow like that of a sream; as, the currency of time. [Obs.] Ayliffe. 2. The state or quality of being current; general acceptance or reception; a passing from person to person, or from hand to hand; circulation; as, a report has had a long or general currency; the currency of bank notes. 3. That which is in circulation, or is given and taken as having or representing value; as, the currency of a country; a specie currency; esp., government or bank notes circulating as a substitute for metallic money. 4. Fluency; readiness of utterance. [Obs.] 5. Current value; general estimation; the rate at which anything is generally valued. He . . . takes greatness of kingdoms according to their bulk and currency, and not after intrinsic value. Bacon. The bare name of Englishman . . . too often gave a transient currency to the worthless and ungrateful. W. Irving.
current |1. Running or moving rapidly. [Archaic] Like the current fire, that renneth Upon a cord. Gower. To chase a creature that was current then In these wild woods, the hart with golden horns. Tennyson. 2. Now passing, as time; as, the current month. 3. Passing from person to person, or from hand to hand; circulating through the community; generally received; common; as, a current coin; a current report; current history. That there was current money in Abraham's time is past doubt. Arbuthnot. Your fire-new stamp of honor is scarce current. Shak. His current value, which is less or more as men have occasion for him. Grew. 4. Commonly estimated or acknowledged. 5. Fitted for general acceptance or circulation; authentic; passable. O Buckingham, now do I play the touch To try if thou be current gold indeed. Shak. Account current. See under Account. -- Current money, lawful money. Abbott.\n\n1. A flowing or passing; onward motion. Hence: A body of fluid moving continuously in a certain direction; a stream; esp., the swiftest part of it; as, a current of water or of air; that which resembles a stream in motion; as, a current of electricity. Two such silver currents, when they join, Do glorify the banks that bound them in. Shak. The surface of the ocean is furrowed by currents, whose direction . . . the navigator should know. Nichol. 2. General course; ordinary procedure; progressive and connected movement; as, the current of time, of events, of opinion, etc. Current meter, an instrument for measuring the velocity, force, etc., of currents. -- Current mill, a mill driven by a current wheel. -- Current wheel, a wheel dipping into the water and driven by the current of a stream or by the ebb and flow of the tide. Syn. -- Stream; course. See Stream.
currently |In a current manner; generally; commonly; as, it is currently believed.
currentness |1. The quality of being current; currency; circulation; general reception. 2. Easiness of pronunciation; fluency. [Obs.] When currentness [combineth] with staidness, how can the language . . . sound other than most full of sweetness Camden.
curricle |1. A small or short course. Upon a curricle in this world depends a long course of the next. Sir T. Browne. 2. A two-wheeled chaise drawn by two horses abreast.
curriculum |1. A race course; a place for running. 2. A course; particularly, a specified fixed course of study, as in a university.
currie |See 2d & 3d Curry.
curried |1. Dressed by currying; cleaned; prepared. 2. Prepared with curry; as, curried rice, fowl, etc.
currier |One who curries and dresses leather, after it is tanned.
currish |Having the qualities, or exhibiting the characteristics, of a cur; snarling; quarrelsome; snappish; churlish; hence, also malicious; malignant; brutal. Thy currish spirit Governed a wolf. Shak. Some currish plot, -- some trick. Lockhart. -- Cur\"rish*ly, adv. -- Cur\"rish*ness, n.
curry |1. To dress or prepare for use by a process of scraping, cleansing, beating, smoothing, and coloring; -- said of leather. 2. To dress the hair or coat of (a horse, ox, or the like) with a currycomb and brush; to comb, as a horse, in order to make clean. Your short horse is soon curried. Beau. & FL. 3. To beat or bruise; to drub; -- said of persons. I have seen him curry a fellow's carcass handsomely. Beau. & FL. To curry favor, to seek to gain favor by flattery or attentions. See Favor, n.\n\n1. (Cookery)  A kind of sauce much used in India, containing garlic, pepper, ginger, and other strong spices. 2. A stew of fowl, fish, or game, cooked with curry. Curry powder (Cookery), a condiment used for making curry, formed of various materials, including strong spices, as pepper, ginger, garlic, coriander seed, etc.\n\nTo flavor or cook with curry.
currycomb |A kind of card or comb having rows of metallic teeth or serrated ridges, used in curryng a horse.\n\nTo comb with a currycomb.
curse |1. To call upon divine or supernatural power to send injury upon; to imprecate evil upon; to execrate. Thou shalt not . . . curse the ruler of thy people. Ex. xxii. 28. Ere sunset I'll make thee curse the deed. Shak. 2. To bring great evil upon; to be the cause of serious harm or unhappiness to; to furnish with that which will be a cause of deep trouble; to afflict or injure grievously; to harass or torment. On impious realms and barbarous kings impose Thy plagues, and curse 'em with such sons as those. Pope. To curse by bell, book, and candle. See under Bell.\n\nTo utter imprecations or curses; to affirm or deny with imprecations; to swear. Then began he to curse and to swear. Matt. xxi. 74. His spirits hear me, And yet I need must curse. Shak.\n\n1. An invocation of, or prayer for, harm or injury; malediction. Lady, you know no rules of charity, Which renders good for bad, blessings for curses. Shak. 2. Evil pronounced or invoked upon another, solemnly, or in passion; subjection to, or sentence of, divine condemnation. The priest shall write these curses in a book. Num. v. 23. Curses, like chickens, come home to roost. Old Proverb. 3. The cause of great harm, evil, or misfortune; that which brings evil or severe affliction; torment. The common curse of mankind, folly and ignorance. Shak. All that I eat, or drink, or shall beget, Is propagated curse. Milton. The curse of Scotland (Card Playing), the nine of diamonds. -- Not worth a curse. See under Cress. Syn. -- Malediction; imprecation; execration. See Malediction.
cursed |Deserving a curse; execrable; hateful; detestable; abominable. Let us fly this cursed place. Milton. This cursed quarrel be no more renewed. Dryden.
cursedly |In a cursed manner; miserably; in a manner to be detested; enormously. [Low]
cursedness |1. The state of being under a curse or of being doomed to execration or to evil. 2. Wickedness; sin; cursing. Chaucer. 3. Shrewishness. \"My wife's cursedness.\" Chaucer.
curser |One who curses.
curship |The state of being a cur; one who is currish. [Jocose] How durst he, I say, oppose thy curship! Hudibras.
cursitating |Moving about slightly. [R.] H. Bushnell.
cursitor |1. A courier or runner. [Obs.] \"Cursitors to and fro.\" Holland. 2. (Eng.Law)  An officer in the Court of Chancery, whose business is to make out original writs.
cursive |Running; flowing. Cursive hand,a running handwriting.\n\n1. A character used in cursive writing. 2. A manuscript, especially of the New Testament, written in small, connected characters or in a running hand; -- opposed to uncial. Shipley.
cursor |Any part of a mathematical instrument that moves or slides backward and forward upon another part.
cursorary |Cursory; hasty. [Obs.] With a cursorary eye o'erglanced the articles. Shak.
cursores |(a) An order of running birds including the ostrich, emu, and allies; the Ratita√¶. (b) A group of running spiders; the wolf spiders.
cursorial |(a) Adapted to running or walking, and not to prehension; as, the limbs of the horse are cursorial. See Illust. of Aves. (b) Of or pertaining to the Cursores.
cursorily |In a running or hasty manner; carelessly.
cursoriness |The quality of being cursory; superficial performance; as, cursoriness of view.
cursory |1. Running about; not stationary. [Obs.] 2. Characterized by haste; hastily or superficially performed; slight; superficial; careless. Events far too important to be treated in a cursory manner. Hallam.
curst |imp. & p.p. of Curse.\n\nFroward; malignant; mischievous; malicious; snarling. [Obs.] Though his mind Be ne'er so curst, his tonque is kind. Crashaw.
curstfully |Peevishly; vexatiously; detestably. [Obs.] \"Curstfully mad.\" Marston.
curstness |Peevishness; malignity; frowardness; crabbedness; surliness. [Obs.] Shak.
curt |Characterized by exessive brevity; short; rudely concise; as, curt limits; a curt answer. The curt, yet comprehensive reply. W. Irving.
curtail |To cut off the end or tail, or any part, of; to shorten; to abridge; to diminish; to reduce. I, that am curtailed of this fair proportion. Shak. Our incomes have been curtailed; his salary has been doubled. Macualay.\n\nThe scroll termination of any architectural member, as of a step, etc.
curtail dog |A dog with a docked tail; formerly, the dog of a person not qualified to course, which, by the forest laws, must have its tail cut short, partly as a mark, and partly from a notion that the tail is necessary to a dog in running; hence, a dog not fit for sporting. Hope is a curtail dog in some affairs. Shak.
curtailer |One who curtails.
curtailment |The act or result of curtailing or cutting off. Bancroft.
curtain |1. A hanging screen intended to darken or conceal, and admitting of being drawn back or up, and reclosed at pleasure; esp., drapery of cloth or lace hanging round a bed or at a window; in theaters, and like places, a movable screen for concealing the stage. 2. (Fort.)  That part of the rampart and parapet which is between two bastions or two gates. See Illustrations of Ravelin and Bastion. 3. (Arch.)  That part of a wall of a building which is between two pavilions, towers, etc. 4. A flag; an ensign; -- in contempt. [Obs.] Shak. Behind the curtain, in concealment; in secret. -- Curtain lecture, a querulous lecture given by a wife to her husband within the bed curtains, or in bed. Jerrold. A curtain lecture is worth all the sermons in the world for teaching the virtues of patience and long-suffering. W. Irving. -- The curtain falls, the performance closes. -- The curtain rises, the performance begins. -- To draw the curtain, to close ot over an object, or to remove it; hence: (a) To hide or to disclose an object. (b) To commence or close a performance. -- To drop the curtain, to end the tale, or close the performance.\n\nTo inclose as with curtains; to furnish with curtains. So when the sun in bed Curtained with cloudy red. Milton.
curtal |Curt; brief; laconic. Essays and curtal aphorisms. Milton. Curtal dog. See Curtail dog.\n\nA horse with a docked tail; hence, anything cut short. [Obs] Nares.
curtal ax |A corruption of Cutlass.
curtal friar |A friar who acted as porter at the gate of a monastery. Sir W. Scott.
curtana |The pointless sword carried before English monarchs at their coronation, and emblematically considered as the sword of mercy; -- also called the sword of Edward the Confessor.
curtate |Shortened or reduced; -- said of the distance of a planet from the sun or earth, as measured in the plane of the ecliptic, or the distance from the sun or earth to that point where a perpendicular, let fall from the planet upon the plane of the ecliptic, meets the ecliptic. Curtate cycloid. (Math.) See Cycloid.
curtation |The interval by which the curtate distance of a planet is less than the true distance.
curtein |Same as Curtana.
curtelasse |A corruption of Cutlass.
curtes |Courteous. [Obs.] Chaucer.
curtesy |the life estate which a husband has in the lands of his deceased wife, which by the common law takes effect where he has had issue by her, born alive, and capable of inheriting the lands. Mozley & W.
curtilage |A yard, courtyard, or piece of ground, included within the fence surrounding a dwelling house. Burrill.
curtle ax |A corruption of Cutlass.
curtly |In a curt manner.
curtness |The quality of bing curt.
curtsy |Same as Courtesy, an act of respect.
curule |1. Of or pertaining to a charoit. 2. (Rom. Antiq.)  Of or pertaining to a kind of chair appropriated to Roman magistrates and dignitaries; pertaining to, having, or conferring, the right to sit in the curule chair; hence, official. Note: The curule chair was usually shaped like a camp stool, and provided with curved legs. It was at first ornamented with ivory, and later sometimes made of ivory and inlaid with gold. Curule dignity right of sitting in the curule chair.
cururo |A Chilian burrowing rodent of the genus Spalacopus.
curval |Bowed; bent; curved.
curvant |Bowed; bent; curved.
curvate |Bent in a regular form; curved.
curvated |Bent in a regular form; curved.
curvation |The act of bending or crooking.
curvative |Having the margins only a little curved; -- said of leaves. Henslow.
curvature |1. The act of curving, or the state of being bent or curved; a curving or bending, normal or abnormal, as of a line or surface from a rectilinear direction; a bend; a curve. Cowper. The elegant curvature of their fronds. Darwin. 2. (Math.)  The amount of degree of bending of a mathematical curve, or the tendency at any point to depart from a tangent drawn to the curve at that point. Aberrancy of curvature (Geom.), the deviation of a curve from a curcular form. -Absolute curvature. See under Absolute. -- Angle of curvature (Geom.), one that expresses the amount of curvature of a curve. -- Chord of curvature. See under Chord. -- Circle of curvature. See Osculating circle of a curve, under Circle. -- Curvature of the spine (Med.), an abnormal curving of the spine, especially in a lateral direction. -- Radius of curvature, the radius of the circle of curvature, or osculatory circle, at any point of a curve.
curve |Bent without angles; crooked; curved; as, a curve line; a curve surface.\n\n1. A bending without angles; that wcich is bent; a flexure; as, a curve in a railway or canal. 2. (Geom.)  A line described according to some low, and having no finite portion of it a straight line. Axis of a curve. See under Axis. -- Curve of quickest descent. See Brachystochrone. -- Curve tracing (Math.), the process of determining the shape, location, singular points, and other perculiarities of a curve from its equation. -- Plane curve (Geom.), a curve such that when a plane passes through three points of the curve, it passes through all the other points of the curve. Any other curve is called a curve of double curvature, or a twisted curve.\n\nTo bend; to crook; as, to curve a line; to curve a pipe; to cause to swerve from a straight course; as, to curve a ball in pitching it.\n\nTo bend or turn gradually from a given direction; as, the road curves to the right.
curvedness |The state of being curved.
curvet |1. (Man.)  A particular leap of a horse, when he raises both his fore legs at once, equally advanced, and, as his fore legs are falling, raises his hind legs, so that all his legs are in the air at once. 2. A prank; a frolic.\n\n1. To make a curvet; to leap; to bound. 'Oft and high he did curvet.\" Drayton. 2. To leap and frisk; to frolic. Shak.\n\nTo cause to curvet. Landor.
curvicaudate |Having a curved or crooked tail.
curvicostate |Having bent ribs.
curvidentate |Having curved teeth.
curviform |Having a curved form.
curvilinead |An instrument for drawing curved lines.
curvilineal |Consisting of, or bounded by, curved lines; as, a curvilinear figure.
curvilinear |Consisting of, or bounded by, curved lines; as, a curvilinear figure.
curvilinearity |The state of being curvilinear or of being bounded by curved lines.
curvilinearly |In a curvilinear manner.
curvinerved |Having the ribs or the veins of the leaves curved; -- called also curvinervate and curve-veined.
curvirostral |Having a crooked beak, as the crossbill.
curvirostres |A group of passerine birds, including the creepers and nuthatches.
curviserial |Distributed in a curved line, as leaves along a stem.
curvity |The state of being curved; a bending in a regular form; crookedness. Holder.
curvograph |An arcograph.
cuscus |A soft grass (Pennisetum typhoideum) found in all tropical regions, used as food for men and cattle in Central Africa.
cuscus oil |Same as Vetiver oil.
cushat |The ringdove or wood pigeon. Scarce with cushat's homely song can vie. Sir W. Scott.
cushewbird |The galeated curassow. See Curassow.
cushion |1. A case or bag stuffed with some soft and elastic material, and used to sit or recline upon; a soft pillow or pad. Two cushions stuffed with straw, the seat to raise. Dryden. 2. Anything resembling a cushion in properties or use; as: (a) a pad on which gilders cut gold leaf; (b) a mass of steam in the end of the cylinder of a steam engine to receive the impact of the piston; (c) the elastic edge of a billiard table. 3. A riotous kind of dance, formerly common at weddings; -- called also cushion dance. Halliwell. Cushion capital.(Arch.) A capital so sculptured as to appear like a cushion pressed down by the weight of its entablature. (b) A name given to a form of capital, much used in the Romanesque style, modeled like a bowl, the upper part of which is cut away on four sides, leaving vertical faces. -- Cushion star (Zo√∂l.) a pentagonal starfish belonging to Goniaster, Astrogonium, and other allied genera; -- so called from its form.\n\n1. To seat or place on, or as on a cushion. Many who are cushioned on thrones would have remained in obscurity. Bolingbroke. 2. To furnish with cushions; as, to cushion a chaise. 3. To conceal or cover up, as under a cushion. Cushioned hammer, a dead-stroke hammer. See under Dead-stroke.
cushion tire |A thick solid-rubber tire, as for a bicycle, with a hollow groove running lengthwise on the inside.
cushionet |A little cushion.
cushionless |Hot furnished with a cushion. Rows of long, cushionless benches, supplying the place of pews. Hawthorne.
cushiony |Like a cushion; soft; pliable. A flat and cushiony noce. Dickens.
cushite |A descendant of Cush, the son of Ham and grandson of Noah.
cusk |A large, edible, marine fish (Brosmius brosme), allied to the cod, common on the northern coasts of Europe and America; -- called also tusk and torsk.
cuskin |A kind of drinking cup. [Obs.]
cusp |1. (Arch.)  A triangular protection from the intrados of an arch, or from an inner curve of tracery. 2. (Astrol.)  The beginning or first entrance of any house in the calculations of nativities, etc. 3. (Astron)  The point or horn of the crescent moon or other crescent-shaped luminary. 4. (Math.)  A multiple point of a curve at which two or more branches of the curve have a common tangent. 5. (Anat.)  A prominence or point, especially on the crown of a tooth. 6. (Bot.)  A sharp and rigid point.\n\nTo furnish with a cusp or cusps.
cuspated |Ending in a point.
cuspid |One of the canine teeth; -- so called from having but one point or cusp on the crown. See Tooth.
cuspidal |Ending in a point.
cuspidate |To make pointed or sharp.\n\nHaving a sharp end, like the point of a spear; terminating in a hard point; as, a cuspidate leaf.
cuspidated |Having a sharp end, like the point of a spear; terminating in a hard point; as, a cuspidate leaf.
cuspidor |Any ornamental vessel used as a spittoon; hence, to avoid the common term, a spittoon of any sort.
cuspis |A point; a sharp end.
cussedness |Disposition to willful wrongdoing; malignity; perversity; cantankerousness; obstinacy. [Slang or Colloq., U. S.] In her opinion it was all pure \"cussedness.\" Mrs. Humphry Ward. Disputatiousness and perversity (what the Americans call \"cussedness\"). James Bryce.
custard |A mixture of milk and eggs, sweetened, and baked or boiled. Custard apple (Bot.), a low tree or shrub of tropical America, including several species of Anona (A. squamosa, reticulata, etc.), having a roundish or ovate fruit the size of a small orange, containing a soft, yellowish, edible pulp. -- Custard coffin, pastry, or crust, which covers or coffins a custard [Obs.] Shak.
custode |See Custodian.
custodial |Relating to custody or guardianship.
custodian |One who has care or custody, as of some public building; a keeper or superintendent.
custodianship |Office or duty of a custodian.
custodier |A custodian. [Scot.] Sir W. Scott.
custody |1. A keeping or guarding; care, watch, inspection, for keeping, preservation, or security. A fleet of thirty ships for the custody of the narrow seas. Bacon. 2. Judicial or penal safe-keeping. Jailer, take him to thy custody. Shak. 3. State of being guarded and watched to prevent escape; restraint of liberty; confinement; imprisonment. What pease will be given To us enslaved, but custody severe, And stripes and arbitrary punishment Milton.
custom |1. Frequent repetition of the same act; way of acting common to many; ordinary manner; habitual practice; usage; method of doing or living. And teach customs which are not lawful. Acts xvi. 21. Moved beyong his custom, Gama said. Tennyson. A custom More honored in the breach than the observance. Shak. 2. Habitual buying of goods; practice of frequenting, as a shop, manufactory, etc., for making purchases or giving orders; business support. Let him have your custom, but not your votes. Addison. 3. (Law)  Long-established practice, considered as unwritten law, and resting for authority on long consent; usage. See Usage, and Prescription. Note: Usage is a fact. Custom is a law. There can be no custom without usage, though there may be usage without custom. Wharton. 4. Familiar aquaintance; familiarity. [Obs.] Age can not wither her, nor custom stale Her infinite variety. Shak. Custom of merchants, a system or code of customs by which affairs of commerce are regulated. -- General customs, those which extend over a state or kingdom. -- Particular customs, those which are limited to a city or district; as, the customs of London. Syn. -- Practice; fashion. See Habit, and Usage.\n\n1. To make familiar; to accustom. [Obs.] Gray. 2. To supply with customers. [Obs.] Bacon.\n\nTo have a custom. [Obs.] On a bridge he custometh to fight. Spenser.\n\n1 the customary toll,tax, or tribute. Render, therefore, to all their dues: tribute to whom tribute is due; custom to whom custom. Rom. xiii. 7. 2. pl.  Duties or tolls imposed by law on commodities, imported or exported.\n\nTo pay the customs of. [Obs.] Marlowe.
customable |1. Customary. [Obs.] Sir T. More. 2. Subject to the payment of customs; dutiable.
customableness |Quality of being customable; conformity to custom. [Obs.]
customably |Usually. [Obs.] Milton.
customarily |In a customary manner; habitually.
customariness |Quality of being customary.
customary |1. Agreeing with, or established by, custom; established by common usage; conventional; habitual. Even now I met him With customary compliment. Shak. A formal customary attendance upon the offices. South. 2. (Law)  Holding or held by custom; as, customary tenants; customary service or estate.\n\nA book containing laws and usages, or customs; as, the Customary of the Normans. Cowell.
customer |1. One who collect customs; a toll gatherer. [Obs.] The customers of the small or petty custom and of the subsidy do demand of them custom for kersey cloths. Hakluyt. 2. One who regularly or repeatedly makes purchases of a trader; a purchaser; a buyer. He has got at last the character of a good customer; by this means he gets credit for something considerable, and then never pays for it. Goldsmith. 3. A person with whom a business house has dealings; as, the customers of a bank. J. A. H. Murray. 4. A peculiar person; -- in an indefinite sense; as, a queer customer; an ugly customer. [Colloq.] Dickens. 5. A lewd woman. [Obs.] Shak.
customhouse |The building where customs and duties are paid, and where vessels are entered or cleared. Customhouse broker, an agent who acts for merchants in the business of entering and clearing goods and vessels.
custos |A keeper; a custodian; a superintendent. [Obs.] Custos rotulorum (r Etym: [LL., keeper of the rolls] (Eng. Law), the principal justice of the peace in a county, who is also keeper of the rolls and records of the sessions of the peace.
custrel |An armor-bearer to a knight. [Obs.]\n\nSee Costrel. [Obs.] Ainsworth.
custumary |See Customary. [Obs.]
cut |1. To sparate the parts of with, or as with, a sharp instrument; to make an incision in; to gash; to sever; to divide. You must cut this flesh from off his breast. Shak. Before the whistling winds the vessels fly, With rapid swiftness cut the liquid way. Pope. 2. To sever and cause to fall for the purpose of gathering; to hew; to mow or reap. Thy servants can skill to cut timer. 2. Chron. ii. 8 3. To sever and remove by cutting; to cut off; to dock; as, to cut the hair; to cut the nails. 4. To castrate or geld; as, to cut a horse. 5. To form or shape by cutting; to make by incision, hewing, etc.; to carve; to hew out. Why should a man. whose blood is warm within, Sit like his grandsire cut in alabaster Shak. Loopholes cut through thickest shade. Milton. 6. To wound or hurt deeply the snsibilities of; to pierce; to lacerate; as, sarcasm cuts to the quick. The man was cut to the heart. Addison. 7. To intersect; to cross; as, one line cuts another at right angles. 8. To refuse to recognize; to ignorre; as, to cut a person in the street; to cut one's acquaintance. [Colloq.] 9. To absent one's self from; as, to cut an appointment, a recitation. etc. [Colloq.] An English tradesman is always solicitous to cut the shop whenever he can do so with impunity. Thomas Hamilton. To cut a caper. See under Caper. -- To cut the cards, to divide a pack of cards into portions, in order to determine the deal or the trump, or to change the cards to be dealt. -- To cut a dash or a figure, to make a display. [Colloq.] -- To cut down. (a) To sever and cause to fall; to fell; to prostrate. \"Timber . . . cut down in the mountains of Cilicia.\" Knolles. (b) To put down; to abash; to humble, [Obs] \"So great is his natural eloquence, that he cuts doun the finest orator.\" Addison (c) To lessen; to retrench; to curtail; as, to cut down expenses. (d) (Naut.) To raze; as, to cut down a frigate into a sloop. -- To cut the knot or the Gordian knot, to dispose of a difficulty summarily; to solve it by prompt, arbitrary action, rather than by skill or patience. -- To cut lots, to determine lots by cuttings cards; to draw lots. -- To cut off. (a) To sever; to separate. I would to God, . . . The king had cut off my brother's. Shak. (b) To put an untimely death; to put an end to; to destroy. \"Irencut off by martyrdom.\" Addison. (c) To interrupt; as, to cut off communication; to cut off (the flow of) steam from (the boiler to) a steam engine. (d) To intercept; as,, to cut off an enemy's retreat. (e) To end; to finish; as, to cut off further debate. -- To cut out. (a) To remove by cutting or carving; as, to cut out a piece from a board. (b) To shape or form by cutting; as, to cut out a garment. \" A large forest cut out into walks.\" Addison. (c) To scheme; to contrive; to prepare; as, to cut out work for another day. \"Every man had cut out a place for himself.\" Addison. (d) To step in and take the place of; to supplant; as, to cut out a rival. [Colloq.] (e) To debar. \"I am cut out from anything but common acknowledgments.\" Pope. (f) To seize and carry off (a vessel) from a harbor, or from under the guns of an enemy. -- To cut to pieces. (a) To cut into pieces; as, to cut cloth to pieces. (b) To slaughter; as, to cut an army to pieces. -- To cut a play (Drama), to shorten it by leaving out passages, to adapt it for the stage. -- To cut rates (Railroads, etc.), to reduce the charges for transportation below the rates established between competing lines. -- To cut short, to arrest or check abruptly; to bring to a sudden termination. \"Achilles cut him short, and thus replied.\" Dryden. -- To cut stick, to make off clandestinely or precipitately. [Slang] -- To cut teeth, to put forth teeth; to have the teeth pierce through the gum and appear. -- To have cut one's eyeteeth, to be sharp and knowing. [Colloq.] -- To cut one's wisdom teeth, to come to years of discretion. -- To cut under, to undersell; as, to cut under a competitor in trade. -- To cut up. (a) To cut to pieces; as, to cut up an animal, or bushes. (b) To damage or destroy; to injure; to wound; as, to cut up a book or its author by severe criticism. \"This doctrine cuts up all government by the roots.\" Locke. (c) To afflict; to discourage; to demoralize; as, the death of his friend cut him up terribly. [Colloq.] Thackeray.\n\n1. To do the work of an edged tool; to serve in dividing or gashing; as, a knife cuts well. 2. To admit of incision or severance; to yield to a cutting instrument. Panels of white wood that cuts like cheese. Holmes. 3. To perform the operation of dividing, severing, incising, intersecting, etc.; to use a cutting instrument. He saved the lives of thousands by manner of cutting for the stone. Pope. 4. To make a stroke with a whip. 5. To interfere, as a horse. 6. To move or make off quickly. [Colloq.] 7. To divide a pack of cards into two portion to decide the deal or trump, or to schange the order of the cards to be dealt. To cut across, to pass over or through in the most direct way; as, to cut across a field. -- To cut and run, to make off suddenly and quickly; -- from the cutting of a ship's cable, when there is not time to raise the anchor. [Colloq.] -- To cut in or into, to interrupt; to jont an anything suddenly. -- To cut up. (a) To play pranks. [Colloq.] (b) To divide into portions well or ill; to have the property left at one's death turn out well or poorly when divided among heirs, legatees, etc. [Slang.] \"When I die, may I cut up as well as Morgan Pendennis.\" Thackeray.\n\n1. An opening made with an edged instrument; a cleft; a gash; a slash; a wound made by cutting; as, a sword cut. 2. A stroke or blow or cutting motion with an edged instrument; a stroke or blow with a whip. 3. That which wounds the feelings, as a harsh remark or criticism, or a sarcasm; personal discourtesy, as neglecting to recognize an acquaintance when meeting him; a slight. Rip called him by name, but the cur snarled, snapped his teeth, and passed on. This was an unkind cut indeed. W. Irving. 4. A notch, passage, or channel made by cutting or digging; a furrow; a groove; as, a cut for a railroad. This great cut or ditch Secostris . . . purposed to have made a great deal wider and deeper. Knolles. 5. The surface left by a cut; as, a smooth or clear cut. 6. A portion severed or cut off; a division; as, a cut of beef; a cut of timber. It should be understood, moreover, . . . that the group are not arbitrary cuts, but natural groups or types. Dana. 7. An engraved block or plate; the impression from such an engraving; as, a book illustrated with fine cuts. 8. (a) The act of dividing a pack cards. (b) The right to divide; as, whose cut is it 9. Manner in which a thing is cut or formed; shape; style; fashion; as, the cut of a garment. With eyes severe and beard of formal cut. Shak. 10. A common work horse; a gelding. [Obs.] He'll buy me a cut, forth for to ride. Beau. & Fl. 11. The failure of a college officer or student to be present at any appointed exercise. [College Cant] 12. A skein of yarn. Wright. A cut in rates (Railroad), a reduction in fare, freight charges, etc., below the established rates. -- A short cut, a cross route which shortens the way and cuts off a circuitous passage. -- The cut of one's jib, the general appearance of a person. [Colloq.] -- To draw cuts, to draw lots, as of paper, etc., cut unequal lengths. Now draweth cut . . . The which that hath the shortest shall begin. Chaucer.\n\n1. Gashed or divided, as by a cutting instrument. 2. Formed or shaped as by cuttting; carved. 3. Overcome by liquor; tipsy. [Slang] Cut and dried, prepered beforehand; not spontaneous. -- Cut glass, glass having a surface ground and polished in facets or figures. -- Cut nail, a nail cut by machinery from a rolled plate of iron, in distinction from a wrought nail. -- Cut stone, stone hewn or chiseled to shape after having been split from the quarry.
cut-off |1. That which cuts off or shortens, as a nearer passage or road. 2. (Mach.) (a) The valve gearing or mechanism by which steam is cut off from entering the cylinder of a steam engine after a definite point in a stroke, so as to allow the remainder of the stroke to be made by the expansive force of the steam already let in. See Expansion gear, under Expansion. (b) Any device for stopping or changing a current, as of grain or water in a spout.
cut-out |(a) (Telegraphy) A species of switch for changing the current from one circuit to another, or for shortening a circuit. (b) (Elec.) A divice for breaking or separating a portion of circuit.
cutaneous |Of pertaining to the skin; existing on, or affecting, the skin; as, a cutaneous disease; cutaneous absorption; cutaneous respiration.
cutaway |Having a part cut off or away; having the corners rounded or cut away. Cutaway coat, a coat whose skirts are cut away in front so as not to meet at the bottom.
cutch |See Catechu.\n\nSee Cultch.
cutchery |A hindoo hall of justice. Malcom.
cute |Clever; sharp; shrewd; ingenious; cunning. [Colloq.]
cuteness |Acuteness; cunning. [Colloq.]
cutgrass |A grass with leaves having edges furnished with very minute hooked prickles, which form a cutting edge; one or more species of Leersia.
cuticle |1. (Anat.)  The scarfskin or epidermis. See Skin. 2. (Bot.)  The outermost skin or pellicle of a plant, found especially in leaves and young stems. 3. A thin skin formed on the surface of a liquid.
cuticular |Pertaining to the cuticle, or external coat of the skin; epidermal.
cutin |The substance which, added to the material of a cell wall, makes it waterproof, as in cork.
cutinization |The conversion of cell walls into a material which repels water, as in cork.
cutinize |To change into cutin.
cutis |See Dermis.
cutlass |A short, heavy, curving sword, used in the navy. See Curtal ax. Cutlass fish, (Zo√∂l.), a peculiar, long, thin, marine fish (Trichirus lepturus) of the southern United States and West Indies; -- called also saber fish, silver eel, and, improperly, swordfish.
cutler |One who makes or deals in cutlery, or knives and other cutting instruments.
cutlery |1. The business of a cutler. 2. Edged or cutting instruments, collectively.
cutlet |A piece of meat, especially of veal or mutton, cut for broiling.
cutling |The art of making edged tools or cutlery. [Obs.] Milton.
cutose |A variety of cellulose, occuring as a fine transparent membrane covering the aerial organs of plants, and forming an essential ingredient of cork; by oxidation it passes to suberic acid.
cutpurse |One who cuts purses for the sake of stealing them or their contents (an act common when men wore purses fastened by a string to their girdles); one who steals from the person; a pickpocket To have an open ear, a quick eye, and a nimble hand, is necessary for a cutpurse. Shak.
cutter |1. One who cuts; as, a stone cutter; a die cutter; esp., one who cuts out garments. 2. That which cuts; a machine or part of a machine, or a tool or instrument used for cutting, as that part of a mower which severs the stalk, or as a paper cutter. 3. A fore tooth; an incisor. Ray. 4. (Naut.) (a) A boat used by ships of war. (b) A fast sailing vessel with one mast, rigged in most essentials like a sloop. A cutter is narrower end deeper than a sloop of the same length, and depends for stability on a deep keel, often heavily weighted with lead. (c) A small armed vessel, usually a steamer, in the revenue marine service; -- also called revenue cutter. 5. A small, light one-horse sleigh. 6. An officer in the exchequer who notes by cutting on the tallies the sums paid. 7. A ruffian; a bravo; a destroyer. [Obs.] 8. A kind of soft yellow brick, used for facework; -- so called from the facility with which it can be cut. Cutter bar.(Mach.) (a) A bar which carries a cutter or cutting tool, as in a boring machine. (b) The bar to which the triangular knives of a harvester are attached. -- Cutter head (Mach.), a rotating head, which itself forms a cutter, or a rotating stock to which cutters may be attached, as in a planing or matching machine. Knight.
cutthroat |One who cuts throats; a murderer; an assassin.\n\nMurderous; cruel; barbarous.
cutting |1. The act or process of making an incision, or of severing, felling, shaping, etc. 2. Something cut, cut off, or cut out, as a twig or\n\n1. Adapted to cut; as, a cutting tool. 2. Chilling; penetratinn; sharp; as, a cutting wind. 3. Severe; sarcastic; biting; as, a cutting reply.
cuttingly |In a cutting manner.
cuttle |A knife. [Obs.] Bale.\n\n1. (Zo√∂l.)  A cephalopod of the genus Sepia, having an internal shell, large eyes, and ten arms furnished with denticulated suckers, by means of which it secures its prey. The name is sometimes applied to dibranchiate cephalopods generally. Note: It has an ink bag, opening into the siphon, from which, when pursued, it throws out a dark liquid that clouds the water, enabling it to escape observation. 2. A foul-mouthed fellow. \"An you play the saucy cuttle me.\" Shak.
cuttle bone |The shell or bone of cuttlefishes, used for various purposes, as for making polishing powder, etc.
cuttlefish |1. (Zo√∂l.)  A cephalopod of the genus Sepia, having an internal shell, large eyes, and ten arms furnished with denticulated suckers, by means of which it secures its prey. The name is sometimes applied to dibranchiate cephalopods generally. Note: It has an ink bag, opening into the siphon, from which, when pursued, it throws out a dark liquid that clouds the water, enabling it to escape observation. 2. A foul-mouthed fellow. \"An you play the saucy cuttle me.\" Shak.
cuttoo plate |A hood over the end of a wagon wheel hub to keep dirt away from the axle.
cutty |Short; as, a cutty knife; a cutty sark. [Scot.]\n\n1. A short spoon. 2. A short tobacco pipe. Ramsay. 3. A light or unchaste woman. Sir W. Scott.
cuttystool |1. A low stool [Scot.] 2. A seat in old Scottish churches, where offenders were made to sit, for public rebuke by the minister.
cutwal |The chief police officer of a large city. [East Indies]
cutwater |1. The fore part of a ship's prow, which cuts the water. 2. A starling or other structure attached to the pier of a birdge, with an angle or edge directed up stream, in order better to resist the action of water, ice, etc.; the sharpened upper end of the pier itself. 3. (Zo√∂l.)  A sea bird of the Atlantic (Rhynchops nigra); -- called also black skimmer, scissorsbill, and razorbill. See Skimmer.
cutwork |An ancient term for embroidery, esp. applied to the earliest form of lace, or to that early embroidery on linen and the like, from which the manufacture of lace was developed.
cutworm |A caterpillar which at night eats off young plants of cabbage, corn, etc., usually at the ground. Some kinds ascend fruit trees and eat off the flower buds. During the day, they conceal themselves in the earth. The common cutworms are the larv√¶ of various species of Agrotis and related genera of noctuid moths.
cuvette |1. A pot, bucket, or basin, in which molten plate glass is carried from the melting pot to the casting table. 2. (Fort.)  A cunette. 3. (Spectrometry) (Analytical chemistry)  A small vessel with at least two flat and transparent sides, used to hold a liquid sample to be analysed in the light path of a spectrometer. Note: The shape and materials vary; for ultraviolet spectrometry, quartz is typically used. For visible-light spectrometry, plastic cuvettes may be employed. Occasionally, small vessels used for other laboratory purposes are called cuvettes. cuvette holder, (Spectrometry) A small device used to hold one or more cuvettes[3], shaped specifically to fit in the sample chamber of a particular type of spectrometer, with openings to permit light to pass through the holder and the cuvettes, and designed so as to hold the cuvette accurately and reproducibly within the light path of the spectrometer. For cuvettes with a square horizontal cross-section, the compartments will have a corresponding square cross-section, usu. slightly larger than the cuvette.
cyamelide |A white amorphous substance, regarded as a polymeric modification of isocyanic acid.
cyamellone |A complex derivative of cyanogen, regarded as an acid, and known chiefly in its salts; -- called also hydromellonic acid.
cyanate |A salt of cyanic acid. Ammonium cyanate (Chem.), a remarkable white crystalline substance, NH4.O.CN, which passes, on standing, to the organic compound, urea, CO.(NH)2.
cyanaurate |See Aurocyanide.
cyanean |Having an azure color. Pennant.
cyanic |1. Pertaining to, or containing, cyanogen. 2. Of or pertaining to a blue color. Cyanic acid (Chem.), an acid, HOCN, derived from cyanogen, well known in its salts, but never isolated in the free state. -- Cyanic colors (Bot.), those colors (of flowers) having some tinge of blue; -- opposed to xanthic colors. A color of either series may pass into red or white, but not into the opposing color. Red and pure white are more common among flowers of cyanic tendency than in those of the other class.
cyanide |A compound formed by the union of cyanogen with an element or radical.
cyanin |The blue coloring matter of flowers; -- called also anthokyan and anthocyanin.
cyanine |One of a series of artificial blue or red dyes obtained from quinoline and lepidine and used in calico printing.
cyanite |A mineral occuring in thin-bladed crystals and crystalline aggregates, of a sky-blue color. It is a silicate of aluminium. [Written also kyanite.]
cyanogen |A colorless, inflammable, poisonous gas, C2N2, with a peach- blossom odor, so called from its tendency to form blue compounds; obtained by heating ammonium oxalate, mercuric cyanide, etc. It is obtained in combination, forming an alkaline cyanide when nitrogen or a nitrogenous compound is strongly ignited with carbon and soda or potash. It conducts itself like a member of the halogen group of elements, and shows a tendency to form complex compounds. The name is also applied to the univalent radical, CN (the half molecule of cyanogen proper), which was one of the first compound radicals recognized. Note: Cyanogen is found in the commercial substances, potassium cyanide, or prussiate of potash, yellow prussiate of potash, Prussian blue, Turnbull's blue, prussic acid, etc.
cyanometer |An instrument for measuring degress of blueness.
cyanopathy |A disease in which the body is colored blue in its surface, arising usually from a malformation of the heart, which causes an imperfect arterialization of the blood; blue jaundice.
cyanophyll |A blue coloring matter supposed by some to be one of the component parts ofchlorophyll.
cyanosed |Rendered blue, as the surface of the body, from cyanosis or deficient a
cyanosis |A condition in which, from insufficient aCyanopathy.
cyanosite |Native sulphate of copper. Cf. Blue vitriol, under Blue.
cyanotic |Relating to cyanosis; affected with cyanosis; as, a cyanotic patient; having the hue caused by cyanosis; as, a cyanitic skin.
cyanotype |A photographic picture obtained by the use of a cyanide.
cyanurate |A salt of cyanuric acid.
cyanuret |A cyanide. [Obs.]
cyanuric |Pertaining to, or derived from, cyanic and uric acids.
cyanuric acid |an organic acid, C3O3N3H3, first obtained by heating uric acid or urea, and called pyrouric acid; afterwards obtained from isocyanic acid. It is a white crystalline substance, odorless and almost tasteless; -- called also tricarbimide.
cyathiform |In the form of a cup, a little widened at the top.
cyatholith |A kind of coccolith, which in shape resembles a minute cup widened at the top, and varies in size from
cyathophylloid |Like, or pertaining to, the family Cyathophyllid√¶.\n\nA fossil coral of the family Cyathophyllid√¶; sometimes extended to fossil corals of other related families belonging to the group Rugosa; -- also called cup corals. Thay are found in paleozoic rocks.
cycad |Any plant of the natural order Cycadece√¶, as the sago palm, etc.
cycadaceous |Pertaining to, or resembling, an order of plants like the palms, but having exogenous wood. The sago palm is an example.
cycas |A genus of trees, intermediate in character between the palms and the pines. The pith of the trunk of some species furnishes a valuable kind of sago.
cyclamen |A genus of plants of the Primrose family, having depressed rounded corms, and pretty nodding flowers with the petals so reflexed as to point upwards, whence it is called rabbit's ears. It is also called sow bread, because hogs are said to eat the corms.
cyclamin |A white amorphous substance, regarded as a glucoside, extracted from the corm of Cyclamen Europ√¶um.
cyclas |A long gown or surcoat (cut off in front), worn in the Middle Ages. It was sometimes embroidered or interwoven with gold. Also, a rich stuff from which the gown was made.
cycle |1. An imaginary circle or orbit in the heavens; one of the celestial spheres. Milton. 2. An interval of time in which a certain succession of events or phenomena is completed, and then returns again and again, uniformly and continually in the same order; a periodical space of time marked by the recurrence of something peculiar; as, the cucle of the seasons, or of the year. Wages . . . bear a full proportion . . . to the medium of provision during the last bad cycle of twenty years. Burke. 3. An age; a long period of time. Better fifty years of Europe than a cycle of Cathay. Tennyson. 4. An orderly list for a given time; a calendar. [Obs.] We . . . present our gardeners with a complete cycle of what is requisite to be done throughout every month of the year. Evelyn. 5. The circle of subjects connected with the exploits of the hero or heroes of some particular period which have severed as a popular theme for poetry, as the legend aof Arthur and the knights of the Round Table, and that of Charlemagne and his paladins. 6. (Bot.)  One entire round in a circle or a spire; as, a cycle or set of leaves. Gray. 7. A bicycle or tricycle, or other light velocipede. Calippic cycle, a period of 76 years, or four Metonic cycles; -- so called from Calippus, who proposed it as an improvement on the Metonic cycle. -- Cycle of eclipses, a priod of about 6,586 days, the time of revolution of the moon's node; -- called Saros by the Chaldeans. -- Cycle of indiction, a period of 15 years, employed in Roman and ecclesiastical chronology, not founded on any astronomical period, but having reference to certain judicial acts which took place at stated epochs under the Greek emperors. -- Cycle of the moon, or Metonic cycle, a period of 19 years, after the lapse of which the new and full moon returns to the same day of the year; -- so called from Meton, who first proposed it. -- Cycle of the sun, Solar cycle, a period of 28 years, at the end of which time the days of the month return to the same days of the week. The dominical or Sunday letter follows the same order; hence the solar cycle is also called the cycle of the Sunday letter. In the Gregorian calendar the solar cycle is in general interrupted at the end of the century.\n\n1. To pass through a cycle of changes; to recur in cycles. Tennyson. Darwin. 2. To ride a bicycle, tricycle, or other form of cycle.
cyclic |Of or pertaining to a cycle or circle; moving in cycles; as, cyclical time. Coleridge. Cyclic chorus, the chorus which performed the songs and dances of the dithyrambic odes at Athens, dancing round the altar of Bacchus in a circle. -- Cyclic poets, certain epic poets who followed Homer, and wrote merely on the Trojan war and its heroes; -- so called because keeping within the circle of a singe subject. Also, any series or coterie of poets writing on one subject. Milman.
cyclical |Of or pertaining to a cycle or circle; moving in cycles; as, cyclical time. Coleridge. Cyclic chorus, the chorus which performed the songs and dances of the dithyrambic odes at Athens, dancing round the altar of Bacchus in a circle. -- Cyclic poets, certain epic poets who followed Homer, and wrote merely on the Trojan war and its heroes; -- so called because keeping within the circle of a singe subject. Also, any series or coterie of poets writing on one subject. Milman.
cyclide |A surface of the fourth degree, having certain special relations to spherical surfaces. The tore or anchor ring is one of the cyclides.
cycling |The act, art, or practice, of riding a cycle, esp. a bicycle or tricycle.
cyclist |A cycler.
cyclo- |A combining form meaning circular, of a circle or wheel.
cyclobranchiate |Having the gills around the margin of the body, as certain limpets.
cycloganoid |Of or pertaining to the Cycloganoidei.\n\nOne of the Cycloganoidei.
cycloganoidei |An order of ganoid fishes, having cycloid scales. The bowfin (Amia calva) is a living example.
cyclograph |See Arcograph.
cycloid |A curve generated by a point in the plane of a circle when the circle is rolled along a straight line, keeping always in the same plane. Note: The common cycloid is the curve described when the generating point (p) is on the circumference of the generating circle; the curtate cycloid, when that point lies without the circumference; the prolate or inflected cycloid, when the generating point (p) lies within that circumference.\n\nOf or pertaining to the Cycloidei. Cycloid scale (Zo√∂l.), a fish scale which is thin and shows concentric lines of growth, without serrations on the margin.\n\nOne of the Cycloidei.
cycloidal |Pertaining to, or resembling, a cycloid; as, the cycloidal space is the space contained between a cycloid and its base. Cycloidal engine. See Geometric lathe.
cycloidei |An order of fishes, formerly proposed by Agassiz, for those with thin, smooth scales, destitute of marginal spines, as the herring and salmon. The group is now regarded as artificial.
cycloidian |Same as 2d and 3d Cycloid.
cyclometer |A contrivance for recording the revolutions of a wheel, as of a bicycle.
cyclometry |The art of measuring circles.
cyclone |A violent storm, often of vast extent, characterized by high winds rotating about a calm center of low atmospheric pressure. This center moves onward, often with a velocity of twenty or thirty miles an hour. Note: The atmospheric disturbance usually accompanying a cyclone, marked by an onward moving area of high pressure, is called an anticyclone.
cyclone cellar |A cellar or excavation used for refuge from a cyclone, or tornado. [Middle U. S.]
cyclone pit |A cellar or excavation used for refuge from a cyclone, or tornado. [Middle U. S.]
cyclonic |Pertaining to a cyclone.
cyclonoscope |An apparatus to assist in locating the center of a cyclone.
cyclop |See Note under Cyclops, 1.
cyclopaedia |The circle or compass of the arts and sciences (originally, of the seven so-called liberal arts and sciences); circle of human knowledge. Hence, a work containing, in alphabetical order, information in all departments of knowledge, or on a particular department or branch; as, a cyclopedia of the physical sciences, or of mechanics. See Encyclopedia.
cyclopean |Pertaining to the Cyclops; characteristic of the Cyclops; huge; gigantic; vast and rough; massive; as, Cyclopean labors; Cyclopean architecture.
cyclopedia |The circle or compass of the arts and sciences (originally, of the seven so-called liberal arts and sciences); circle of human knowledge. Hence, a work containing, in alphabetical order, information in all departments of knowledge, or on a particular department or branch; as, a cyclopedia of the physical sciences, or of mechanics. See Encyclopedia.
cyclopedic |Belonging to the circle of the sciences, or to a cyclopedia; of the nature of a cyclopedia; hence, of great range, extent, or amount; as, a man of cyclopedic knowledge.
cyclopedist |A maker of, or writer for, a cyclopedia.
cyclopic |Pertaining to the Cyclops; Cyclopean.
cyclops |1. (Gr. Myth.)  One of a race of giants, sons of Neptune and Amphitrite, having but one eye, and that in the middle of the forehead. They were fabled to inhabit Sicily, and to assist in the workshops of Vulcan, under Mt. Etna. Note: Pope, in his translation of the \"Odyssey,\" uniformly spells this word Cyclop, when used in the singular. 2. (Zo√∂l.)  A genus of minute Entomostraca, found both in fresh and salt water. See Copepoda. 3. A portable forge, used by tinkers, etc.
cyclorama |A pictorial view which is extended circularly, so that the spectator is surrounded by the objects represented as by things in nature. The realistic effect is increased by putting, in the space between the spectator and the picture, things adapted to the scene represented, and in some places only parts of these objects, the completion of them being carried out pictorially.
cycloscope |A machine for measuring at any moment velocity of rotation, as of a wheel of a steam engine. Knight.
cyclosis |The circulation or movement of protoplasmic granules within a living vegetable cell.
cyclostome |A division of Bryozoa, in which the cells have circular apertures.\n\nPertaining to the Cyclostomi.
cyclostomi |A glass of fishes having a suckerlike mouth, without jaws, as the lamprey; the Marsipobranchii.
cyclostomous |Pertaining to the Cyclostomi.
cyclostylar |Relating to a structure composed of a circular range of columns, without a core or building within. Weale.
cyclostyle |A contrivance for producing manifold copies of writing or drawing. The writing or drawing is done with a style carrying a small wheel at the end which makes minute punctures in the paper, thus converting it into a stencil. Copies are transferred with an inked roller.
cyder |See Cider. [Archaic]
cydonin |A peculiar mucilaginous substance extracted from the seeds of the quince (Cydonia vulgaris), and regarded as a variety of amylose.
cygnet |A young swan. Shak.
cygnus |A constellation of the northern hemisphere east of, or following, Lyra; the Swan.
cylinder |1. (Geom.) (a) A solid body which may be generated by the rotation of a parallelogram round one its sides; or a body of rollerlike form, of which the longitudinal section is oblong, and the cross section is circular. (b) The space inclosed by any cylindrical surface. The space may be limited or unlimited in length. 2. Any hollow body of cylindrical form, as: (a) The chamber of a steam engine in which the piston is moved by the force of steam. (b) The barrel of an air or other pump. (c) (Print.) The revolving platen or bed which produces the impression or carries the type in a cylinder press. (d) The bore of a gun; the turning chambered breech of a revolver. 3. The revolving square prism carryng the cards in a Jacquard loom. Cylinder axis. (Anat.) SeeAxis cylinder, under Axis. -- Cylinder engine (Paper Making), a machine in which a cylinder takes up the pulp and delivers it in a continuous sheet to the dryers. -- Cylinder escapement. See Escapement. -- Cylinder glass. See Glass. -- Cylinder mill. See Roller mill. -- Cylinder press. See Press.
cylindraceous |Cylindrical, or approaching a cylindrical form.
cylindric |Having the form of a cylinder, or of a section of its convex surface; partaking of the properties of the cylinder. Cylindrical lens, a lens having one, or more than one, cylindrical surface. -- Cylindric, or Cylindrical, surface (Geom.), a surface described by a straight line that moves according to any law, but so as to be constantly parallel to a given line. -- Cylindrical vault. (Arch.) See under Vault, n.
cylindrical |Having the form of a cylinder, or of a section of its convex surface; partaking of the properties of the cylinder. Cylindrical lens, a lens having one, or more than one, cylindrical surface. -- Cylindric, or Cylindrical, surface (Geom.), a surface described by a straight line that moves according to any law, but so as to be constantly parallel to a given line. -- Cylindrical vault. (Arch.) See under Vault, n.
cylindrically |In the manner or shape of a cylinder; so as to be cylindrical.
cylindricity |The quality or condition of being cylindrical.
cylindriform |Having the form of a cylinder.
cylindroid |1. A solid body resembling a right cylinder, but having the bases or ends elliptical. 2. (Geom.)  A certain surface of the third degree, described by a moving straight line; -- used to illustrate the motions of a rigid body and also the forces acting on the body.
cylindrometric |Belonging to a scale used in measuring cylinders.
cyma |1. (Arch.)  A member or molding of the cornice, the profile of which is wavelike in form. 2. (Bot.)  A cyme. See Cyme. Cyma recta, or Cyma, a cyma, hollow in its upper part and swelling below. -- Cyma reversa, or Ogee, a cyma swelling out on the upper part and hollow below.
cymar |A sight covering; a scarf. See Simar. Her body shaded with a light cymar. Dryden.
cymatium |A capping or crowning molding in classic architecture.
cymbal |1. A musical instrument used by the ancients. It is supposed to have been similar to the modern kettle drum, though perhaps smaller. 2. A musical instrument of brass, shaped like a circular dish or a flat plate, with a handle at the back; -- used in pairs to produce a sharp ringing sound by clashing them together. Note: In orchestras, one cymbal is commonly attached to the bass drum, and the other heid in the drummer's left hand, while his right hand uses the drumstick. 3. A musical instrument used by gypsies and others, made of steel wire, in a triangular form, on which are movable rings.
cymbalist |A performer upon cymbals.
cymbiform |Shaped like a boat; (Bot.) elongated and having the upper surface decidedly concave, as the glumes of many grasses.
cymbium |A genus of marine univalve shells; the gondola.
cymbling |A scalloped or \"pattypan\" variety of summer squash.
cyme |A flattish or convex flower cluster, of the centrifugal or determinate type, differing from a corymb chiefly in the order of the opening of the blossoms.
cymene |A colorless, liquid, combustible hydrocarbon, CH3.C6H4.C3H7, of pleasant odor, obtained from oil of cumin, oil of caraway, carvacrol, camphor, etc.; -- called also paracymene, and formerly camphogen.
cymenol |See Carvacrol.
cymidine |A liquid organic base, C10H13.NH2, derived from cymene.
cymiferous |Producing cymes.
cymling |A scalloped or \"pattypan\" variety of summer squash.
cymogene |A highly volatile liquid, condensed by cold and pressure from the first products of the distillation of petroleum; -- used for producing low temperatures.
cymograph |(a) An instrument for making tracings of the outline or contour of profiles, moldings, etc. (b) Var. of Kymograph. --Cy`mo*graph\"ic (#), a.\n\nTo trace or copy with a cymograph.
cymoid |Having the form of a cyme.
cymometer |An instrument for exhibiting and measuring wave motion; specif. (Elec.),  an instrument for determining the frequency of electic wave oscillations, esp. in connection with wireless telegraphy.
cymophane |See Chrysoberyl.
cymophanous |Having a wavy, floating light; opalescent; chatoyant.
cymoscope |Any device for detecting the presence of electric waves. The influence of electric waves on the resistance of a particular kind of electric circuit, on the magnetization of steel, on the polarization of an electrolytic cell, or on the electric condition of a vacuum has been applied in the various cymoscopes.
cymose |Having the nature of a cyme, or derived from a cyme; bearing, or pertaining to, a cyme or cymes.
cymous |Having the nature of a cyme, or derived from a cyme; bearing, or pertaining to, a cyme or cymes.
cymric |Welsh. -- n.  The Welsh language. [Written also Kymric.]
cymry |A collective term for the Welsh race; -- so called by themselves . [Written also Cymri, Cwmry, Kymry, etc.]
cymule |A small cyme, or one of very few flowers.
cynanche |Any disease of the tonsils, throat, or windpipe, attended with inflammation, swelling, and difficulty of breathing and swallowing.
cynanthropy |A kind of madness in which men fancy themselves changed into dogs, and imitate the voice and habits of that animal.
cynarctomachy |Bear baiting with a dog. Hudibras.
cynarrhodium |A fruit like that of the rose, consisting of a cup formed of the calyx tube and receptacle, and containing achenes.
cynegetics |The art of hunting with dogs.
cynic |1. Having the qualities of a surly dog; snarling; captious; currish. I hope it is no very cynical asperity not to confess obligations where no benefit has been received. Johnson. 2. Pertaining to the Dog Star; as, the cynic, or Sothic, year; cynic cycle. 3. Belonging to the sect of philosophers called cynics; having the qualities of a cynic; pertaining to, or resembling, the doctrines of the cynics. 4. Given to sneering at rectitude and the conduct of life by moral principles; disbelieving in the reality of any human purposes which are not suggested or directed by self-interest or self-indulgence; as, a cynical man who scoffs at pretensions of integrity; characterized by such opinions; as, cynical views of human nature. Note: In prose, cynical is used rather than cynic, in the senses 1 and 4. Cynic spasm (Med.), a convulsive contraction of the muscles of one side of the face, producing a sort of grin, suggesting certain movements in the upper lip of a dog.\n\n1. One of a sect or school of philosophers founded by Antisthenes, and of whom Diogenes was a disciple. The first Cynics were noted for austere lives and their scorn for social customs and current philosophical opinions. Hence the term Cynic symbolized, in the popular judgment, moroseness, and contempt for the views of others. 2. One who holds views resembling those of the Cynics; a snarler; a misanthrope; particularly, a person who believes that human conduct is directed, either consciously or unconsciously, wholly by self- interest or self-indulgence, and that appearances to the contrary are superficial and untrustworthy. He could obtain from one morose cynic, whose opinion it was impossible to despise, scarcely any not acidulated with scorn. Macaulay.
cynical |1. Having the qualities of a surly dog; snarling; captious; currish. I hope it is no very cynical asperity not to confess obligations where no benefit has been received. Johnson. 2. Pertaining to the Dog Star; as, the cynic, or Sothic, year; cynic cycle. 3. Belonging to the sect of philosophers called cynics; having the qualities of a cynic; pertaining to, or resembling, the doctrines of the cynics. 4. Given to sneering at rectitude and the conduct of life by moral principles; disbelieving in the reality of any human purposes which are not suggested or directed by self-interest or self-indulgence; as, a cynical man who scoffs at pretensions of integrity; characterized by such opinions; as, cynical views of human nature. Note: In prose, cynical is used rather than cynic, in the senses 1 and 4. Cynic spasm (Med.), a convulsive contraction of the muscles of one side of the face, producing a sort of grin, suggesting certain movements in the upper lip of a dog.
cynically |In a cynical manner.
cynicalness |The quality of being cynical.
cynicism |The doctrine of the Cynics; the quality of being cynical; the mental state, opnions, or conduct, of a cynic; morose and contemptuous views and opinions.
cynoidea |A division of Carnivora, including the dogs, wolves, and foxes.
cynorexia |A voracious appetite, like that of a starved dog.
cynosural |Of or pertaining to a cynosure.
cynosure |1. The constellation of the Lesser Bear, to which, as containing the polar star, the eyes of mariners and travelers were often directed. 2. That which serves to direct. Southey. 3. Anything to which attention is strongly turned; a center of attraction. Where perhaps some beauty lies, The cynosure of neighboring eyes. Milton.
cyon |See Cion, and Scion.
cyperaceous |Of, pertaining to, or resembling, a large family of plants of which the sedge is the type.
cyperus |A large genus of plants belonging to the Sedge family, and including the species called galingale, several bulrushes, and the Egyptian papyrus.
cypher |See Cipher.
cyphonautes |The free-swimming, bivalve larva of certain Bryozoa.
cyphonism |A punishment sometimes used by the ancients, consisting in the besmearing of the criminal with honey, and exposing him to insects. It is still in use among some Oriental nations.
cypraea |A genus of mollusks, including the cowries. See Cowrie.
cypres |A rule for construing written instruments so as to conform as nearly to the intention of the parties as is consistent with law. Mozley & W.
cypress |A coniferous tree of the genus Cupressus. The species are mostly evergreen, and have wood remarkable for its durability. Note: Among the trees called cypress are the common Oriental cypress, Cupressus sempervirens, the evergreen American cypress, C. thyoides (now called Chamaecyparis sphaeroidea), and the deciduous American cypress, Taxodium distichum. As having anciently been used at funerals, and to adorn tombs, the Oriental species is an emblem of mourning and sadness. Cypress vine (Bot.), a climbing plant with red or white flowers (Ipotoea Quamoclit, formerly Quamoclit vulgaris).
cyprian |1. Belonging to Cyprus. 2. Of, pertaining, or conducing to, lewdness.\n\n1. A native or inhabitant of Cyprus, especially of ancient Cyprus; a Cypriot. 2. A lewd woman; a harlot.
cyprine |Of or pertaining to the cypress.\n\nCyprinoid.
cyprinodont |One of the Cyprinodontidae, a family of fishes including the killifishes or minnows. See Minnow.
cyprinoid |Like the carp (Cyprinus). -- n.  One of the Cyprinidae, or Carp family, as the goldfish, barbel, etc.
cypriot |A native or inhabitant of Cyprus.
cypripedium |A genus of orchidaceous plants including the lady's slipper.
cypris |A genus of small, bivalve, freshwater Crustacea, belonging to the Ostracoda; also, a member of this genus.
cyprus |A thin, transparent stuff, the same as, or corresponding to, crape. It was either white or black, the latter being most common, and used for mourning. [Obs.] Lawn as white as driven snow, Cyprus black as e'er was crow. Shak.
cypruslawn |Same as Cyprus. Milton.
cypsela |A one-seeded, one-called, indehiscent fruit; an achene with the calyx tube adherent.
cypseliform |Like or belonging to the swifts (Cypselid√¶.)
cyrenaic |Pertaining to Cyrenaica, an ancient country of northern Africa, and to Cyrene, its principal city; also, to a school of philosophy founded by Aristippus, a native of Cyrene. -- n.  A native of Cyrenaica; also, a disciple of the school of Aristippus. See Cyrenian, n.
cyrenian |Pertaining to Cyrene, in Africa; Cyrenaic.\n\n1. A native or inhabitant of Cyrene. 2. One of a school of philosophers, established at Cyrene by Aristippus, a disciple of Socrates. Their doctrines were nearly the same as those of the Epicureans.
cyriologic |Relating to capital letters.
cyrtostyle |A circular projecting portion.
cyst |1. (Med.) (a) A pouch or sac without opening, usually membranous and containing morbid matter, which is accidentally developed in one of the natural cavaties or in the substance of an organ. (b) In old authors, the urinary bladder, or the gall bladder. [Written also cystis.] 2. (Bot.)  One of the bladders or air vessels of certain alg√¶, as of the great kelp of the Pacific, and common rockweeds (Fuci) of our shores. D. C. Eaton. 3. (Zo√∂l.) (a) A small capsule or sac of the kind in which many immature entozoans exit in the tissues of living animals; also, a similar form in Rotifera, etc. (b) A form assumed by Protozoa inwhich they become saclike and quiescent. It generally precedes the production of germs. See Encystment.
cysted |Inclosed in a cyst.
cystic |1. Having the form of, or living in, a cyst; as, the cystic entozoa. 2. Containing cysts; cystose; as, cystic sarcoma. 3. (Anat.)  Pertaining to, or contained in, a cyst; esp., pertaining to, or contained in, either the urinary bladder or the gall bladder. Cystic duct, the duct from the gall bladder which unites with the hepatic to form the common bile duct. -- Cystic worm (Zo√∂l.), a larval tape worm, as the cysticercus and echinococcus.
cysticerce |The larval form of a tapeworm, having the head and neck of a tapeworm attached to a saclike body filled with fluid; -- called also bladder worm, hydatid, and measle (as, pork measle). Note: These larvae live in the tissues of various living animals, and, when swallowed by a suitable carnivorous animal, develop into adult tapeworms in the intestine. See Measles, 4, Tapeworm.
cysticercus |The larval form of a tapeworm, having the head and neck of a tapeworm attached to a saclike body filled with fluid; -- called also bladder worm, hydatid, and measle (as, pork measle). Note: These larvae live in the tissues of various living animals, and, when swallowed by a suitable carnivorous animal, develop into adult tapeworms in the intestine. See Measles, 4, Tapeworm.
cysticule |An appendage of the vestibular ear sac of fishes. Owen.
cystid |One of the Cystidea.
cystidea |An order of Crinoidea, mostly fossils of the Paleozoic rocks. They were usually roundish or egg-shaped, and often unsymmetrical; some were sessile, others had short stems.
cystidean |One of the Cystidea.
cystine |A white crystalline substance, C3H7NSO2, containing sulphur, occuring as a constituent of certain rare urinary calculi, and occasionally found as a sediment in urine.
cystis |A cyst. See Cyst.
cystitis |Inflammation of the bladder.
cystocarp |A minute vesicle in a red seaweed, which contains the reproductive spores.
cystocele |Hernia in which the urinary bladder protrudes; vesical hernia.
cystoid |Same as Cystidean.
