defiatory |Bidding or manifesting defiance. [Obs.] Shelford.
defibrinate |To deprive of fibrin, as fresh blood or lymph by stirring with twigs.
defibrination |The act or process of depriving of fibrin.
defibrinize |To defibrinate.
deficience |Same as Deficiency. Thou in thyself art perfect, and in thee Is no deficience found. Milton.
deficiency |The state of being deficient; inadequacy; want; failure; imperfection; shortcoming; defect. \"A deficiencyof blood.\" Arbuthnot. [Marlborough] was so miserably ignorant, that his deficiencies made him the ridicule of his contemporaries. Buckle. Deficiency of a curve (Geom.), the amount by which the number of double points on a curve is short of the maximum for curves of the same degree.
deficient |Wanting, to make up completeness; wanting, as regards a requirement; not sufficient; inadequate; defective; imperfect; incomplete; lacking; as, deficient parts; deficient estate; deficient strength; deficient in judgment. The style was indeed deficient in ease and variety. Macaulay. Deficient number. (Arith.) See under Abundant. -- De*fi\"cient-ly, adv.
deficit |Deficiency in amount or quality; a falling short; lack; as, a deficit in taxes, revenue, etc. Addison.
defier |One who dares and defies; a contemner; as, a defier of the laws.
defiguration |Disfiguration; mutilation. [Obs.] Bp. Hall.
defigure |To delineate. [Obs.] These two stones as they are here defigured. Weever.
defilade |To raise, as a rampart, so as to shelter interior works commanded from some higher point.
defilading |The art or act of determining the directions and heights of the lines of rampart with reference to the protection of the interior from exposure to an enemy's fire from any point within range, or from any works which may be erected. Farrow.
defile |To march off in a line, file by file; to file off.\n\nSame as Defilade.\n\n1. Any narrow passage or gorge in which troops can march only in a file, or with a narrow front; a long, narrow pass between hills, rocks, etc. 2. (Mil.)  The act of defilading a fortress, or of raising the exterior works in order to protect the interior. See Defilade.\n\n1. To make foul or impure; to make filthy; to dirty; to befoul; to pollute. They that touch pitch will be defiled. Shak. 2. To soil or sully; to tarnish, as reputation; to taint. He is . . . among the greatest prelates of this age, however his character may be defiled by . . . dirty hands. Swift. 3. To injure in purity of character; to corrupt. Defile not yourselves with the idols of Egypt. Ezek. xx. 7. 4. To corrupt the chastity of; to debauch; to violate. The husband murder'd and the wife defiled. Prior. 5. To make ceremonially unclean; to pollute. That which dieth of itself, or is torn with beasts, he shall not eat to defile therewith. Lev. xxii. 8.
defilement |The protection of the interior walls of a fortification from an enfilading fire, as by covering them, or by a high parapet on the exposed side.\n\nThe act of defiling, or state of being defiled, whether physically or morally; pollution; foulness; dirtiness; uncleanness. Defilements of the flesh. Hopkins. The chaste can not rake into such filth without danger of defilement. Addison.
defiler |One who defiles; one who corrupts or violates; that which pollutes.
defiliation |Abstraction of a child from its parents. Lamb.
definable |Capable of being defined, limited, or explained; determinable; describable by definition; ascertainable; as, definable limits; definable distinctions or regulations; definable words. -- De*fin\"a*bly, adv.
define |1. To fix the bounds of; to bring to a termination; to end. \"To define controversies.\" Barrow. 2. To determine or clearly exhibit the boundaries of; to mark the limits of; as, to define the extent of a kingdom or country. 3. To determine with precision; to mark out with distinctness; to ascertain or exhibit clearly; as, the defining power of an optical instrument. Rings . . . very distinct and well defined. Sir I. Newton. 4. To determine the precise signification of; to fix the meaning of; to describe accurately; to explain; to expound or interpret; as, to define a word, a phrase, or a scientific term. They define virtue to be life ordered according to nature. Robynson (More's Utopia).\n\nTo determine; to decide. [Obs.]
definement |The act of defining; definition; description. [Obs.] Shak.
definer |One who defines or explains.
definite |1. Having certain or distinct; determinate in extent or greatness; limited; fixed; as, definite dimensions; a definite measure; a definite period or interval. Elements combine in definite proportions. Whewell. 2. Having certain limits in signification; determinate; certain; precise; fixed; exact; clear; as, a definite word, term, or expression. 3. Determined; resolved. [Obs.] Shak. 4. Serving to define or restrict; limiting; determining; as, the definite article. Definite article (Gram.), the article the, which is used to designate a particular person or thing, or a particular class of persons or things; -- also called a definitive. See Definitive, n. -- Definite inflorescence. (Bot.) See Determinate inflorescence, under Determinate. -- Law of definite proportions (Chem.), the essential law of chemical combination that every definite compound always contains the same elements in the same proportions by weight; and, if two or more elements form more than one compound with each other, the relative proportions of each are fixed. Compare Law of multiple proportions, under Multiple.\n\nA thing defined or determined. [Obs.]
definitely |In a definite manner; with precision; precisely; determinately.
definiteness |The state of being definite; determinateness; precision; certainty.
definition |1. The act of defining; determination of the limits; as, the telescope accurate in definition. 2. Act of ascertaining and explaining the signification; a description of a thing by its properties; an explanation of the meaning of a word or term; as, the definition of \"circle;\" the definition of \"wit;\" an exact definition; a loose definition. Definition being nothing but making another understand by words what the term defined stands for. Locke. 3. Description; sort. [R.] \"A new creature of another definition.\" Jer. Taylor. 4. (Logic)  An exact enunciation of the constituents which make up the logical essence. 5. (Opt.)  Distinctness or clearness, as of an image formed by an optical instrument; precision in detail. Syn. -- Definition, Explanation, Description. A definition is designed to settle a thing in its compass and extent; an explanation is intended to remove some obscurity or misunderstanding, and is therefore more extended and minute; a description enters into striking particulars with a view to interest or impress by graphic effect. It is not therefore true, though often said, that description is only an extended definition. \"Logicians distinguish definitions into essential and accidental. An essential definition states what are regarded as the constituent parts of the essence of that which is to be defined; and an accidental definition lays down what are regarded as circumstances belonging to it, viz., properties or accidents, such as causes, effects, etc.\" Whately.
definitional |Relating to definition; of the nature of a definition; employed in defining.
definitive |1. Determinate; positive; final; conclusive; unconditional; express. A strict and definitive truth. Sir T. Browne. Some definitive . . . scheme of reconciliation. Prescott. 2. Limiting; determining; as, a definitive word. 3. Determined; resolved. [Obs.] Shak.\n\nA word used to define or limit the extent of the signification of a common noun, such as the definite article, and some pronouns. Note: Definitives . . . are commonly called by grammarians articles. . . . They are of two kinds, either those properly and strictly so called, or else pronominal articles, such as this, that, any, other, some, all, no, none, etc. Harris (Hermes).
definitively |In a definitive manner.
definitiveness |The quality of being definitive.
definitude |Definiteness. [R.] Definitude . . . is a knowledge of minute differences. Sir W. Hamilton.
defix |To fix; to fasten; to establish. [Obs.] \"To defix their princely seat . . . in that extreme province.\" Hakluyt.
deflagrability |The state or quality of being deflagrable. The ready deflagrability . . . of saltpeter. Boyle.
deflagrable |Burning with a sudden and sparkling combustion, as niter; hence, slightly explosive; liable to snap and crackle when heated, as salt.
deflagrate |To burn with a sudden and sparkling combustion, as niter; also, to snap and crackle with slight explosions when heated, as salt.\n\nTo cause to burn with sudden and sparkling combustion, as by the action of intense heat; to burn or vaporize suddenly; as, to deflagrate refractory metals in the oxyhydrogen flame.
deflagration |1. A burning up; conflagration. \"Innumerable deluges and deflagrations.\" Bp. Pearson. 2. (Chem.)  The act or process of deflagrating.
deflagrator |A form of the voltaic battery having large plates, used for producing rapid and powerful combustion.
deflate |To reduce from an inflated condition.
deflect |To cause to turn aside; to bend; as, rays of light are often deflected. Sitting with their knees deflected under them. Lord (1630).\n\nTo turn aside; to deviate from a right or a horizontal line, or from a proper position, course or direction; to swerve. At some part of the Azores, the needle deflecteth not, but lieth in the true meridian. Sir T. Browne. To deflect from the line of truth and reason. Warburton.
deflectable |Capable of being deflected.
deflected |1. Turned aside; deviating from a direct line or course. 2. Bent downward; deflexed.
deflection |1. The act of turning aside, or state of being turned aside; a turning from a right line or proper course; a bending, esp. downward; deviation. The other leads to the same point, through certain deflections. Lowth. 2. (Gunnery)  The deviation of a shot or ball from its true course. 3. (Opt.)  A deviation of the rays of light toward the surface of an opaque body; inflection; diffraction. 4. (Engin.)  The bending which a beam or girder undergoes from its own weight or by reason of a load.
deflectionization |The act of freeing from inflections. Earle.
deflectionize |To free from inflections. Deflectionized languages are said to be analytic. Earle.
deflective |Causing deflection. Deflective forces, forces that cause a body to deviate from its course.
deflector |That which deflects, as a diaphragm in a furnace, or a come in a lamp (to deflect and mingle air and gases and help combustion).
deflexed |Bent abruptly downward.
deflexion |See Deflection.
deflexure |A bending or turning aside; deflection. Bailey.
deflorate |Past the flowering state; having shed its pollen. Gray.
defloration |1. The act of deflouring; as, the defloration if a virgin. Johnson. 2. That which is chosen as the flower or choicest part; careful culling or selection. [R.] The laws of Normandy are, in a great measure, the defloration of the English laws. Sir M. Hale.
deflour |1. To deprive of flowers. 2. To take away the prime beauty and grace of; to rob of the choicest ornament. He died innocent and before the sweetness of his soul was defloured and ravished from him. Jer. Taylor. 3. To deprive of virginity, as a woman; to violate; to ravish; also, to seduce.
deflourer |One who deflours; a ravisher.
deflow |To flow down. [Obs.] Sir T. Browne.
deflower |Same as Deflour. An earthquake . . . deflowering the gardens. W. Montagu. If a man had deflowered a virgin. Milton.
deflowerer |See Deflourer. Milton.
defluous |Flowing down; falling off. [Obs.] Bailey.
deflux |Downward flow. [Obs.] Bacon.
defluxion |A discharge or flowing of humors or fluid matter, as from the nose in catarrh; -- sometimes used synonymously with inflammation. Dunglison.
defly |Deftly. [Obs.] Spenser.
defoedation |Defedation. [Obs.]
defoliate |Deprived of leaves, as by their natural fall.
defoliated |Deprived of leaves, as by their natural fall.
defoliation |The separation of ripened leaves from a branch or stem; the falling or shedding of the leaves.
deforce |(a) To keep from the rightful owner; to withhold wrongfully the possession of, as of lands or a freehold. (b) (Scots Law) To resist the execution of the law; to oppose by force, as an officer in the execution of his duty. Burrill.
deforcement |(a) A keeping out by force or wrong; a wrongful withholding, as of lands or tenements, to which another has a right. (b) (Scots Law) Resistance to an officer in the execution of law. Burrill.
deforceor |Same as Deforciant. [Obs.]
deforciant |(a) One who keeps out of possession the rightful owner of an estate. (b) One against whom a fictitious action of fine was brought. [Obs.] Burrill.
deforciation |Same as Deforcement, n.
deforest |To clear of forests; to dis U. S. Agric. Reports.
deform |1. To spoil the form of; to mar in form; to misshape; to disfigure. Deformed, unfinished, sent before my time Into this breathing world. Shak. 2. To render displeasing; to deprive of comeliness, grace, or perfection; to dishonor. Above those passions that this world deform. Thomson.\n\nDeformed; misshapen; shapeless; horrid. [Obs.] Sight so deform what heart of rock could long Dry-eyed behold Milton.
deformation |1. The act of deforming, or state of anything deformed. Bp. Hall. 2. Transformation; change of shape.
deformed |Unnatural or distorted in form; having a deformity; misshapen; disfigured; as, a deformed person; a deformed head. -- De*form\"ed*ly, adv. -- De*form\"ed*ness, n.
deformer |One who deforms.
deformity |1. The state of being deformed; want of proper form or symmetry; any unnatural form or shape; distortion; irregularity of shape or features; ugliness. To make an envious mountain on my back, Where sits deformity to mock my body. Shak. 2. Anything that destroys beauty, grace, or propriety; irregularity; absurdity; gross deviation from other or the established laws of propriety; as, deformity in an edifice; deformity of character. Confounded, that her Maker's eyes Should look so near upon her foul deformities. Milton.
deforser |A deforciant. [Obs.] Blount.
defoul |1. To tread down. [Obs.] Wyclif. 2. To make foul; to defile. [Obs.] Wyclif.
defraud |To deprive of some right, interest, or property, by a deceitful device; to withhold from wrongfully; to injure by embezzlement; to cheat; to overreach; as, to defraud a servant, or a creditor, or the state; -- with of before the thing taken or withheld. We have defrauded no man. 2 Cor. vii. 2. Churches seem injured and defrauded of their rights. Hooker.
defraudation |The act of defrauding; a taking by fraud. [R.] Sir T. Browne.
defrauder |One who defrauds; a cheat; an embezzler; a peculator.
defraudment |Privation by fraud; defrauding. [Obs.] Milton.
defray |1. To pay or discharge; to serve in payment of; to provide for, as a charge, debt, expenses, costs, etc. For the discharge of his expenses, and defraying his cost, he allowed him . . . four times as much. Usher. 2. To avert or appease, as by paying off; to satisfy; as, to defray wrath. [Obs.] Spenser.
defrayal |The act of defraying; payment; as, the defrayal of necessary costs.
defrayer |One who pays off expenses.
defrayment |Payment of charges.
deft |Apt; fit; dexterous; clever; handy; spruce; neat. [Archaic or Poetic] \"The deftest way.\" Shak. \"Deftest feats.\" Gay. The limping god, do deft at his new ministry. Dryden. Let me be deft and debonair. Byron.
deftly |Aptly; fitly; dexterously; neatly. \"Deftly dancing.\" Drayton. Thyself and office deftly show. Shak.
deftness |The quality of being deft. Drayton.
defunct |Having finished the course of life; dead; deceased. \"Defunct organs.\" Shak. The boar, defunct, lay tripped up, near. Byron.\n\nA dead person; one deceased.
defunction |Death. [Obs.] After defunction of King Pharamond. Shak.
defunctive |Funereal. [Obs.] \"Defunctive music.\" Shak.
defuse |To disorder; to make shapeless. [Obs.] Shak.
defy |1. To renounce or dissolve all bonds of affiance, faith, or obligation with; to reject, refuse, or renounce. [Obs.] I defy the surety and the bond. Chaucer. For thee I have defied my constant mistress. Beau. & Fl. 2. To provoke to combat or strife; to call out to combat; to challenge; to dare; to brave; to set at defiance; to treat with contempt; as, to defy an enemy; to defy the power of a magistrate; to defy the arguments of an opponent; to defy public opinion. I once again Defy thee to the trial of mortal fight. Milton. I defy the enemies of our constitution to show the contrary. Burke.\n\nA challenge. [Obs.] Dryden.
degage |Unconstrained; easy; free. Vanbrugh. A graceful and dégagé manner. Poe.
degarnish |1. To strip or deprive of entirely, as of furniture, ornaments, etc.; to disgarnish; as, to degarnish a house, etc. [R.] 2. To deprive of a garrison, or of troops necessary for defense; as, to degarnish a city or fort. [R.] Washington.
degarnishment |The act of depriving, as of furniture, apparatus, or a garrison. [R.]
degender |To degenerate. [Obs.] \"Degendering to hate.\" Spenser. He degenereth into beastliness. Joye.
degener |To degenerate. [Obs.] \"Degendering to hate.\" Spenser. He degenereth into beastliness. Joye.
degeneracy |1. The act of becoming degenerate; a growing worse. Willful degeneracy from goodness. Tillotson. 2. The state of having become degenerate; decline in good qualities; deterioration; meanness. Degeneracy of spirit in a state of slavery. Addison. To recover mankind out of their universal corruption and degeneracy. S. Clarke.
degenerate |Having become worse than one's kind, or one's former state; having declined in worth; having lost in goodness; deteriorated; degraded; unworthy; base; low. Faint-hearted and degenerate king. Shak. A degenerate and degraded state. Milton. Degenerate from their ancient blood. Swift. These degenerate days. Pope. I had planted thee a noble vine . . . : how then art thou turned into the degenerate plant of a strange vine unto me Jer. ii. 21.\n\n1. To be or grow worse than one's kind, or than one was originally; hence, to be inferior; to grow poorer, meaner, or more vicious; to decline in good qualities; to deteriorate. When wit transgresseth decency, it degenerates into insolence and impiety. Tillotson. 2. (Biol.)  To fall off from the normal quality or the healthy structure of its kind; to become of a lower type.
degenerately |In a degenerate manner; unworthily.
degenerateness |Degeneracy.
degeneration |1. The act or state of growing worse, or the state of having become worse; decline; degradation; debasement; degeneracy; deterioration. Our degeneration and apostasy. Bates. 2. (Physiol.)  That condition of a tissue or an organ in which its vitality has become either diminished or perverted; a substitution of a lower for a higher form of structure; as, fatty degeneration of the liver. 3. (Biol.)  A gradual deterioration, from natural causes, of any class of animals or plants or any particular or organs; hereditary degradation of type. 4. The thing degenerated. [R.] Cockle, aracus, . . . and other degenerations. Sir T. Browne. Amyloid degeneration, Caseous degeneration, etc. See under Amyloid, Caseous, etc.
degenerationist |A believer in the theory of degeneration, or hereditary degradation of type; as, the degenerationists hold that savagery is the result of degeneration from a superior state.
degenerative |Undergoing or producing degeneration; tending to degenerate.
degenerous |Degenerate; base. [Obs.] \"Degenerous passions.\" Dryden. \"Degenerous practices.\" South.
degenerously |Basely. [Obs.]
degerm |To extract the germs from, as from wheat grains.
degerminator |A machine for breaking open the kernels of wheat or other grain and removing the germs.
deglaze |To remove the glaze from, as pottery or porcelain, so as to give a dull finish.
deglazing |The process of giving a dull or ground surface to glass by acid or by mechanical means. Knight.
degloried |Deprived of glory; dishonored. [Obs.] \"With thorns degloried.\" G. Fletcher.
deglutinate |To loosen or separate by dissolving the glue which unties; to unglue.
deglutination |The act of ungluing.
deglutition |The act or process of swallowing food; the power of swallowing. The muscles employed in the act of deglutition. Paley.
deglutitious |Pertaining to deglutition. [R.]
deglutitory |Serving for, or aiding in, deglutition.
degradation |1. The act of reducing in rank, character, or reputation, or of abasing; a lowering from one's standing or rank in office or society; diminution; as, the degradation of a peer, a knight, a general, or a bishop. He saw many removes and degradations in all the other offices of which he had been possessed. Clarendon. 2. The state of being reduced in rank, character, or reputation; baseness; moral, physical, or intellectual degeneracy; disgrace; abasement; debasement. The . . . degradation of a needy man of letters. Macaulay. Deplorable is the degradation of our nature. South. Moments there frequently must be, when a sidegradation of his state. Blair. 3. Diminution or reduction of strength, efficacy, or value; degeneration; deterioration. The development and degradation of the alphabetic forms can be traced. I. Taylor (The Alphabet). 4. (Geol.)  A gradual wearing down or wasting, as of rocks and banks, by the action of water, fro 5. (Biol.)  The state or condition of a species or group which exhibits degraded forms; degeneration. The degradation of the species man is observed in some of its varieties. Dana. 6. (Physiol.)  Arrest of development, or degeneration of any organ, or of the body as a whole. Degradation of energy, or Dissipation of energy (Physics), the transformation of energy into some form in which it is less available for doing work. Syn. -- Abasement; debasement; reduction; decline.
degrade |1. To reduce from a higher to a lower rank or degree; to lower in rank' to deprive of office or dignity; to strip of honors; as, to degrade a nobleman, or a general officer. Prynne was sentenced by the Star Chamber Court to be degraded from the bar. Palfrey. 2. To reduce in estimation, character, or reputation; to lessen the value of; to lower the physical, moral, or intellectual character of; to debase; to bring shame or contempt upon; to disgrace; as, vice degrades a man. O miserable mankind, to what fall Degraded, to what wretched state reserved! Milton. He pride . . . struggled hard against this degrading passion. Macaulay. 3. (Geol.)  To reduce in altitude or magnitude, as hills and mountains; to wear down. Syn. -- To abase; demean; lower; reduce. See Abase.\n\nTo degenerate; to pass from a higher to a lower type of structure; as, a family of plants or animals degrades through this or that genus or group of genera.
degraded |1. Reduced in rank, character, or reputation; debased; sunken; low; base. The Netherlands . . . were reduced practically to a very degraded condition. Motley. 2. (Biol.)  Having the typical characters or organs in a partially developed condition, or lacking certain parts. Some families of plants are degraded dicotyledons. Dana. 3. Etym: [Cf. F. degré step.] (Her.)  Having steps; -- said of a cross each of whose extremities finishes in steps growing larger as they leave the center; -- termed also on degrees.
degradement |Deprivation of rank or office; degradation. [R.] Milton.
degradingly |In a degrading manner.
degras |A semisolid emulsion produced by the treatment of certain skins with oxidized fish oil, which extracts their soluble albuminoids. It was formerly solely a by-product of chamois leather manufacture, but is now made for its own sake, being valuable as a dressing for hides.\n\nA semisolid emulsion produced by the treatment of certain skins with oxidized fish oil, which extracts their soluble albuminoids. It was formerly solely a by-product of chamois leather manufacture, but is now made for its own sake, being valuable as a dressing for hides.
degravation |The act of making heavy. [Obs.] Bailey.
degrease |To remove grease or fatty matter from, as wool or silk.
degree |1. A step, stair, or staircase. [Obs.] By ladders, or else by degree. Rom. of R. 2. One of a series of progressive steps upward or downward, in quality, rank, acquirement, and the like; a stage in progression; grade; gradation; as, degrees of vice and virtue; to advance by slow degrees; degree of comparison. 3. The point or step of progression to which a person has arrived; rank or station in life; position. \"A dame of high degree.\" Dryden. \"A knight is your degree.\" Shak. \"Lord or lady of high degree.\" Lowell. 4. Measure of advancement; quality; extent; as, tastes differ in kind as well as in degree. The degree of excellence which proclaims genius, is different in different times and different places. Sir. J. Reynolds. 5. Grade or rank to which scholars are admitted by a college or university, in recognition of their attainments; as, the degree of bachelor of arts, master, doctor, etc. Note: In the United States diplomas are usually given as the evidence of a degree conferred. In the humanities the first degree is that of bachelor of arts (B. A. or A. B.); the second that of master of arts (M. A. or A. M.). The degree of bachelor (of arts, science, divinity, law, etc.) is conferred upon those who complete a prescribed course of undergraduate study. The first degree in medicine is that of doctor of medicine (M. D.). The degrees of master and doctor are sometimes conferred, in course, upon those who have completed certain prescribed postgraduate studies, as doctor of philosophy (Ph. D.); but more frequently the degree of doctor is conferred as a complimentary recognition of eminent services in science or letters, or for public services or distinction (as doctor of laws (LL. D.) or doctor of divinity (D. D.), when they are called honorary degrees. The youth attained his bachelor's degree, and left the university. Macaulay. 5. (Genealogy)  A certain distance or remove in the line of descent, determining the proximity of blood; one remove in the chain of relationship; as, a relation in the third or fourth degree. In the 11th century an opinion began to gain ground in Italy, that third cousins might marry, being in the seventh degree according to the civil law. Hallam. 7. (Arith.)  Three figures taken together in numeration; thus, 140 is one degree, 222,140 two degrees. 8. (Algebra)  State as indicated by sum of exponents; more particularly, the degree of a term is indicated by the sum of the exponents of its literal factors; thus, a2b2c is a term of the sixth degree. The degree of a power, or radical, is denoted by its index, that of an equation by the greatest sum of the exponents of the unknown quantities in any term; thus, ax4 + bx2 = c, and mx2y2 + nyx = p, are both equations of the fourth degree. 9. (Trig.)  A 360th part of the circumference of a circle, which part is taken as the principal unit of measure for arcs and angles. The degree is divided into 60 minutes and the minute into 60 seconds. 10. A division, space, or interval, marked on a mathematical or other instrument, as on a thermometer. 11. (Mus.)  A line or space of the staff. Note: The short lines and their spaces are added degrees. Accumulation of degrees. (Eng. Univ.) See under Accumulation. -- By degrees, step by step; by little and little; by moderate advances. \"I 'll leave by degrees.\" Shak. -- Degree of a curve or surface (Geom.), the number which expresses the degree of the equation of the curve or surface in rectilinear coördinates. A straight line will, in general, meet the curve or surface in a number of points equal to the degree of the curve or surface and no more. -- Degree of latitude (Geog.), on the earth, the distance on a meridian between two parallels of latitude whose latitudes differ from each other by one degree. This distance is not the same on different parts of a meridian, on account of the flattened figure of the earth, being 68.702 statute miles at the equator, and 69.396 at the poles. -- Degree of longitude, the distance on a parallel of latitude between two meridians that make an angle of one degree with each other at the poles -- a distance which varies as the cosine of the latitude, being at the equator 69.16 statute miles. -- To a degree, to an extreme; exceedingly; as, mendacious to a degree. It has been said that Scotsmen . . . are . . . grave to a degree on occasions when races more favored by nature are gladsome to excess. Prof. Wilson.
degu |A small South American rodent (Octodon Cumingii), of the family Octodontidæ.
degum |To deprive of, or free from, gum; as, to degum ramie.
degust |To taste. [Obs.] Cockeram.
degustation |Tasting; the appreciation of sapid qualities by the taste organs. Bp. Hall.
dehisce |To gape; to open by dehiscence.
dehiscence |1. The act of gaping. 2. (Biol.)  A gaping or bursting open along a definite line of attachment or suture, without tearing, as in the opening of pods, or the bursting of capsules at maturity so as to emit seeds, etc.; also, the bursting open of follicles, as in the ovaries of animals, for the expulsion of their contents.
dehiscent |Characterized by dehiscence; opening in some definite way, as the capsule of a plant.
dehonestate |To disparage. [Obs.]
dehonestation |A dishonoring; disgracing. [Obs.] Gauden.
dehorn |To deprive of horns; to prevent the growth or the horns of (cattle) by burning their ends soon after they start. See Dishorn. \"Dehorning cattle.\" Farm Journal (1886).
dehors |Out of; without; foreign to; out of the agreement, record, will, or other instrument.\n\nAll sorts of outworks in general, at a distance from the main works; any advanced works for protection or cover. Farrow.
dehort |To urge to abstain or refrain; to dissuade. [Obs.] The apostles vehemently dehort us from unbelief. Bp. Ward. \"Exhort\" remains, but dehort, a word whose place neither \"dissuade\" nor any other exactly supplies, has escaped us. Trench.
dehortation |Dissuasion; advice against something. [R.]
dehortative |Dissuasive. [R.]
dehortatory |Fitted or designed to dehort or dissuade. Bp. Hall.
dehorter |A dissuader; an adviser to the contrary. [Obs.]
dehumanize |To divest of human qualities, such as pity, tenderness, etc.; as, dehumanizing influences.
dehusk |To remove the husk from. [Obs.] \"Wheat dehusked upon the floor.\" Drant.
dehydration |The act or process of freeing from water; also, the condition of a body from which the water has been removed.
dehydrogenate |To deprive of, or free from, hydrogen.
dehydrogenation |The act or process or freeing from hydrogen; also, the condition resulting from the removal of hydrogen.
deicide |1. The act of killing a being of a divine nature; particularly, the putting to death of Jesus Christ. [R.] Earth profaned, yet blessed, with deicide. Prior. 2. One concerned in putting Christ to death.
deictic |Direct; proving directly; -- applied to reasoning, and opposed to elenchtic or refutative.
deictically |In a manner to show or point out; directly; absolutely; definitely. When Christ spake it deictically. Hammond.
deific |Making divine; producing a likeness to God; god-making. \"A deifical communion.\" Homilies.
deifical |Making divine; producing a likeness to God; god-making. \"A deifical communion.\" Homilies.
deification |The act of deifying; exaltation to divine honors; apotheosis; excessive praise.
deified |Honored or worshiped as a deity; treated with supreme regard; godlike.
deifier |One who deifies.
deiform |1. Godlike, or of a godlike form. Dr. H. More. 2. Conformable to the will of God. [R.] Bp. Burnet.
deiformity |Likeness to deity. [Obs.]
deify |1. To make a god of; to exalt to the rank of a deity; to enroll among the deities; to apotheosize; as, Julius Cæsar was deified. 2. To praise or revere as a deity; to treat as an object of supreme regard; as, to deify money. He did again to extol and deify the pope. Bacon. 3. To render godlike. By our own spirits are we deified. Wordsworth.
deign |1. To esteem worthy; to consider worth notice; -- opposed to disdain. [Obs.] I fear my Julia would not deign my lines. Shak. 2. To condescend to give or bestow; to stoop to furnish; to vouchsafe; to allow; to grant. Nor would we deign him burial of his men. Shak.\n\nTo think worthy; to vouchsafe; to condescend; -- followed by an infinitive. O deign to visit our forsaken seats. Pope. Yet not Lord Cranstone deigned she greet. Sir W. Scott. Round turned he, as not deigning Those craven ranks to see. Macaulay. Note: In early English deign was often used impersonally. Him deyneth not to set his foot to ground. Chaucer.
deignous |Haughty; disdainful. [Obs.] Chaucer.
deil |Devil; -- spelt also deel. [Scot.] Deil's buckie. See under Buckie.
deinoceras |See Dinoceras.
deinornis |See Dinornis.
deinosaur |See Dinosaur.
deinotherium |See Dinotherium.
deintegrate |To disintegrate. [Obs.]
deinteous |Rare; excellent; costly. [Obs.] Chaucer.
deintevous |Rare; excellent; costly. [Obs.] Chaucer.
deiparous |Bearing or bringing forth a god; -- said of the Virgin Mary. [Obs.] Bailey.
deipnosophist |One of an ancient sect of philosophers, who cultivated learned conversation at meals.
deis |See Dais.
deism |The doctrine or creed of a deist; the belief or system of those who acknowledge the existence of one God, but deny revelation. Note: Deism is the belief in natural religion only, or those truths, in doctrine and practice, which man is to discover by the light of reason, independent of any revelation from God. Hence, deism implies infidelity, or a disbelief in the divine origin of the Scriptures.
deist |One who believes in the existence of a God, but denies revealed religion; a freethinker. Note: A deist, as denying a revelation, is opposed to a Christian; as, opposed to the denier of a God, whether atheist or patheist, a deist is generally denominated theist. Latham. Syn. -- See Infidel.
deistic |Pertaining to, savoring of, or consisting in, deism; as, a deistic writer; a deistical book. The deistical or antichristian scheme. I. Watts.
deistical |Pertaining to, savoring of, or consisting in, deism; as, a deistic writer; a deistical book. The deistical or antichristian scheme. I. Watts.
deistically |After the manner of deists.
deisticalness |State of being deistical.
deitate |Deified. [Obs.] Granmer.
deity |1. The collection of attributes which make up the nature of a god; divinity; godhead; as, the deity of the Supreme Being is seen in his works. They declared with emphasis the perfect deity and the perfect manhood of Christ. Milman. 2. A god or goddess; a heathen god. To worship calves, the deities Of Egypt. Milton. The Deity, God, the Supreme Being. This great poet and philosopher [Simonides], the more he contemplated the nature of the Deity, found that he waded but the more out of his depth. Addison.
deject |1. To cast down. [Obs. or Archaic] Christ dejected himself even unto the hells. Udall. Sometimes she dejects her eyes in a seeming civility; and many mistake in her a cunning for a modest look. Fuller. 2. To cast down the spirits of; to dispirit; to discourage; to dishearten. Nor think, to die dejects my lofty mind. Pope.\n\nDejected. [Obs.]
dejecta |Excrements; as, the dejecta of the sick.
dejected |Cast down; afflicted; low-spirited; sad; as, a dejected look or countenance. -- De*ject\"ed*ly, adv. -- De*ject\"ed*ness, n.
dejecter |One who casts down, or dejects.
dejection |1. A casting down; depression. [Obs. or Archaic] Hallywell. 2. The act of humbling or abasing one's self. Adoration implies submission and dejection. Bp. Pearson. 3. Lowness of spirits occasioned by grief or misfortune; mental depression; melancholy. What besides, Of sorrow, and dejection, and despair, Our frailty can sustain, thy tidings bring. Milton. 4. A low condition; weakness; inability. [R.] A dejection of appetite. Arbuthnot. 5. (Physiol.) (a) The discharge of excrement. (b) Fæces; excrement. Ray.
dejectly |Dejectedly. [Obs.]
dejectory |1. Having power, or tending, to cast down. 2. Promoting evacuations by stool. Ferrand.
dejecture |That which is voided; excrements. Arbuthnot.
dejerate |To swear solemnly; to take an oath. [Obs.] Cockeram.
dejeration |The act of swearing solemnly. [Obs.] Bp. Hall.
dejeune |A déjeuner. Take a déjeuné of muskadel and eggs. B. Jonson.
dejeuner |A breakfast; sometimes, also, a lunch or collation.
deka- |A prefix signifying ten. See Deca-.
dekabrist |A Decembrist.
dekagram |Same as Decagram.
dekaliter |Same as Decaliter.
dekameter |Same as Decameter.
dekastere |Same as Decastere.
dekle |See Deckle.
del |Share; portion; part. [Obs.] Chaucer.
del credere |An agreement by which an agent or factor, in consideration of an additional premium or commission (called a del credere commission), engages, when he sells goods on credit, to insure, warrant, or guarantee to his principal the solvency of the purchaser, the engagement of the factor being to pay the debt himself if it is not punctually discharged by the buyer when it becomes due.
delaceration |A tearing in pieces. [Obs.] Bailey.
delacrymation |An involuntary discharge of watery humors from the eyes; wateriness of the eyes. [Obs.] Bailey.
delactation |The act of weaning. [Obs.] Bailey.
delaine |A kind of fabric for women's dresses.
delamination |Formation and separation of laminæ or layers; one of the methods by which the various blastodermic layers of the ovum are differentiated. Note: This process consists of a concentric splitting of the cells of the blastosphere into an outer layer (epiblast) and an inner layer (hypoblast). By the perforation of the resultant two-walled vesicle, a gastrula results similar to that formed by the process of invagination.
delapsation |See Delapsion. Ray.
delapse |To pass down by inheritance; to lapse. [Obs.] Which Anne derived alone the right, before all other, Of the delapsed crown from Philip. Drayton.
delapsion |A falling down, or out of place; prolapsion.
delassation |Fatigue. Able to continue without delassation. Ray.
delate |1. To carry; to convey. Try exactly the time wherein sound is delated. Bacon. 2. To carry abroad; to spread; to make public. When the crime is delated or notorious. Jer. Taylor. 3. To carry or bring against, as a charge; to inform against; to accuse; to denounce. As men were delated, they were marked down for such a fine. Bp. Burnet. 4. To carry on; to conduct. Warner.\n\nTo dilate. [Obs.] Goodwin.
delation |1. Conveyance. [Obs. or Archaic] In delation of sounds, the inclosure of them preserveth them. Bacon. 2. (Law)  Accusation by an informer. Milman.
delator |An accuser; an informer. [R.] Howell.
delaware |An American grape, with compact bunches of small, amber-colored berries, sweet and of a good flavor.
delawares |A tribe of Indians formerly inhabiting the valley of the Delaware River, but now mostly located in the Indian Territory.
delay |A putting off or deferring; procrastination; lingering inactivity; stop; detention; hindrance. Without any delay, on the morrow I sat on the judgment seat. Acts xxv. 17. The government ought to be settled without the delay of a day. Macaulay.\n\n1. To put off; to defer; to procrastinate; to prolong the time of or before. My lord delayeth his coming. Matt. xxiv. 48. 2. To retard; to stop, detain, or hinder, for a time; to retard the motion, or time of arrival, of; as, the mail is delayed by a heavy fall of snow. Thyrsis! whose artful strains have oft delayed The huddling brook to hear his madrigal. Milton. 3. To allay; to temper. [Obs.] The watery showers delay the raging wind. Surrey.\n\nTo move slowly; to stop for a time; to linger; to tarry. There seem to be certain bounds to the quickness and slowness of the succession of those ideas, . . . beyond which they can neither delay nor hasten. Locke.
delayer |One who delays; one who lingers.
delayingly |By delays. [R.] Tennyson.
delayment |Hindrance. [Obs.] Gower.
dele |Erase; remove; -- a direction to cancel something which has been put in type; usually expressed by a peculiar form of d, thus: .\n\nTo erase; to cancel; to delete; to mark for omission.\n\nTo deal; to divide; to distribute. [Obs.] Chaucer.
deleble |Capable of being blotted out or erased. \"An impression easily deleble.\" Fuller.
delectable |Highly pleasing; delightful. Delectable both to behold and taste. Milton. -- De*lec\"ta*ble*ness, n. -- De*lec\"ta*bly, adv.
delectate |To delight; to charm. [R.]
delectation |Great pleasure; delight.
delectus |A name given to an elementary book for learners of Latin or Greek. G. Eliot.
delegacy |1. The act of delegating, or state of being delegated; deputed power. [Obs.] By way of delegacy or grand commission. Sir W. Raleigh. 2. A body of delegates or commissioners; a delegation. [Obs.] Burton.
delegate |1. Any one sent and empowered to act for another; one deputed to represent; a chosen deputy; a representative; a commissioner; a vicar. 2. (a) One elected by the people of a territory to represent them in Congress, where he has the right of debating, but not of voting. (b) One sent by any constituency to act as its representative in a convention; as, a delegate to a convention for nominating officers, or for forming or altering a constitution. [U.S.] Court of delegates, formerly, the great court of appeal from the archbishops' courts and also from the court of admiralty. It is now abolished, and the privy council is the immediate court of appeal in such cases. [Eng.]\n\nSent to act for a represent another; deputed; as, a delegate judge. \"Delegate power.\" Strype.\n\n1. To send as one's representative; to empower as an ambassador; to send with power to transact business; to commission; to depute; to authorize. 2. To intrust to the care or management of another; to transfer; to assign; to commit. The delegated administration of the law. Locke. Delegated executive power. Bancroft. The power exercised by the legislature is the people's power, delegated by the people to the legislative. J. B. Finch.
delegation |1. The act of delegating, or investing with authority to act for another; the appointment of a delegate or delegates. 2. One or more persons appointed or chosen, and commissioned to represent others, as in a convention, in Congress, etc.; the collective body of delegates; as, the delegation from Massachusetts; a deputation. 3. (Rom. Law)  A kind of novation by which a debtor, to be liberated from his creditor, gives him a third person, who becomes obliged in his stead to the creditor, or to the person appointed by him. Pothier.
delegatory |Holding a delegated position. Nash.
delenda |Things to be erased or blotted out.
delenifical |Assuaging pain. [Obs.] Bailey.
delete |To blot out; to erase; to expunge; to dele; to omit. I have, therefore, . . . inserted eleven stanzas which do not appear in Sir Walter Scott's version, and have deleted eight. Aytoun.
deleterious |Hurtful; noxious; destructive; pernicious; as, a deleterious plant or quality; a deleterious example. -- Del`e*te\"ri*ous*ly, adv. -- Del`e*te\"ri*ous*ness, n.
deletery |Destructive; poisonous. [Obs.] \"Deletery medicines.\" Hudibras.\n\nThat which destroys. [Obs.] They [the Scriptures] are the only deletery of heresies. Jer. Taylor.
deletion |Act of deleting, blotting out, or erasing; destruction. [Obs.] Jer. Taylor. A total deletion of every person of the opposing party. Sir M. Hale.
deletitious |Of such a nature that anything may be erased from it; -- said of paper.
deletive |Adapted to destroy or obliterate. [R.] Evelyn.
deletory |That which blots out. [Obs.] \"A deletory of sin.\" Jer. Taylor.
delf |A mine; a quarry; a pit dug; a ditch. [Written also delft, and delve.] [Obs.] The delfts would be so flown with waters, that no gins or machines could . . . keep them dry. Ray.\n\nSame as Delftware.
delft |Same as Delftware.
delftware |(a) Pottery made at the city of Delft in Holland; hence: (b) Earthenware made in imitation of the above; any glazed earthenware made for table use, and the like.
delibate |To taste; to take a sip of; to dabble in. [Obs.]
delibation |Act of tasting; a slight trial. [Obs.] Berkeley.
deliber |To deliberate. [Obs.]
deliberate |1. Weighing facts and arguments with a view a choice or decision; carefully considering the probable consequences of a step; circumspect; slow in determining; -- applied to persons; as, a deliberate judge or counselor. \"These deliberate fools.\" Shak. 2. Formed with deliberation; well-advised; carefully considered; not sudden or rash; as, a deliberate opinion; a deliberate measure or result. Settled visage and deliberate word. Shak. 3. Not hasty or sudden; slow. Hooker. His enunciation was so deliberate. W. Wirt.\n\nTo weigh in the mind; to consider the reasons for and against; to consider maturely; to reflect upon; to ponder; as, to deliberate a question.\n\nTo take counsel with one's self; to weigh the arguments for and against a proposed course of action; to reflect; to consider; to hesitate in deciding; -- sometimes with on, upon, concerning. The woman the deliberation is lost. Addison.
deliberately |With careful consideration, or deliberation; circumspectly; warily; not hastily or rashly; slowly; as, a purpose deliberately formed.
deliberateness |The quality of being deliberate; calm consideration; circumspection.
deliberation |1. The act of deliberating, or of weighing and examining the reasons for and against a choice or measure; careful consideration; mature reflection. Choosing the fairest way with a calm deliberation. W. Montagu. 2. Careful discussion and examination of the reasons for and against a measure; as, the deliberations of a legislative body or council.
deliberative |Pertaining to deliberation; proceeding or acting by deliberation, or by discussion and examination; deliberating; as, a deliberative body. A consummate work of deliberative wisdom. Bancroft. The court of jurisdiction is to be distinguished from the deliberative body, the advisers of the crown. Hallam.\n\n1. A discourse in which a question is discussed, or weighed and examined. Bacon. 2. A kind of rhetoric employed in proving a thing and convincing others of its truth, in order to persuade them to adopt it.
deliberatively |In a deliberative manner; circumspectly; considerately.
deliberator |One who deliberates.
delibrate |To strip off the bark; to peel. [Obs.] Ash.
delibration |The act of stripping off the bark. [Obs.] Ash.
delicacy |1. The state or condition of being delicate; agreeableness to the senses; delightfulness; as, delicacy of flavor, of odor, and the like. What choice to choose for delicacy best. Milton. 2. Nicety or fineness of form, texture, or constitution; softness; elegance; smoothness; tenderness; and hence, frailty or weakness; as, the delicacy of a fiber or a thread; delicacy of a hand or of the human form; delicacy of the skin; delicacy of frame. 3. Nice propriety of manners or conduct; susceptibility or tenderness of feeling; refinement; fastidiousness; and hence, in an exaggerated sense, effeminacy; as, great delicacy of behavior; delicacy in doing a kindness; delicacy of character that unfits for earnest action. You know your mother's delicacy in this point. Cowper. 4. Addiction to pleasure; luxury; daintiness; indulgence; luxurious or voluptuous treatment. And to those dainty limbs which Nature lent For gentle usage and soft delicacy Milton. 5. Nice and refined perception and discrimination; critical niceness; fastidious accuracy. That Augustan delicacy of taste which is the boast of the great public schools of England. Macaulay. 6. The state of being affected by slight causes; sensitiveness; as, the delicacy of a chemist's balance. 7. That which is alluring, delicate, or refined; a luxury or pleasure; something pleasant to the senses, especially to the sense of taste; a dainty; as, delicacies of the table. The merchants of the earth are waxed rich through the abundance of her delicacies. Rev. xviii. 3. 8. Pleasure; gratification; delight. [Obs.] He Rome brent for his delicacie. Chaucer. Syn. -- See Dainty.
delicate |1. Addicted to pleasure; luxurious; voluptuous; alluring. [R.] Dives, for his delicate life, to the devil went. Piers Plowman. Haarlem is a very delicate town. Evelyn. 2. Pleasing to the senses; refinedly; hence, adapted to please a nice or cultivated taste; nice; fine; elegant; as, a delicate dish; delicate flavor. 3. Slight and shapely; lovely; graceful; as, \"a delicate creature.\" Shak. 4. Fine or slender; minute; not coarse; -- said of a thread, or the like; as, delicate cotton. 5. Slight or smooth; light and yielding; -- said of texture; as, delicate lace or silk. 6. Soft and fair; -- said of the skin or a surface; as, a delicate cheek; a delicate complexion. 7. Light, or softly tinted; -- said of a color; as; as, a delicate blue. 8. Refined; gentle; scrupulous not to trespass or offend; considerate; -- said of manners, conduct, or feelings; as, delicate behavior; delicate attentions; delicate thoughtfulness. 9. Tender; not able to endure hardship; feeble; frail; effeminate; -- said of constitution, health, etc.; as, a delicate child; delicate health. A delicate and tender prince. Shak. 10. Requiring careful handling; not to be rudely or hastily dealt with; nice; critical; as, a delicate subject or question. There are some things too delicate and too sacred to be handled rudely without injury to truth. F. W. Robertson. 11. Of exacting tastes and habits; dainty; fastidious. 12. Nicely discriminating or perceptive; refinedly critical; sensitive; exquisite; as, a delicate taste; a delicate ear for music. 13. Affected by slight causes; showing slight changes; as, a delicate thermometer.\n\n1. A choice dainty; a delicacy. [R.] With abstinence all delicates he sees. Dryden. 2. A delicate, luxurious, or effeminate person. All the vessels, then, which our delicates have, -- those I mean that would seem to be more fine in their houses than their neighbors, -- are only of the Corinth metal. Holland.
delicately |In a delicate manner.
delicateness |The quality of being delicate.
delicatessen |Relishes for the table; dainties; delicacies. \"A dealer in delicatessen\".  G. H. Putnam.
delices |Delicacies; delights. [Obs.] \"Dainty delices.\" Spenser.
deliciate |To delight one's self; to indulge in feasting; to revel. [Obs.]
delicious |1. Affording exquisite pleasure; delightful; most sweet or grateful to the senses, especially to the taste; charming. Some delicious landscape. Coleridge. One draught of spring's delicious air. Keble. Were not his words delicious Tennyson. 2. Addicted to pleasure; seeking enjoyment; luxurious; effeminate. [Obs.] Others, lastly, of a more delicious and airy spirit, retire themselves to the enjoyments of ease and luxury. Milton. Syn. -- Delicious, Delightful. Delicious refers to the pleasure derived from certain of the senses, particularly the taste and smell; as, delicious food; a delicious fragrance. Delightful may also refer to most of the senses (as, delightful music; a delightful prospect; delightful sensations), but has a higher application to matters of taste, feeling, and sentiment; as, a delightful abode, conversation, employment; delightful scenes, etc. Like the rich fruit he sings, delicious in decay. Smith. No spring, nor summer, on the mountain seen, Smiles with gay fruits or with delightful green. Addison.
deliciously |Delightfully; as, to feed deliciously; to be deliciously entertained.
deliciousness |1. The quality of being delicious; as, the deliciousness of a repast. 2. Luxury. \"To drive away all superfluity and deliciousness.\" Sir T. North.
delict |An offense or transgression against law; (Scots Law) an offense of a lesser degree; a misdemeanor. Every regulation of the civil code necessarily implies a delict in the event of its violation. Jeffrey.
deligate |To bind up; to bandage.
deligation |A binding up; a bandaging. Wiseman.
delight |1. A high degree of gratification of mind; a high-wrought state of pleasurable feeling; lively pleasure; extreme satisfaction; joy. Sounds and sweet airs, that give delight and hurt not. Shak. A fool hath no delight in understanding. Prov. xviii. 2. 2. That which gives great pleasure or delight. Heaven's last, best gift, my ever new delight. Milton. 3. Licentious pleasure; lust. [Obs.] Chaucer.\n\nTo give delight to; to affect with great pleasure; to please highly; as, a beautiful landscape delights the eye; harmony delights the ear. Inventions to delight the taste. Shak. Delight our souls with talk of knightly deeds. Tennyson.\n\nTo have or take great delight or pleasure; to be greatly pleased or rejoiced; -- followed by an infinitive, or by in. Love delights in praises. Shak. I delight to do thy will, O my God. Ps. xl. 8.
delightable |Capable of delighting; delightful. [Obs.] Many a spice delightable. Rom. of R.
delighted |Endowed with delight. If virtue no delighted beauty lack. Shak. Syn. -- Glad; pleased; gratified. See Glad.
delightedly |With delight; gladly.
delighter |One who gives or takes delight.
delightful |Highly pleasing; affording great pleasure and satisfaction. \"Delightful bowers.\" Spenser. \"Delightful fruit.\" Milton. Syn. -- Delicious; charming. See Delicious. -- De*light\"ful*ly, adv. -- De*light\"ful*ness, n.
delighting |Giving delight; gladdening. -- De*light\"ing*ly, adv. Jer. Taylor.
delightless |Void of delight. Thomson.
delightous |Delightful. [Obs.] Rom. of R.
delightsome |Very pleasing; delightful. \"Delightsome vigor.\" Grew. Ye shall be a delightsome land, . . . saith the Lord. Mal. iii. 12. -- De*light\"some*ly, adv. -- De*light\"some*ness, n.
delignate |1.  To clear or strip of wood (by cutting down trees). [R.] Fuller. 2.  To strip or remove the wood from; as, to delignate ramie, in the preparation of ribbons of the fiber for further working.
delilah |The mistress of Samson, who betrayed him (Judges xvi.); hence, a harlot; a temptress. Other Delilahs on a smaller scale Burns met with during his Dumfries sojourn. J. C. Shairp.
delimit |To fix the limits of; to demarcate; to bound.
delimitation |The act or process of fixing limits or boundaries; limitation. Gladstone.
deline |1. To delineate. [Obs.] 2. To mark out. [Obs.] R. North.
delineable |Capable of being, or liable to be, delineated. Feltham.
delineament |Delineation; sketch. Dr. H. More.
delineate |Delineated; portrayed. [R.]\n\n1. To indicate by lines drawn in the form or figure of; to represent by sketch, design, or diagram; to sketch out; to portray; to picture; in drawing and engraving, to represent in lines, as with the pen, pencil, or graver; hence, to represent with accuracy and minuteness. See Delineation. Adventurous to delineate nature's form. Akenside. 2. To portray to the mind or understanding by words; to set forth; to describe. Customs or habits delineated with great accuracy. Walpole.
delineation |1. The act of representing, portraying, or describing, as by lines, diagrams, sketches, etc.; drawing an outline; as, the delineation of a scene or face; in drawing and engraving, representation by means of lines, as distinguished from representation by means of tints shades; accurate and minute representation, as distinguished from art that is careless of details, or subordinates them excessively. 2. A delineated picture; representation; sketch; description in words. Their softest delineations of female beauty. W. Irving. Syn. -- Sketch; portrait; outline. See Sketch.
delineator |1. One who, or that which, delineates; a sketcher. 2. (Surv.)  A perambulator which records distances and delineates a profile, as of a road.
delineatory |That delineates; descriptive; drawing the outline; delineating.
delineature |Delineation. [Obs.]
delinition |A smearing. [Obs.] Dr. H. More.
delinquency |Failure or omission of duty; a fault; a misdeed; an offense; a misdemeanor; a crime. The delinquencies of the little commonwealth would be represented in the most glaring colors. Motley.
delinquent |Failing in duty; offending by neglect of duty.\n\nOne who fails or neglects to perform his duty; an offender or transgressor; one who commits a fault or a crime; a culprit. A delinquent ought to be cited in the place or jurisdiction where the delinquency was committed. Ayliffe.
delinquently |So as to fail in duty.
deliquate |To melt or be dissolved; to deliquesce. [Obs.] Boyle.\n\nTo cause to melt away; to dissolve; to consume; to waste. [Obs.] Dilapidating, or rather deliquating, his bishopric. Fuller.
deliquation |A melting. [Obs.]
deliquesce |To dissolve gradually and become liquid by attracting and absorbing moisture from the air, as certain salts, acids, and alkalies. In very moist air crystals of strontites deliquesce. Black.
deliquescence |The act of deliquescing or liquefying; process by which anything deliquesces; tendency to melt.
deliquescent |1. Dissolving; liquefying by contact with the air; capable of attracting moisture from the atmosphere and becoming liquid; as, deliquescent salts. 2. (Bot.)  Branching so that the stem is lost in branches, as in most deciduous trees. Gray.
deliquiate |To melt and become liquid by absorbing water from the air; to deliquesce. Fourcroy.
deliquiation |The act of deliquating.
deliquium |1. (Chem.)  A melting or dissolution in the air, or in a moist place; a liquid condition; as, a salt falls into a deliquium. [R.] 2. A sinking away; a swooning. [Obs.] Bacon. 3. A melting or maudlin mood. Carlyle.
deliracy |Delirium. [Obs.]
delirament |A wandering of the mind; a crazy fancy. [Obs.] Heywood.
delirancy |Delirium. [Obs.] Gauden.
delirant |Delirious. [Obs.] Owen.
delirate |To madden; to rave. [Obs.] An infatuating and delirating spirit in it. Holland.
deliration |Aberration of mind; delirium. J. Motley. Deliration or alienation of the understanding. Mede.
deliriant |A poison which occasions a persistent delirium, or mental aberration (as belladonna).
delirifacient |Producing, or tending to produce, delirium. -- n.  Any substance which tends to cause delirium.
delirious |Having a delirium; wandering in mind; light-headed; insane; raving; wild; as, a delirious patient; delirious fancies. -- De*lir\"i*ous*ly, adv. -- De*lir\"i*ous*ness, n.
delirium |1. (Med.)  A state in which the thoughts, expressions, and actions are wild, irregular, and incoherent; mental aberration; a roving or wandering of the mind, -- usually dependent on a fever or some other disease, and so distinguished from mania, or madness. 2. Strong excitement; wild enthusiasm; madness. The popular delirium [of the French Revolution] at first caught his enthusiastic mind. W. Irving. The delirium of the preceding session (of Parliament). Motley. Delirium tremens (. Etym: [L., trembling delirium] (Med.), a violent delirium induced by the excessive and prolonged use of intoxicating liquors. -- Traumatic delirium (Med.), a variety of delirium following injury. Syn. -- Insanity; frenzy; madness; derangement; aberration; mania; lunacy; fury. See Insanity.
delit |Delight. [Obs.] Chaucer.
delitable |Delightful; delectable. [Obs.]
delitescence |1. Concealment; seclusion; retirement. The delitescence of mental activities. Sir W. Hamilton. 2. (Med.)  The sudden disappearance of inflammation.
delitescency |Concealment; seclusion. The mental organization of the novelist must be characterized, to speak craniologically, by an extraordinary development of the passion for delitescency. Sir W. Scott.
delitescent |Lying hid; concealed.
delitigate |To chide; to rail heartily. [Obs.]
delitigation |Chiding; brawl. [Obs.]
deliver |1. To set free from restraint; to set at liberty; to release; to liberate, as from control; to give up; to free; to save; to rescue from evil actual or feared; -- often with from or out of; as, to deliver one from captivity, or from fear of death. He that taketh warning shall deliver his soul. Ezek. xxxiii. 5. Promise was that I Should Israel from Philistian yoke deliver. Milton. 2. To give or transfer; to yield possession or control of; to part with (to); to make over; to commit; to surrender; to resign; -- often with up or over, to or into. Thou shalt deliver Pharaoh's cup into his hand. Gen. xl. 13. The constables have delivered her over. Shak. The exalted mind All sense of woe delivers to the wind. Pope. 3. To make over to the knowledge of another; to communicate; to utter; to speak; to impart. Till he these words to him deliver might. Spenser. Whereof the former delivers the precepts of the art, and the latter the perfection. Bacon. 4. To give forth in action or exercise; to discharge; as, to deliver a blow; to deliver a broadside, or a ball. Shaking his head and delivering some show of tears. Sidney. An uninstructed bowler . . . thinks to attain the jack by delivering his bowl straightforward. Sir W. Scott. 5. To free from, or disburden of, young; to relieve of a child in childbirth; to bring forth; -- often with of. She was delivered safe and soon. Gower. Tully was long ere he could be delivered of a few verses, and those poor ones. Peacham. 6. To discover; to show. [Poetic] I 'll deliver Myself your loyal servant. Shak. 7. To deliberate. [Obs.] Chaucer. 8. To admit; to allow to pass. [Obs.] Bacon. Syn. -- To Deliver, Give Forth, Discharge, Liberate, Pronounce, Utter. Deliver denotes, literally, to set free. Hence the term is extensively applied to cases where a thing is made to pass from a confined state to one of greater freedom or openness. Hence it may, in certain connections, be used as synonymous with any or all of the above-mentioned words, as will be seen from the following examples: One who delivers a package gives it forth; one who delivers a cargo discharges it; one who delivers a captive liberates him; one who delivers a message or a discourse utters or pronounces it; when soldiers deliver their fire, they set it free or give it forth.\n\nFree; nimble; sprightly; active. [Obs.] Wonderly deliver and great of strength. Chaucer.
deliverable |Capable of being, or about to be, delivered; necessary to be delivered. Hale.
deliverance |1. The act of delivering or freeing from restraint, captivity, peril, and the like; rescue; as, the deliverance of a captive. He hath sent me to heal the broken-hearted, to preach deliverance to the captives. Luke iv. 18. One death or one deliverance we will share. Dryden. 2. Act of bringing forth children. [Archaic] Shak. 3. Act of speaking; utterance. [Archaic] Shak. Note: In this and in the preceding sense delivery is the word more commonly used. 4. The state of being delivered, or freed from restraint. I do desire deliverance from these officers. Shak. 5. Anything delivered or communicated; esp., an opinion or decision expressed publicly. [Scot.] 6. (Metaph.)  Any fact or truth which is decisively attested or intuitively known as a psychological or philosophical datum; as, the deliverance of consciousness.
deliverer |1. One who delivers or rescues; a preserver. 2. One who relates or communicates.
deliveress |A female de [R.] Evelyn.
deliverly |Actively; quickly; nimbly. [Obs.] Swim with your bodies, And carry it sweetly and deliverly. Beau. & Fl.
deliverness |Nimbleness; agility. [Obs.]
delivery |1. The act of delivering from restraint; rescue; release; liberation; as, the delivery of a captive from his dungeon. 2. The act of delivering up or over; surrender; transfer of the body or substance of a thing; distribution; as, the delivery of a fort, of hostages, of a criminal, of goods, of letters. 3. The act or style of utterance; manner of speaking; as, a good delivery; a clear delivery. 4. The act of giving birth; parturition; the expulsion or extraction of a fetus and its membranes. 5. The act of exerting one's strength or limbs. Neater limbs and freer delivery. Sir H. Wotton. 6. The act or manner of delivering a ball; as, the pitcher has a swift delivery.
dell |1. A small, retired valley; a ravine. In dells and dales, concealed from human sight. Tickell. 2. A young woman; a wench. [Obs.] Sweet doxies and dells. B. Jonson.
della crusca |A shortened form of Academia della Crusca, an academy in Florescence, Italy, founded in the 16th century, especially for conversing the purity of the Italian language. Note: The Accademia della Crusca (literally, academy of the bran or chaff) was so called in allusion to its chief object of bolting or purifying the national language.
dellacruscan |Of or pertaining to the Accademia della Crusca in Florence. The Dellacruscan School, a name given in satire to a class of affected English writers, most of whom lived in Florence, about a. d. 1785.
deloo |The duykerbok.
deloul |A special breed of the dromedary used for rapid traveling; the swift camel; -- called also herire, and maharik.
delph |Delftware. Five nothings in five plates of delph. Swift.\n\nThe drain on the land side of a sea embankment. Knight.
delphian |Delphic.
delphic |1. Of or relating to Delphi, or to the famous oracle of that place. 2. Ambiguous; mysterious. \"If he is silent or delphic.\" New York Times.
delphin |Pertaining to the dauphin of France; as, the Delphin classics, an edition of the Latin classics, prepared in the reign of Louis XIV., for the use of the dauphin (in usum Delphini).\n\nA fatty substance contained in the oil of the dolphin and the porpoise; -- called also phocenin.
delphine |Pertaining to the dauphin of France; as, the Delphin classics, an edition of the Latin classics, prepared in the reign of Louis XIV., for the use of the dauphin (in usum Delphini).\n\nPertaining to the dolphin, a genus of fishes.
delphinic |Pertaining to, or derived from, the dolphin; phocenic. Delphinic acid. (Chem.) See Valeric acid, under Valeric. [Obs.]\n\nPertaining to, or derived from, the larkspur; specifically, relating to the stavesacre (Delphinium staphisagria).
delphinine |A poisonous alkaloid extracted from the stavesacre (Delphinium staphisagria), as a colorless amorphous powder.
delphinoid |Pertaining to, or resembling, the dolphin.
delphinoidea |The division of Cetacea which comprises the dolphins, porpoises, and related forms.
delphinus |1. (Zoöl.)  A genus of Cetacea, including the dolphin. See Dolphin, 1. 2. (Astron.)  The Dolphin, a constellation near the equator and east of Aquila.
delsarte |A system of calisthenics patterned on the theories of François Delsarte (1811 -- 71), a French teacher of dramatic and musical expression.
delsarte system |A system of calisthenics patterned on the theories of François Delsarte (1811 -- 71), a French teacher of dramatic and musical expression.
delta |A tract of land shaped like the letter delta (as, the delta of the Ganges, of the Nile, or of the Mississippi.
delta connection |One of the usual forms or methods for connecting apparatus to a three-phase circuit, the three corners of the delta or triangle, as diagrammatically represented, being connected to the three wires of the supply circuit.
delta current |The current flowing through a delta connection.
deltafication |The formation of a delta or of deltas. [R.]
deltaic |Relating to, or like, a delta.
delthyris |A name formerly given to certain Silurian brachiopod shells of the genus Spirifer. Delthyris limestone (Geol.), one of the divisions of the Upper Silurian rocks in New York.
deltic |Deltaic.
deltidium |The triangular space under the beak of many brachiopod shells.
deltohedron |A solid bounded by twelve quadrilateral faces. It is a hemihedral form of the isometric system, allied to the tetrahedron.
deltoid |Shaped like the Greek Deltoid leaf (Bot.), a leaf in the form of a triangle with the stem inserted at the middle of the base. -- Deltoid muscle (Anat.), a triangular muscle in the shoulder which serves to move the arm directly upward.
deludable |Capable of being deluded; liable to be imposed on gullible. Sir T. Browne.
delude |1. To lead from truth or into error; to mislead the mind or judgment of to beguile; to impose on; to dupe; to make a fool of. To delude the nation by an airy phantom. Burke. 2. To frustrate or disappoint. It deludes thy search. Dryden. Syn. -- To mislead; deceive; beguile; cajole; cheat; dupe. See Deceive.
deluder |One who deludes; a deceiver; an impostor.
deluge |1. A washing away; an overflowing of the land by water; an inundation; a flood; specifically, The Deluge, the great flood in the days of Noah (Gen. vii.). 2. Fig.: Anything which overwhelms, or causes great destruction. \"The deluge of summer.\" Lowell. A fiery deluge fed With ever-burning sulphur unconsumed. Milton. As I grub up some quaint old fragment of a [London] street, or a house, or a shop, or tomb or burial ground, which has still survived in the deluge. F. Harrison. After me the deluge. (Aprés moi le déluge.) Madame de Pompadour.\n\n1. To overflow with water; to inundate; to overwhelm. The deluged earth would useless grow. Blackmore. 2. To overwhelm, as with a deluge; to cover; to overspread; to overpower; to submerge; to destroy; as, the northern nations deluged the Roman empire with their armies; the land is deluged with woe. At length corruption, like a general fldeluge all. Pope.
delundung |An East Indian carnivorous mammal (Prionodon gracilis), resembling the civets, but without scent pouches. It is handsomely spotted.
delusion |1. The act of deluding; deception; a misleading of the mind. Pope. 2. The state of being deluded or misled. 3. That which is falsely or delusively believed or propagated; false belief; error in belief. And fondly mourned the dear delusion gone. Prior. Syn. -- Delusion, Illusion. These words both imply some deception practiced upon the mind. Delusion is deception from want of knowledge; illusion is deception from morbid imagination. An illusion is a false show, a mere cheat on the fancy or senses. It is, in other words, some idea or image presented to the bodily or mental vision which does not exist in reality. A delusion is a false judgment, usually affecting the real concerns of life. Or, in other words, it is an erroneous view of something which exists indeed, but has by no means the qualities or attributes ascribed to it. Thus we speak of the illusions of fancy, the illusions of hope, illusive prospects, illusive appearances, etc. In like manner, we speak of the delusions of stockjobbing, the delusions of honorable men, delusive appearances in trade, of being deluded by a seeming excellence. \"A fanatic, either religious or political, is the subject of strong delusions; while the term illusion is applied solely to the visions of an uncontrolled imagination, the chimerical ideas of one blinded by hope, passion, or credulity, or lastly, to spectral and other ocular deceptions, to which the word delusion is never applied.\" Whately.
delusional |Of or pertaining to delusions; as, delusional monomania.
delusive |Apt or fitted to delude; tending to mislead the mind; deceptive; beguiling; delusory; as, delusive arts; a delusive dream. Delusive and unsubstantial ideas. Whewell. -- De*lu\"sive*ly, adv. -- De*lu\"sive*ness, n.
delusory |Delusive; fallacious. Glanvill.
delve |1. To dig; to open (the ground) as with a spade. Delve of convenient depth your thrashing flooDryden. 2. To dig into; to penetrate; to trace out; to fathom. I can not delve him to the root. Shak.\n\nTo dig or labor with a spade, or as with a spade; to labor as a drudge. Delve may I not: I shame to beg. Wyclif (Luke xvi. 3).\n\nA place dug; a pit; a ditch; a den; a cave. Which to that shady delve him brought at last The very tigers from their delves Look out. Moore.
delver |One who digs, as with a spade.
demagnetize |1. To deprive of magnetic properties. See Magnetize. If the bar be rapidly magnetized and demagnetized. A. Cyc. 2. To free from mesmeric influence; to demesmerize. -- De*mag`net*i*za\"tion, n. -- De*mag\"net*i`zer, n.
demagog |Demagogue.
demagogic |Relating to, or like, a demagogue; factious.
demagogical |Relating to, or like, a demagogue; factious.
demagogism |The practices of a demagogue.
demagogue |A leader of the rabble; one who attempts to control the multitude by specious or deceitful arts; an unprincipled and factious mob orator or political leader.
demagogy |Demagogism.
demain |1. Rule; management. [Obs.] Chaucer. 2. (Law)  See Demesne.
demand |1. To ask or call for with authority; to claim or seek from, as by authority or right; to claim, as something due; to call for urgently or peremptorily; as, to demand a debt; to demand obedience. This, in our foresaid holy father's name, Pope Innocent, I do demand of thee. Shak. 2. To inquire authoritatively or earnestly; to ask, esp. in a peremptory manner; to question. I did demand what news from Shrewsbury. Shak. 3. To require as necessary or useful; to be in urgent need of; hence, to call for; as, the case demands care. 4. (Law)  To call into court; to summon. Burrill.\n\nTo make a demand; to inquire. The soldiers likewise demanded of him, saying, And what shall we do Luke iii. 14.\n\n1. The act of demanding; an asking with authority; a peremptory urging of a claim; a claiming or challenging as due; requisition; as, the demand of a creditor; a note payable on demand. The demand [is] by the word of the holy ones. Dan. iv. 17. He that has confidence to turn his wishes into demands will be but a little way from thinking he ought to obtain them. Locke. 2. Earnest inquiry; question; query. Shak. 3. A diligent seeking or search; manifested want; desire to posses; request; as, a demand for certain goods; a person's company is in great demand. In 1678 came forth a second edition [Pilgrim's Progress] with additions; and the demand became immense. Macaulay. 4. That which one demands or has a right to demand; thing claimed as due; claim; as, demands on an estate. 5. (Law) (a) The asking or seeking for what is due or claimed as due. (b) The right or title in virtue of which anything may be claimed; as, to hold a demand against a person. (c) A thing or amount claimed to be due.
demandable |That may be demanded or claimed. \"All sums demandable.\" Bacon.
demandant |One who demands; the plaintiff in a real action; any plaintiff.
demander |One who demands.
demandress |A woman who demands.
demantoid |A yellow-green, transparent variety of garnet found in the Urals. It is valued as a gem because of its brilliancy of luster, whence the name.
demarcate |To mark by bounds; to set the limits of; to separate; to discriminate. Wilkinson.
demarcation |The act of marking, or of ascertaining and setting a limit; separation; distinction. The speculative line of demarcation, where obedience ought to end and resistance must begin, is faint, obscure, and not easily definable. Burke.
demarch |March; walk; gait. [Obs.]\n\nA chief or ruler of a deme or district in Greece.
demarkation |Same as Demarcation.
dematerialize |To deprive of material or physical qualities or characteristics. Dematerializing matter by stripping if of everything which . . . has distinguished matter. Milman.
deme |1. (Gr. Antiq.)  A territorial subdivision of Attica (also of modern Greece), corresponding to a township. Jowett (Thucyd). 2. (Biol.)  An undifferentiated aggregate of cells or plastids.
demean |1. To manage; to conduct; to treat. [Our] clergy have with violence demeaned the matter. Milton. 2. To conduct; to behave; to comport; -- followed by the reflexive pronoun. They have demeaned themselves Like men born to renown by life or death. Shak. They answered . . . that they should demean themselves according to their instructions. Clarendon. 3. To debase; to lower; to degrade; -- followed by the reflexive pronoun. Her son would demean himself by a marriage with an artist's daughter. Thackeray. Note: This sense is probably due to a false etymology which regarded the word as connected with the adjective mean.\n\n1. Management; treatment. [Obs.] Vile demean and usage bad. Spenser. 2. Behavior; conduct; bearing; demeanor. [Obs.] With grave demean and solemn vanity. West.\n\n1. Demesne. [Obs.] 2. pl.  Resources; means. [Obs.] You know How narrow our demeans are. Massinger.
demeanance |Demeanor. [Obs.] Skelton.
demeanor |1. Management; treatment; conduct. [Obs.] God commits the managing so great a trust . . . wholly to the demeanor of every grown man. Milton. 2. Behavior; deportment; carriage; bearing; mien. His demeanor was singularly pleasing. Macaulay. The men, as usual, liked her artless kindness and simple refined demeanor. Thackeray.
demeanure |Behavior. [Obs.] Spenser.
demency |Dementia; loss of mental powers. See Insanity.
dement |To deprive of reason; to make mad. [R.] Bale.\n\nDemented; dementate. [R.] J. H. Newman.
dementate |Deprived of reason. Arise, thou dementate sinner! Hammond.\n\nTo deprive of reason; to dement. [R.] Burton.
dementation |The act of depriving of reason; madness. Whitlock.
demented |Insane; mad; of unsound mind. -- De*ment\"ed*ness, n.
dementia |Insanity; madness; esp. that form which consists in weakness or total loss of thought and reason; mental imbecility; idiocy.
demephitize |To purify from mephitic. -- De*meph`i*ti*za\"tion, n.
demerge |To plunge down into; to sink; to immerse. [Obs.] The water in which it was demerged. Boyle.
demerit |1. That which one merits or deserves, either of good or ill; desert. [Obs.] By many benefits and demerits whereby they obliged their adherents, [they] acquired this reputation. Holland. 2. That which deserves blame; ill desert; a fault; a vice; misconduct; -- the opposite of Ant: merit. They see no merit or demerit in any man or any action. Burke. Secure, unless forfeited by any demerit or offense. Sir W. Temple. 3. The state of one who deserves ill.\n\n1. To deserve; -- said in reference to both praise and blame. [Obs.] If I have demerited any love or thanks. Udall. Executed as a traitor . . . as he well demerited. State Trials (1645). 2. To depreciate or cry down. [R.] Bp. Woolton.\n\nTo deserve praise or blame.
demerse |To immerse. [Obs.] Boyle.
demersed |Situated or growing under water, as leaves; submersed.
demersion |1. The act of plunging into a fluid; a drowning. 2. The state of being overwhelmed in water, or as if in water. Ray.
demesmerize |To relieve from mesmeric influence. See Mesmerize.
demesne |A lord's chief manor place, with that part of the lands belonging thereto which has not been granted out in tenancy; a house, and the land adjoining, kept for the proprietor's own use. [Written also demain.] Wharton's Law Dict. Burrill. Ancient demesne. (Eng. Law) See under Ancient.
demesnial |Of or pertaining to a demesne; of the nature of a demesne.
demi |See Demy, n.
demi- |A prefix, signifying half.
demi-island |Peninsula. [Obs.] Knolles.
demi-rilievo |(a) Half relief; sculpture in relief of which the figures project from the background by one half their full roundness. (b) A work of sculpture of the above character. See Alto-rilievo.
demi-tasse |A small cup for, or of, black coffee.
demibastion |A half bastion, or that part of a bastion consisting of one face and one flank.
demibrigade |A half brigade.
demicadence |An imperfect or half cadence, falling on the dominant instead of on the key note.
demicannon |A kind of ordnance, carrying a ball weighing from thirty to thirty-six pounds. Shak.
demicircle |An instrument for measuring angles, in surveying, etc. It resembles
demiculverin |A kind of ordnance, carrying a ball weighing from nine to thirteen pounds.
demideify |To deify in part. Cowper.
demidevil |A half devil. Shak.
demigod |A half god, or an inferior deity; a fabulous hero, the offspring of a deity and a mortal.
demigoddess |A female demigod.
demigorge |Half the gorge, or entrance into a bastion, taken from the angle of the flank to the center of the bastion.
demigrate |To emigrate. [Obs.] Cockeram.
demigration |Emigration. [Obs.] Bp. Hall.
demigroat |A half groat.
demijohn |A glass vessel or bottle with a large body and small neck, inclosed in wickerwork.
demilance |A light lance; a short spear; a half pike; also, a demilancer.
demilancer |A soldier of light cavalry of the 16th century, who carried a demilance.
demilune |1. (Fort.)  A work constructed beyond the main ditch of a fortress, and in front of the curtain between two bastions, intended to defend the curtain; a ravelin. See Ravelin. 2. (Physiol.)  A crescentic mass of granular protoplasm present in the salivary glands. Note: Each crescent is made of polyhedral cells which under some circumstances are supposed to give rise to new salivary cells.
demiman |A half man. [R.] Knolles.
demimonde |Persons of doubtful reputation; esp., women who are kept as mistresses, though not public prostitutes; demireps. Literary demimonde, writers of the lowest kind.
deminatured |Having half the nature of another. [R.] Shak.
demiquaver |A note of half the length of the quaver; a semiquaver. [R.]
demirelief |Half relief. See Demi-rilievo.
demirelievo |Half relief. See Demi-rilievo.
demirep |A woman of doubtful reputation or suspected character; an adventuress. [Colloq.] De Quincey.
demisability |The state of being demisable.
demisable |Capable of being leased; as, a demisable estate.
demise |1. Transmission by formal act or conveyance to an heir or successor; transference; especially, the transfer or transmission of the crown or royal authority to a successor. 2. The decease of a royal or princely person; hence, also, the death of any illustrious person. After the demise of the Queen [of George II.], in 1737, they [drawing-rooms] were held but twice a week. P. Cunningham. 3. (Law)  The conveyance or transfer of an estate, either in fee for life or for years, most commonly the latter. Bouvier. Note: The demise of the crown is a transfer of the crown, royal authority, or kingdom, to a successor. Thus, when Edward IV. was driven from his throne for a few months by the house of Lancaster, this temporary transfer of his dignity was called a demise. Thus the natural death of a king or queen came to be denominated a demise, as by that event the crown is transferred to a successor. Blackstone. Demise and redemise, a conveyance where there are mutual leases made from one to another of the same land, or something out of it. Syn. -- Death; decease; departure. See Death.\n\n1. To transfer or transmit by succession or inheritance; to grant or bestow by will; to bequeath. \"Power to demise my lands.\" Swift. What honor Canst thou demise to any child of mine Shak. 2. To convey; to give. [R.] His soul is at his conception demised to him. Hammond. 3. (Law)  To convey, as an estate, be lease; to lease.
demisemiquaver |A short note, equal in time to the half of a semiquaver, or the thirty-second part of a whole note.
demiss |Cast down; humble; submissive. [Obs.] He down descended like a most demiss And abject thrall. Spenser.
demission |1. The act of demitting, or the state of being demitted; a letting down; a lowering; dejection. \"Demission of mind.\" Hammond. Demission of sovereign authority. L'Estrange. 2. Resignation of an office. [Scot.]
demissionary |1. Pertaining to transfer or conveyance; as, a demissionary deed. 2. Tending to lower, depress, or degrade.
demissive |Downcast; submissive; humble. [R.] They pray with demissive eyelids. Lord (1630).
demissly |In a humble manner. [Obs.]
demisuit |A suit of light armor covering less than the whole body, as having no protection for the legs below the things, no vizor to the helmet, and the like.
demit |1. To let fall; to depress. [R.] They [peacocks] demit and let fall the same [i. e., their train]. Sir T. Browne. 2. To yield or submit; to humble; to lower; as, to demit one's self to humble duties. [R.] 3. To lay down, as an office; to resign. [Scot.] General Conway demitted his office. Hume.
demitint |(a) That part of a painting, engraving, or the like, which is neither in full darkness nor full light. (b) The shade itself; neither the darkest nor the lightest in a composition. Also called half tint.
demitone |Semitone. [R.]
demiurge |1. (Gr. Antiq.)  The chief magistrate in some of the Greek states. 2. God, as the Maker of the world. 3. According to the Gnostics, an agent or one employed by the Supreme Being to create the material universe and man.
demiurgic |Pertaining to a demiurge; formative; creative. \"Demiurgic power.\" De Quincey.
demivill |A half-vill, consisting of five freemen or frankpledges. Blackstone.
demivolt |A half vault; one of the seven artificial motions of a horse, in which he raises his fore legs in a particular manner.
demiwolf |A half wolf; a mongrel dog, between a dog and a wolf.
demobilization |The disorganization or disarming of troops which have previously been mobilized or called into active service; the change from a war footing to a peace footing.
demobilize |To disorganize, or disband and send home, as troops which have been mobilized.
democracy |1. Government by the people; a form of government in which the supreme power is retained and directly exercised by the people. 2. Government by popular representation; a form of government in which the supreme power is retained by the people, but is indirectly exercised through a system of representation and delegated authority periodically renewed; a constitutional representative government; a republic. 3. Collectively, the people, regarded as the source of government. Milton. 4. The principles and policy of the Democratic party, so called. [U.S.]
democrat |1. One who is an adherent or advocate of democracy, or government by the people. Whatever they call him, what care I, Aristocrat, democrat, autocrat. Tennyson. 2. A member of the Democratic party. [U.S.]
democratic |1. Pertaining to democracy; favoring democracy, or constructed upon the principle of government by the people. 2. Relating to a political party so called. 3. Befitting the common people; -- opposed to aristocratic. The Democratic party, the name of one of the chief political parties in the United States.
democratical |Democratic. The democratical was democratically received. Algernon Sidney.
democratically |In a democratic manner.
democratism |The principles or spirit of a democracy. [R.]
democratist |A democrat. [R.] Burke.
democratize |To render democratic.
democraty |Democracy. [Obs.] Milton.
demogorgon |, A mysterious, terrible, and evil divinity, regarded by some as the author of creation, by others as a great magician who was supposed to command the spirits of the lower world. See Gorgon. Orcus and Ades, and the dreaded name Of Demogorgon. Milton.
demography |The study of races, as to births, marriages, mortality, health, etc. -- Dem`o*graph\"ic, a.
demoiselle |1. A young lady; a damsel; a lady's maid. 2. (Zoöl.)  The Numidian crane (Antropoides virgo); -- so called on account of the grace and symmetry of its form and movements. 3. (Zoöl.)  A beautiful, small dragon fly of the genus Agrion.
demolish |To throw or pull down; to raze; to destroy the fabric of; to pull to pieces; to ruin; as, to demolish an edifice, or a wall. I expected the fabric of my book would long since have been demolished, and laid even with the ground. Tillotson. Syn. -- To Demolish, Overturn, Destroy, Dismantle, Raze. That is overturned or overthrown which had stood upright; that is destroyed whose component parts are scattered; that is demolished which had formed a mass or structure; that is dismantled which is stripped of its covering, as a vessel of its sails, or a fortress of its bastions, etc.; that is razed which is brought down smooth, and level to the ground. An ancient pillar is overturned or overthrown as the result of decay; as city is destroyed by an invasion of its enemies; a monument, the walls of a castle, a church, or any structure, real or imaginary, may be demolished; a fortress may be dismantled from motives of prudence, in order to render it defenseless; a city may be razed by way of punishment, and its ruins become a memorial of vengeance.
demolisher |One who, or that which, demolishes; as, a demolisher of towns.
demolishment |Demolition.
demolition |The act of overthrowing, pulling down, or destroying a pile or structure; destruction by violence; utter overthrow; -- opposed to construction; as, the demolition of a house, of military works, of a town, or of hopes.
demolitionist |A demolisher. [R.] Carlyle.
demon |1. (Gr. Antiq.)  A spirit, or immaterial being, holding a middle place between men and deities in pagan mythology. The demon kind is of an inSydenham. 2. One's genius; a tutelary spirit or internal voice; as, the demon of Socrates. [Often written dæmon.] 3. An evil spirit; a devil. That same demon that hath gulled thee thus. Shak.
demoness |A female demon.
demonetization |The act of demonetizing, or the condition of being demonetized.
demonetize |To deprive of current value; to withdraw from use, as money. They [gold mohurs] have been completely demonetized by the [East India] Company. R. Cobden.
demoniac |1. Pertaining to, or characteristic of, a demon or evil spirit; devilish; as, a demoniac being; demoniacal practices. Sarcastic, demoniacal laughter. Thackeray. 2. Influenced or produced by a demon or evil spirit; as, demoniac or demoniacal power. \"Demoniac frenzy.\" Milton.\n\n1. A human being possessed by a demon or evil spirit; one whose faculties are directly controlled by a demon. The demoniac in the gospel was sometimes cast into the fire. Bates. 2. (Eccl. Hist.)  One of a sect of Anabaptists who maintain that the demons or devils will finally be saved.
demoniacal |1. Pertaining to, or characteristic of, a demon or evil spirit; devilish; as, a demoniac being; demoniacal practices. Sarcastic, demoniacal laughter. Thackeray. 2. Influenced or produced by a demon or evil spirit; as, demoniac or demoniacal power. \"Demoniac frenzy.\" Milton.
demoniacally |In a demoniacal manner.
demoniacism |The state of being demoniac, or the practices of demoniacs.
demonial |Of or pertaining to a demon. [Obs.] Cudworth.
demonian |Relating to, or having the nature of, a demon. \"Demonian spirits.\" Milton.
demonianism |The state of being possessed by a demon or by demons.
demoniasm |See Demonianism. [R.]
demonic |Of or pertaining to a demon or to demons; demoniac. \"Demonic ambushes.\" Lowell.
demonism |The belief in demons or false gods. The established theology of the heathen world . . . rested upon the basis of demonism. Farmer.
demonist |A believer in, or worshiper of, demons.
demonize |1. To convert into a demon; to infuse the principles or fury of a demon into. 2. To control or possess by a demon.
demonocracy |The power or government of demons. A demonocracy of unclean spirits. H. Taylor.
demonographer |A demonologist. [R.] Am. Cyc.
demonolatry |The worship of demons.
demonologer |One versed in demonology. R. North.
demonologic |Of or Pertaining to demonology.
demonological |Of or Pertaining to demonology.
demonologist |One who writes on, or is versed in, demonology.
demonology |A treatise on demons; a supposititious science which treats of demons and their manifestations. Sir W. Scott.
demonomagy |Magic in which the aid of demons is invoked; black or infernal magic. Bp. Hurd.
demonomania |A form of madness in which the patient conceives himself possessed of devils.
demonomist |One in subjection to a demon, or to demons. [R.] Sir T. Herbert.
demonomy |The dominion of demons. [R.] Sir T. Herbert.
demonry |Demoniacal influence or possession. J. Baillie.
demonship |The state of a demon. Mede.
demonstrability |The quality of being demonstrable; demonstrableness.
demonstrable |1. Capable of being demonstrated; that can be proved beyond doubt or question. The grand articles of our belief are as demonstrable as geometry. Glanvill. 2. Proved; apparent. [Obs.] Shak.
demonstrableness |The quality of being demonstrable; demonstrability.
demonstrably |In a demonstrable manner; incontrovertibly; clearly. Cases that demonstrably concerned the public cause. Clarendon.
demonstrance |Demonstration; proof. [Obs.] Holland.
demonstrate |1. To point out; to show; to exhibit; to make evident. Shak. 2. To show, or make evident, by reasoning or proof; to prove by deduction; to establish so as to exclude the possibility of doubt or denial. We can not demonstrate these things so as to show that the contrary often involves a contradiction. Tillotson. 3. (Anat.)  To exhibit and explain (a dissection or other anatomical preparation).
demonstrater |See Demonstrator.
demonstration |1. The act of demonstrating; an exhibition; proof; especially, proof beyond the possibility of doubt; indubitable evidence, to the senses or reason. Those intervening ideas which serve to show the agreement of any two others are called \"proofs;\" and where agreement or disagreement is by this means plainly and clearly perceived, it is called demonstration. Locke. 2. An expression, as of the feelings, by outward signs; a manifestation; a show. Did your letters pierce the queen to any demonstration of grief Shak. Loyal demonstrations toward the prince. Prescott. 3. (Anat.)  The exhibition and explanation of a dissection or other anatomical preparation. 4. (Mil.) a decisive exhibition of force, or a movement indicating an attack. 5. (Logic)  The act of proving by the syllogistic process, or the proof itself. 6. (Math.)  A course of reasoning showing that a certain result is a necessary consequence of assumed premises; -- these premises being definitions, axioms, and previously established propositions. Direct, or Positive, demonstration (Logic & Math.), one in which the correct conclusion is the immediate sequence of reasoning from axiomatic or established premises; -- opposed to Indirect, or Negative, demonstration (called also reductio ad absurdum), in which the correct conclusion is an inference from the demonstration that any other hypothesis must be incorrect.
demonstrative |1. Having the nature of demonstration; tending to demonstrate; making evident; exhibiting clearly or conclusively. \"Demonstrative figures.\" Dryden. An argument necessary and demonstrative. Hooker. 2. Expressing, or apt to express, much; displaying feeling or sentiment; as, her nature was demonstrative. 3. Consisting of eulogy or of invective. \"Demonstrative eloquence.\" Blair. Demonstrative pronoun (Gram.), a pronoun distinctly designating that to which it refers.\n\nA demonstrative pronoun; as, \"this\" and \"that\" are demonstratives.
demonstratively |In a manner fitted to demonstrate; clearly; convincingly; forcibly.
demonstrativeness |The state or quality of being demonstrative.
demonstrator |1. One who demonstrates; one who proves anything with certainty, or establishes it by indubitable evidence. 2. (Anat.)  A teacher of practical anatomy.
demonstratory |Tending to demonstrate; demonstrative. Johnson.
demorage |Demurrage. [Obs.] Pepys (1663).
demoralization |The act of corrupting or subverting morals. Especially: The act of corrupting or subverting discipline, courage, hope, etc., or the state of being corrupted or subverted in discipline, courage, etc.; as, the demoralization of an army or navy.
