diagraph |A drawing instrument, combining a protractor and scale.
diagraphic |Descriptive.
diagraphical |Descriptive.
diagraphics |The art or science of descriptive drawing; especially, the art or science of drawing by mechanical appliances and mathematical rule.
diaheliotropic |Relating or, or manifesting, diaheliotropism.
diaheliotropism |A tendency of leaves or other organs of plants to have their dorsal surface faced towards the rays of light.
dial |1. An instrument, formerly much used for showing the time of day from the shadow of a style or gnomon on a graduated arc or surface; esp., a sundial; but there are lunar and astral dials. The style or gnomon is usually parallel to the earth's axis, but the dial plate may be either horizontal or vertical. 2. The graduated face of a timepiece, on which the time of day is shown by pointers or hands. 3. A miner's compass. Dial bird (Zoöl.), an Indian bird (Copsychus saularius), allied to the European robin. The name is also given to other related species. -- Dial lock, a lock provided with one or more plates having numbers or letters upon them. These plates must be adjusted in a certain determined way before the lock can be operated. -- Dial plate, the plane or disk of a dial or timepiece on which lines and figures for indicating the time are placed.\n\n1. To measure with a dial. Hours of that true time which is dialed in heaven. Talfourd. 2. (Mining)  To survey with a dial. Raymond.
dialect |1. Means or mode of expressing thoughts; language; tongue; form of speech. This book is writ in such a dialect As may the minds of listless men affect. Bunyan. The universal dialect of the world. South. 2. The form of speech of a limited region or people, as distinguished from ether forms nearly related to it; a variety or subdivision of a language; speech characterized by local peculiarities or specific circumstances; as, the Ionic and Attic were dialects of Greece; the Yorkshire dialect; the dialect of the learned. In the midst of this Babel of dialects there suddenly appeared a standard English language. Earle. [Charles V.] could address his subjects from every quarter in their native dialect. Prescott. Syn. -- Language; idiom; tongue; speech; phraseology. See Language, and Idiom.
dialectal |Relating to a dialect; dialectical; as, a dialectical variant.
dialectic |Same as Dialectics. Plato placed his dialectic above all sciences. Liddell & Scott.\n\n1. Pertaining to dialectics; logical; argumental. 2. Pertaining to a dialect or to dialects. Earle.
dialectical |1. Pertaining to dialectics; logical; argumental. 2. Pertaining to a dialect or to dialects. Earle.
dialectically |In a dialectical manner.
dialectician |One versed in dialectics; a logician; a reasoner.
dialectics |That branch of logic which teaches the rules and modes of reasoning; the application of logical principles to discursive reasoning; the science or art of discriminating truth from error; logical discussion. Note: Dialectics was defined by Aristotle to be the method of arguing with probability on any given problem, and of defending a tenet without inconsistency. By Plato, it was used in the following senses: 1. Discussion by dialogue as a method of scientific investigation. 2. The method of investigating the truth by analysis. 3. The science of ideas or of the nature and laws of being -- higher metaphysics. By Kant, it was employed to signify the logic of appearances or illusions, whether these arise from accident or error, or from those necessary limitations which, according to this philosopher, originate in the constitution of the human intellect.
dialectology |That branch of philology which is devoted to the consideration of dialects. Beck.
dialector |One skilled in dialectics.
dialing |1. The art of constructing dials; the science which treats of measuring time by dials. [Written also dialling.] 2. A method of surveying, especially in mines, in which the bearings of the courses, or the angles which they make with each other, are determined by means of the circumferentor.
dialist |A maker of dials; one skilled in dialing.
diallage |A figure by which arguments are placed in various points of view, and then turned to one point. Smart.\n\nA dark green or bronze-colored laminated variety of pyroxene, common in certain igneous rocks.
diallel |Meeting and intersecting, as lines; not parallel; -- opposed to parallel. [Obs.] Ash.
diallyl |A volatile, pungent, liquid hydrocarbon, C6H10, consisting of two allyl radicals, and belonging to the acetylene series.
dialogical |Relating to a dialogue; dialogistical. Burton.
dialogically |In the manner or nature of a dialogue. Goldsmith.
dialogism |An imaginary speech or discussion between two or more; dialogue. Fulke.
dialogist |1. A speaker in a dialogue. 2. A writer of dialogues. P. Skelton.
dialogistic |Pertaining to a dialogue; having the form or nature of a dialogue. -- Di*al`o*gis\"tic*al*ly, adv.
dialogistical |Pertaining to a dialogue; having the form or nature of a dialogue. -- Di*al`o*gis\"tic*al*ly, adv.
dialogite |Native carbonate of manganese; rhodochrosite.
dialogize |To discourse in dialogue. Fotherby.
dialogue |1. A conversation between two or more persons; particularly, a formal conservation in theatrical performances or in scholastic exercises. 2. A written composition in which two or more persons are represented as conversing or reasoning on some topic; as, the Dialogues of Plato.\n\nTo take part in a dialogue; to dialogize. [R.] Shak.\n\nTo express as in dialogue. [R.] And dialogued for him what he would say. Shak.
dialypetalous |Having separate petals; polypetalous.
dialysis |1. (Gram.)  Diæresis. See Diæresis, 1. 2. (Rhet.)  Same as Asyndeton. 3. (Med.) (a) Debility. (b) A solution of continuity; division; separation of parts. 4. (Chem.)  The separation of different substances in solution, as crystalloids and colloids, by means of their unequal diffusion, especially through natural or artificial membranes.
dialytic |Having the quality of unloosing or separating. Clarke. Dialytic telescope, an achromatic telescope in which the colored dispersion produced by a single object lens of crown glass is corrected by a smaller concave lens, or combination of lenses, of high dispersive power, placed at a distance in the narrower part of the converging cone of rays, usually near the middle of the tube.
dialyzate |The material subjected to dialysis.
dialyzation |The act or process of dialysis.
dialyze |To separate, prepare, or obtain, by dialysis or osmose; to pass through an animal membrane; to subject to dialysis. [Written also dialyse.]
dialyzed |Prepared by diffusion through an animal membrane; as, dialyzed iron.
dialyzer |The instrument or medium used to effect chemical dialysis.
diamagnet |A body having diamagnetic polarity.
diamagnetic |Pertaining to, or exhibiting the phenomena of, diamagnetism; taking, or being of a nature to take, a position at right angles to the lines of magnetic force. See Paramagnetic. Diamagnetic attraction. See under Attraction.\n\nAny substance, as bismuth, glass, phosphorous, etc., which in a field of magnetic force is differently affected from the ordinary magnetic bodies, as iron; that is, which tends to take a position at right angles to the lines of magnetic force, and is repelled by either pole of the magnet.
diamagnetically |In the manner of, or according to, diamagnetism.
diamagnetism |1. The science which treats of diamagnetic phenomena, and of the properties of diamagnetic bodies. 2. That form or condition of magnetic action which characterizes diamagnetics.
diamantiferous |Yielding diamonds.
diamantine |Adamantine. [Obs.]
diameter |1. (Geom.) (a) Any right line passing through the center of a figure or body, as a circle, conic section, sphere, cube, etc., and terminated by the opposite boundaries; a straight line which bisects a system of parallel chords drawn in a curve. (b) A diametral plane. 2. The length of a straight line through the center of an object from side to side; width; thickness; as, the diameter of a tree or rock. Note: In an elongated object the diameter is usually taken at right angles to the longer axis. 3. (Arch.)  The distance through the lower part of the shaft of a column, used as a standard measure for all parts of the order. See Module. Conjugate diameters. See under Conjugate.
diametral |Pertaining to a diameter; diametrical. Diametral curve, Diametral surface (Geom.), any line or surface which bisects a system of parallel chords drawn in a curve or surface. -- Diametral planes (Crystal.), planes in which two of the axes lie.\n\nA diameter. [Obs.] Sir T. Browne.
diametrally |Diametrically.
diametric |1. Of or pertaining to a diameter. 2. As remote as possible, as if at the opposite end of a diameter; directly adverse.
diametrical |1. Of or pertaining to a diameter. 2. As remote as possible, as if at the opposite end of a diameter; directly adverse.
diametrically |In a diametrical manner; directly; as, diametrically opposite. Whose principles were diametrically opposed to his. Macaulay.
diamide |Any compound containing two amido groups united with one or more acid or negative radicals, -- as distinguished from a diamine. Cf. Amido acid, under Amido, and Acid amide, under Amide.
diamido- |A prefix or combining form of Diamine. Note: [Also used adjectively.]
diamine |A compound containing two amido groups united with one or more basic or positive radicals, -- as contrasted with a diamide. Note: In chemical nomenclature, if any amine or diamine is named by prefixing the nitrogen group, the name of the latter takes the form of amido, diamido, etc., thus ethylene diamine, C2H4.(NH2)2, is also called diamido-ethylene.
diamond |1. A precious stone or gem excelling in brilliancy and beautiful play of prismatic colors, and remarkable for extreme hardness. Note: The diamond is native carbon in isometric crystals, often octahedrons with rounded edges. It is usually colorless, but some are yellow, green, blue, and even black. It is the hardest substance known. The diamond as found in nature (called a rough diamond) is cut, for use in jewelry, into various forms with many reflecting faces, or facets, by which its brilliancy is much increased. See Brilliant, Rose. Diamonds are said to be of the first water when very transparent, and of the second or third water as the transparency decreases. 2. A geometrical figure, consisting of four equal straight lines, and having two of the interior angles acute and two obtuse; a rhombus; a lozenge. 3. One of a suit of playing cards, stamped with the figure of a diamond. 4. (Arch.)  A pointed projection, like a four-sided pyramid, used for ornament in lines or groups. 5. (Baseball)  The infield; the square space, 90 feet on a side, having the bases at its angles. 6. (Print.)  The smallest kind of type in English printing, except that called brilliant, which is seldom seen. Note: * This line is printed in the type called Diamond. Black diamond, coal; (Min.) See Carbonado. -- Bristol diamond. See Bristol stone, under Bristol. -- Diamond beetle (Zoöl.), a large South American weevil (Entimus imperialis), remarkable for its splendid luster and colors, due to minute brilliant scales. -- Diamond bird (Zoöl.), a small Australian bird (Pardalotus punctatus, family Ampelidæ.). It is black, with white spots. -- Diamond drill (Engin.), a rod or tube the end of which is set with black diamonds; -- used for perforating hard substances, esp. for boring in rock. -- Diamond finch (Zoöl.), a small Australian sparrow, often kept in a cage. Its sides are black, with conspicuous white spots, and the rump is bright carmine. -- Diamond groove (Iron Working), a groove of V-section in a roll. -- Diamond mortar (Chem.), a small steel mortar used for pulverizing hard substances. -- Diamond-point tool, a cutting tool whose point is diamond-shaped. -- Diamond snake (Zoöl.), a harmless snake of Australia (Morelia spilotes); the carpet snake. -- Glazier's diamond, a small diamond set in a glazier's tool, for cutting glass.\n\nResembling a diamond; made of, or abounding in, diamonds; as, a diamond chain; a diamond field.
diamond anniversary |One celebrated upon the completion of sixty, or, according to some, seventy-five, years from the beginning of the thing commemorated.
diamond jubilee |One celebrated upon the completion of sixty, or, according to some, seventy-five, years from the beginning of the thing commemorated.
diamond state |Delaware; -- a nickname alluding to its small size.
diamond-back |The salt-marsh terrapin of the Atlantic coast (Malacoclemmys palustris).
diamond-shaped |Shaped like a diamond or rhombus.
diamonded |1. Having figures like a diamond or lozenge. 2. Adorned with diamonds; diamondized. Emerson.
diamondize |To set with diamonds; to adorn; to enrich. [R.] Diamondizing of your subject. B. Jonson.
diamylene |A liquid hydrocarbon, C10H20, of the ethylene series, regarded as a polymeric form of amylene.
dian |, Diana. [Poetic]
diana |The daughter of Jupiter and Latona; a virgin goddess who presided over hunting, chastity, and marriage; -- identified with the Greek goddess Artemis. And chaste Diana haunts the forest shade. Pope. Diana monkey (Zoöl.), a handsome, white-bearded monkey of West Africa (Cercopithecus Diana).
diandria |A Linnæan class of plants having two stamens.
diandrian |Diandrous.
diandrous |Of or pertaining to the class Diandria; having two stamens.
dianium |Same as Columbium. [Obs.]
dianoetic |Pertaining to the discursive faculty, its acts or products. I would employ . . . dianoetic to denote the operation of the discursive, elaborative, or comparative faculty. Sir W. Hamilton.
dianoialogy |The science of the dianoetic faculties, and their operations. Sir W. Hamilton.
dianthus |A genus of plants containing some of the most popular of cultivated flowers, including the pink, carnation, and Sweet William.
diapase |Same as Diapason. [Obs.] A tuneful diapase of pleasures. Spenser.
diapasm |Powdered aromatic herbs, sometimes made into little balls and strung together. [Obs.]
diapason |1. (Gr. Mus.)  The octave, or interval which includes all the tones of the diatonic scale. 2. Concord, as of notes an octave apart; harmony. The fair music that all creatures made . . . In perfect diapason. Milton. 3. The entire compass of tones. Through all the compass of the notes it ran, The diapason closing full in man. Dryden. 4. A standard of pitch; a tuning fork; as, the French normal diapason. 5. One of certain stops in the organ, so called because they extend through the scale of the instrument. They are of several kinds, as open diapason, stopped diapason, double diapason, and the like.
diapedesis |The passage of the corpuscular elements of the blood from the blood vessels into the surrounding tissues, without rupture of the walls of the blood vessels.
diapente |1. (Anc. Mus.)  The interval of the fifth. 2. (Med.)  A composition of five ingredients.
diaper |1. Any textile fabric (esp. linen or cotton toweling) woven in diaper pattern. See 2. 2. (Fine Arts)  Surface decoration of any sort which consists of the constant repetition of one or more simple figures or units of design evenly spaced. 3. A towel or napkin for wiping the hands, etc. Let one attend him with a silver basin, . . . Another bear the ewer, the third a diaper. Shak. 4. An infant's breechcloth.\n\n1. To ornament with figures, etc., arranged in the pattern called diaper, as cloth in weaving. \"Diapered light.\" H. Van Laun. Engarlanded and diapered With in wrought flowers. Tennyson. 2. To put a diaper on (a child).\n\nTo draw flowers or figures, as upon cloth. \"If you diaper on folds.\" Peacham.
diapering |Same as Diaper, n., 2.
diaphane |A woven silk stuff with transparent and colored figures; diaper work.
diaphaned |Transparent or translucent. [R.]
diaphaneity |The quality of being diaphanous; transparency; pellucidness.
diaphanic |Having power to transmit light; transparent; diaphanous.
diaphanie |The art of imitating
diaphanometer |An instrument for measuring the transparency of the air.
diaphanoscope |A dark box constructed for viewing transparent pictures, with or without a lens.
diaphanotype |A colored photograph produced by superimposing a translucent colored positive over a strong uncolored one.
diaphanous |Allowing light to pass through, as porcelain; translucent or transparent; pellucid; clear. Another cloud in the region of them, light enough to be fantastic and diaphanous. Landor.
diaphanously |Translucently.
diaphemetric |Relating to the measurement of the tactile sensibility of parts; as, diaphemetric compasses. Dunglison.
diaphonic |Diacoustic.
diaphonical |Diacoustic.
diaphonics |The doctrine of refracted sound; diacoustics.
diaphoresis |Perspiration, or an increase of perspiration.
diaphoretic |Having the power to increase perspiration.\n\nA medicine or agent which promotes perspiration. Note: Diaphoretics differ from sudorifics; the former only increase the insensible perspiration, the latter excite the sensible discharge called sweat. Parr.
diaphoretical |Having the power to increase perspiration.
diaphote |An instrument designed for transmitting pictures by telegraph. Fallows.
diaphragm |1. A dividing membrane or thin partition, commonly with an opening through it. 2. (Anat.)  The muscular and tendinous partition separating the cavity of the chest from that of the abdomen; the midriff. 3. (Zoöl.)  A calcareous plate which divides the cavity of certain shells into two parts. 4. (Opt.)  A plate with an opening, which is generally circular, used in instruments to cut off marginal portions of a beam of light, as at the focus of a telescope. 5. (Mach.)  A partition in any compartment, for various purposes. Diaphragm pump, one in which a flexible diaphragm takes the place of a piston.
diaphragmatic |Pertaining to a diaphragm; as, diaphragmatic respiration; the diaphragmatic arteries and nerves.
diaphysis |1. (Bot.)  An abnormal prolongation of the axis of inflorescence. 2. (Anat.)  The shaft, or main part, of a bone, which is first ossified.
diapnoic |Slightly increasing an insensible perspiration; mildly diaphoretic. -- n.  A gentle diaphoretic.
diapophysical |Pertaining to a diapophysis.
diapophysis |The dorsal transverse, or tubercular, process of a vertebra. See Vertebra.
diarchy |A form of government in which the supreme power is vested in two persons.
diarial |Pertaining to a diary; daily.
diarian |Pertaining to a diary; daily.
diarist |One who keeps a diary.
diarrhea |A morbidly frequent and profuse discharge of loose or fluid evacuations from the intestines, without tenesmus; a purging or looseness of the bowels; a flux.
diarrheal |Of or pertaining to diarrhea; like diarrhea.
diarrhetic |Producing diarrhea, or a purging.
diarrhoea |A morbidly frequent and profuse discharge of loose or fluid evacuations from the intestines, without tenesmus; a purging or looseness of the bowels; a flux.
diarrhoeal |Of or pertaining to diarrhea; like diarrhea.
diarrhoetic |Producing diarrhea, or a purging.
diarthrodial |Relating to diarthrosis, or movable articulations.
diarthrosis |A form of articulation which admits of considerable motion; a complete joint; abarticulation. See Articulation.
diary |A register of daily events or transactions; a daily record; a journal; a blank book dated for the record of daily memoranda; as, a diary of the weather; a physician's diary.\n\nlasting for one day; as, a diary fever. [Obs.] \"Diary ague.\" Bacon.
diaspora |(a) To those Jews who, after the Exile, were scattered through the Old World, and afterwards to Jewish Christians living among heathen. Cf. James i.1. (b) By extension, to Christians isolated from their own communion, as among the Moravians to those living, usually as missionaries, outside of the parent congregation.
diaspore |A hydrate of alumina, often occurring in white lamellar masses with brilliant pearly luster; -- so named on account of its decrepitating when heated before the blowpipe.
diastase |A soluble, nitrogenous ferment, capable of converting starch and dextrin into sugar. Note: The name is more particularly applied to that ferment formed during the germination of grain, as in the malting of barley; but it is also occasionally used to designate the amylolytic ferment contained in animal fluids, as in the saliva.
diastasic |Pertaining to, or consisting of, diastase; as, diastasic ferment.
diastasis |A forcible of bones without fracture.
diastatic |Relating to diastase; having the properties of diastase; effecting the conversion of starch into sugar. The influence of acids and alkalies on the diastatic action of saliva. Lauder Brunton.
diastem |(a) Intervening space; interval. (b) (Anc. Mus.) An interval.
diastema |A vacant space, or gap, esp. between teeth in a jaw.
diaster |A double star; -- applied to the nucleus of a cell, when, during cell division, the loops of the nuclear network separate into two groups, preparatory to the formation of two daughter nuclei. See Karyokinesis.
diastolic |Of or pertaining to diastole.
diastyle |See under Intercolumniation.
diatessaron |1. (Anc. Mus.)  The interval of a fourth. 2. (Theol.)  A continuous narrative arranged from the first four books of the New Testament. 3. An electuary compounded of four medicines.
diathermal |Freely permeable by radiant heat.
diathermancy |The property of transmitting radiant heat; the quality of being diathermous. Melloni.
diathermaneity |The property of transmitting radiant heat; the quality of being diathermous. Melloni.
diathermanism |The doctrine or the phenomena of the transmission of radiant heat. Nichol.
diathermanous |Having the property of transmitting radiant heat; diathermal; - - opposed to athermanous.
diathermic |Affording a free passage to heat; as, diathermic substances. Melloni.
diathermometer |An instrument for examining the thermal resistance or heat- conducting power of liquids.
diathermous |Same as Diathermal.
diathesis |Bodily condition or constitution, esp. a morbid habit which predisposes to a particular disease, or class of diseases.
diathetic |Pertaining to, or dependent on, a diathesis or special constitution of the body; as, diathetic disease.
diatom |1. (Bot.)  One of the Diatomaceæ, a family of minute unicellular Algæ having a siliceous covering of great delicacy, each individual multiplying by spontaneous division. By some authors diatoms are called Bacillariæ, but this word is not in general use. 2. A particle or atom endowed with the vital principle. The individual is nothing. He is no more than the diatom, the bit of protoplasm. Mrs. E. Lynn Linton.
diatomic |(a) Containing two atoms. (b) Having two replaceable atoms or radicals.
diatomous |Having a single, distinct, diagonal cleavage; -- said of crystals. Mohs.
diatonic |Pertaining to the scale of eight tones, the eighth of which is the octave of the first. Diatonic scale (Mus.), a scale consisting of eight sounds with seven intervals, of which two are semitones and five are whole tones; a modern major or minor scale, as distinguished from the chromatic scale.
diatonically |In a diatonic manner.
diatribe |A prolonged or exhaustive discussion; especially, an acrimonious or invective harangue; a strain of abusive or railing language; a philippic. The ephemeral diatribe of a faction. John Morley.
diatribist |One who makes a diatribe or diatribes.
diatryma |An extinct eocene bird from New Mexico, larger than the ostrich.
diazeuctic |Disjoining two fourths; as, the diazeutic tone, which, like that from F to G in modern music, lay between two fourths, and, being joined to either, made a fifth. [Obs.]
diazeutic |Disjoining two fourths; as, the diazeutic tone, which, like that from F to G in modern music, lay between two fourths, and, being joined to either, made a fifth. [Obs.]
diazo- |A combining form (also used adjectively), meaning pertaining to, or derived from, a series of compounds containing a radical of two nitrogen atoms, united usually to an aromatic radical; as, diazo- benzene, C6H5.N2.OH. Note: Diazo compounds are in general unstable, but are of great importance in recent organic chemistry. They are obtained by a partial reduction of the salts of certain amido compounds. Diazo reactions (Chem.), a series of reactions whereby diazo compounds are employed in substitution. These reactions are of great importance in organic chemistry.
diazotize |To subject to such reactions or processes that diazo compounds, or their derivatives, shall be produced by chemical exchange or substitution.
dib |To dip. [Prov. Eng.] Walton.\n\n1. One of the small bones in the knee joints of sheep uniting the bones above and below the joints. 2. pl.  A child's game, played with dib bones.
dibasic |Having two acid hydrogen atoms capable of replacement by basic atoms or radicals, in forming salts; bibasic; -- said of acids, as oxalic or sulphuric acids. Cf. Diacid, Bibasic. Note: In the case of certain acids dibasic and divalent are not synonymous; as, tartaric acid is tetravalent and dibasic, lactic acid is divalent but monobasic.
dibasicity |The property or condition of being dibasic.
dibber |A dibble. Halliwell.
dibble |A pointed implement used to make holes in the ground in which no set out plants or to plant seeds.\n\nTo dib or dip frequently, as in angling. Walton.\n\n1. To plant with a dibble; to make holes in (soil) with a dibble, for planting. 2. To make holes or indentations in, as if with a dibble. The clayey soil around it was dibbled thick at the time by the tiny hoofs of sheep. H. Miller.
dibbler |One who, or that which, dibbles, or makes holes in the ground for seed.
dibranchiata |An order of cephalopods which includes those with two gills, an apparatus for emitting an inky fluid, and either eight or ten cephalic arms bearing suckers or hooks, as the octopi and squids. See Cephalopoda.
dibranchiate |Having two gills. -- n.  One of the Dibranchiata.
dibs |A sweet preparation or treacle of grape juice, much used in the East. Johnston.
dibstone |A pebble used in a child's game called dibstones. Locke.
dibutyl |A liquid hydrocarbon, C8H18, of the marsh-gas series, being one of several octanes, and consisting of two butyl radicals. Cf. Octane.
dicacious |Talkative; pert; saucy. [Obs.]
dicacity |Pertness; sauciness. [Obs.]
dicalcic |Having two atoms or equivalents of calcium to the molecule.
dicarbonic |Containing two carbon residues, or two carboxyl or radicals; as, oxalic acid is a dicarbonic acid.
dicast |A functionary in ancient Athens answering nearly to the modern juryman.
dicastery |A court of justice; judgment hall. [R.] J. S. Mill.
dice |Small cubes used in gaming or in determining by chance; also, the game played with dice. See Die, n. Dice coal, a kind of coal easily splitting into cubical fragments. Brande & C.\n\n1. To play games with dice. I . . . diced not above seven times a week. Shak. 2. To ornament with squares, diamonds, or cubes.
dicebox |A box from which dice are thrown in gaming. Thackeray.
dicentra |A genus of herbaceous plants, with racemes of two-spurred or heart-shaped flowers, including the Dutchman's breeches, and the more showy Bleeding heart (D. spectabilis). [Corruptly written dielytra.]
dicephalous |Having two heads on one body; double-headed.
dicer |A player at dice; a dice player; a gamester. As false as dicers' oaths. Shak.
dich |To ditch. [Obs.]
dichastic |Capable of subdividing spontaneously.
dichlamydeous |Having two coverings, a calyx and in corolla.
dichloride |Same as Bichloride.
dichogamous |Manifesting dichogamy.
dichogamy |The condition of certain species of plants, in which the stamens and pistil do not mature simultaneously, so that these plants can never fertilize themselves.
dichotomist |One who dichotomizes. Bacon.
dichotomize |1. To cut into two parts; to part into two divisions; to divide into pairs; to bisect. [R.] The apostolical benediction dichotomizes all good things into grace and peace. Bp. Hall. 2. (Astron.)  To exhibit as a half disk. See Dichotomy, 3. \"[The moon] was dichotomized.\" Whewell.\n\nTo separate into two parts; to branch dichotomously; to become dichotomous.
dichotomous |Regularly dividing by pairs from bottom to top; as, a dichotomous stem. -- Di*chot\"o*mous*ly, adv.
dichotomy |1. A cutting in two; a division. A general breach or dichotomy with their church. Sir T. Browne. 2. Division or distribution of genera into two species; division into two subordinate parts. 3. (Astron.)  That phase of the moon in which it appears bisected, or shows only half its disk, as at the quadratures. 4. (Biol.)  Successive division and subdivision, as of a stem of a plant or a vein of the body, into two parts as it proceeds from its origin; successive bifurcation. 5. The place where a stem or vein is forked. 6. (Logic)  Division into two; especially, the division of a class into two subclasses opposed to each other by contradiction, as the division of the term man into white and not white.
dichroic |Having the property of dichroism; as, a dichroic crystal.
dichroiscope |Same as Dichroscope.
dichroism |The property of presenting different colors by transmitted light, when viewed in two different directions, the colors being unlike in the direction of unlike or unequal axes.
dichroite |Iolite; -- so called from its presenting two different colors when viewed in two different directions. See Iolite.
dichroitic |Dichroic.
dichromate |A salt of chromic acid containing two equivalents of the acid radical to one of the base; -- called also bichromate.
dichromatic |1. Having or exhibiting two colors. 2. (Zoöl.)  Having two color varieties, or two phases differing in color, independently of age or sex, as in certain birds and insects.
dichromatism |The state of being dichromatic.
dichromic |Furnishing or giving two colors; -- said of defective vision, in which all the compound colors are resolvable into two elements instead of three. Sir J. Herschel.
dichroous |Dichroic.
dichroscope |An instrument for examining the dichroism of crystals.
dichroscopic |Pertaining to the dichroscope, or to observations with it.
dicing |1. An ornamenting in squares or cubes. 2. Gambling with dice. J. R. Green.
dickcissel |The American black-throated bunting (Spiza Americana).
dickens |The devil. [A vulgar euphemism.] I can not tell what the dickens his name is. Shak.
dicker |1. The number or quantity of ten, particularly ten hides or skins; a dakir; as, a dicker of gloves. [Obs.] A dicker of cowhides. Heywood. 2. A chaffering, barter, or exchange, of small wares; as, to make a dicker. [U.S.] For peddling dicker, not for honest sales. Whittier.\n\nTo negotiate a dicker; to barter. [U.S.] \"Ready to dicker. and to swap.\" Cooper.
dickey |1. A seat behind a carriage, for a servant. 2. A false shirt front or bosom. 3. A gentleman's shirt collar. [Local, U. S.]
dicky |1. A seat behind a carriage, for a servant. 2. A false shirt front or bosom. 3. A gentleman's shirt collar. [Local, U. S.]
diclinic |Having two of the intersections between the three axes oblique. See Crystallization.
diclinous |Having the stamens and pistils in separate flowers. Gray.
dicoccous |Composed pf two coherent, one-seeded carpels; as, a dicoccous capsule.
dicotyledon |A plant whose seeds divide into two seed lobes, or cotyledons, in germinating.
dicotyledonous |Having two cotyledons or seed lobes; as, a dicotyledonous plant.
dicrotal |Dicrotic.
dicrotic |(a) Of or pertaining to dicrotism; as, a dicrotic pulse. (b) Of or pertaining to the second expansion of the artery in the dicrotic pulse; as, the dicrotic wave.
dicrotism |A condition in which there are two beats or waves of the arterial pulse to each beat of the heart.
dicrotous |Dicrotic.
dicta |See Dictum.
dictagraph |Var. of Dictograph.
dictamen |A dictation or dictate. [R.] Falkland.
dictamnus |A suffrutescent, D. Fraxinella (the only species), with strong perfume and showy flowers. The volatile oil of the leaves is highly inflammable.
dictaphone |A form of phonographic recorder and reproducer adapted for use in dictation, as in business.
dictate |1. To tell or utter so that another may write down; to inspire; to compose; as, to dictate a letter to an amanuensis. The mind which dictated the Iliad. Wayland. Pages dictated by the Holy Spirit. Macaulay. 2. To say; to utter; to communicate authoritatively; to deliver (a command) to a subordinate; to declare with authority; to impose; as, to dictate the terms of a treaty; a general dictates orders to his troops. Whatsoever is dictated to us by God must be believed. Watts. Syn. -- To suggest; prescribe; enjoin; command; point out; urge; admonish.\n\n1. To speak as a superior; to command; to impose conditions (on). Who presumed to dictate to the sovereign. Macaulay. 2. To compose literary works; to tell what shall be written or said by another. Sylla could not skill of letters, and therefore knew not how to dictate. Bacon.\n\nA statement delivered with authority; an order; a command; an authoritative rule, principle, or maxim; a prescription; as, listen to the dictates of your conscience; the dictates of the gospel. I credit what the Grecian dictates say. Prior. Syn. -- Command; injunction; direction suggestion; impulse; admonition.
dictation |1. The act of dictating; the act or practice of prescribing; also that which is dictated. It affords security against the dictation of laws. Paley. 2. The speaking to, or the giving orders to, in an overbearing manner; authoritative utterance; as, his habit, even with friends, was that of dictatio.
dictator |1. One who dictates; one who prescribes rules and maxims authoritatively for the direction of others. Locke. 2. One invested with absolute authority; especially, a magistrate created in times of exigence and distress, and invested with unlimited power. Invested with the authority of a dictator, nay, of a pope, over our language. Macaulay.
dictatorial |1. Pertaining or suited to a dictator; absolute. Military powers quite dictatorial. W. Irving. 2. Characteristic of a dictator; imperious; dogmatical; overbearing; as, a dictatorial tone or manner. -- Dic`ta*to\"ri*al*ly, adv. -- Dic`ta*to\"ri*al*ness, n.
dictatorian |Dictatorial. [Obs.]
dictatorship |The office, or the term of office, of a dictator; hence, absolute power.
dictatory |Dogmatical; overbearing; dictatorial. Milton.
dictatress |A woman who dictates or commands. Earth's chief dictatress, ocean's mighty queen. Byron.
dictatrix |A dictatress.
dictature |Office of a dictator; dictatorship. [R.] Bacon.
diction |Choice of words for the expression of ideas; the construction, disposition, and application of words in discourse, with regard to clearness, accuracy, variety, etc.; mode of expression; language; as, the diction of Chaucer's poems. His diction blazes up into a sudden explosion of prophetic grandeur. De Quincey. Syn. -- Diction, Style, Phraseology. Style relates both to language and thought; diction, to language only; phraseology, to the mechanical structure of sentences, or the mode in which they are phrased. The style of Burke was enriched with all the higher graces of composition; his diction was varied and copious; his phraseology, at times, was careless and cumbersome. \"Diction is a general term applicable alike to a single sentence or a connected composition. Errors in grammar, false construction, a confused disposition of words, or an improper application of them, constitute bad diction; but the niceties, the elegancies, the peculiarities, and the beauties of composition, which mark the genius and talent of the writer, are what is comprehended under the name of style.\" Crabb.
dictionalrian |A lexicographer. [R.]
dictionary |1. A book containing the words of a language, arranged alphabetically, with explanations of their meanings; a lexicon; a vocabulary; a wordbook. I applied myself to the perusal of our writers; and noting whatever might be of use to ascertain or illustrate any word or phrase, accumulated in time the materials of a dictionary. Johnson. 2. Hence, a book containing the words belonging to any system or province of knowledge, arranged alphabetically; as, a dictionary of medicine or of botany; a biographical dictionary.
dictograph |A telephonic instrument for office or other similar use, having a sound-magnifying device enabling the ordinary mouthpiece to be dispensed with. Much use has been made of it for overhearing, or for recording, conversations for the purpose of obtaining evidence for use in litigation. The makers of this instrument spell it dictograph.
dictum |1. An authoritative statement; a dogmatic saying; an apothegm. A class of critical dicta everywhere current. M. Arnold. 2. (Law) (a) A judicial opinion expressed by judges on points that do not necessarily arise in the case, and are not involved in it. (b) (French Law) The report of a judgment made by one of the judges who has given it. Bouvier. (c) An arbitrament or award.
dictyogen |A plant with netveined leaves, and monocotyledonous embryos, belonging to the class Dictyogenæ, proposed by Lindley for the orders Dioscoreaceæ, Smilaceæ, Trilliaceæ, etc.
dicyanide |A compound of a binary type containing two cyanogen groups or radicals; -- called also bicyanide.
dicyemata |An order of worms parasitic in cephalopods. They are remarkable for the extreme simplicity of their structure. The embryo exists in two forms.
dicyemid |Like or belonging to the Dicyemata. -- n.  One of the Dicyemata.
dicynodont |One of a group of extinct reptiles having the jaws armed with a horny beak, as in turtles, and in the genus Dicynodon, supporting also a pair of powerful tusks. Their remains are found in triassic strata of South Africa and India.
did |of Do.
didactic |Fitted or intended to teach; conveying instruction; preceptive; instructive; teaching some moral lesson; as, didactic essays. \"Didactical writings.\" Jer. Taylor. The finest didactic poem in any language. Macaulay.\n\nA treatise on teaching or education. [Obs.] Milton.
didactical |Fitted or intended to teach; conveying instruction; preceptive; instructive; teaching some moral lesson; as, didactic essays. \"Didactical writings.\" Jer. Taylor. The finest didactic poem in any language. Macaulay.
didactically |In a didactic manner.
didacticism |The didactic method or system.
didacticity |Aptitude for teaching. Hare.
didactics |The art or science of teaching.
didactyl |An animal having only two digits.
didactylous |Having only two digits; two-toed.
didal |A kind of triangular spade. [Obs.]
didapper |See Dabchick.
didascalar |Didascalic. [R.]
didascalic |Didactic; preceptive. [R.] Prior.
diddle |To totter, as a child in walking. [Obs.] Quarles.\n\nTo cheat or overreach. [Colloq.] Beaconsfield.
diddler |A cheat. [Colloq.] Jeremy Diddler, a character in a play by James Kenney, entitled \"Raising the wind.\" The name is applied to any needy, tricky, constant borrower; a confidence man.
didelphia |The subclass of Mammalia which includes the marsupials. See Marsupialia.
didelphian |Of or relating to the Didelphia. -- n.  One of the Didelphia.
didelphic |Having the uterus double; of or pertaining to the Didelphia.
didelphid |Same as Didelphic.\n\nA marsupial animal.
didelphous |Didelphic.\n\nFormerly, any marsupial; but the term is now restricted to an American genus which includes the opossums, of which there are many species. See Opossum. [Written also Didelphis.] See Illustration in Appendix. Cuvier.
didelphyc |Same as Didelphic.
didelphys |Formerly, any marsupial; but the term is now restricted to an American genus which includes the opossums, of which there are many species. See Opossum. [Written also Didelphis.] See Illustration in Appendix.  Cuvier.
didine |Like or pertaining to the genus Didus, or the dodo.
dido |A shrewd trick; an antic; a caper. To cut a dido, to play a trick; to cut a caper; -- perhaps so called from the trick of Dido, who having bought so much land as a hide would cover, is said to have cut it into thin strips long enough to inclose a spot for a citadel.
didonia |The curve which on a given surface and with a given perimeter contains the greatest area. Tait.
didrachm |A two-drachma piece; an ancient Greek silver coin, worth nearly forty cents.
didrachma |A two-drachma piece; an ancient Greek silver coin, worth nearly forty cents.
didst |, the 2d pers. sing. imp. of Do.
diducement |Diduction; separation into distinct parts. Bacon.
diduction |The act of drawing apart; separation.
didym |See Didymium.
didymium |A rare metallic substance usually associated with the metal cerium; -- hence its name. It was formerly supposed to be an element, but has since been found to consist of two simpler elementary substances, neodymium and praseodymium. See Neodymium, and Praseodymium.
didymous |Growing in pairs or twins.
didynamia |A Linnæan class of plants having four stamens disposed in pairs of unequal length.
didynamian |Didynamous.
didynamous |Of or pertaining to the Didynamia; containing four stamens disposed in pairs of unequal length.
die |1. To pass from an animate to a lifeless state; to cease to live; to suffer a total and irreparable loss of action of the vital functions; to become dead; to expire; to perish; -- said of animals and vegetables; often with of, by, with, from, and rarely for, before the cause or occasion of death; as, to die of disease or hardships; to die by fire or the sword; to die with horror at the thought. To die by the roadside of grief and hunger. Macaulay. She will die from want of care. Tennyson. 2. To suffer death; to lose life. In due time Christ died for the ungodly. Rom. v. 6. 3. To perish in any manner; to cease; to become lost or extinct; to be extinguished. Letting the secret die within his own breast. Spectator. Great deeds can not die. Tennyson. 4. To sink; to faint; to pine; to languish, with weakness, discouragement, love, etc. His heart died within, and he became as a stone. 1 Sam. xxv. 37. The young men acknowledged, in love letters, that they died for Rebecca. Tatler. 5. To become indifferent; to cease to be subject; as, to die to pleasure or to sin. 6. To recede and grow fainter; to become imperceptible; to vanish; -- often with out or away. Blemishes may die away and disappear amidst the brightness. Spectator. 7. (Arch.)  To disappear gradually in another surface, as where moldings are lost in a sloped or curved face. 8. To become vapid, flat, or spiritless, as liquor. To die in the last ditch, to fight till death; to die rather than surrender. \"There is one certain way,\" replied the Prince [William of Orange] \" by which I can be sure never to see my country's ruin, -- I will die in the last ditch.\" Hume (Hist. of Eng. ). -- To die out, to cease gradually; as, the prejudice has died out. Syn. -- To expire; decease; perish; depart; vanish.\n\n1. A small cube, marked on its faces with spots from one to six, and used in playing games by being shaken in a box and thrown from it. See Dice. 2. Any small cubical or square body. Words . . . pasted upon little flat tablets or dies. Watts. 3. That which is, or might be, determined, by a throw of the die; hazard; chance. Such is the die of war. Spenser. 4. (Arch.)  That part of a pedestal included between base and cornice; the dado. 5. (Mach.) (a) A metal or plate (often one of a pair) so cut or shaped as to give a certain desired form to, or impress any desired device on, an object or surface, by pressure or by a blow; used in forging metals, coining, striking up sheet metal, etc. (b) A perforated block, commonly of hardened steel used in connection with a punch, for punching holes, as through plates, or blanks from plates, or for forming cups or capsules, as from sheet metal, by drawing. (c) A hollow internally threaded screw-cutting tool, made in one piece or composed of several parts, for forming screw threads on bolts, etc.; one of the separate parts which make up such a tool. Cutting die (Mech.), a thin, deep steel frame, sharpened to a cutting edge, for cutting out articles from leather, cloth, paper, etc. -- The die is cast, the hazard must be run; the step is taken, and it is too late to draw back; the last chance is taken.
diecian |See Dioecian, and Dioecious.
diecious |See Dioecian, and Dioecious.
diedral |The same as Dihedral.
diegesis |A narrative or history; a recital or relation.
dielectric |Any substance or medium that transmits the electric force by a process different from conduction, as in the phenomena of induction; a nonconductor. separating a body electrified by induction, from the electrifying body.
dielytra |See Dicentra.
diencephalon |The interbrain or thalamencephalon; -- sometimes abbreviated to dien. See Thalamencephalon.
dieresis |1. (Gram.)  The separation or resolution of one syllable into two; -- the opposite of synæresis. 2. A mark consisting of two dots [..], placed over the second of two adjacent vowels, to denote that they are to be pronounced as distinct letters; as, coöperate, aërial.\n\nSame as Diæresis.
dies irae |Day of wrath; -- the name and beginning of a famous mediæval Latin hymn on the Last Judgment.
dies juridicus |A court day.
dies non |A day on which courts are not held, as Sunday or any legal holiday.
diesel engine |A type of internal-combustion engine in which the air drawn in by the suction stroke is so highly compressed that the heat generated ignites the fuel (usually crude oil), the fuel being automatically sprayed into the cylinder under pressure. The Diesel engine has a very high thermal efficiency.
diesel motor |A type of internal-combustion engine in which the air drawn in by the suction stroke is so highly compressed that the heat generated ignites the fuel (usually crude oil), the fuel being automatically sprayed into the cylinder under pressure. The Diesel engine has a very high thermal efficiency.
diesinker |An engraver of dies for stamping coins, medals, etc.
diesinking |The process of engraving dies.
diesis |1. (Mus.)  A small interval, less than any in actual practice, but used in the mathematical calculation of intervals. 2. (Print.)  The mark ; -- called also double dagger.
diestock |A stock to hold the dies used for cutting screws.
diet |1. Course of living or nourishment; what is eaten and drunk habitually; food; victuals; fare. \"No inconvenient diet.\" Milton. 2. A course of food selected with reference to a particular state of health; prescribed allowance of food; regimen prescribed. To fast like one that takes diet. Shak. Diet kitchen, a kitchen in which diet is prepared for invalids; a charitable establishment that provides proper food for the sick poor.\n\n1. To cause to take food; to feed. [R.] Shak. 2. To cause to eat and drink sparingly, or by prescribed rules; to regulate medicinally the food of. She diets him with fasting every day. Spenser.\n\n1. To eat; to take one's meals. [Obs.] Let him . . . diet in such places, where there is good company of the nation, where he traveleth. Bacon. 2. To eat according to prescribed rules; to ear sparingly; as, the doctor says he must diet.\n\nA legislative or administrative assembly in Germany, Poland, and some other countries of Europe; a deliberative convention; a council; as, the Diet of Worms, held in 1521.
dietarian |One who lives in accordance with prescribed rules for diet; a dieter.
dietary |Pertaining to diet, or to the rules of diet.\n\nA rule of diet; a fixed allowance of food, as in workhouse, prison, etc.
dieter |One who diets; one who prescribes, or who partakes of, food, according to hygienic rules.
dietetic |Of or performance to diet, or to the rules for regulating the kind and quantity of food to be eaten.
dietetical |Of or performance to diet, or to the rules for regulating the kind and quantity of food to be eaten.
dietetically |In a dietetical manner.
dietetics |That part of the medical or hygienic art which relates to diet or food; rules for diet. To suppose that the whole of dietetics lies in determining whether or not bread is more nutritive than potatoes. H. Spencer.
dietetist |A physician who applies the rules of dietetics to the cure of diseases. Dunglison.
diethylamine |A colorless, volatile, alkaline liquid, NH(C2H5)2, having a strong fishy odor resembling that of herring or sardines. Cf. Methylamine.
dietic |Dietetic.
dietical |Dietetic. [R.] Ferrand.
dietine |A subordinate or local assembly; a diet of inferior rank.
dietist |One skilled in dietetics. [R.]
dietitian |One skilled in dietetics. [R.]
diffame |Evil name; bad reputation; defamation. [Obs.] Chaucer.
diffarreation |A form of divorce, among the ancient Romans, in which a cake was used. See Confarreation.
differ |1. To be or stand apart; to disagree; to be unlike; to be distinguished; -- with from. One star differeth from another star in glory. 1 Cor. xv. 41. Minds differ, as rivers differ. Macaulay. 2. To be of unlike or opposite opinion; to disagree in sentiment; -- often with from or with. 3. To have a difference, cause of variance, or quarrel; to dispute; to contend. We 'll never differ with a crowded pit. Rowe. Syn. -- To vary; disagree; dissent; dispute; contend; oppose; wrangle. -- To Differ with, Differ from. Both differ from and aiffer with are used in reference to opinions; as, \"I differ from you or with you in that opinion.\"\" In all other cases, expressing simple unlikeness, differ from is used; as, these two persons or things differ entirely from each other. Severely punished, not for differing from us in opinion, but for committing a nuisance. Macaulay. Davidson, whom on a former occasion we quoted, to differ from him. M. Arnold. Much as I differ from him concerning an essential part of the historic basis of religion. Gladstone. I differ with the honorable gentleman on that point. Brougham. If the honorable gentleman differs with me on that subject, I differ as heartily with him, and shall always rejoice to differ. Canning.\n\nTo cause to be different or unlike; to set at variance. [R.] But something 'ts that differs thee and me. Cowley.
difference |1. The act of differing; the state or measure of being different or unlike; distinction; dissimilarity; unlikeness; variation; as, a difference of quality in paper; a difference in degrees of heat, or of light; what is the difference between the innocent and the guilty Differencies of administration, but the same Lord. 1 Cor. xii. 5. 2. Disagreement in opinion; dissension; controversy; quarrel; hence, cause of dissension; matter in controversy. What was the difference It was a contention in public. Shak. Away therefore went I with the constable, leaving the old warden and the young constable to compose their difference as they could. T. Ellwood. 3. That by which one thing differs from another; that which distinguishes or causes to differ;; mark of distinction; characteristic quality; specific attribute. The marks and differences of sovereignty. Davies. 4. Choice; preference. [Obs.] That now be chooseth with vile difference To be a beast, and lack intelligence. Spenser. 5. (Her.)  An addition to a coat of arms to distinguish the bearings of two persons, which would otherwise be the same. See Augmentation, and Marks of cadency, under Cadency. 6. (Logic)  The quality or attribute which is added to those of the genus to constitute a species; a differentia. 7. (Math.)  The quantity by which one quantity differs from another, or the remainder left after subtracting the one from the other. Ascensional difference. See under Ascensional. Syn. -- Distinction; dissimilarity; dissimilitude; variation; diversity; variety; contrariety; disagreement; variance; contest; contention; dispute; controversy; debate; quarrel; wrangle; strife.\n\nTo cause to differ; to make different; to mark as different; to distinguish. Thou mayest difference gods from men. Chapman. Kings, in receiving justice and undergoing trial, are not differenced from the meanest subject. Milton. So completely differenced by their separate and individual characters that we at once acknowledge them as distinct persons. Sir W. Scott.
different |1. Distinct; separate; not the same; other. \"Five different churches.\" Addison. 2. Of various or contrary nature, form, or quality; partially or totally unlike; dissimilar; as, different kinds of food or drink; different states of health; different shapes; different degrees of excellence. Men are as different from each other, as the regions in which they are born are different. Dryden. Note: Different is properly followed by from. Different to, for different from, is a common English colloquialism. Different than is quite inadmissible.
differentia |The formal or distinguishing part of the essence of a species; the characteristic attribute of a species; specific difference.
differential |1. Relating to or indicating a difference; creating a difference; discriminating; special; as, differential characteristics; differential duties; a differential rate. For whom he produced differential favors. Motley. 2. (Math.)  Of or pertaining to a differential, or to differentials. 3. (Mech.)  Relating to differences of motion or leverage; producing effects by such differences; said of mechanism. Differential calculus. (Math.) See under Calculus. -- Differential coefficient, the limit of the ratio of the increment of a function of a variable to the increment of the variable itself, when these increments are made indefinitely small. -- Differential coupling, a form of slip coupling used in light machinery to regulate at pleasure the velocity of the connected shaft. -- Differential duties (Polit. Econ.), duties which are not imposed equally upon the same products imported from different countries. -- Differential galvanometer (Elec.), a galvanometer having two coils or circuits, usually equal, through which currents passing in opposite directions are measured by the difference of their effect upon the needle. -- Differential gearing, a train of toothed wheels, usually an epicyclic train, so arranged as to constitute a differential motion. -- Differential motion, a mechanism in which a simple differential combination produces such a change of motion or force as would, with ordinary compound arrangements, require a considerable train of parts. It is used for overcoming great resistance or producing very slow or very rapid motion. -- Differential pulley. (Mach.) (a) A portable hoisting apparatus, the same in principle as the differential windlass. (b) A hoisting pulley to which power is applied through a differential gearing. -- Differential screw, a compound screw by which a motion is produced equal to the difference of the motions of the component screws. -- Differential thermometer, a thermometer usually with a U-shaped tube terminating in two air bulbs, and containing a colored liquid, used for indicating the difference between the temperatures to which the two bulbs are exposed, by the change of position of the colored fluid, in consequence of the different expansions of the air in the bulbs. A graduated scale is attached to one leg of the tube. -- Differential windlass, or Chinese windlass, a windlass whose barrel has two parts of different diameters. The hoisting rope winds upon one part as it unwinds from the other, and a pulley sustaining the weight to be lifted hangs in the bight of the rope. It is an ancient example of a differential motion.\n\n1. (Math.)  An increment, usually an indefinitely small one, which is given to a variable quantity. Note: According to the more modern writers upon the differential and integral calculus, if two or more quantities are dependent on each other, and subject to increments of value, their differentials need not be small, but are any quantities whose ratios to each other are the limits to which the ratios of the increments approximate, as these increments are reduced nearer and nearer to zero. 2. A small difference in rates which competing railroad lines, in establishing a common tariff, allow one of their number to make, in order to get a fair share of the business. The lower rate is called a differential rate. Differentials are also sometimes granted to cities. 3. (Elec.) (a) One of two coils of conducting wire so related to one another or to a magnet or armature common to both, that one coil produces polar action contrary to that of the other. (b) A form of conductor used for dividing and distributing the current to a series of electric lamps so as to maintain equal action in all. Knight. Partial differential (Math.), the differential of a function of two or more variables, when only one of the variables receives an increment. -- Total differential (Math.), the differential of a function of two or more variables, when each of the variables receives an increment. The total differential of the function is the sum of all the partial differentials.
differentially |In the way of differentiation.
differentiate |1. To distinguish or mark by a specific difference; to effect a difference in, as regards classification; to develop differential characteristics in; to specialize; to desynonymize. The word then was differentiated into the two forms then and than. Earle. Two or more of the forms assumed by the same original word become differentiated in signification. Dr. Murray. 2. To express the specific difference of; to describe the properties of (a thing) whereby it is differenced from another of the same class; to discriminate. Earle. 3. (Math.)  To obtain the differential, or differential coefficient, of; as, to differentiate an algebraic expression, or an equation.\n\nTo acquire a distinct and separate character. Huxley.
differentiation |1. The act of differentiating. Further investigation of the Sanskrit may lead to differentiation of the meaning of such of these roots as are real roots. J. Peile. 2. (Logic)  The act of distinguishing or describing a thing, by giving its different, or specific difference; exact definition or determination. 3. (Biol.)  The gradual formation or production of organs or parts by a process of evolution or development, as when the seed develops the root and the stem, the initial stem develops the leaf, branches, and flower buds; or in animal life, when the germ evolves the digestive and other organs and members, or when the animals as they advance in organization acquire special organs for specific purposes. 4. (Metaph.)  The supposed act or tendency in being of every kind, whether organic or inorganic, to assume or produce a more complex structure or functions.
differentiator |One who, or that which, differentiates.
differently |In a different manner; variously.
differingly |In a differing or different manner. Boyle.
difficile |Difficult; hard to manage; stubborn. [Obs.] -- Dif\"fi*cile*ness, n. [Obs.] Bacon.
difficilitate |To make difficult. [Obs.] W. Montagu.
difficult |1. Hard to do or to make; beset with difficulty; attended with labor, trouble, or pains; not easy; arduous. Note: Difficult implies the notion that considerable mental effort or skill is required, or that obstacles are to be overcome which call for sagacity and skill in the agent; as, a difficult task; hard work is not always difficult work; a difficult operation in surgery; a difficult passage in an author. There is not the strength or courage left me to venture into the wide, strange, and difficult world, alone. Hawthorne. 2. Hard to manage or to please; not easily wrought upon; austere; stubborn; as, a difficult person. Syn. -- Arduous; painful; crabbed; perplexed; laborious; unaccommodating; troublesome. See Arduous.\n\nTo render difficult; to impede; to perplex. [R.] Sir W. Temple.
difficultate |To render difficult; to difficilitate. [Obs.] Cotgrave.
difficultly |With difficulty. Cowper.
difficultness |Difficulty. [R.] Golding.
difficulty |1. The state of being difficult, or hard to do; hardness; arduousness; -- opposed to easiness or facility; as, the difficulty of a task or enterprise; a work of difficulty. Not being able to promote them [the interests of life] on account of the difficulty of the region. James Byrne. 2. Something difficult; a thing hard to do or to understand; that which occasions labor or perplexity, and requires skill perseverance to overcome, solve, or achieve; a hard enterprise; an obstacle; an impediment; as, the difficulties of a science; difficulties in theology. They lie under some difficulties by reason of the emperor's displeasure. Addison. 3. A controversy; a falling out; a disagreement; an objection; a cavil. Measures for terminating all local difficulties. Bancroft. 4. Embarrassment of affairs, especially financial affairs; -- usually in the plural; as, to be in difficulties. In days of difficulty and pressure. Tennyson. Syn. -- Impediment; obstacle; obstruction; embarrassment; perplexity; exigency; distress; trouble; trial; objection; cavil. See Impediment.
diffide |To be distrustful. [Obs.] Dr. H. More.
diffidence |1. The state of being diffident; distrust; want of confidence; doubt of the power, ability, or disposition of others. [Archaic] That affliction grew heavy upon me, and weighed me down even to a diffidence of God's mercy. Donne. 2. Distrust of one's self or one's own powers; lack of self-reliance; modesty; modest reserve; bashfulness. It is good to speak on such questions with diffidence. Macaulay. An Englishman's habitual diffidence and awkwardness of adress. W. Irving. Syn. -- Humility; bashfulness; distrust; suspicion; doubt; fear; timidity; apprehension; hesitation. See Humility, and Bashfulness.
diffidency |See Diffidence. [Obs.]
diffident |1. Wanting confidence in others; distrustful. [Archaic] You were always extremely diffident of their success. Melmoth. 2. Wanting confidence in one's self; distrustful of one's own powers; not self-reliant; timid; modest; bashful; characterized by modest reserve. The diffident maidens, Folding their hands in prayer. Longfellow. Syn. -- Distrustful; suspicious; hesitating; doubtful; modest; bashful; lowly; reserved.
diffidently |In a diffident manner. To stand diffidently against each other with their thoughts in battle array. Hobbes.
diffind |To split. [Obs.] Bailey.
diffine |To define. [Obs.] Chaucer.
diffinitive |Definitive; determinate; final. [Obs.] Sir H. Wotton.
diffission |Act of cleaving or splitting. [R.] Bailey.
difflation |A blowing apart or away. [Obs.] Bailey.
diffluence |A flowing off on all sides; fluidity. [R.]
diffluency |A flowing off on all sides; fluidity. [R.]
diffluent |Flowing apart or off; dissolving; not fixed. [R.] Bailey.
difform |Irregular in form; -- opposed to uniform; anomalous; hence, unlike; dissimilar; as, to difform corolla, the parts of which do not correspond in size or proportion; difform leaves. The unequal refractions of difform rays. Sir I. Newton.
difformity |Irregularity of form; diversity of form; want of uniformity. [Obs.] Sir T. Browne.
diffract |To break or separate into parts; to deflect, or decompose by deflection, a
diffraction |The deflection and decomposition of light in passing by the edges of opaque bodies or through narrow slits, causing the appearance of parallel bands or fringes of prismatic colors, as by the action of a grating of fine lines or bars. Remarked by Grimaldi (1665), and referred by him to a property of light which he called diffraction. Whewell. Diffraction grating. (Optics) See under Grating. -- Diffraction spectrum. (Optics) See under Spectrum.
diffractive |That produces diffraction.
diffranchise |See Disfranchise, Disfranchisement.
diffranchisement |See Disfranchise, Disfranchisement.
diffusate |Material which, in the process of catalysis, has diffused or passed through the separating membrane.
diffuse |To pour out and cause to spread, as a fluid; to cause to flow on all sides; to send out, or extend, in all directions; to spread; to circulate; to disseminate; to scatter; as to diffuse information. Thence diffuse His good to worlds and ages infinite. Milton. We find this knowledge diffused among all civilized nations. Whewell. Syn. -- To expand; spread; circulate; extend; scatter; disperse; publish; proclaim.\n\nTo pass by spreading every way, to diffuse itself.\n\nPoured out; widely spread; not restrained; copious; full; esp., of style, opposed to concise or terse; verbose; prolix; as, a diffuse style; a diffuse writer. A diffuse and various knowledge of divine and human things. Milton. Syn. -- Prolix; verbose; wide; copious; full. See Prolix.
diffused |Spread abroad; dispersed; loose; flowing; diffuse. It grew to be a widely diffused opinion. Hawthorne. -- Dif*fus\"ed*ly, adv. -- Dif*fus\"ed*ness, n.
diffusely |In a diffuse manner.
diffuseness |The quality of being diffuse; especially, in writing, the use of a great or excessive number of word to express the meaning; copiousness; verbosity; prolixity.
diffuser |One who, or that which, diffuses.
diffusibility |The quality of being diffusible; capability of being poured or spread out.
diffusible |1. Capable of flowing or spreading in all directions; that may be diffused. 2. (Physiol.)  Capable of passing through animal membranes by osmosis.
diffusibleness |Diffusibility.
diffusion |1. The act of diffusing, or the state of being diffused; a spreading; extension; dissemination; circulation; dispersion. A diffusion of knowledge which has undermined superstition. Burke. 2. (Physiol.)  The act of passing by osmosis through animal membranes, as in the distribution of poisons, gases, etc., through the body. Unlike absorption, diffusion may go on after death, that is, after the blood ceases to circulate. Syn. -- Extension; spread; propagation; circulation; expansion; dispersion.
diffusive |Having the quality of diffusing; capable of spreading every way by flowing; spreading widely; widely reaching; copious; diffuse. \"A plentiful and diffusive perfume.\" Hare.
diffusively |In a diffusive manner.
diffusiveness |The quality or state of being diffusive or diffuse; extensiveness; expansion; dispersion. Especially of style: Diffuseness; want of conciseness; prolixity. The fault that I find with a modern legend, it its diffusiveness. Addison.
diffusivity |Tendency to become diffused; tendency, as of heat, to become equalized by spreading through a conducting medium.
dig |1. To turn up, or delve in, (earth) with a spade or a hoe; to open, loosen, or break up (the soil) with a spade, or other sharp instrument; to pierce, open, or loosen, as if with a spade. Be first to dig the ground. Dryden. 2. To get by digging; as, to dig potatoes, or gold. 3. To hollow out, as a well; to form, as a ditch, by removing earth; to excavate; as, to dig a ditch or a well. 4. To thrust; to poke. [Colloq.] You should have seen children . . . dig and push their mothers under the sides, saying thus to them: Look, mother, how great a lubber doth yet wear pearls. Robynson (More's Utopia). To dig down, to undermine and cause to fall by digging; as, to dig down a wall. -- To dig from, out of, out, or up, to get out or obtain by digging; as, to dig coal from or out of a mine; to dig out fossils; to dig up a tree. The preposition is often omitted; as, the men are digging coal, digging iron ore, digging potatoes. -- To dig in, to cover by digging; as, to dig in manure.(b) To entrench oneself so as to give stronger resistance; -- used of warfare. Also figuratively, esp. in the phrase to dig in one's heels.\n\n1. To work with a spade or other like implement; to do servile work; to delve. Dig for it more than for hid treasures. Job iii. 21. I can not dig; to beg I am ashamed. Luke xvi. 3. 2. (Mining)  To take ore from its bed, in distinction from making excavations in search of ore. 3. To work like a digger; to study ploddingly and laboriously. [Cant, U.S.]\n\n1. A thrust; a punch; a poke; as, a dig in the side or the ribs. See Dig, v. t., 4. [Colloq.] 2. A plodding and laborious student. [Cant, U.S.]
digamist |One who marries a second time; a deuterogamist. Hammond.
digamma |A letter ( Note: This form identifies it with the Latin F, though in sound it is said to have been nearer V. It was pronounced, probably, much like the English W.
digammate |Having the digamma or its representative letter or sound; as, the Latin word vis is a digammated form of the Greek . Andrews.
digammated |Having the digamma or its representative letter or sound; as, the Latin word vis is a digammated form of the Greek . Andrews.
digamous |Pertaining to a second marriage, that is, one after the death of the first wife or the first husband.
digamy |Act, or state, of being twice married; deuterogamy. [R.]
digastric |(a) Having two bellies; biventral; -- applied to muscles which are fleshy at each end and have a tendon in the middle, and esp. to the muscle which pulls down the lower jaw. (b) Pertaining to the digastric muscle of the lower jaw; as, the digastric nerves.
digenea |A division of Trematoda in which alternate generations occur, the immediate young not resembling their parents.
digenesis |The faculty of multiplying in two ways; -- by ova fecundated by spermatic fluid, and asexually, as by buds. See Parthenogenesis.
digenous |Sexually reproductive. Digenous reproduction. (Biol.) Same as Digenesis.
digerent |Digesting. [Obs.] Bailey.
digest |1. To distribute or arrange methodically; to work over and classify; to reduce to portions for ready use or application; as, to digest the laws, etc. Joining them together and digesting them into order. Blair. We have cause to be glad that matters are so well digested. Shak. 2. (Physiol.)  To separate (the food) in its passage through the alimentary canal into the nutritive and nonnutritive elements; to prepare, by the action of the digestive juices, for conversion into blood; to convert into chyme. 3. To think over and arrange methodically in the mind; to reduce to a plan or method; to receive in the mind and consider carefully; to get an understanding of; to comprehend. Feelingly digest the words you speak in prayer. Sir H. Sidney. How shall this bosom multiplied digest The senate's courtesy Shak. 4. To appropriate for strengthening and comfort. Grant that we may in such wise hear them [the Scriptures], read, mark, learn, and inwardly digest them. Book of Common Prayer. 5. Hence: To bear comfortably or patiently; to be reconciled to; to brook. I never can digest the loss of most of Origin's works. Coleridge. 6. (Chem.)  To soften by heat and moisture; to expose to a gentle heat in a boiler or matrass, as a preparation for chemical operations. 7. (Med.)  To dispose to suppurate, or generate healthy pus, as an ulcer or wound. 8. To ripen; to mature. [Obs.] Well-digested fruits. Jer. Taylor. 9. To quiet or abate, as anger or grief.\n\n1. To undergo digestion; as, food digests well or ill. 2. (Med.)  To suppurate; to generate pus, as an ulcer.\n\nThat which is digested; especially, that which is worked over, classified, and arranged under proper heads or titles; esp. (Law),  a compilation of statutes or decisions analytically arranged. The term is applied in a general sense to the Pandects of Justinian (see Pandect), but is also specially given by authors to compilations of laws on particular topics; a summary of laws; as, Comyn's Digest; the United States Digest. A complete digest of Hindu and Mahommedan laws after the model of Justinian's celebrated Pandects. Sir W. Jones. They made a sort of institute and digest of anarchy, called the Rights of Man. Burke.
digestedly |In a digested or well-arranged manner; methodically.
digester |1. One who digests. 2. A medicine or an article of food that aids digestion, or strengthens digestive power. Rice is . . . a great restorer of health, and a great digester. Sir W. Temple. 3. A strong closed vessel, in which bones or other substances may be subjected, usually in water or other liquid, to a temperature above that of boiling, in order to soften them.
digestibility |The quality of being digestible.
digestible |Capable of being digested.
digestibleness |The quality of being digestible; digestibility.
digestion |1. The act or process of digesting; reduction to order; classification; thoughtful consideration. 2. (Physiol.)  The conversion of food, in the stomach and intestines, into soluble and diffusible products, capable of being absorbed by the blood. 3. (Med.)  Generation of pus; suppuration.
digestive |Pertaining to digestion; having the power to cause or promote digestion; as, the digestive ferments. Digestive cheese and fruit there sure will be. B. Jonson. Digestive apparatus, the organs of food digestion, esp. the alimentary canal and glands connected with it. -- Digestive salt, the chloride of potassium.\n\n1. That which aids digestion, as a food or medicine. Chaucer. That digestive [a cigar] had become to me as necessary as the meal itself. Blackw. Mag. 2. (Med.) (a) A substance which, when applied to a wound or ulcer, promotes suppuration. Dunglison. (b) A tonic. [R.]
digestor |See Digester.
digesture |Digestion. [Obs.] Harvey.
diggable |Capable of being dug.
digger |One who, or that which, digs. Digger wasp (Zoöl.), any one of the fossorial Hymenoptera.
diggers |A degraded tribe of California Indians; -- so called from their practice of digging roots for food.
digging |1. The act or the place of excavating. 2. pl.  Places where ore is dug; especially, certain localities in California, Australia, and elsewhere, at which gold is obtained. [Recent] 3. pl.  Region; locality. [Low]
dight |1. To prepare; to put in order; hence, to dress, or put on; to array; to adorn. [Archaic] \"She gan the house to dight.\" Chaucer. Two harmless turtles, dight for sacrifice. Fairfax. The clouds in thousand liveries dight. Milton. 2. To have sexual intercourse with. [Obs.] Chaucer.
dighter |One who dights. [Obs.]
digit |1. (Zoöl.)  One of the terminal divisions of a limb appendage; a finger or toe. The ruminants have the \"cloven foot,\" i. e., two hoofed digits on each foot. Owen. 2. A finger's breadth, commonly estimated to be three fourths of an inch. 3. (Math.)  One of the ten figures or symbols, 0, 1, 2, 3, 4, 5, 6, 7, 8, 9, by which all numbers are expressed; -- so called because of the use of the fingers in counting and computing. Note: By some authorities the symbol 0 is not included with the digits. 4. (Anat.)  One twelfth part of the diameter of the sun or moon; -- a term used to express the quantity of an eclipse; as, an eclipse of eight digits is one which hides two thirds of the diameter of the disk.\n\nTo point at or out with the finger. [R.]
digital |Of or performance to the fingers, or to digits; done with the fingers; as, digital compression; digital examination.
digitalin |(a) (Med.) Any one of several extracts of foxglove (Digitalis), as the \"French extract,\" the \"German extract,\" etc., which differ among themselves in composition and properties. (b) (Chem.) A supposedly distinct vegetable principle as the essential ingredient of the extracts. It is a white, crystalline substance, and is regarded as a glucoside.
digitalis |1. (Bot.)  A genus of plants including the foxglove. 2. (Med.)  The dried leaves of the purple foxglove (Digitalis purpurea), used in heart disease, disturbance of the circulation, etc.
digitate |To point out as with the finger. [R.] Robinson (Eudoxa).\n\nHaving several leaflets arranged, like the fingers of the hand, at the extremity of a stem or petiole. Also, in general, characterized by digitation. -- Dig\"i*tate*ly, adv.
digitated |Having several leaflets arranged, like the fingers of the hand, at the extremity of a stem or petiole. Also, in general, characterized by digitation. -- Dig\"i*tate*ly, adv.
digitation |A division into fingers or fingerlike processes; also, a fingerlike process.
digitiform |Formed like a finger or fingers; finger-shaped; as, a digitiform root.
digitigrade |Walking on the toes; -- distinguished from plantigrade.\n\nAn animal that walks on its toes, as the cat, lion, wolf, etc.; -- distinguished from a plantigrade, which walks on the palm of the foot.
digitipartite |Parted like the fingers.
digitize |To finger; as, to digitize a pen. [R.] Sir T. Browne. computers to convert (information, a signal, an image) into a form expressible in binary notation
digitorium |A small dumb keyboard used by pianists for exercising the fingers; -- called also dumb piano.
digitule |A little finger or toe, or something resembling one.
digladiate |To fight like gladiators; to contend fiercely; to dispute violently. [Obs.] Digladiating like Æschines and Demosthenes. Hales.
digladiation |Act of digladiating. [Obs.] \"Sore digladiations and contest.\" Evelyn.
diglottism |Bilingualism. [R.] Earle.
diglyph |A projecting face like the triglyph, but having only two channels or grooves sunk in it.
dignation |The act of thinking worthy; honor. [Obs.] Jer. Taylor.
digne |1. Worthy; honorable; deserving. [Obs.] Chaucer. 2. Suitable; adequate; fit. [Obs.] Chaucer. 3. Haughty; disdainful. [Obs.] Chaucer.
dignification |The act of dignifying; exaltation.
dignified |Marked with dignity; stately; as, a dignified judge.
dignify |To invest with dignity or honor; to make illustrious; to give distinction to; to exalt in rank; to honor. Your worth will dignity our feast. B. Jonson. Syn. -- To exalt; elevate; prefer; advance; honor; illustrate; adorn; ennoble.
dignitary |One who possesses exalted rank or holds a position of dignity or honor; especially, one who holds an ecclesiastical rank above that of a parochial priest or clergyman.
dignity |1. The state of being worthy or honorable; elevation of mind or character; true worth; excellence. 2. Elevation; grandeur. The dignity of this act was worth the audience of kings. Shak. 3. Elevated rank; honorable station; high office, political or ecclesiastical; degree of excellence; preferment; exaltation. Macaulay. And the king said, What honor and dignity hath been done to Mordecai for this Esth. vi. 3. Reuben, thou art my firstborn, . . . the excellency of dignity, and the excellency of power. Gen. xlix. 3. 4. Quality suited to inspire respect or reverence; loftiness and grace; impressiveness; stateliness; -- said of A letter written with singular energy and dignity of thought Macaulay. 5. One holding high rank; a dignitary. These filthy dreamers . . . speak evil of dignities. Jude. 8. 6. Fundamental principle; axiom; maxim. [Obs.] Sciences concluding from dignities, and principles known by themselves. Sir T. Browne. Syn. -- See Decorum. To stand upon one's dignity, to have or to affect a high notion of one's own rank, privilege, or character. They did not stand upon their dignity, nor give their minds to being or to seeming as elegant and as fine as anybody else. R. G. White.
dignotion |Distinguishing mark; diagnostic. [Obs.] Sir T. Browne.
digonous |Having two angles. Smart.
digram |A digraph.
digraph |Two signs or characters combined to express a single articulated sound; as ea in head, or th in bath.
digraphic |Of or pertaining to a digraph. H. Sweet.
digress |1. To step or turn aside; to deviate; to swerve; especially, to turn aside from the main subject of attention, or course of argument, in writing or speaking. Moreover she beginneth to digress in latitude. Holland. In the pursuit of an argument there is hardly room to digress into a particular definition as often as a man varies the signification of any term. Locke. 2. To turn aside from the right path; to transgress; to offend. [R.] Thy abundant goodness shall excuse This deadly blot on thy digressing son. Shak.\n\nDigression. [Obs.] Fuller.
digression |1. The act of digressing or deviating, esp. from the main subject of a discourse; hence, a part of a discourse deviating from its main design or subject. The digressions I can not excuse otherwise, than by the confidence that no man will read them. Sir W. Temple. 2. A turning aside from the right path; transgression; offense. [R.] Then my digression is so vile, so base, That it will live engraven in my face. Shak. 3. (Anat.)  The elongation, or angular distance from the sun; -- said chiefly of the inferior planets. [R.]
digressional |Pertaining to, or having the character of, a digression; departing from the main purpose or subject. T. Warton.
digressive |Departing from the main subject; partaking of the nature of digression. Johnson.
digressively |By way of digression.
digue |A bank; a dike. [Obs.] Sir W. Temple.
digynia |A Linnæan order of plants having two styles.
digynian |Of or pertaining to the Digynia; having two styles.
digynous |Of or pertaining to the Digynia; having two styles.
dihedral |Having two plane faces; as, the dihedral summit of a crystal. Dihedral angle, the angular space contained between planes which intersect. It is measured by the angle made by any two lines at right angles to the two planes.
dihedron |A figure with two sides or surfaces. Buchanan.
dihexagonal |(a) Consisting of two hexagonal parts united; thus, a dihexagonal pyramid is composed of two hexagonal pyramids placed base to base. (b) Having twelve similar faces; as, a dihexagonal prism.
diiamb |A diiambus.
diiambus |A double iambus; a foot consisting of two iambuses (
diiodide |A compound of a binary type containing two atoms of iodine; -- called also biniodide.
diisatogen |A red crystalline nitrogenous substance or artificial production, which by reduction passes directly to indigo.
dijudicant |One who dijudicates. [R.] Wood.
dijudicate |To make a judicial decision; to decide; to determine. [R.] Hales.
dijudication |The act of dijudicating; judgment. [R.] Cockeram.
dika |A kind of food, made from the almondlike seeds of the Irvingia Barteri, much used by natives of the west coast of Africa; -- called also dika bread.
dike |1. A ditch; a channel for water made by digging. Little channels or dikes cut to every bed. Ray. 2. An embankment to prevent inundations; a levee. Dikes that the hands of the farmers had raised . . . Shut out the turbulent tides. Longfellow. 3. A wall of turf or stone. [Scot.] 4. (Geol.)  A wall-like mass of mineral matter, usually an intrusion of igneous rocks, filling up rents or fissures in the original strata.\n\n1. To surround or protect with a dike or dry bank; to secure with a bank. 2. To drain by a dike or ditch.\n\nTo work as a ditcher; to dig. [Obs.] He would thresh and thereto dike and delve. Chaucer.
diker |1. A ditcher. Piers Plowman. 2. One who builds stone walls; usually, one who builds them without lime. [Scot.]
dilacerate |To rend asunder; to tear to pieces. Sir T. Browne.
dilaceration |The act of rending asunder. Arbuthnot.
dilaniate |To rend in pieces; to tear. [R.] Howell.
dilaniation |A rending or tearing in pieces; dilaceration. [R.]
dilapidate |1. To bring into a condition of decay or partial ruin, by misuse or through neglect; to destroy the fairness and good condition of; -- said of a building. If the bishop, parson, or vicar, etc., dilapidates the buildings, or cuts down the timber of the patrimony. Blackstone. 2. To impair by waste and abuse; to squander. The patrimony of the bishopric of Oxon was much dilapidated. Wood.\n\nTo get out of repair; to fall into partial ruin; to become decayed; as, the church was suffered to dilapidate. Johnson.
dilapidated |Decayed; fallen into partial ruin; injured by bad usage or neglect. A deserted and dilapidated buildings. Cooper.
dilapidation |1. The act of dilapidating, or the state of being dilapidated, reduced to decay, partially ruined, or squandered. Tell the people that are relived by the dilapidation of their public estate. Burke. 2. Ecclesiastical waste; impairing of church property by an incumbent, through neglect or by intention. The business of dilapidations came on between our bishop and the Archibishop of York. Strype. 3. (Law)  The pulling down of a building, or suffering it to fall or be in a state of decay. Burrill.
dilapidator |One who causes dilapidation. Strype.
dilatability |The quality of being dilatable, or admitting expansion; -- opposed to contractibility. Ray.
dilatable |Capable of expansion; that may be dilated; -- opposed to contractible; as, the lungs are dilatable by the force of air; air is dilatable by heat.
dilatation |1. Prolixity; diffuse discourse. [Obs.] \"What needeth greater dilatation\" Chaucer. 2. The act of dilating; expansion; an enlarging on al 3. (Anat.)  A dilation or enlargement of a canal or other organ.
dilatator |A muscle which dilates any part; a dilator.
dilate |1. To expand; to distend; to enlarge or extend in all directions; to swell; -- opposed to contract; as, the air dilates the lungs; air is dilated by increase of heat. 2. To enlarge upon; to relate at large; to tell copiously or diffusely. [R.] Do me the favor to dilate at full What hath befallen of them and thee till now. Shak. Syn. -- To expand; swell; distend; enlarge; spread out; amplify; expatiate.\n\n1. To grow wide; to expand; to swell or extend in all directions. His heart dilates and glories in his strength. Addison. 2. To speak largely and copiously; to dwell in narration; to enlarge; -- with on or upon. But still on their ancient joys dilate. Crabbe.\n\nExtensive; expanded. [Obs.] B. Jonson.
dilated |1. Expanded; enlarged. Shak. 2. (Bot.)  Widening into a lamina or into lateral winglike appendages. 3. (Zoöl.)  Having the margin wide and spreading.
dilatedly |In a dilated manner. Feltham.
dilater |One who, or that which, dilates, expands, o r enlarges.
dilation |Delay. [Obs.] Bp. Hall.\n\nThe act of dilating, or the state of being dilated; expansion; dilatation. Mrs. Browning. At first her eye with slow dilation rolled. Tennyson. A gigantic dilation of the hateful figure. Dickens.
dilative |Causing dilation; tending to dilate, on enlarge; expansive. Coleridge.
dilatometer |An instrument for measuring the dilatation or expansion of a substance, especially of a fluid.
dilator |1. One who, or that which, widens or expands. 2. (Anat.)  A muscle that dilates any part. 3. (Med.)  An instrument for expanding a part; as, a urethral dilator.
dilatorily |With delay; tardily.
dilatoriness |The quality of being dilatory; lateness; slowness; tardiness; sluggishness.
dilatory |1. Inclined to defer or put off what ought to be done at once; given the procrastination; delaying; procrastinating; loitering; as, a dilatory servant. 2. Marked by procrastination or delay; tardy; slow; sluggish; -- said of actions or measures. Alva, as usual, brought his dilatory policy to bear upon hiMotley. Dilatory plea (Law), a plea designed to create delay in the trial of a cause, generally founded upon some matter not connected with the merits of the case. Syn. -- Slow; delaying; sluggish; inactive; loitering; behindhand; backward; procrastinating. See Slow.
dildo |A burden in popular songs. [Obs.] Delicate burthens of dildos and fadings. Shak.\n\nA columnar cactaceous plant of the West Indies (Cereus Swartzii).
dilection |Love; choice. [Obs.] T. Martin.
dilemma |1. (Logic)  An argument which presents an antagonist with two or more alternatives, but is equally conclusive against him, whichever alternative he chooses. Note: The following are instances of the dilemma. A young rhetorician applied to an old sophist to be taught the art of pleading, and bargained for a certain reward to be paid when he should gain a cause. The master sued for his reward, and the scholar endeavored to dilemma. \"If I gain my cause, I shall withhold your pay, because the judge's award will be against you; if I lose it, I may withhold it, because I shall not yet have gained a cause.\" \"On the contrary,\" says the master, \"if you gain your cause, you must pay me, because you are to pay me when you gain a cause; if you lose it, you must pay me, because the judge will award it.\" Johnson. 2. A state of things in which evils or obstacles present themselves on every side, and it is difficult to determine what course to pursue; a vexatious alternative or predicament; a difficult choice or position. A strong dilemma in a desperate case! To act with infamy, or quit the place. Swift. Horns of a dilemma, alternatives, each of which is equally difficult of encountering.
dilettant |Of or pertaining to dilettanteism; amateur; as, dilettant speculation. Carlyle.\n\nA dilettante. Though few art lovers can be connoisseurs, many are dilettants. Fairholt.
dilettante |An admirer or lover of the fine arts; popularly, an amateur; especially, one who follows an art or a branch of knowledge, desultorily, or for amusement only. The true poet is not an eccentric creature, not a mere artist living only for art, not a dreamer or a dilettante, sipping the nectar of existence, while he keeps aloof from its deeper interests. J. C. Shairp.
dilettanteish |Somewhat like a dilettante.
dilettanteism |The state or quality of being a dilettante; the desultory pursuit of art, science, or literature.
dilettantish |Dilettanteish.
dilettantism |Same as Dilettanteism. F. Harrison.
diligence |1. The quality of being diligent; carefulness; careful attention; -- the opposite of negligence. 2. Interested and persevering application; devoted and painstaking effort to accomplish what is undertaken; assiduity in service. That which ordinary men are fit for, I am qualified in; and the best of me is diligence. Shak. 3. (Scots Law)  Process by which persons, lands, or effects are seized for debt; process for enforcing the attendance of witnesses or the production of writings. To do one's diligence, give diligence, use diligence, to exert one's self; to make interested and earnest endeavor. And each of them doth all his diligence To do unto the festé reverence. Chaucer. Syn. -- Attention; industry; assiduity; sedulousness; earnestness; constancy; heed; heedfulness; care; caution. -- Diligence, Industry. Industry has the wider sense of the two, implying an habitual devotion to labor for some valuable end, as knowledge, property, etc. Diligence denotes earnest application to some specific object or pursuit, which more or less directly has a strong hold on one's interests or feelings. A man may be diligent for a time, or in seeking some favorite end, without meriting the title of industrious. Such was the case with Fox, while Burke was eminent not only for diligence, but industry; he was always at work, and always looking out for some new field of mental effort. The sweat of industry would dry and die, But for the end it works to. Shak. Diligence and accuracy are the only merits which an historical writer ascribe to himself. Gibbon.\n\nA four-wheeled public stagecoach, used in France.
diligency |Diligence; care; persevering endeavor. [Obs.] Milton.
diligent |1. Prosecuted with careful attention and effort; careful; painstaking; not careless or negligent. The judges shall make diligent inquisition. Deut. xix. 18. 2. Interestedly and perseveringly attentive; steady and earnest in application to a subject or pursuit; assiduous; industrious. Seest thou a man diligent in his business he shall stand before kings. Prov. xxii. 29. Diligent cultivation of elegant literature. Prescott. Syn. -- Active; assiduous; sedulous; laborious; persevering; attentive; industrious.
diligently |In a diligent manner; not carelessly; not negligently; with industry or assiduity. Ye diligently keep commandments of the Lord your God. Deut. vi. 17.
dill |An herb (Peucedanum graveolens), the seeds of which are moderately warming, pungent, and aromatic, and were formerly used as a soothing medicine for children; -- called also dill-seed. Dr. Prior.\n\nTo still; to calm; to soothe, as one in pain. [Obs.]
dilling |A darling; a favorite. [Obs.] Whilst the birds billing, Each one with his dilling. Drayton.
dilluing |A process of sorting ore by washing in a hand sieve. [Written also deluing.]
dilly |A kind of stagecoach. \"The Derby dilly.\" J. H. Frere.
dilly-dally |To loiter or trifle; to waste time.
dilogical |Ambiguous; of double meaning. [Obs.] T. Adams.
dilogy |An ambiguous speech; a figure in which a word is used an equivocal sense. [R.]
dilucid |Clear; lucid. [Obs.] Bacon. -- Di*lu\"cid*ly, adv. [Obs.] -- Di`lu*cid\"i*ty, n. [Obs.]
dilucidate |To elucidate. [Obs.] Boyle.
dilucidation |The act of making clear. [Obs.] Boyle.
diluent |Diluting; making thinner or weaker by admixture, esp. of water. Arbuthnot.\n\n1. That which dilutes. 2. (Med.)  An agent used for effecting dilution of the blood; a weak drink. There is no real diluent but water. Arbuthnot.
dilute |1. To make thinner or more liquid by admixture with something; to thin and dissolve by mixing. Mix their watery store. With the chyle's current, and dilute it more. Blackmore. 2. To diminish the strength, flavor, color, etc., of, by mixing; to reduce, especially by the addition of water; to temper; to attenuate; to weaken. Lest these colors should be diluted and weakened by the mixture of any adventitious light. Sir I. Newton.\n\nTo become attenuated, thin, or weak; as, it dilutes easily.\n\nDiluted; thin; weak. A dilute and waterish exposition. Hopkins.
diluted |Reduced in strength; thin; weak. -- Di*lut\"ed*ly, adv.
diluteness |The quality or state of being dilute. Bp. Wilkins.
diluter |One who, or that which, dilutes or makes thin, more liquid, or weaker.
dilution |The act of diluting, or the state of being diluted. Arbuthnot.
diluvial |1. Of or pertaining to a flood or deluge, esp. to the great deluge in the days of Noah; diluvian. 2. (Geol.)  Effected or produced by a flood or deluge of water; -- said of coarse and imperfectly stratified deposits along ancient or existing water courses. Similar unstratified deposits were formed by the agency of ice. The time of deposition has been called the Diluvian epoch.
diluvialist |One who explains geological phenomena by the Noachian deluge. Lyell.
diluvian |Of or pertaining to a deluge, esp. to the Noachian deluge; diluvial; as, of diluvian origin. Buckland.
diluviate |To run as a flood. [Obs.] Sir E. Sandys.
diluvium |A deposit of superficial loam, sand, gravel, stones, etc., caused by former action of flowing waters, or the melting of glacial ice. Note: The accumulation of matter by the ordinary operation of water is termed alluvium.
dim |1. Not bright or distinct; wanting luminousness or clearness; obscure in luster or sound; dusky; darkish; obscure; indistinct; overcast; tarnished. The dim magnificence of poetry. Whewell. How is the gold become dim! Lam. iv. 1. I never saw The heavens so dim by day. Shak. Three sleepless nights I passed in sounding on, Through words and things, a dim and perilous way. Wordsworth. 2. Of obscure vision; not seeing clearly; hence, dull of apprehension; of weak perception; obtuse. Mine eye also is dim by reason of sorrow. Job xvii. 7. The understanding is dim. Rogers. Note: Obvious compounds: dim-eyed; dim-sighted, etc. Syn. -- Obscure; dusky; dark; mysterious; imperfect; dull; sullied; tarnished.\n\n1. To render dim, obscure, or dark; to make less bright or distinct; to take away the luster of; to darken; to dull; to obscure; to eclipse. A king among his courtiers, who dims all his attendants. Dryden. Now set the sun, and twilight dimmed the ways. Cowper. 2. To deprive of distinct vision; to hinder from seeing clearly, either by dazzling or clouding the eyes; to darken the senses or understanding of. Her starry eyes were dimmed with streaming tears. C. Pitt.\n\nTo grow dim. J. C. Shairp.
dim-sighted |Having dim sight; lacking perception. -- Dim\"-sight`ed*ness, n.
dimble |A bower; a dingle. [Obs.] Drayton.
dime |A silver coin of the United States, of the value of ten cents; the tenth of a dollar. Dime novel, a novel, commonly sensational and trashy, which is sold for a dime, or ten cents.
dimension |1. Measure in a single line, as length, breadth, height, thickness, or circumference; extension; measurement; -- usually, in the plural, measure in length and breadth, or in length, breadth, and thickness; extent; size; as, the dimensions of a room, or of a ship; the dimensions of a farm, of a kingdom. Gentlemen of more than ordinary dimensions. W. Irving. Space of dimension, extension that has length but no breadth or thickness; a straight or curved line. -- Space of two dimensions, extension which has length and breadth, but no thickness; a plane or curved surface. -- Space of three dimensions, extension which has length, breadth, and thickness; a solid. -- Space of four dimensions, as imaginary kind of extension, which is assumed to have length, breadth, thickness, and also a fourth imaginary dimension. Space of five or six, or more dimensions is also sometimes assumed in mathematics. 2. Extent; reach; scope; importance; as, a project of large dimensions. 3. (Math.)  The degree of manifoldness of a quantity; as, time is quantity having one dimension; volume has three dimensions, relative to extension. 4. (Alg.)  A literal factor, as numbered in characterizing a term. The term dimensions forms with the cardinal numbers a phrase equivalent to degree with the ordinal; thus, a2b2c is a term of five dimensions, or of the fifth degree. 5. pl. (Phys.)  The manifoldness with which the fundamental units of time, length, and mass are involved in determining the units of other physical quantities. Thus, since the unit of velocity varies directly as the unit of length and inversely as the unit of time, the dimensions of velocity are said to be length ÷ time; the dimensions of work are mass × (length)2 ÷ (time)2; the dimensions of density are mass ÷ (length)3. Dimension lumber, Dimension scantling, or Dimension stock (Carp.), lumber for building, etc., cut to the sizes usually in demand, or to special sizes as ordered. -- Dimension stone, stone delivered from the quarry rough, but brought to such sizes as are requisite for cutting to dimensions given.
dimensional |Pertaining to dimension.
dimensioned |Having dimensions. [R.]
dimensionless |Without dimensions; having no appreciable or noteworthy extent. Milton.
dimensity |Dimension. [R.] Howell.
dimensive |Without dimensions; marking dimensions or the limits. Who can draw the soul's dimensive lines Sir J. Davies.
dimera |(a) A division of Coleoptera, having two joints to the tarsi. (b) A division of the Hemiptera, including the aphids.
dimeran |One of the Dimera.
dimerous |Composed of, or having, two parts of each kind. Note: A dimerous flower has two sepals, two petals, two stamens, and two pistils.
dimeter |Having two poetical measures or meters. -- n.  A verse of two meters.
dimethyl |Ethane; -- sometimes so called because regarded as consisting of two methyl radicals. See Ethane.
dimetric |Same as Tetragonal. Dana.
dimication |A fight; contest. [Obs.] Bp. Hall.
dimidiate |1. Divided into two equal parts; reduced to half in shape or form. 2. (Biol.) (a) Consisting of only one half of what the normal condition requires; having the appearance of lacking one half; as, a dimidiate leaf, which has only one side developed. (b) Having the organs of one side, or half, different in function from the corresponding organs on the other side; as, dimidiate hermaphroditism.\n\n1. To divide into two equal parts. [Obs.] Cockeram. 2. (Her.)  To represent the half of; to halve.
dimidiation |The act of dimidiating or halving; the state of being dimidiate.
diminish |1. To make smaller in any manner; to reduce in bulk or amount; to lessen; -- opposed to augment or increase. Not diminish, but rather increase, the debt. Barrow. 2. To lessen the authority or dignity of; to put down; to degrade; to abase; to weaken. This doth nothing diminish their opinion. Robynson (More's Utopia). I will diminish them, that they shall no more rule over the nations. Ezek. xxix. 15. O thou . . . at whose sight all the stars Hide their diminished heads. Milton. 3. (Mus.)  To make smaller by a half step; to make (an interval) less than minor; as, a diminished seventh. 4. To take away; to subtract. Neither shall ye diminish aught from it. Deut. iv. 2. Diminished column, one whose upper diameter is less than the lower. -- Diminished, or Diminishing, scale, a scale of gradation used in finding the different points for drawing the spiral curve of the volute. Gwilt. -- Diminishing rule (Arch.), a board cut with a concave edge, for fixing the entasis and curvature of a shaft. -- Diminishing stile (Arch.), a stile which is narrower in one part than in another, as in many glazed doors. Syn. -- To decrease; lessen; abate; reduce; contract; curtail; impair; degrade. See Decrease.\n\nTo become or appear less or smaller; to lessen; as, the apparent size of an object diminishes as we recede from it.
