diminishable |Capable of being diminished or lessened.
diminisher |One who, or that which, diminishes anything. Clerke (1637).
diminishingly |In a manner to diminish.
diminishment |Diminution. [R.] Cheke.
diminuendo |In a gradually diminishing manner; with abatement of tone; decrescendo; -- expressed on the staff by Dim., or Dimin., or the sign.
diminuent |Lessening. Bp. Sanderson.
diminutal |Indicating or causing diminution. Earle.
diminute |Small; diminished; diminutive. [Obs.] Jer. Taylor.
diminutely |Diminutively. [Obs.]
diminution |1. The act of diminishing, or of making or becoming less; state of being diminished; reduction in size, quantity, or degree; -- opposed to augmentation or increase. 2. The act of lessening dignity or consideration, or the state of being deprived of dignity; a lowering in estimation; degradation; abasement. The world's opinion or diminution of me. Eikon Basilike. Nor thinks it diminution to be ranked In military honor next. Philips. 3. (Law)  Omission, inaccuracy, or defect in a record. 4. (Mus.)  In counterpoint, the imitation of, or reply to, a subject, in notes of half the length or value of those the subject itself. Syn. -- Decrease; decay; abatement; reduction; deduction; decrement.
diminutival |Indicating diminution; diminutive. \"Diminutival forms\" [of words]. Earle. -- n.  A diminutive. Earle.
diminutive |1. Below the average size; very small; little. 2. Expressing diminution; as, a diminutive word. 3. Tending to diminish. [R.] Diminutive of liberty. Shaftesbury.\n\n1. Something of very small size or value; an insignificant thing. Such water flies, diminutives of nature. Shak. 2. (Gram.)  A derivative from a noun, denoting a small or a young object of the same kind with that denoted by the primitive; as, gosling, eaglet, lambkin. Babyisms and dear diminutives. Tennyson. Note: The word sometimes denotes a derivative verb which expresses a diminutive or petty form of the action, as scribble.
diminutively |In a diminutive manner.
diminutiveness |The quality of being diminutive; smallness; littleness; minuteness.
dimish |See Dimmish.
dimission |Leave to depart; a dismissing. [Obs.] Barrow.
dimissory |Sending away; dismissing to another jurisdiction; granting leave to depart. Letters dimissory (Eccl.), letters given by a bishop dismissing a person who is removing into another diocese, and recommending him for reception there. Hook.
dimit |To dismiss, let go, or release. [Obs.]
dimity |A cotton fabric employed for hangings and furniture coverings, and formerly used for women's under-garments. It is of many patterns, both plain and twilled, and occasionally is printed in colors.
dimly |In a dim or obscure manner; not brightly or clearly; with imperfect sight.
dimmish |Somewhat dim; as, dimmish eyes. \"Dimmy clouds.\" Sir P. Sidney.
dimmy |Somewhat dim; as, dimmish eyes. \"Dimmy clouds.\" Sir P. Sidney.
dimness |1. The state or quality 2. Dullness, or want of clearness, of vision or of intellectual perception. Dr. H. More. Syn. -- Darkness; obscurity; gloom. See Darkness.
dimorph |Either one of the two forms of a dimorphous substance; as, calcite and aragonite are dimorphs.
dimorphic |Having the property of dimorphism; dimorphous.
dimorphism |1. (Biol.)  Difference of form between members of the same species, as when a plant has two kinds of flowers, both hermaphrodite (as in the partridge berry), or when there are two forms of one or both sexes of the same species of butterfly. Dimorphism is the condition of the appearance of the same species under two dissimilar forms. Darwin. 2. (Crystallog.)  Crystallization in two independent forms of the same chemical compound, as of calcium carbonate as calcite and aragonite.
dimorphous |1. (Biol.)  Characterized by dimorphism; occurring under two distinct forms, not dependent on sex; dimorphic. 2. (Crystallog.)  Crystallizing under two forms fundamentally different, while having the same chemical composition.
dimple |1. A slight natural depression or indentation on the surface of some part of the body, esp. on the cheek or chin. Milton. The dimple of her chin. Prior. 2. A slight indentation on any surface. The garden pool's dark surface . . . Breaks into dimples small and bright. Wordsworth.\n\nTo form dimples; to sink into depressions or little inequalities. And smiling eddies dimpled on the main. Dryden.\n\nTo mark with dimples or dimplelike depressions. Shak.
dimplement |The state of being dimpled, or marked with gentle depressions. [R.] The ground's most gentle dimplement. Mrs. Browning.
dimply |Full of dimples, or small depressions; dimpled; as, the dimply pool. Thomson.
dimya |An order of lamellibranchiate mollusks having an anterior and posterior adductor muscle, as the common clam. See Bivalve.
dimyaria |An order of lamellibranchiate mollusks having an anterior and posterior adductor muscle, as the common clam. See Bivalve.
dimyarian |Like or pertaining to the Dimya. -- n.  One of the Dimya.
dimyary |Same as Dimyarian.
din |Loud, confused, harsh noise; a loud, continuous, rattling or clanging sound; clamor; roar. Think you a little din can daunt mine ears Shak. He knew the battle's din afar. Sir W. Scott. The dust and din and steam of town. Tennyson.\n\n1. To strike with confused or clanging sound; to stun with loud and continued noise; to harass with clamor; as, to din the ears with cries. 2. To utter with a din; to repeat noisily; to ding. This hath been often dinned in my ears. Swift. To din into, to fix in the mind of another by frequent and noisy repetitions. Sir W. Scott.\n\nTo sound with a din; a ding. The gay viol dinning in the dale. A. Seward.
dinaphthyl |A colorless, crystalline hydrocarbon, C20H14, obtained from naphthylene, and consisting of a doubled naphthylene radical.
dinar |1. A petty money of accounts of Persia. 2. An ancient gold coin of the East.
dinarchy |See Diarchy.
dine |To eat the principal regular meal of the day; to take dinner. Now can I break my fast, dine, sup, and sleep. Shak. To dine with Duke Humphrey, to go without dinner; -- a phrase common in Elizabethan literature, said to be from the practice of the poor gentry, who beguiled the dinner hour by a promenade near the tomb of Humphrey, Duke of Gloucester, in Old Saint Paul's.\n\n1. To give a dinner to; to furnish with the chief meal; to feed; as, to dine a hundred men. A table massive enough to have dined Johnnie Armstrong and his merry men. Sir W. Scott. 2. To dine upon; to have to eat. [Obs.] \"What will ye dine.\" Chaucer.
diner |One who dines.
diner-out |One who often takes his dinner away from home, or in company. A brilliant diner-out, though but a curate. Byron.
dinetical |Revolving on an axis. [Obs.] Sir T. Browne.
ding |1. To dash; to throw violently. [Obs.] To ding the book a coit's distance from him. Milton. 2. To cause to sound or ring. To ding (anything) in one's ears, to impress one by noisy repetition, as if by hammering.\n\n1. To strike; to thump; to pound. [Obs.] Diken, or delven, or dingen upon sheaves. Piers Plowman. 2. To sound, as a bell; to ring; to clang. The fretful tinkling of the convent bell evermore dinging among the mountain echoes. W. Irving. 3. To talk with vehemence, importunity, or reiteration; to bluster. [Low]\n\nA thump or stroke, especially of a bell.
dingdong |1. The sound of, or as of, repeated strokes on a metallic body, as a bell; a repeated and monotonous sound. 2. (Horol.)  An attachment to a clock by which the quarter hours are struck upon bells of different tones.
dingdong theory |The theory which maintains that the primitive elements of language are reflex expressions induced by sensory impressions; that is, as stated by Max MÃ¼ller, the creative faculty gave to each general conception as it thrilled for the first time through the brain a phonetic expression; -- jocosely so called from the analogy of the sound of a bell induced by the stroke of the clapper.
dingey |1. A kind of boat used in the East Indies. [Written also dinghey.] Malcom. 2. A ship's smallest boat.
dinghy |1. A kind of boat used in the East Indies. [Written also dinghey.] Malcom. 2. A ship's smallest boat.
dingily |In a dingy manner.
dinginess |Quality of being dingy; a dusky hue.
dingle |A narrow dale; a small dell; a small, secluded, and embowered valley.
dingle-dangle |In a dangling manner.
dingo |A wild dog found in Australia, but supposed to have introduced at a very early period. It has a wolflike face, bushy tail, and a reddish brown color.
dingthrift |A spendthrift. [Obs.] Wilt thou, therefore, a drunkard be, A dingthrift and a knave Drant.
dingy |1. A kind of boat used in the East Indies. [Written also dinghey.] Malcom. 2. A ship's smallest boat.\n\nSoiled; sullied; of a dark or dusky color; dark brown; dirty. \"Scraps of dingy paper.\" Macaulay.
dinichthys |A genus of large extinct Devonian ganoid fishes. In some parts of Ohio remains of the Dinichthys are abundant, indicating animals twenty feet in length.
dining |from Dine, a. Note: Used either adjectively or as the first part of a compound; as, dining hall or dining-hall, dining room, dining table, etc.
dink |Trim; neat. [Scot.] Burns. -- Dink\"ly, adv.\n\nTo deck; -- often with out or up. [Scot.]
dinmont |A wether sheep between one and two years old. [Scot.]
dinner |1. The principal meal of the day, eaten by most people about midday, but by many (especially in cities) at a later hour. 2. An entertainment; a feast. A grand political dinner. Tennyson. Note: Dinner is much used, in an obvious sense, either adjectively or as the first part of a compound; as, dinner time, or dinner-time, dinner bell, dinner hour, etc.
dinnerless |Having no dinner. Fuller.
dinnerly |Of or pertaining to dinner. [R.] The dinnerly officer. Copley.
dinoceras |A genus of large extinct Eocene mammals from Wyoming; -- called also Uintatherium. See Illustration in Appendix. Note: They were herbivorous, and remarkable for three pairs of hornlike protuberances on the skull. The males were armed with a pair of powerful canine tusks.
dinornis |A genus of extinct, ostrichlike birds of gigantic size, which formerly inhabited New Zealand. See Moa. [Written also Deinornis.]
dinosaur |One of the Dinosauria. [Written also deinosaur, and deinosaurian.]
dinosauria |An order of extinct mesozoic reptiles, mostly of large size (whence the name). Notwithstanding their size, they present birdlike characters in the skeleton, esp. in the pelvis and hind limbs. Some walked on their three-toed hind feet, thus producing the large \"bird tracks,\" so-called, of mesozoic sandstones; others were five-toed and quadrupedal. See Illust. of Compsognathus, also Illustration of Dinosaur in Appendix.
dinosaurian |One of the Dinosauria. [Written also deinosaur, and deinosaurian.]
dinothere |A large extinct proboscidean mammal from the miocene beds of Europe and Asia. It is remarkable fora pair of tusks directed downward from the decurved apex of the lower jaw.
dinotherium |A large extinct proboscidean mammal from the miocene beds of Europe and Asia. It is remarkable fora pair of tusks directed downward from the decurved apex of the lower jaw.
dinoxide |Same as Dioxide.
dinsome |Full of din. [Scot.] Burns.
dint |1. A blow; a stroke. [Obs.] \"Mortal dint.\" Milton. \"Like thunder's dint.\" Fairfax. 2. The mark left by a blow; an indentation or impression made by violence; a dent. Dryden. Every dint a sword had beaten in it [the shield]. Tennyson. 3. Force; power; -- esp. in the phrase by dint of. Now you weep; and, I perceive, you feel The dint of pity. Shak. It was by dint of passing strength That he moved the massy stone at length. Sir W. Scott.\n\nTo make a mark or cavity on or in, by a blow or by pressure; to dent. Donne. Tennyson.
dinumeration |Enumeration. [Obs.] Bullokar.
diocesan |Of or pertaining to a diocese; as, diocesan missions.\n\n1. A bishop, viewed in relation to his diocese; as, the diocesan of New York. 2. pl.  The clergy or the people of a diocese. Strype.
diocese |The circuit or extent of a bishop's jurisdiction; the district in which a bishop exercises his ecclesiastical authority. [Frequently, but improperly, spelt diocess.]
diocesener |One who belongs to a diocese. [Obs.] Bacon.
diodon |1. (ZoÃ¶l.)  A genus of spinose, plectognath fishes, having the teeth of each jaw united into a single beaklike plate. They are able to inflate the body by taking in air or water, and, hence, are called globefishes, swellfishes, etc. fishes, and sea hedgehogs. 2. (ZoÃ¶l.)  A genus of whales.
diodont |Like or pertaining to the genus Diodon. -- n.  A fish of the genus Diodon, or an allied genus.
dioecia |1. (Bot.)  A LinnÃ¦an class of plants having the stamens and pistils on different plants. 2. (ZoÃ¶l.)  A subclass of gastropod mollusks in which the sexes are separate. It includes most of the large marine species, like the conchs, cones, and cowries.
dioecian |Having the sexes in applied to plants in which the female flowers occur on one individual and the male flowers on another of the same species, and to animals in which the ovum is produced by one individual and the sperm cell by another; -- opposed to monoecious.
dioecious |Having the sexes in applied to plants in which the female flowers occur on one individual and the male flowers on another of the same species, and to animals in which the ovum is produced by one individual and the sperm cell by another; -- opposed to monoecious.
dioeciously |In a dioecious manner. Dioeciously hermaphrodite (Bot.), having flowers structurally perfect, but practically dioecious, -- those on one plant producing no pollen, and those on another no ovules.
dioeciousness |The state or quality of being dioecious.
dioecism |The condition of being dioecious.
diogenes |A Greek Cynic philosopher (412-323 B. C.) who lived much in Athens and was distinguished for contempt of the common aims and conditions of life, and for sharp, caustic sayings. Diogenes' crab (ZoÃ¶l.), a species of terrestrial hermit crabs (Cenobita Diogenes), abundant in the West Indies and often destructive to crops. -- Diogenes' tub, the tub which the philosopher Diogenes is said to have carried about with him as his house, in which he lived.
dioicous |See Dioecious.
diomedea |A genus of large sea birds, including the albatross. See Albatross.
dionaea |An insectivorous plant. See Venus's flytrap.
dionysia |Any of the festivals held in honor of the Olympian god Dionysus. They correspond to the Roman Bacchanalia; the greater Dionysia were held at Athens in March or April, and were celebrated with elaborate performances of both tragedies and comedies.
dionysiac |Of or pertaining to Dionysus or to the Dionysia; Bacchic; as, a Dionysiac festival; the Dionysiac theater at Athens.
dionysian |Relating to Dionysius, a monk of the 6th century; as, the Dionysian, or Christian, era. Dionysian period, a period of 532 years, depending on the cycle of the sun, or 28 years, and the cycle of the moon, or 19 years; -- sometimes called the Greek paschal cycle, or Victorian period.
diophantine |Originated or taught by Diophantus, the Greek writer on algebra. Diophantine analysis (Alg.), that branch of indeterminate analysis which has for its object the discovery of rational values that satisfy given equations containing squares or cubes; as, for example, to find values of x and y which make x2 + y2 an exact square.
diopside |A crystallized variety of pyroxene, of a clear, grayish green color; mussite.
dioptase |A hydrous silicate of copper, occurring in emerald-green crystals.
diopter |An optical instrument, invented by Hipparchus, for taking altitudes, leveling, etc.
dioptra |An optical instrument, invented by Hipparchus, for taking altitudes, leveling, etc.
dioptre |A unit employed by oculists in numbering glasses according to the metric system; a refractive power equal to that of a glass whose principal focal distance is one meter.
dioptric |Of or pertaining to the dioptre, or to the metric system of numbering glasses. -- n.  A dioptre. See Dioptre.\n\nOf or pertaining to dioptrics; assisting vision by means of the refraction of light; refractive; as, the dioptric system; a dioptric glass or telescope. \"Dioptrical principles.\" Nichol. Dioptric curve (Geom.), a Cartesian oval. See under Cartesian.
dioptrical |Of or pertaining to dioptrics; assisting vision by means of the refraction of light; refractive; as, the dioptric system; a dioptric glass or telescope. \"Dioptrical principles.\" Nichol. Dioptric curve (Geom.), a Cartesian oval. See under Cartesian.
dioptrics |The science of the refraction of light; that part of geometrical optics which treats of the laws of the refraction of light in passing from one medium into another, or through different mediums, as air, water, or glass, and esp. through different lenses; -- distinguished from catoptrics, which refers to reflected light.
dioptry |A dioptre.
diorama |1. A mode of scenic representation, invented by Daguerre and Bouton, in which a painting is seen from a distance through a large opening. By a combination of transparent and opaque painting, and of transmitted and reflected light, and by contrivances such as screens and shutters, much diversity of scenic effect is produced. 2. A building used for such an exhibition.
dioramic |Pertaining to a diorama.
diorism |Definition; logical direction. [Obs.] Dr. H. More.
dioristic |Distinguishing; distinctive; defining. [R.] -- Di`o*ris\"tic*al*ly, adv. [R.] Dr. H. More.
diorite |An igneous, crystalline in structure, consisting essentially of a triclinic feldspar and hornblende. It includes part of what was called greenstone.
dioritic |Containing diorite.
diorthotic |Relating to the correcting or straightening out of something; corrective.
dioscorea |A genus of plants. See Yam.
diota |A vase or drinking cup having two handles or ears.
dioxide |(a) An oxide containing two atoms of oxygen in each molecule; binoxide. (b) An oxide containing but one atom or equivalent of oxygen to two of a metal; a suboxide. [Obs.] Carbon dioxide. See Carbonic acid, under Carbonic.
dioxindol |A white, crystalline, nitrogenous substance obtained by the reduction of isatin. It is a member of the indol series; -- hence its name.
dip |1. To plunge or immerse; especially, to put for a moment into a liquid; to insert into a fluid and withdraw again. The priest shall dip his finger in the blood. Lev. iv. 6. [Wat'ry fowl] now dip their pinions in the briny deep. Pope. While the prime swallow dips his wing. Tennyson. 2. To immerse for baptism; to baptize by immersion. Book of Common Prayer. Fuller. 3. To wet, as if by immersing; to moisten. [Poetic] A cold shuddering dew Dips me all o'er. Milton. 4. To plunge or engage thoroughly in any affair. He was . . . dipt in the rebellion of the Commons. Dryden. 5. To take out, by dipping a dipper, ladle, or other receptacle, into a fluid and removing a part; -- often with out; as, to dip water from a boiler; to dip out water. 6. To engage as a pledge; to mortgage. [Obs.] Live on the use and never dip thy lands. Dryden. Dipped candle, a candle made by repeatedly dipping a wick in melted tallow. -- To dip snuff, to take snuff by rubbing it on the gums and teeth. [Southern U. S.] -- To dip the colors (Naut.), to lower the colors and return them to place; -- a form of naval salute.\n\n1. To immerse one's self; to become plunged in a liquid; to sink. The sun's rim dips; the stars rush out. Coleridge. 2. To perform the action of plunging some receptacle, as a dipper, ladle. etc.; into a liquid or a soft substance and removing a part. Whoever dips too deep will find death in the pot. L'Estrange. 3. To pierce; to penetrate; -- followed by in or into. When I dipt into the future. Tennyson. 4. To enter slightly or cursorily; to engage one's self desultorily or by the way; to partake limitedly; -- followed by in or into. \"Dipped into a multitude of books.\" Macaulay. 5. To incline downward from the plane of the horizon; as, strata of rock dip. 6. To dip snuff. [Southern U.S.]\n\n1. The action of dipping or plunging for a moment into a liquid. \"The dip of oars in unison.\" Glover. 2. Inclination downward; direction below a horizontal line; slope; pitch. 3. A liquid, as a sauce or gravy, served at table with a ladle or spoon. [Local, U.S.] Bartlett. 4. A dipped candle. [Colloq.] Marryat. Dip of the horizon (Astron.), the angular depression of the seen or visible horizon below the true or natural horizon; the angle at the eye of an observer between a horizontal line and a tangent drawn from the eye to the surface of the ocean. -- Dip of the needle, or Magnetic dip, the angle formed, in a vertical plane, by a freely suspended magnetic needle, or the line of magnetic force, with a horizontal line; -- called also inclination. -- Dip of a stratum (Geol.), its greatest angle of inclination to the horizon, or that of a line perpendicular to its direction or strike; -- called also the pitch.
dipaschal |Including two passovers. Carpenter.
dipchick |See Dabchick.
dipetalous |Having two petals; two-petaled.
diphenyl |A white crystalline substance, C6H5.C6H5, obtained by leading benzene through a heated iron tube. It consists of two benzene or phenyl radicals united.
diphtheria |A very dangerous contagious disease in which the air passages, and especially the throat, become coated with a false membrane, produced by the solidification of an inflammatory exudation. Cf. Group.
diphtherial |Relating to diphtheria; diphtheritic.
diphtheric |Relating to diphtheria; diphtheritic.
diphtheritic |1. Pertaining to, or connected with, diphtheria. 2. Having characteristics resembling those of diphtheria; as, diphtheritic inflammation of the bladder.
diphthong |(a) A coalition or union of two vowel sounds pronounced in one syllable; as, ou in out, oi in noise; -- called a proper diphthong. (b) A vowel digraph; a union of two vowels in the same syllable, only one of them being sounded; as, ai in rain, eo in people; -- called an improper diphthong.\n\nTo form or pronounce as a diphthong; diphthongize. [R.]
diphthongal |Relating or belonging to a diphthong; having the nature of a diphthong. -- Diph*thon\"gal*ly, adv.
diphthongalize |To make into a diphthong; to pronounce as a diphthong.
diphthongation |See Diphthongization.
diphthongic |Of the nature of diphthong; diphthongal. H. Sweet.
diphthongization |The act of changing into a diphthong. H. Sweet.
diphthongize |To change into a diphthong, as by affixing another vowel to a simple vowel. \"The diphthongized long vowels.\" H. Sweet.
diphycercal |Having the tail fin divided into two equal parts by the notochord, or end of the vertebral column; protocercal. See Protocercal.
diphygenic |Having two modes of embryonic development.
diphyllous |Having two leaves, as a calyx, etc.
diphyodont |Having two successive sets of teeth (deciduous and permanent), one succeeding the other; as, a diphyodont mammal; diphyodont dentition; -- opposed to monophyodont. -- n.  An animal having two successive sets of teeth.
diphyozooid |One of the free-swimming sexual zooids of Siphonophora.
diplanar |Of or pertaining to two planes.
dipleidoscope |An instrument for determining the time of apparent noon. It consists of two mirrors and a plane glass disposed in the form of a prism, so that, by the reflections of the sun's rays from their surfaces, two images are presented to the eye, moving in opposite directions, and coinciding at the instant the sun's center is on the meridian.
diplex |Pertaining to the sending of two messages in the same direction at the same time. Diplex and contraplex are the two varieties of duplex.
diploblastic |Characterizing the ovum when it has two primary germinal layers.
diplocardiac |Having the heart completely divided or double, one side systemic, the other pulmonary.
diplococcus |A form of micrococcus in which cocci are united in a binary manner. See Micrococcus.
diploe |The soft, spongy, or cancellated substance between the plates of the skull.
diploetic |Diploic.
diplogenic |Partaking of the nature of two bodies; producing two substances. Wright.
diplograph |An instrument used for double writing, as one for producing embossed writing for the blind and ordinary writing at the same time. -- Dip`lo*graph\"ic*al (#), a. -- Dip*log\"ra*phy (#), n.
diploic |Of or pertaining to the diploÃ«.
diploid |A solid bounded by twenty-four similar quadrilateral faces. It is a hemihedral form of the hexoctahedron.
diploma |A letter or writing, usually under seal, conferring some privilege, honor, or power; a document bearing record of a degree conferred by a literary society or educational institution.
diplomacy |1. The art and practice of conducting negotiations between nations (particularly in securing treaties), including the methods and forms usually employed. 2. Dexterity or skill in securing advantages; tact. 3. The body of ministers or envoys resident at a court; the diplomatic body. [R.] Burke.
diplomat |A diplomatist.
diplomate |A diplomatist.\n\nTo invest with a title o [R.] Wood.
diplomatial |Diplomatic. [R.]
diplomatic |1. Pertaining to diplomacy; relating to the foreign ministers at a court, who are called the diplomatic body. 2. Characterized by tact and shrewdness; dexterous; artful; as, diplomatic management. 3. Pertaining to diplomatics; paleographic. Astle.\n\nA minister, official agent, or envoy to a foreign court; a diplomatist.
diplomatical |1. Pertaining to diplomacy; relating to the foreign ministers at a court, who are called the diplomatic body. 2. Characterized by tact and shrewdness; dexterous; artful; as, diplomatic management. 3. Pertaining to diplomatics; paleographic. Astle.
diplomatically |According to the rules of diplomacy; in the manner of a diplomatist; artfully.
diplomatics |The science of diplomas, or the art of deciphering ancient writings, and determining their age, authenticity, etc.; paleography.
diplomatism |Diplomacy. [R.]
diplomatist |A person employed in, or skilled in, diplomacy; a diplomat. In ability, Avaux had no superior among the numerous able diplomatics whom his country then possessed. Macaulay.
diplopia |The act or state of seeing double. Note: In crossed or heteronymous diplopia the image seen by the right eye is upon the left hand, and that seen by the left eye is upon the right hand. In homonymous diplopia the image seen by the right eye is on the right side, that by the left eye on the left side. In vertical diplopia one image stands above the other.
diplopod |One of the Diplopoda.
diplopoda |An order of myriapods having two pairs of legs on each segment; the Chilognatha.
diplopy |The act or state of seeing double. Note: In crossed or heteronymous diplopia the image seen by the right eye is upon the left hand, and that seen by the left eye is upon the right hand. In homonymous diplopia the image seen by the right eye is on the right side, that by the left eye on the left side. In vertical diplopia one image stands above the other.
diplostemonous |Having twice as many stamens as petals, as the geranium. R. Brown.
diplostemony |The condition of being diplostemonous.
dipneumona |A group of spiders having only two lunglike organs. [Written also Dipneumones.]
dipnoi |A group of ganoid fishes, including the living genera Ceratodus and Lepidosiren, which present the closest approximation to the Amphibia. The air bladder acts as a lung, and the nostrils open inside the mouth. See Ceratodus, and Illustration in Appendix.
dipody |Two metrical feet taken together, or included in one measure. Hadley. Trochaic, iambic, and anapestic verses . . . are measured by dipodies. W. W. Goodwin.
dipolar |Having two poles, as a magnetic bar. DIPPEL'S OIL Dip\"pel's oil`. (Chem.) Etym: [From the name of the inventor.]  See Bone oil, under Bone.
dipper |1. One who, or that which, dips; especially, a vessel used to dip water or other liquid; a ladle. 2. (ZoÃ¶l.) (a) A small grebe; the dabchick. (b) The buffel duck. (c) The water ouzel (Cinolus aquaticus) of Europe. (d) The American dipper or ouzel (Cinclus Mexicanus). The Dipper (Astron.), the seven principal stars in the constellation of the Great Bear; popularly so called from their arrangement in the form of a dipper; -- called also Charles's Wain. See Ursa Major, under Ursa.
dipping |1. The act or process of immersing. 2. The act of inclining downward. 3. The act of lifting or moving a liquid with a dipper, ladle, or the like. 4. The process of cleaning or brightening sheet metal or metalware, esp. brass, by dipping it in acids, etc. 5. The practice of taking snuff by rubbing the teeth or gums with a stick or brush dipped in snuff. [U.S.] Dipping needle, a magnetic needle suspended at its center of gravity, and moving freely in a vertical plane, so as to indicate on a graduated circle the magnetic dip or inclination.
diprismatic |Doubly prismatic.
dipropargyl |A pungent, mobile, volatile liquid, C6H6, produced artificially from certain allyl derivatives. Though isomeric with benzine, it is very different in its chemical relations. Called also dipropinyl.
dipropyl |One of the hexane paraffins, found in petroleum, consisting of two propyl radicals. See Hexane.
diprotodon |An extinct Quaternary marsupial from Australia, about as large as the hippopotamus; -- so named because of its two large front teeth. See Illustration in Appendix.
dipsas |1. A serpent whose bite was fabled to produce intense thirst. Milton. 2. (ZoÃ¶l.)  A genus of harmless colubrine snakes.
dipsetic |Tending to produce thirst. Wright.
dipsey |Deep-sea; as, a dipsey line; a dipsy lead. [Sailor's Cant]\n\n1. A sinker attached to a fishing line; also, a line having several branches, each with such a sinker, used in deep-sea fishing. [Local, U. S.] 2.  (Naut.) A deep-sea lead. [Rare]
dipsie |Deep-sea; as, a dipsey line; a dipsy lead. [Sailor's Cant]\n\n1. A sinker attached to a fishing line; also, a line having several branches, each with such a sinker, used in deep-sea fishing. [Local, U. S.] 2.  (Naut.) A deep-sea lead. [Rare]
dipsomania |A morbid an uncontrollable craving (often periodic) for drink, esp. for alcoholic liquors; also improperly used to denote acute and chronic alcoholism.
dipsomaniac |One who has an irrepressible desire for alcoholic drinks.
dipsomaniacal |Of or pertaining to dipsomania.
dipsosis |Excessive thirst produced by disease.
dipsy |Deep-sea; as, a dipsey line; a dipsy lead. [Sailor's Cant]\n\n1. A sinker attached to a fishing line; also, a line having several branches, each with such a sinker, used in deep-sea fishing. [Local, U. S.] 2.  (Naut.) A deep-sea lead. [Rare]
diptera |An extensive order of insects having only two functional wings and two balancers, as the house fly, mosquito, etc. They have a suctorial proboscis, often including two pairs of sharp organs (mandibles and maxillÃ¦) with which they pierce the skin of animals. They undergo a complete metamorphosis, their larvÃ¦ (called maggots) being usually without feet.
dipteral |1. (ZoÃ¶l.)  Having two wings only; belonging to the order Diptera. 2. (Anc. Arch.)  Having a double row of columns on each on the flanks, as well as in front and rear; -- said of a temple.
dipteran |An insect of the order Diptera.
dipterocarpus |A genus of trees found in the East Indies, some species of which produce a fragrant resin, other species wood oil. The fruit has two long wings.
dipterous |1. (ZoÃ¶l.)  Having two wings, as certain insects; belonging to the order Diptera. 2. (Bot.)  Having two wings; two-winged.
dipterygian |Having two dorsal fins; -- said of certain fishes.
diptote |A noun which has only two cases. Andrews.
diptych |1. Anything consisting of two leaves. Especially: (a) (Roman Antiq.) A writing tablet consisting of two leaves of rigid material connected by hinges and shutting together so as to protect the writing within. (b) A picture or series of pictures painted on two tablets connected by hinges. See Triptych. 2. A double catalogue, containing in one part the names of living, and in the other of deceased, ecclesiastics and benefactors of the church; a catalogue of saints.
dipyre |A mineral of the scapolite group; -- so called from the double effect of fire upon it, in fusing it, and rendering it phosphorescent.
dipyrenous |Containing two stones or nutlets.
dipyridine |A polymeric form of pyridine, C10H10N2, obtained as a colorless oil by the action of sodium on pyridine.
dipyridyl |A crystalline nitrogenous base, C10H8N2, obtained by the reduction of pyridine.
diradiation |The emission and diffusion of rays of light.
dire |1. Ill-boding; portentous; as, dire omens. 2. Evil in great degree; dreadful; dismal; horrible; terrible; lamentable. Dire was the tossing, deep the groans. Milton. Gorgons and hydras and chimeras dire. Milton.
direct |1. Straight; not crooked, oblique, or circuitous; leading by the short or shortest way to a point or end; as, a direct line; direct means. What is direct to, what slides by, the question. Locke. 2. Straightforward; not of crooked ways, or swerving from truth and openness; sincere; outspoken. Be even and direct with me. Shak. 3. Immediate; express; plain; unambiguous. He howhere, that I know, says it in direct words. Locke. A direct and avowed interference with elections. Hallam. 4. In the line of descent; not collateral; as, a descendant in the direct line. 5. (Astron.)  In the direction of the general planetary motion, or from west to east; in the order of the signs; not retrograde; -- said of the motion of a celestial body. Direct action. (Mach.) See Direct-acting. -- Direct discourse (Gram.), the language of any one quoted without change in its form; as, he said \"I can not come;\" -- correlative to indirect discourse, in which there is change of form; as, he said that he could not come. They are often called respectively by their Latin names, oratio directa, and oratio obliqua. -- Direct evidence (Law), evidence which is positive or not inferential; -- opposed to circumstantial, or indirect, evidence. -- This distinction, however, is merely formal, since there is no direct evidence that is not circumstantial, or dependent on circumstances for its credibility. Wharton. -- Direct examination (Law), the first examination of a witness in the orderly course, upon the merits. Abbott. -- Direct fire (Mil.), fire, the direction of which is perpendicular to the line of troops or to the parapet aimed at. -- Direct process (Metal.), one which yields metal in working condition by a single process from the ore. Knight. -- Direct tax, a tax assessed directly on lands, etc., and polls, distinguished from taxes on merchandise, or customs, and from excise.\n\n1. To arrange in a direct or straight line, as against a mark, or towards a goal; to point; to aim; as, to direct an arrow or a piece of ordnance. 2. To point out or show to (any one), as the direct or right course or way; to guide, as by pointing out the way; as, he directed me to the left-hand road. The Lord direct your into the love of God. 2 Thess. iii. 5. The next points to which I will direct your attention. Lubbock. 3. To determine the direction or course of; to cause to go on in a particular manner; to order in the way to a certain end; to regulate; to govern; as, to direct the affairs of a nation or the movements of an army. I will direct their work in truth. Is. lxi. 8. 4. To point out to with authority; to instruct as a superior; to order; as, he directed them to go. I 'll first direct my men what they shall do. Shak. 5. To put a direction or address upon; to mark with the name and residence of the person to whom anything is sent; to superscribe; as, to direct a letter. Syn. -- To guide; lead; conduct; dispose; manage; regulate; order; instruct; command.\n\nTo give direction; to point out a course; to act as guide. Wisdom is profitable to direct. Eccl. x. 10.\n\nA character, thus [ Moore (Encyc. of Music).
direct action |See Syndicalism, below.
direct current |(a) A current flowing in one direction only; -- distinguished from alternating current. When steady and not pulsating a direct current is often called a continuous current. (b) A direct induced current, or momentary current of the same direction as the inducing current, produced by stopping or removing the latter; also, a similar current produced by removal of a magnet.
direct nomination |The nomination or designation of candidates for public office by direct popular vote rather than through the action of a convention or body of elected nominating representatives or delegates. The term is applied both to the nomination of candidates without any nominating convention, and, loosely, to the nomination effected, as in the case of candidates for president or senator of the United States, by the election of nominating representatives pledged or instructed to vote for certain candidates dssignated by popular vote.
direct primary |A primary by which direct nominations of candidates for office are made.
direct-acting |Acting directly, as one part upon another, without the intervention of other working parts. Direct-acting steam engine, one in which motion is transmitted to the crank without the intervention of a beam or lever; -- also called direct-action steam engine. -- Direct-acting steam pump, one in which the steam piston rod is directly connected with the pump rod; -- also called direct-action steam pump.
direct-coupled |Coupled without intermediate connections, as an engine and a dynamo. Direct-coupled antenna (Wireless Teleg.), an antenna connected electrically with one point of a closed oscillation circuit in syntony with it and earthed.
directer |One who directs; a director. Directer plane (Geom.), the plane to which all right-lined elements in a warped surface are parallel.
direction |1. The act of directing, of aiming, regulating, guiding, or ordering; guidance; management; superintendence; administration; as, the direction o. I do commit his youth To your direction. Shak. All nature is but art, unknown to thee;direction, which thou canst not see. Pope. 2. That which is imposed by directing; a guiding or authoritative instruction; prescription; order; command; as, he grave directions to the servants. The princes digged the well . . . by the direction of the law giver. Numb. xxi. 18. 3. The name and residence of a person to whom any thing is sent, written upon the thing sent; superscription; address; as, the direction of a letter. 4. The line or course upon which anything is moving or aimed to move, or in which anything is lying or pointing; aim; line or point of tendency; direct line or course; as, the ship sailed in a southeasterly direction. 5. The body of managers of a corporation or enterprise; board of directors. 6. (Gun.)  The pointing of a piece with reference to an imaginary vertical axis; -- distinguished from elevation. The direction is given when the plane of sight passes through the object. Wilhelm. Syn. -- Administration; guidance; management; superintendence; oversight; government; order; command; guide; clew. Direction, Control, Command, Order. These words, as here compared, have reference to the exercise of power over the actions of others. Control is negative, denoting power to restrain; command is positive, implying a right to enforce obedience; directions are commands containing instructions how to act. Order conveys more prominently the idea of authority than the word direction. A shipmaster has the command of his vessel; he gives orders or directions to the seamen as to the mode of sailing it; and exercises a due control over the passengers.
directive |1. Having power to direct; tending to direct, guide, or govern; showing the way. Hooker. The precepts directive of our practice in relation to God. Barrow. 2. Able to be directed; manageable. [Obs.] Swords and bows Directive by the limbs. Shak.
directly |1. In a direct manner; in a straight line or course. \"To run directly on.\" Shak. Indirectly and directly too Thou hast contrived against the very life Of the defendant. Shak. 2. In a straightforward way; without anything intervening; not by secondary, but by direct, means. 3. Without circumlocution or ambiguity; absolutely; in express terms. No man hath hitherto been so impious as plainly and directly to condemn prayer. Hooker. 4. Exactly; just. Stand you directly in Antonius' way. Shak. 5. Straightforwardly; honestly. I have dealt most directly in thy affair. Shak. 6. Manifestly; openly. [Obs.] Desdemona is directly in love with him. Shak. 7. Straightway; next in order; without delay; immediately. \"Will she go now to bed' Directly.'\" Shak. 8. Immediately after; as soon as. Directly he stopped, the coffin was removed. Dickens. Note: This use of the word is common in England, especially in colloquial speech, but it can hardly be regarded as a well-sanctioned or desirable use. Directly proportional (Math.), proportional in the order of the terms; increasing or decreasing together, and with a constant ratio; -- opposed to inversely proportional. Syn. -- Immediately; forthwith; straightway; instantly; instantaneously; soon; promptly; openly; expressly. -- Directly, Immediately, Instantly, Instantaneously. Directly denotes, without any delay or diversion of attention; immediately implies, without any interposition of other occupation; instantly implies, without any intervention of time. Hence, \"I will do it directly,\" means, \"I will go straightway about it.\" \"I will do it immediately,\" means, \"I will do it as the very next thing.\" \"I will do it instantly,\" allows not a particle of delay. Instantaneously, like instantly, marks an interval too small to be appreciable, but commonly relates to physical causes; as, the powder touched by fire instantaneously exploded.
directness |The quality of being direct; straightness; straightforwardness; immediateness.
directoire style |A style of dress prevalent at the time of the French Directory, characterized by great extravagance of design and imitating the Greek and Roman costumes.
director |1. One who, or that which, directs; one who regulates, guides, or orders; a manager or superintendent. In all affairs thou sole director. Swift. 2. One of a body of persons appointed to manage the affairs of a company or corporation; as, the directors of a bank, insurance company, or railroad company. What made directors cheat in South-Sea year Pope. 3. (Mech.)  A part of a machine or instrument which directs its motion or action. 4. (Surg.)  A slender grooved instrument upon which a knife is made to slide when it is wished to limit the extent of motion of the latter, or prevent its injuring the parts beneath.
directorate |The office of director; also, a body of directors taken jointly.
directorial |1. Having the quality of a director, or authoritative guide; directive. 2. Pertaining to: director or directory; specifically, relating to the Directory of France under the first republic. See Directory, 3. Whoever goes to the directorial presence under this passport. Burke.
directorship |The condition or office of a director; directorate.
directory |Containing directions; enjoining; instructing; directorial.\n\n1. A collection or body of directions, rules, or ordinances; esp., a book of directions for the conduct of worship; as, the Directory used by the nonconformists instead of the Prayer Book. 2. A book containing the names and residences of the inhabitants of any place, or of classes of them; an address book; as, a business directory. 3. Etym: [Cf. F. directoire.]  A body of directors; board of management; especially, a committee which held executive power in France under the first republic. 4. Direction; guide. [R.] Whitlock.
directress |A woman who directs. Bp. Hurd.
directrix |1. A directress. [R.] Jer. Taylor. 2. (Geom.) (a) A line along which a point in another line moves, or which in any way governs the motion of the point and determines the position of the curve generated by it; the line along which the generatrix moves in generating a surface. (b) A straight line so situated with respect to a conic section that the distance of any point of the curve from it has a constant ratio to the distance of the same point from the focus.
direful |Dire; dreadful; terrible; calamitous; woeful; as, a direful fiend; a direful day. -- Dire\"ful*ly, adv. -- Dire\"ful*ness, n.
direly |In a dire manner. Drayton.
dirempt |Divided; separated. [Obs.] Stow.\n\nTo separate by force; to tear apart. [Obs.] Holinshed.
diremption |A tearing apart; violent separation. [Obs.] Bp. Hall.
direness |Terribleness; horror; woefulness. Shak.
direption |The act of plundering, despoiling, or snatching away. [R.] Speed.
direptitious |Characterized by direption. [R.] Encyc. Dict.
direptitiously |With plundering violence; by violent injustice. [R.] Strype.
dirge |A piece of music of a mournful character, to accompany funeral rites; a funeral hymn. The raven croaked, and hollow shrieks of owls Sung dirges at her funeral. Ford.
dirgeful |Funereal; moaning. Soothed sadly by the dirgeful wind. Coleridge.
dirige |A service for the dead, in the Roman Catholic Church, being the first antiphon of Matins for the dead, of which Dirige is the first word; a dirge. Evensongs and placebo and dirige. Wyclif. Resort, I pray you, unto my sepulture To sing my dirige with great devotion. Lamentation of Mary Magdalene.
dirigent |Directing. Baxter.\n\nThe line of motion along which a describent line or surface is carried in the genesis of any plane or solid figure; a directrix. Hutton.
dirigible |Capable of being directed; steerable; as, a dirigible balloon.
diriment |Absolute. Diriment impediment (R. C. Ch.), an impediment that nullifies marriage.
dirk |A kind of dagger or poniard; -- formerly much used by the Scottish Highlander. Dirk knife, a clasp knife having a large, dirklike blade.\n\nTo stab with a dirk. Sir W. Scott.\n\nDark. [Obs.] Chaucer.\n\nTo darken. [Obs.] Spenser.
dirkness |Darkness. [Obs.] Chaucer.
dirl |To thrill; to vibrate; to penetrate. [Prov. Eng.] Halliwell.
dirt |1. Any foul of filthy substance, as excrement, mud, dust, etc.; whatever, adhering to anything, renders it foul or unclean; earth; as, a wagonload of dirt. Whose waters cast up mire and dirt. Is. lvii. 20. 2. Meanness; sordidness. Honors . . . thrown away upon dirt and infamy. Melmoth. 3. In placer mining, earth, gravel, etc., before washing. Dirt bed (Geom.), a layer of clayey earth forming a stratum in a geological formation. Dirt beds are common among the coal measures. -- Dirt eating. (a) The use of certain kinds of clay for food, existing among some tribes of Indians; geophagism. Humboldt. (b) (Med.) Same as Chthonophagia. -- Dirt pie, clay or mud molded by children in imitation of pastry. Otway (1684). -- To eat dirt, to submit in a meanly humble manner to insults; to eat humble pie.\n\nTo make foul of filthy; to dirty. Swift.
dirtily |In a dirty manner; foully; nastily; filthily; meanly; sordidly.
dirtiness |The state of being dirty; filthiness; foulness; nastiness; baseness; sordidness.
dirty |1. Defiled with dirt; foul; nasty; filthy; not clean or pure; serving to defile; as, dirty hands; dirty water; a dirty white. Spenser. 2. Sullied; clouded; -- applied to color. Locke. 3. Sordid; base; groveling; as, a dirty fellow. The creature's at his dirty work again. Pope. 4. Sleety; gusty; stormy; as, dirty weather. Storms of wind, clouds of dust, an angry, dirty sea. M. Arnold. Syn. -- Nasty; filthy; foul. See Nasty.\n\n1. To foul; to make filthy; to soil; as, to dirty the clothes or hands. 2. To tarnish; to sully; to scandalize; -- said of reputation, character, etc.
diruption |Disruption.
dis |The god Pluto. Shak.
dis- |. 1. A prefix from the Latin, whence F. dÃ©s, or sometimes dÃ©-, dis-. The Latin dis- appears as di- before b, d, g, l, m, n, r, v, becomes dif- before f, and either dis- or di- before j. It is from the same root as bis twice, and duo, E. two. See Two, and cf. Bi-, Di-, Dia-. Dis- denotes separation, a parting from, as in distribute, disconnect; hence it often has the force of a privative and negative, as in disarm, disoblige, disagree. Also intensive, as in dissever. Note: Walker's rule of pronouncing this prefix is, that the s ought always to be pronounced like z, when the next syllable is accented and begins with \"a flat mute [b, d, v, g, z], a liquid [l, m, n, r], or a vowel; as, disable, disease, disorder, disuse, disband, disdain, disgrace, disvalue, disjoin, dislike, dislodge, dismay, dismember, dismiss, dismount, disnatured, disrank, disrelish, disrobe.\" Dr. Webster's example in disapproving of Walker's rule and pronouncing dis- as diz in only one (disease) of the above words, is followed by recent orthoÃ«pists. See Disable, Disgrace, and the other words, beginning with dis-, in this Dictionary. 2. A prefix from Gr. Di-.
disability |1. State of being disabled; deprivation or want of ability; absence of competent physical, intellectual, or moral power, means, fitness, and the like. Grossest faults, or disabilities to perform what was covenanted. Milton. Chatham refused to see him, pleading his disability. Bancroft. 2. Want of legal qualification to do a thing; legal incapacity or incompetency. The disabilities of idiocy, infancy, and coverture. Abbott. Syn. -- Weakness; inability; incompetence; impotence; incapacity; incompetency; disqualification. -- Disability, Inability. Inability is an inherent want of power to perform the thing in question; disability arises from some deprivation or loss of the needed competency. One who becomes deranged is under a disability of holding his estate; and one who is made a judge, of deciding in his own case. A man may decline an office on account of his inability to discharge its duties; he may refuse to accept a trust or employment on account of some disability prevents him from entering into such engagements.
disable |Lacking ability; unable. [Obs.] \"Our disable and unactive force.\" Daniel.\n\n1. To render unable or incapable; to destroy the force, vigor, or power of action of; to deprive of competent physical or intellectual power; to incapacitate; to disqualify; to make incompetent or unfit for service; to impair. A Christian's life is a perpetual exercise, a wrestling and warfare, for which sensual pleasure disables him. Jer. Taylor. And had performed it, if my known offense Had not disabled me. Milton. I have disabled mine estate. Shak. 2. (Law)  To deprive of legal right or qualification; to render legally incapable. An attainder of the ancestor corrupts the blood, and disables his children to inherit. Blackstone. 3. To deprive of that which gives value or estimation; to declare lacking in competency; to disparage; to undervalue. [Obs.] \"He disabled my judgment.\" Shak. Syn. -- To weaken; unfit; disqualify; incapacitate.
disablement |Deprivation of ability; incapacity. Bacon.
disabuse |To set free from mistakes; to undeceive; to disengage from fallacy or deception; to set right. To undeceive and disabuse the people. South. If men are now sufficiently enlightened to disabuse themselves or artifice, hypocrisy, and superstition, they will consider this event as an era in their history. J. Adams.
disaccommodate |To put to inconvenience; to incommode. [R.] Bp. Warburton.
disaccommodation |A state of being unaccommodated or unsuited. [R.] Sir M. Hale.
disaccord |To refuse to assent. [Obs.] Spenser.\n\nDisagreement. Pop. Sci. Monthly.
disaccordant |Not accordant. Fabyan.
disaccustom |To destroy the force of habit in; to wean from a custom. Johnson.
disacidify |To free from acid.
disacknowledge |To refuse to acknowledge; to deny; to disown. [Obs.] South.
disacquaint |To render unacquainted; to make unfamiliar. [Obs.] While my sick heart With dismal smart Is disacquainted never. Herrick.
disacquaintance |Neglect of disuse of familiarity, or familiar acquaintance. [Obs.] South.
disacryl |A white amorphous substance obtained as a polymeric modification of acrolein.
disadorn |To deprive of ornaments. Congreve.
disadvance |To draw back, or cause to draw back. [Obs.] Spenser.
disadvantage |1. Deprivation of advantage; unfavorable or prejudicial quality, condition, circumstance, or the like; that which hinders success, or causes loss or injury. I was brought here under the disadvantage of being unknown by sight to any of you. Burke. Abandoned by their great patron, the faction henceforward acted at disadvantage. Palfrey. 2. Loss; detriment; hindrance; prejudice to interest, fame, credit, profit, or other good. They would throw a construction on his conduct, to his disadvantage before the public. Bancroft. Syn. -- Detriment; injury; hurt; loss; damage.\n\nTo injure the interest of; to be detrimental to.
disadvantageable |Injurious; disadvantageous. [Obs.] Bacon.
disadvantageous |Attended with disadvantage; unfavorable to success or prosperity; inconvenient; prejudicial; -- opposed to advantageous; as, the situation of an army is disadvantageous for attack or defense. Even in the disadvantageous position in which he had been placed, he gave clear indications of future excellence. Prescott. -- Dis*ad`van*ta\"geous*ly, adv. -- Dis*ad`van*ta\"geous*ness, n.
disadventure |Misfortune; mishap. [Obs.] Sir W. Raleigh.
disadventurous |Unprosperous; unfortunate. [Obs.] Spenser.
disadvise |To advise against; to dissuade from. [R.] Boyle.
disaffect |1. To alienate or diminish the affection of; to make unfriendly or less friendly; to fill with discontent and unfriendliness. They had attempted to disaffect and discontent his majesty's late army. Clarendon. 2. To disturb the functions of; to disorder. It disaffects the bowels. Hammond. 3. To lack affection for; to be alienated from, or indisposed toward; to dislike. [Obs.] Bp. Hall.
disaffected |Alienated in feeling; not wholly loyal. J. H. Newman. -- Dis`af*fect\"ed*ly, adv. -- Dis`af*fect\"ed*ness, n.
disaffection |1. State of being disaffected; alienation or want of affection or good will, esp. toward those in authority; unfriendliness; dislike. In the making laws, princes must have regard to . . . the affections and disaffections of the people. Jer. Taylor. 2. Disorder; bad constitution. [R.] Wiseman. Syn. -- Dislike; disgust; discontent; unfriendliness; alienation; disloyalty; hostility.
disaffectionate |Not disposed to affection; unfriendly; disaffected. [R.] Blount.
disaffirm |1. To assert the contrary of; to contradict; to deny; -- said of that which has been asserted. 2. (Law)  To refuse to confirm; to annul, as a judicial decision, by a contrary judgment of a superior tribunal.
disaffirmance |1. The act of disaffirming; denial; negation. 2. (Law)  Overthrow or annulment by the decision of a superior tribunal; as, disaffirmance of judgment.
disaffirmation |The act of disaffirming; negation; refutation.
disafforest |To reduce from the privileges of a forest to the state of common ground; to exempt from forest laws. By charter 9 Henry III. many forests were disafforested. Blackstone.
disaggregate |To destroy the aggregation of; to separate into component parts, as an aggregate mass.
disaggregation |The separation of an aggregate body into its component parts.
disagree |1. To fail to accord; not to agree; to lack harmony; to differ; to be unlike; to be at variance. They reject the plainest sense of Scripture, because it seems disagree with what they call reason. Atterbury. 2. To differ in opinion; to hold discordant views; to be at controversy; to quarrel. Who shall decide, when doctors disagree Pope. 3. To be unsuited; to have unfitness; as, medicine sometimes disagrees with the patient; food often disagrees with the stomach or the taste. Note: Usually followed by with, sometimes by to, rarely by from; as, I disagree to your proposal. Syn. -- To differ; vary; dissent.
disagreeable |1. Not agreeable, conformable, or congruous; Preach you truly the doctrine which you have received, and each nothing that is disagreeable thereunto. Udall. 2. Exciting repugnance; offensive to the feelings or That which is disagreeable to one is many times agreeable to another, or disagreeable in a less degree. Wollaston.
disagreeableness |The state or quality of being; disagreeable; unpleasantness.
disagreeably |In a disagreeable manner; unsuitably; offensively.
disagreeance |Disagreement. [Obs.]
disagreement |1. The state of disagreeing; a being at variance; dissimilitude; diversity. 2. Unsuitableness; unadaptedness. [R.] 3. Difference of opinion or sentiment. 4. A falling out, or controversy; difference. Syn. -- Difference; diversity; dissimilitude; unlikeness; discrepancy; variance; dissent; misunderstanding; dissension; division; dispute; jar; wrangle; discord.
disagreer |One who disagrees. Hammond.
disalliege |To alienate from allegiance. [Obs. & R.] Milton.
disallow |To refuse to allow; to deny the force or validity of; to disown and reject; as, the judge disallowed the executor's charge. To whom coming, as unto a living stone, disallowed indeed of men, but chosen of God. 1 Pet. ii. 4. That the edicts of CÃ¦sar we may at all times disallow, but the statutes of God for no reason we may reject. Milton. Note: This verb was sometimes followed by of; as, \"What follows, if we disallow of this\" Shak. See Allow. Syn. -- To disapprove; prohibit; censure; reject.
disallowable |Not allowable; not to be suffered. Raleigh. -- Dis`al*low\"a*ble*ness, n.
disallowance |The act of disallowing; refusal to admit or permit; rejection. Syn. -- Disapprobation; prohibition; condemnation; censure; rejection.
disally |To part, as an alliance; to sunder. [R.] \"Disallied their nuptials.\" Milton.
disanchor |To raise the anchor of, as a ship; to weigh anchor. [Obs.] Heywood.
disangelical |Not angelical. [R.] \"Disangelical nature.\" Coventry.
disanimate |1. To deprive of life. [R.] Cudworth. 2. To deprive of spirit; to dishearten. Shak.
disanimation |1. Privation of life. [R.] Sir T. Browne. 2. The state of being disanimated or discouraged; depression of spirits.
disannex |To disunite; to undo or repeal the annexation of. State Trials (1608).
disannul |To annul completely; to render void or of no effect. For the Lord of hosts hath purposed, and who shall disannul Isaiah xiv. 27. Note: The prefix in this word an its derivatives is intensive, and not negative.
disannuller |One who disannuls.
disannulment |Complete annulment.
disanoint |To invalidate the consecration of; as, to disanoint a king. [Obs.] Milton.
disapparel |To disrobe; to strip of apparel; to make naked. Drink disapparels the soul. Junius (1635).
disappear |1. To cease to appear or to be perceived; to pass from view, gradually or suddenly; to vanish; to be no longer seen; as, darkness disappears at the approach of light; a ship disappears as she sails from port. 2. To cease to be or exist; as, the epidemic has disappeared.
disappearance |The act of disappearing; cessation of appearance; removal from sight; vanishing. Addison.
disappearing |p. pr. & vb. n. of Disappear. Disappearing carriage (Ordnance), a carriage for heavy coast guns on which the gun is raised above the parapet for firing and upon discharge is lowered behind the parapet for protection. The standard type of disappearing carriage in the coast artillery of the United States army is the Buffington-Crozier carriage, in which the gun trunnions are secured at the upper and after ends of a pair of heavy levers, at the lower ends of which is attached a counterweight of lead. The levers are pivoted at their middle points, which are, with the top carriage, permitted restrained motion along the slightly inclined chassis rails. The counterweight is held in place by a pawl and ratchet. When the gun is loaded the pawl is released and the counterweight sinks, raising the gun to the firing position above the parapet. The recoil following the discharge returns the gun to the loading position, the counterweight rising until the pawl engages the ratchet.
disappendency |A detachment or separation from a former connection. [R.]
disappendent |Freed from a former connection or dependence; disconnected. [R.]
disappoint |1. To defeat of expectation or hope; to hinder from the attainment of that which was excepted, hoped, or desired; to balk; as, a man is disappointed of his hopes or expectations, or his hopes, desires, intentions, expectations, or plans are disappointed; a bad season disappoints the farmer of his crops; a defeat disappoints an enemy of his spoil. I was disappointed, but very agreeably. Macaulay. Note: Disappointed of a thing not obtained; disappointed in a thing obtained. 2. To frustrate; to fail; to hinder of result. His retiring foe Shrinks from the wound, and disappoints the blow. Addison. Syn. -- To tantalize; fail; frustrate; balk; baffle; delude; foil; defeat. See Tantalize.
disappointed |1. Defeated of expectation or hope; balked; as, a disappointed person or hope. 2. Unprepared; unequipped. [Obs.] Cut off even in the blossoms of my sin, Unhouseled, disappointed, unaneled. Shak.
disappointment |1. The act of disappointing, or the state of being disappointed; defeat or failure of expectation or hope; miscarriage of design or plan; frustration. If we hope for things of which we have not thoroughly considered the value, our disappointment will be greater our pleasure in the fruition of them. Addison. In disappointment thou canst bless. Keble. 2. That which disappoints. Syn. -- Miscarriage; frustration; balk.
disappreciate |To undervalue; not to esteem. -- Dis`ap*pre`ci*a\"tion, n.
disapprobation |The act of disapproving; mental condemnation of what is judged wrong, unsuitable, or inexpedient; feeling of censure. We have ever expressed the most unqualified disapprobation of all the steps. Burke.
disapprobatory |Containing disapprobation; serving to disapprove.
disappropriate |Severed from the appropriation or possession of a spiritual corporation. The appropriation may be severed, and the church become disappropriate, two ways. Blackstone.\n\n1. To release from individual ownership or possession. Milton. 2. (Law)  To sever from appropriation or possession a spiritual corporation. Appropriations of the several parsonages . . . would heave been, by the rules of the common law, disappropriated. Blackstone.
disappropriation |The act of disappropriating.
disapproval |Disapprobation; dislike; censure; adverse judgment.
disapprove |1. To pass unfavorable judgment upon; to condemn by an act of the judgment; to regard as wrong, unsuitable, or inexpedient; to censure; as, to disapprove the conduct of others. 2. To refuse official approbation to; to disallow; to decline to sanction; as, the sentence of the court-martial was disapproved by the commander in chief. Note: This verb is often followed by of; as, to disapprove of an opinion, of such conduct. See Approve.
disapprover |One who disapproves.
disapprovingly |In a disapproving manner.
disard |See Dizzard. [Obs.] Burton.
disarm |1. To deprive of arms; to take away the weapons of; to deprive of the means of attack or defense; to render defenseless. Security disarms the best-appointed army. Fuller. The proud was half disarmed of pride. Tennyson. 2. To deprive of the means or the disposition to harm; to render harmless or innocuous; as, to disarm a man's wrath.
disarmament |The act of disarming.
disarmature |The act of divesting of armature. [R.]
disarmed |1. Deprived of arms. 2. (Her.)  Deprived of claws, and teeth or beaks. Cussans.
disarmer |One who disarms.
disarrange |To unsettle or disturb the order or due arrangement of; to throw out of order.
disarrangement |The act of disarranging, or the state of being disarranged; confusion; disorder. Cowper.
disarray |1. To throw into disorder; to break the array of. Who with fiery steeds Oft disarrayed the foes in battle ranged. Fenton. 2. To take off the dress of; to unrobe. So, as she bade, the witch they disarrayed. Spenser.\n\n1. Want of array or regular order; disorder; confusion. Disrank the troops, set all in disarray. Daniel. 2. Confused attire; undress. Spenser.
disarrayment |Disorder. [R.] Feltham.
disarticulate |To sunder; to separate, as joints. -- Dis`ar*tic`u*la\"tion, n.
disarticulator |One who disarticulates and prepares skeletons.
disassent |To dissent. [Obs.]\n\nDissent. [Obs.] E. Hall.
disassenter |One who disassents; a dissenter. [Obs.] State Trials (1634).
disassiduity |Want of as siduity or care. [R.] Sir H. Wotton.
disassimilate |To subject to disassimilation.
disassimilation |The decomposition of complex substances, within the organism, into simpler ones suitable only for excretion, with evolution of energy, -- a normal nutritional process the reverse of assimilation; downward metabolism. The breaking down of already existing chemical compounds into simpler ones, sometimes called disassimilation. Martin.
disassimilative |Having power to disassimilate; of the nature of disassimilation. Disassimilative processes constitute a marked feature in the life of animal cells. McKendrick.
disassociate |To disconnect from things associated; to disunite; to dissociate. Florio.
disaster |1. An unpropitious or baleful aspect of a planet or star; malevolent influence of a heavenly body; hence, an ill portent. [Obs.] Disasters in the sun. Shak. 2. An adverse or unfortunate event, esp. a sudden and extraordinary misfortune; a calamity; a serious mishap. But noble souls, through dust and heat, Rise from disaster and defeat The stronger. Longfellow. Syn. -- Calamity; misfortune; mishap; mischance; visitation; misadventure; ill luck. See Calamity.\n\n1. To blast by the influence of a baleful star. [Obs.] Sir P. Sidney. 2. To bring harm upon; to injure. [R.] Thomson.
disasterly |Disastrously. [Obs.] Drayton.
disastrous |1. Full of unpropitious stellar influences; unpropitious; ill-boding. [Obs.] The moon In dim eclipse, disastrous twilight sheds. Milton. 2. Attended with suffering or disaster; very unfortunate; calamitous; ill-fated; as, a disastrous day; a disastrous termination of an undertaking. Wherein I spake of most disastrous chances. Shak. -- Dis*as\"trous*ly, adv. -- Dis*as\"trous*ness, n.
disattire |To unrobe; to undress. Spenser.
disaugment |To diminish. [R.]
disauthorize |To deprive of credit or authority; to discredit. [R.] W. Wotton.
disavaunce |To retard; to repel; to do damage to. [Obs.] Chaucer.
disaventure |Misfortune. [Obs.] Spenser.
disaventurous |Misadventurous; unfortunate. [Obs.] Spenser.
disavouch |To disavow. [R.] Daniel.
disavow |1. To refuse strongly and solemnly to own or acknowledge; to deny responsibility for, approbation of, an the like; to disclaim; to disown; as, he was charged with embezzlement, but he disavows the crime. A solemn promise made and disavowed. Dryden. 2. To deny; to show the contrary of; to disprove. Yet can they never Toss into air the freedom of my birth, Or disavow my blood Plantagenet's. Ford.
disavowal |The act of disavowing, disclaiming, or disowning; rejection and denial. An earnest disavowal of fear often proceeds from fear. Richardson.
disavowance |Disavowal. [Obs.] South.
disavower |One who disavows.
disavowment |Disavowal. [R.] Wotton.
disband |1. To loose the bands of; to set free; to disunite; to scatter; to disperse; to break up the organization of; especially, to dismiss from military service; as, to disband an army. They disbanded themselves and returned, every man to his own dwelling. Knolles. 2. To divorce. [Obs.] And therefore . . . she ought to be disbanded. Milton.\n\nTo become separated, broken up, dissolved, or scattered; especially, to quit military service by breaking up organization. When both rocks and all things shall disband. Herbert. Human society would in a short space disband. Tillotson.
disbandment |The act of disbanding.
disbar |To expel from the bar, or the legal profession; to deprive (an attorney, barrister, or counselor) of his status and privileges as such. Abbott.
disbark |To disembark. Pope.\n\nTo strip of bark; to bark. [R.] Boyle.
disbarment |Act of disbarring.
disbase |To debase or degrade. [Obs.] Nor you nor your house were so much as spoken of before I disbased myself. B. Jonson.
disbecome |To misbecome. [Obs.] Massinger.
disbelief |The act of disbelieving;; a state of the mind in which one is fully persuaded that an opinion, assertion, or doctrine is not true; refusal of assent, credit, or credence; denial of belief. Our belief or disbelief of a thing does not alter the nature of the thing. Tillotson. No sadder proof can be given by a man of his own littleness that disbelief in great men. Carlyle. Syn. -- Distrust; unbelief; incredulity; doubt; skepticism. -- Disbelief, Unbelief. Unbelief is a mere failure to admit; disbelief is a positive rejection. One may be an unbeliever in Christianity from ignorance or want of inquiry; a unbeliever has the proofs before him, and incurs the guilt of setting them aside. Unbelief is usually open to conviction; disbelief is already convinced as to the falsity of that which it rejects. Men often tell a story in such a manner that we regard everything they say with unbelief. Familiarity with the worst parts of human nature often leads us into a disbelief in many good qualities which really exist among men.
disbelieve |Not to believe; to refuse belief or credence to; to hold not to be true or actual. Assertions for which there is abundant positive evidence are often disbelieved, on account of what is called their improbability or impossibility. J. S. Mill.
disbeliever |One who disbelieves, or refuses belief; an unbeliever. Specifically, one who does not believe the Christian religion. I. Watts.
disbench |1. To drive from a bench or seat. [R.] Shak. 2. (Eng. Law)  To deprive (a bencher) of his privileges. Mozley & W.
disbend |To unbend. [Obs.] Stirling.
disbind |To unbind; to loosen. [Obs.] Mede.
disblame |To clear from blame. [Obs.] Chaucer.
disbodied |Disembodied. [R.]
disboscation |Converting forest land into cleared or arable land; removal of a forest. Sir W. Scott.
disbowel |To disembowel. [R.] Spenser.
disbranch |To divest of a branch or branches; to tear off. Shak.
disbud |To deprive of buds or shoots, as for training, or economizing the vital strength of a tree.
disburden |To rid of a burden; to free from a load borne or from something oppressive; to unload; to disencumber; to relieve. He did it to disburden a conscience. Feltham. My mediations . . . will, I hope, be more calm, being thus disburdened. Hammond. Syn. -- To unload; unburden; discharge; free.\n\nTo relieve one's self of a burden; to ease the mind. Milton.
disburgeon |To strip of burgeons or buds; to disbud. [R.] Holland.
disburse |To pay out; to expend; -- usually from a public fund or treasury. The duty of collecting and disbursing his revenues. Macaulay. Disbursing officer, an officer in any department of the public service who is charged with the duty of paying out public money.
disbursement |1. The act of disbursing or paying out. The disbursement of the public moneys. U. S. Statutes. 2. That which is disbursed or paid out; as, the annual disbursements exceed the income.
disburser |One who disburses money.
disburthen |To disburden; to relieve of a load. [Archaic]
disc |A flat round plate; (Biol.)  a circular structure either in plants or animals; as, a blood disc, a germinal disc, etc. Same as Disk.
discage |To uncage. [R.] Tennyson.
discal |Pertaining to, or resembling, a disk; as, discal cells.
discalceate |To pull off shoes or sandals from. [Obs.] Cockeram.
discalceated |Deprived off shoes or sandals; unshod; discalced.
discalceation |The act of pulling off the shoes or sandals. [Obs.] Sir T. Browne.
discalced |Unshod; barefooted; -- in distinction from calced. \"The foundation of houses of discalced friars.\" Cardinal Manning's St. Teresa.
discamp |To drive from a camp. [Obs.] Holland.
discandy |To melt; to dissolve; to thaw. [Obs.]
discant |See Descant, n.
discapacitate |To deprive of capacity; to incapacitate. [R.]
discard |1. (Card Playing)  To throw out of one's hand, as superfluous cards; to lay aside (a card or cards). 2. To cast off as useless or as no longer of service; to dismiss from employment, confidence, or favor; to discharge; to turn away. They blame the favorites, and think it nothing extraordinary that the queen should . . . resolve to discard them. Swift. 3. To put or thrust away; to reject. A man discards the follies of boyhood. I. Taylor. Syn. -- To dismiss; displace; discharge; cashier.\n\nTo make a discard.\n\nThe act of discarding; also, the card or cards discarded.
discardure |Rejection; dismissal. [R.] Hayter.
discarnate |Stripped of flesh. [Obs.] \"Discarnate bones.\" Glanvill.
discase |To strip; to undress. Shak.
discede |To yield or give up; to depart. [Obs.] I dare not discede from my copy a tittle. Fuller.
discept |To debate; to discuss. [R.] One dissertates, he is candid; Two must discept, -- has distinguished. R. Browning.
disceptation |Controversy; disputation; discussion. [Archaic] Verbose janglings and endless disceptations. Strype.
disceptator |One who arbitrates or decides. [R.] Cowley.
discern |1. To see and identify by noting a difference or differences; to note the distinctive character of; to discriminate; to distinguish. To discern such buds as are fit to produce blossoms. Boyle. A counterfeit stone which thine eye can not discern from a right stone. Robynson (More's Utopia). 2. To see by the eye or by the understanding; to perceive and recognize; as, to discern a difference. And [I] beheld among the simple ones, I discerned among the youths, a young man void of understanding. Prov. vii. 7. Our unassisted sight . . . is not acute enough to discern the minute texture of visible objects. Beattie. I wake, and I discern the truth. Tennyson. Syn. -- To perceive; distinguish; discover; penetrate; discriminate; espy; descry; detect. See Perceive.\n\n1. To see or understand the difference; to make distinction; as, to discern between good and evil, truth and falsehood. More than sixscore thousand that cannot discern between their right hand their left. Jonah iv. 11. 2. To make cognizance. [Obs.] Bacon.
discernance |Discernment. [Obs.]
discerner |One who, or that which, discerns, distinguishes, perceives, or judges; as, a discerner of truth, of right and wrong. A great observer and discerner of men's natures. Clarendon.
discernible |Capable of being discerned by the eye or the understanding; as, a star is discernible by the eye; the identity of difference of ideas is discernible by the understanding. The effect of the privations and sufferings . . . was discernible to the last in his temper and deportment. Macaulay. Syn. -- Perceptible; distinguishable; apparent; visible; evident; manifest.
discernibleness |The quality of being discernible.
discernibly |In a manner to be discerned; perceptibly; visibly. Hammond.
discerning |Acute; shrewd; sagacious; sharp-sighted. Macaulay.
discerningly |In a discerning manner; with judgment; judiciously; acutely. Garth.
discernment |1. The act of discerning. 2. The power or faculty of the mind by which it distinguishes one thing from another; power of viewing differences in objects, and their relations and tendencies; penetrative and discriminate mental vision; acuteness; sagacity; insight; as, the errors of youth often proceed from the want of discernment. Syn. -- Judgment; acuteness; discrimination; penetration; sagacity; insight. -- Discernment, Penetration, Discrimination. Discernment is keenness and accuracy of mental vision; penetration is the power of seeing deeply into a subject in spite of everything that intercepts the view; discrimination is a capacity of tracing out minute distinctions and the nicest shades of thought. A discerning man is not easily misled; one of a penetrating mind sees a multitude of things which escape others; a discriminating judgment detects the slightest differences.
discerp |1. To tear in pieces; to rend. [R.] Stukeley. 2. To separate; to disunite. [R.] Bp. Hurd.
discerpibility |Capability or liableness to be discerped. [R.] Wollaston.
discerpible |Capable of being discerped. [R.]
discerptibility |Capability or liableness to be discerped. [R.] Wollaston.
discerptible |Capable of being discerped. [R.]
discerption |The act of pulling to pieces, or of separating the parts. Bp. Hall.
discerptive |Tending to separate or disunite parts. Encys. Dict.
discession |Departure. [Obs.]
discharge |1. To relieve of a charge, load, or burden; to empty of a load or cargo; to unburden; to unload; as, to discharge a vessel. 2. To free of the missile with which anything is charged or loaded; to let go the charge of; as, to discharge a bow, catapult, etc.; especially, said of firearms, -- to fire off; to shoot off; also, to relieve from a state of tension, as a Leyden jar. The galleys also did oftentimes, out of their prows, discharge their great pieces against the city. Knolles. Feeling in other cases discharges itself in indirect muscular actions. H. Spencer. 3. To of something weighing upon or impeding over one, as a debt, claim, obligation, responsibility, accusation, etc.; to absolve; to acquit; to clear. Discharged of business, void of strife. Dryden. In one man's fault discharge another man of his duty. L'Estrange. 4. To relieve of an office or employment; to send away from service; to dismiss. Discharge the common sort With pay and thanks. Shak. Grindal . . . was discharged the government of his see. Milton. 5. To release legally from confinement; to set at liberty; as, to discharge a prisoner. 6. To put forth, or remove, as a charge or burden; to take out, as that with which anything is loaded or filled; as, to discharge a cargo. 7. To let fly, as a missile; to shoot. They do discharge their shot of courtesy. Shak. 8. To set aside; to annul; to dismiss. We say such an order was \"discharged on appeal.\" Mozley & W. The order for Daly's attendance was discharged. Macaulay. 9. To throw off the obligation of, as a duty or debt; to relieve one's self of, by fulfilling conditions, performing duty, trust, and the like; hence, to perform or ex Had I a hundred tongues, a wit so large As could their hundred offices discharge. Dryden. 10. To send away (a creditor) satisfied by payment; to pay one's debt or obligation to. [Obs.] If he had The present money to discharge the Jew. Shak. 11. To give forth; to emit or send out; as, a pipe discharges water; to let fly; to give expression to; to utter; as, to discharge a horrible oath. 12. To prohibit; to forbid. [Scot. Obs.] Sir W. Scott. Discharging arch (Arch.), an arch over a door, window, or other opening, to distribute the pressure of the wall above. See Illust. of Lintel. -- Discharging piece, Discharging strut (Arch.), a piece set to carry thrust or weight to a solid point of support. -- Discharging rod (Elec.), a bent wire, with knobs at both ends, and insulated by a glass handle. It is employed for discharging a Leyden jar or an electrical battery. See Discharger. Syn. -- See Deliver.\n\nTo throw off or deliver a load, charge, or burden; to unload; to emit or give vent to fluid or other contents; as, the water pipe discharges freely. The cloud, if it were oily or fatty, would not discharge. Bacon.\n\n1. The act of discharging; the act of relieving of a charge or load; removal of a load or burden; unloading; as, the discharge of a ship; discharge of a cargo. 2. Firing off; explosive removal of a charge; explosion; letting off; as, a discharge of arrows, of artillery. 3. Act of relieving of something which oppresses or weighs upon one, as an obligation, liability, debt, accusation, etc.; acquittance; as, the discharge of a debtor. 4. Act of removing, or getting rid of, an obligation, liability, etc.; fulfillment, as by the payment of a debt, or the performance of a trust or duty. Indefatigable in the discharge of business. Motley. Nothing can absolve us from the discharge of those duties. L'Estrange. 5. Release or dismissal from an office, employment, etc.; dismission; as, the discharge of a workman by his employer. 6. Legal release from confinement; liberation; as, the discharge of a prisoner. 7. The state of being discharged or relieved of a debt, obligation, office, and the like; acquittal. Too secure of our discharge From penalty. Milton. 8. That which discharges or releases from an obligation, liability, penalty, etc., as a price of ransom, a legal document. Death, who sets all free, Hath paid his ransom now and full discharge. Milton. 9. A flowing or issuing out; emission; vent; evacuation; also, that which is discharged or emitted; as, a rapid discharge of water from the pipe. The hemorrhage being stopped, the next occurrence is a thin serous discharge. S. Sharp. Charge and discharge. (Equity Practice) See under Charge, n. -- Paralytic discharge (Physiol.), the increased secretion from a gland resulting from the cutting of all of its nerves.
discharger |One who, or that which, discharges. Specifically, in electricity, an instrument for discharging a Leyden jar, or electrical battery, by making a connection between the two surfaces; a discharging rod.
dischevele |Disheveled. [Obs.] Chaucer.
dischurch |To deprive of status as a church, or of membership in a church. Bp. Hall.
discide |To divide; to cleave in two. [Obs.] Spenser.
disciferous |Bearing disks.
discifloral |Bearing the stamens on a discoid outgrowth of the receptacle; - - said of a subclass of plants. Cf. Calycifloral.
disciflorous |Bearing the stamens on a discoid outgrowth of the receptacle; - - said of a subclass of plants. Cf. Calycifloral.
disciform |Discoid.
discina |A genus of Branchiopoda, having a disklike shell, attached by one valve, which is perforated by the peduncle.
discinct |Ungirded; loosely dressed. [R.] Sir W. Scott.
discind |To part; to divide. [Obs.] Boyle.
disciple |One who receives instruction from another; a scholar; a learner; especially, a follower who has learned to believe in the truth of the doctrine of his teacher; an adherent in doctrine; as, the disciples of Plato; the disciples of our Savior. The disciples, or The twelve disciples, the twelve selected companions of Jesus; -- also called the apostles. -- Disciples of Christ. See Christian, n., 3, and Campbellite. Syn. -- Learner; scholar; pupil; follower; adherent.\n\n1. To teach; to train. [Obs.] That better were in virtues discipled. Spenser. 2. To punish; to discipline. [Obs.] B. Jonson. 3. To make disciples of; to convert to doctrines or principles. [R.] Sending missionaries to disciple all nations. E. D. Griffin.
discipleship |The state of being a disciple or follower in doctrines and precepts. Jer. Taylor.
discipless |A female disciple. [Obs.]
disciplinable |1. Capable of being disciplined or improved by instruction and training. 2. Liable or deserving to be disciplined; subject to disciplinary punishment; as, a disciplinable offense.
disciplinableness |The quality of being improvable by discipline. Sir M. Hale.
disciplinal |Relating to discipline. Latham.
disciplinant |A flagellant. See Flagellant.
disciplinarian |Pertaining to discipline. \"Displinarian system.\" Milman.\n\n1. One who disciplines; one who excels in training, especially with training, especially with regard to order and obedience; one who enforces rigid discipline; a stickler for the observance of rules and methods of training; as, he is a better disciplinarian than scholar. 2. A Puritan or Presbyterian; -- because of rigid adherence to religious or church discipline. [Obs.]
disciplinary |Pertaining to discipline; intended for discipline; corrective; belonging to a course of training. Those canons . . . were only disciplinary. Bp. Ferne. The evils of the . . . are disciplinary and remedial. Buckminster.
discipline |1. The treatment suited to a disciple or learner; education; development of the faculties by instruction and exercise; training, whether physical, mental, or moral. Wife and children are a kind of discipline of humanity. Bacon. Discipline aims at the removal of bad habits and the substitution of good ones, especially those of order, regularity, and obedience. C. J. Smith. 2. Training to act in accordance with established rules; accustoming to systematic and regular action; drill. Their wildness lose, and, quitting nature's part, Obey the rules and discipline of art. Dryden. 3. Subjection to rule; submissiveness to order and control; habit of obedience. The most perfect, who have their passions in the best discipline, are yet obliged to be constantly on their guard. Rogers. 4. Severe training, corrective of faults; instruction by means of misfortune, suffering, punishment, etc. A sharp discipline of half a century had sufficed to educate Macaulay. 5. Correction; chastisement; punishment inflicted by way of correction and training. Giving her the discipline of the strap. Addison. 6. The subject matter of instruction; a branch of knowledge. Bp. Wilkins. 7. (Eccl.)  The enforcement of methods of correction against one guilty of ecclesiastical offenses; reformatory or penal action toward a church member. 8. (R. C. Ch.)  Self- inflicted and voluntary corporal punishment, as penance, or otherwise; specifically, a penitential scourge. 9. (Eccl.)  A system of essential rules and duties; as, the Romish or Anglican discipline. Syn. -- Education; instruction; training; culture; correction; chastisement; punishment.\n\n1. To educate; to develop by instruction and exercise; to train. 2. To accustom to regular and systematic action; to bring under control so as to act systematically; to train to act together under orders; to teach subordination to; to form a habit of obedience in; to drill. Ill armed, and worse disciplined. Clarendon. His mind . . . imperfectly disciplined by nature. Macaulay. 3. To improve by corrective and penal methods; to chastise; to correct. Has he disciplined Aufidius soundly Shak. 4. To inflict ecclesiastical censures and penalties upon. Syn. -- To train; form; teach; instruct; bring up; regulate; correct; chasten; chastise; punish.
discipliner |One who disciplines.
disclaim |1. To renounce all claim to deny; ownership of, or responsibility for; to disown; to disavow; to reject. He calls the gods to witness their offense; Disclaims the war, asserts his innocence. Dryden. He disclaims the authority of Jesus. Farmer. 2. To deny, as a claim; to refuse. The payment was irregularly made, if not disclaimed. Milman. 3. (Law)  To relinquish or deny having a claim; to disavow another's claim; to decline accepting, as an estate, interest, or office. Burrill. Syn. -- To disown; disavow; renounce; repudiate.\n\nTo disavow or renounce all part, claim, or share. Blackstone. Disclaim in, Disclaim from, to disown; to disavow. [Obs.] \"Nature disclaims in thee.\" Shak.
disclaimer |1. One who disclaims, disowns, or renounces. 2. (Law)  A denial, disavowal, or renunciation, as of a title, claim, interest, estate, or trust; relinquishment or waiver of an interest or estate. Burrill. 3. A public disavowal, as of pretensions, claims, opinions, and the like. Burke.
disclamation |A disavowing or disowning. Bp. Hall.
disclame |To disclaim; to expel. [Obs.] \"Money did love disclame.\" Spenser.
disclaunder |To injure one's good name; to slander. [Obs.]
discloak |To take off a cloak from; to uncloak. [Obs.] B. Jonson.
disclose |1. To unclose; to open; -- applied esp. to eggs in the sense of to hatch. The ostrich layeth her eggs under sand, where the heat of the discloseth them. Bacon. 2. To remove a cover or envelope from;; to set free from inclosure; to uncover. The shells being broken, . . . the stone included in them is thereby disclosed and set at liberty. Woodward. 3. To lay open or expose to view; to cause to appear; to bring to light; to reveal. How softly on the Spanish shore she plays, Disclosing rock, and slope, and forest brown! Byron. Her lively looks a sprightly mind disclose. Pope. 4. To make known, as that which has been kept secret or hidden; to reveal; to expose; as, events have disclosed his designs. If I disclose my passion, Our friendship 's an end. Addison. Syn. -- To uncover; open; unveil; discover; reveal; divulge; tell; utter.\n\nDisclosure. [Obs.] Shak. Young.
disclosed |Represented with wings expanded; -- applied to doves and other birds not of prey. Cussans.
discloser |One who discloses.
disclosure |1. The act of disclosing, uncovering, or revealing; bringing to light; exposure. He feels it [his secret] beating at his heart, rising to his throat, and demanding disclosure. D. Webster. 2. That which is disclosed or revealed. Were the disclosures of 1695 forgotten Macaulay.
discloud |To clear from clouds. [Archaic] Fuller.
disclout |To divest of a clout. [R.]
disclusion |A shutting off; exclusion. [Obs.] Dr. H. More.
discoast |To depart; to quit the coast (that is, the side or border) of anything; to be separated. [Obs.] As far as heaven and earth discoasted lie. G. Fletcher. To discoast from the plain and simple way of speech. Barrow.
discoblastic |Applied to a form of egg cleavage seen in osseous fishes, which occurs only in a small disk that separates from the rest of the egg.
discobolus |(a) A thrower of the discus. (b) A statue of an athlete holding the discus, or about to throw it Note: The Discobolus of Myron was a famous statue of antiquity, and several copies or imitations of it have been preserved.
discodactyl |One of the tree frogs.
discodactylia |A division of amphibians having suctorial disks on the toes, as the tree frogs.
discodactylous |Having sucking disks on the toes, as the tree frogs.
discoherent |Incoherent. [R.]
discoid |Having the form of a disk, as those univalve shells which have the whorls in one plane, so as to form a disk, as the pearly nautilus. Discoid flower (Bot.), a compound flower, consisting of tubular florets only, as a tansy, lacking the rays which are seen in the daisy and sunflower.\n\nAnything having the form of a discus or disk; particularly, a discoid shell.
discoidal |Disk-shaped; discoid.
discolith |One of a species of coccoliths, having an oval discoidal body, with a thick strongly refracting rim, and a thinner central portion. One of them measures about
discolor |1. To alter the natural hue or color of; to change to a different color; to stain; to tinge; as, a drop of wine will discolor water; silver is discolored by sea water. 2. To alter the true complexion or appearance of; to put a false hue upon. To discolor all your ideas. Wat
discolorate |To discolor. [R.] Fuller.
discoloration |1. The act of discoloring, or the state of being discolored; alteration of hue or appearance. Darwin. 2. A discolored spot; a stain. Arbuthnot.
discolored |1. Altered in color; 2. Variegated; of divers colors. [R.] That ever wore discolored arms. Chapman.
discomfit |1. To scatter in fight; to put to rout; to defeat. And his proud foes discomfit in victorious field. Spenser. 2. To break up and frustrate the plans of; to balk Well, go with me and be not so discomfited. Shak. Syn. -- To defeat; overthrow; overpower; vanquish; conquer; baffle; frustrate; confound; discourage.\n\nDiscomfited; overthrown. [Obs.]\n\nRout; overthrow; discomfiture. Such as discomfort as shall quite despoil him. Milton.
discomfiture |The act of discomfiting, or the state of being discomfited; rout; overthrow; defeat; frustration; confusion and dejection. Every man's sword was against his fellow, and there was a very great discomfiture. 1 Sam. xiv. 20. A hope destined to end . . . in discomfiture and disgrace. Macaulay.
discomfort |1. To discourage; to deject. His funeral shall not be in our camp, Lest it discomfort us. Shak. 2. To destroy or disturb the comfort of; to deprive oas, a smoky chimney discomforts a family.\n\n1. Discouragement. [Obs.] Shak. 2. Want of comfort; uneasiness, mental or physical; disturbance of peace; inquietude; pain; distress; sorrow. \"An age of spiritual discomfort.\" M. Arnold. Strive against all the discomforts of thy sufferings. Bp. Hall.
discomfortable |1. Causing discomfort; occasioning uneasiness; making sad. [Obs.] Sir P. Sidney. 2. Destitute of comfort; uncomfortable. [R.] A labyrinth of little discomfortable garrets. Thackeray. -- Dis*com\"fort*a*ble*ness, n. [Obs.]
discommend |1. To mention with disapprobation; to blame; to disapprove. [R.] Spenser. By commending something in him that is good, and discommending the same fault in others. Jer. Taylor. 2. To expose to censure or ill favor; to put out of the good graces of any one. A compliance will discommend me to Mr. Coventry. Pepys.
discommendable |Deserving, disapprobation or blame. -- Dis`com*mend\"a*ble*ness, n.
discommendation |Blame; censure; reproach. [R.] Ayliffe.
discommender |One who discommends; a dispraiser. Johnson.
discommission |To deprive of a commission or trust. [R.] Laud.
discommodate |To discommode. [Obs.] Howell.
discommode |To put inconvenience; to incommode; to trouble. [R.] Syn. -- To incommode; annoy; inconvenience.
discommodious |Inconvenient; troublesome; incommodious. [R.] Spenser. -- Dis`com*mo\"di*ous*ly, adv. -- Dis`com*mo\"di*ous*ness, n.
discommodity |Disadvantage; inconvenience. Bacon.
discommon |1. To deprive of the right of common. [R.] Bp. Hall. 2. To deprive of privileges. [R.] T. Warton. 3. (Law)  To deprive of commonable quality, as lands, by inclosing or appropriating. Burrill.
discommunity |A lack of common possessions, properties, or relationship. Community of embryonic structure reveals community of descent; but dissimilarity of embryonic development does not prove discommunity of descent. Darwin.
discompany |To free from company; to dissociate. [R.] It she be alone now, and discompanied. B. Jonson.
discomplexion |To change the complexion or hue of. [Obs.] Beau. & Fl.
discompliance |Failure or refusal to comply; noncompliance. A compliance will discommend me to Mr. Coventry, and a discompliance to my lord chancellor. Pepys.
discompose |1. To disarrange; to interfere with; to disturb; to disorder; to unsettle; to break up. Or discomposed the headdress of a prude. Pope. 2. To throw into disorder; to ruffle; to destroy the composure or equanimity; to agitate. Opposition . . . discomposeth the mind's serenity. Glanvill. 3. To put out of place or service; to discharge; to displace. [Obs.] Bacon. Syn. -- To disorder; derange; unsettle; disturb; disconcert; agitate; ruffle; fret; vex.
discomposed |Disordered; disturbed; disquieted. -- Dis`com*pos\"ed*ly, adv. -- Dis`com*pos\"ed*ness, n.
discomposition |Inconsistency; discordance. [Obs.] Donne.
discomposure |1. The state of being discomposed; disturbance; disorder; agitation; perturbation. No discomposure stirred her features. Akenside. 2. Discordance; disagreement of parts. [Obs.] Boyle.
discompt |To discount. See Discount. Hudibras.
disconcert |1. To break up the harmonious progress of; to throw into disorder or confusion; as, the emperor disconcerted the plans of his enemy. 2. To confuse the faculties of; to disturb the composure of; to discompose; to abash. The embrace disconcerted the daughter-in-law somewhat, as the caresses of old gentlemen unshorn and perfumed with tobacco might well do. Thackeray. Syn. -- To discompose; derange; ruffle; confuse; disturb; defeat; frustrate.\n\nWant of concert; disagreement. Sir W. Temple.
disconcertion |The act of disconcerting, or state of being disconcerted; discomposure; perturbation. [R.] State Trials (1794).
disconducive |Not conductive; impeding; disadvantageous. [R.]
disconformable |Not conformable. Disconformable in religion from us. Stow (1603).
disconformity |Want of conformity or correspondence; inconsistency; disagreement. Those . . . in some disconformity to ourselves. Milton. Disagreement and disconformity betwixt the speech and the conception of the mind. Hakewill.
discongruity |Incongruity; disagreement; unsuitableness. Sir M. Hale.
disconnect |To dissolve the union or connection of; to disunite; to sever; to separate; to disperse. The commonwealth itself would . . . be disconnected into the dust and powder of individuality. Burke. This restriction disconnects bank paper and the precious metals. Walsh.
disconnection |The act of disconnecting, or state of being disconnected; separation; want of union. Nothing was therefore to be left in all the subordinate members but weakness, disconnection, and confusion. Burke.
disconsecrate |To deprive of consecration or sacredness. [R.]
disconsent |To differ; to disagree; to dissent. [Obs.] Milton.
disconsolacy |The state of being disconsolate. [Obs.] Barrow.
disconsolate |Disconsolateness. [Obs.] Barrow.\n\n1. Destitute of consolation; deeply dejected and dispirited; hopelessly sad; comfortless; filled with grief; as, a bereaved and disconsolate parent. One morn a Peri at the gate Of Eden stood disconsolate. Moore. The ladies and the knights, no shelter nigh, Were dropping wet, disconsolate and wan. Dryden. 2. Inspiring dejection; saddening; cheerless; as, the disconsolate darkness of the winter nights. Ray. Syn. -- Forlorn; melancholy; sorrowful; desolate; woeful; hopeless; gloomy. -- Dis*con\"so*late*ly, adv. -- Dis*con\"so*late*ness, n.
disconsolated |Disconsolate. [Obs.] A poor, disconsolated, drooping creature. Sterne.
disconsolation |Dejection; grief. [R.] Bp. Hall.
discontent |Not content; discontented; dissatisfied. Jer. Taylor. Passion seemed to be much discontent, but Patience was very quiet. Bunyan.\n\nTo deprive if content; to make uneasy; to dissatisfy. Suckling.\n\n1. Want of content; uneasiness and inquietude of mind; dissatisfaction; disquiet. Now is the winter of our discontent Made glorious summer by this sun of York. Shak. The rapacity of his father's administration had excited such universal discontent. Hallam 2. A discontented person; a malcontent. [R.] Thus was the Scotch nation full of discontents. Fuller.
discontentation |Discontent. [Obs.] Ascham.
discontented |Dissatisfied; uneasy in mind; malcontent. And every one that was in distress, and every one that was in debt, and every one that was discontented, gathered themselves unto him. 1 Sam. xxii. 2. -- Dis`con*tent\"ed*ly, adv. -- Dis`con*tent\"ed*ness, n.
discontentful |Full of discontent. [R.]
discontenting |1. Discontented. [Obs.] Shak. 2. Causing discontent; dissatisfying. Milton.
discontentive |Relating or tending to discontent. [R.] \"Pride is ever discontentive.\" Feltham.
discontentment |The state of being discontented; uneasiness; inquietude. Bacon.
discontinuable |Admitting of being discontinued. [R.]
discontinuance |1. The act of discontinuing, or the state of being discontinued; want of continued connection or continuity; breaking off; cessation; interruption; as, a discontinuance of conversation or intercourse; discontinuance of a highway or of travel. 2. (Law) (a) A breaking off or interruption of an estate, which happened when an alienation was made by a tenant in tail, or other tenant, seized in right of another, of a larger estate than the tenant was entitled to, whereby the party ousted or injured was driven to his real action, and could not enter. This effect of such alienation is now obviated by statute in both England and the United States. (b) The termination of an action in practice by the voluntary act of the plaintiff; an entry on the record that the plaintiff discontinues his action. (c) That technical interruption of the proceedings in pleading in an action, which follows where a defendant does not answer the whole of the plaintiff's declaration, and the plaintiff omits to take judgment for the part unanswered. Wharton's Law Dict. Burrill. Syn. -- Cessation; intermission; discontinuation; separation; disunion; disjunction; disruption; break.
discontinuation |Breach or interruption of continuity; separation of parts in a connected series; discontinuance. Upon any discontinuation of parts, made either by bubbles or by shaking the glass, the whole mercury falls. Sir I. Newton.
discontinue |To interrupt the continuance of; to intermit, as a practice or habit; to put an end to; to cause to cease; to cease using, to stop; to leave off. Set up their conventicles again, which had been discontinued. Bp. Burnet. I have discontinued school Above a twelvemonth. Shak. Taught the Greek tongue, discontinued before in these parts the space of seven hundred years. Daniel. They modify and discriminate the voice, without appearing to discontinue it. Holder.\n\n1. To lose continuity or cohesion of parts; to be disrupted or broken off. Bacon. 2. To be separated or severed; to part. Thyself shalt discontinue from thine heritage. Jer. xvii. 4.
discontinuee |One whose possession of an estate is broken off, or discontinued; one whose estate is subject to discontinuance.
discontinuer |One who discontinues, or breaks off or away from; an absentee. He was no gadder abroad, not discontinuer from his convent for a long time. Fuller.
discontinuity |Want of continuity or cohesion; disunion of parts. \"Discontinuity of surface.\" Boyle.
discontinuor |One who deprives another of the possession of an estate by discontinuance. See Discontinuance, 2.
discontinuous |1. Not continuous; interrupted; broken off. A path that is zigzag, discontinuous, and intersected at every turn by human negligence. De Quincey. 2. Exhibiting a dissolution of continuity; gaping. \"Discontinuous wound.\" Milton. Discontinuous function (Math.), a function which for certain values or between certain values of the variable does not vary continuously as the variable increases. The discontinuity may, for example, consist of an abrupt change in the value of the function, or an abrupt change in its law of variation, or the function may become imaginary.
disconvenience |Unsuitableness; incongruity. [Obs.] Bacon.
disconvenient |Not convenient or congruous; unsuitable; ill-adapted. [Obs.] Bp. Reynolds.
discophora |A division of acalephs or jellyfishes, including most of the large disklike species. -- Dis*coph\"o*rous, a.
discord |1. Want of concord or agreement; absence of unity or harmony in sentiment or action; variance leading to contention and strife; disagreement; -- applied to persons or to things, and to thoughts, feelings, or purposes. A false witness that speaketh lies, and he that soweth discord among brethren. Prov. vi. 19. Peace to arise out of universal discord fomented in all parts of the empire. Burke. 2. (Mus.)  Union of musical sounds which strikes the ear harshly or disagreeably, owing to the incommensurability of the vibrations which they produce; want of musical concord or harmony; a chord demanding resolution into a concord. For a discord itself is but a harshness of divers sounds mBacon. Apple of discord. See under Apple. Syn. -- Variance; difference; opposition; contrariety; clashing; dissension; contention; strife; disagreement; dissonance.\n\nTo disagree; to be discordant; to jar; to clash; not to suit. [Obs.] The one discording with the other. Bacon.
discordable |That may produce discord; disagreeing; discordant. [R.] Halliwell.
