displosive |Explosive.
displume |To strip of, or as of, a plume, or plumes; to deprive of decoration; to dishonor; to degrade. Displumed, degraded, and metamorphosed. Burke.
dispoline |One of several isomeric organic bases of the quinoline series of alkaloids.
dispond |See Despond.
dispondee |A double spondee; a foot consisting of four long syllables.
dispone |1. (Her.)  To dispose. 2. To dispose of. Chaucer. 3. (Scots Law)  To make over, or convey, legally. He has disponed . . . the whole estate. Sir W. Scott.
disponee |The person to whom any property is legally conveyed.
disponer |One who legally transfers property from himself to another.
disponge |To sprinkle, as with water from a sponge. [Poetic & Rare] [Written also dispunge.] O sovereign mistress of true melancholy, The poisonous damp of night disponge upon me. Shak.
dispope |To refuse to consider as pope; to depose from the popedom. One whom they disposed. Tennyson.
disporous |Having two spores.
disport |Play; sport; pastime; diversion; playfulness. Milton.\n\nTo play; to wanton; to move in gayety; to move lightly and without restraint; to amuse one's self. Where light disports in ever mingling dyes. Pope. Childe Harold basked him in the noontide sun, Disporting there like any other fly. Byron.\n\n1. To divert or amuse; to make merry. They could disport themselves. Buckle. 2. To remove from a port; to carry away. Prynne.
disportment |Act of disporting; diversion; play. [Obs.] Dr. H. More.
disposable |Subject to disposal; free to be used or employed as occasion may require; not assigned to any service or use. The great of this kingdom . . . has easily afforded a disposable surplus. Burke.
disposal |1. The act of disposing, or disposing of, anything; arrangement; orderly distribution; a putting in order; as, the disposal of the troops in two lines. 2. Ordering; regulation; adjustment; management; government; direction. The execution leave to high disposal. Milton. 3. Regulation of the fate, condition, application, etc., of anything; the transference of anything into new hands, a new place, condition, etc.; alienation, or parting; as, a disposal of property. A domestic affair of great importance, which is no less than the disposal of my sister Jenny for life. Tatler. 4. Power or authority to dispose of, determine the condition of, control, etc., especially in the phrase at, or in, the disposal of. The sole and absolute disposal of him an his concerns. South. Syn. -- Disposition; dispensation; management; conduct; government; distribution; arrangement; regulation; control.
dispose |1. To distribute and put in place; to arrange; to set in order; as, to dispose the ships in the form of a crescent. Who hath disposed the whole world Job xxxiv. 13. All ranged in order and disposed with grace. Pope. The rest themselves in troops did else dispose. Spenser. 2. To regulate; to adjust; to settle; to determine. The knightly forms of combat to dispose. Dryden. 3. To deal out; to assign to a use; to bestow for an object or purpose; to apply; to employ; to dispose of. Importuned him that what he designed to bestow on her funeral, he would rather dispose among the poor. Evelyn. 4. To give a tendency or inclination to; to adapt; to cause to turn; especially, to incline the mind of; to give a bent or propension to; to incline; to make inclined; -- usually followed by to, sometimes by for before the indirect object. Endure and conquer; Jove will soon dispose To future good our past and present woes. Dryden. Suspicions dispose kings to tyranny, husbands to jealousy, and wise men to irresolution and melancholy. Bacon. To dispose of. (a) To determine the fate of; to exercise the power of control over; to fix the condition, application, employment, etc. of; to direct or assign for a use. Freedom to order their actions and dispose of their possessions and persons. Locke. (b) To exercise finally one's power of control over; to pass over into the control of some one else, as by selling; to alienate; to part with; to relinquish; to get rid of; as, to dispose of a house; to dispose of one's time. More water . . . than can be disposed of. T. Burnet. I have disposed of her to a man of business. Tatler. A rural judge disposed of beauty's prize. Waller. Syn. -- To set; arrange; order; distribute; adjust; regulate; adapt; fit; incline; bestow; give.\n\nTo bargain; to make terms. [Obs.] She had disposed with Cæsar. Shak.\n\n1. Disposal; ordering; management; power or right of control. [Obs.] But such is the dispose of the sole Disposer of empires. Speed. 2. Cast of mind; disposition; inclination; behavior; demeanor. [Obs.] He hath a person, and a smooth dispose To be suspected. Shak.
disposed |1. Inclined; minded. When he was disposed to pass into Achaia. Acts xviii. 27. 2. Inclined to mirth; jolly. [Obs.] Beau. & Fl. Well disposed, in good condition; in good health. [Obs.] Chaucer.
disposedness |The state of being disposed or inclined; inclination; propensity. [R.]
disposement |Disposal. [Obs.] Goodwin.
disposer |One who, or that which, disposes; a regulator; a director; a bestower. Absolute lord and disposer of all things. Barrow.
disposingly |In a manner to dispose.
disposited |Disposed. [Obs.] Glanvill.
disposition |1. The act of disposing, arranging, ordering, regulating, or transferring; application; disposal; as, the disposition of a man's property by will. Who have received the law by the disposition of angels. Acts vii. 53. The disposition of the work, to put all things in a beautiful order and harmony, that the whole may be of a piece. Dryden. 2. The state or the manner of being disposed or arranged; distribution; arrangement; order; as, the disposition of the trees in an orchard; the disposition of the several parts of an edifice. 3. Tendency to any action or state resulting from natural constitution; nature; quality; as, a disposition in plants to grow in a direction upward; a disposition in bodies to putrefaction. 4. Conscious inclination; propension or propensity. How stands your disposition to be married Shak. 5. Natural or prevailing spirit, or temperament of mind, especially as shown in intercourse with one's fellow-men; temper of mind. \"A man of turbulent disposition.\" Hallam. \"He is of a very melancholy disposition.\" Shak. His disposition led him to do things agreeable to his quality and condition wherein God had placed him. Strype. 6. Mood; humor. As I perchance hereafter shall think meet To put an antic disposition on. Shak. Syn. -- Disposal; adjustment; regulation; arrangement; distribution; order; method; adaptation; inclination; propensity; bestowment; alienation; character; temper; mood. -- Disposition, Character, Temper. Disposition is the natural humor of a person, the predominating quality of his character, the constitutional habit of his mind. Character is this disposition influenced by motive, training, and will. Temper is a quality of the fiber of character, and is displayed chiefly when the emotions, especially the passions, are aroused.
dispositional |Pertaining to disposition.
dispositioned |Having (such) a disposition; -- used in compounds; as, well- dispositioned.
dispositive |1. Disposing; tending to regulate; decretive. [Obs.] His dispositive wisdom and power. Bates. 2. Belonging to disposition or natural, tendency. [Obs.] \"Dispositive holiness.\" Jer. Taylor.
dispositively |In a dispositive manner; by natural or moral disposition. [Obs.] Sir T. Browne. Do dispositively what Moses is recorded to have done literally, . . . break all the ten commandments at once. Boyle.
dispositor |1. A disposer. 2. (Astrol.)  The planet which is lord of the sign where another planet is. [Obs.] Crabb.
dispossess |To put out of possession; to deprive of the actual occupancy of, particularly of land or real estate; to disseize; to eject; -- usually followed by of before the thing taken away; as, to dispossess a king of his crown. Usurp the land, and dispossess the swain. Goldsmith.
dispossession |1. The act of putting out of possession; the state of being dispossessed. Bp. Hall. 2. (Law)  The putting out of possession, wrongfully or otherwise, of one who is in possession of a freehold, no matter in what title; -- called also ouster.
dispossessor |One who dispossesses. Cowley.
dispost |To eject from a post; to displace. [R.] Davies (Holy Roode).
disposure |1. The act of disposing; power to dispose of; disposal; direction. Give up My estate to his disposure. Massinger. 2. Disposition; arrangement; position; posture. [Obs.] In a kind of warlike disposure. Sir H. Wotton.
dispraisable |Blamable. [R.]
dispraise |To withdraw praise from; to notice with disapprobation or some degree of censure; to disparage; to blame. Dispraising the power of his adversaries. Chaucer. I dispraised him before the wicked, that the wicked might not fall in love with him. Shak.\n\nThe act of dispraising; detraction; blame censure; reproach; disparagement. Dryden. In praise and in dispraise the same. Tennyson.
dispraiser |One who blames or dispraises.
dispraisingly |By way of dispraise.
dispread |To spread abroad, or different ways; to spread apart; to open; as, the sun dispreads his beams. Spenser.\n\nTo extend or expand itself. [R.] While tyrant Hdispreading through the sky. Thomson.
dispreader |One who spreads abroad. Dispreaders both of vice and error. Milton.
disprejudice |To free from prejudice. [Obs.] W. Montagu.
disprepare |To render unprepared. [Obs.] Hobbes.
disprince |To make unlike a prince. [R.] For I was drench'd with ooze, and torn with briers, . . . And, all one rag, disprinced from head to heel. Tennyson.
disprison |To let loose from prison, to set all liberty. [R.] Bulwer.
disprivilege |To deprive of a privilege or privileges. [R.]
disprize |To do preciate. [R.] Cotton (Ode to Lydia).
disprofess |To renounce the profession or pursuit of. His arms, which he had vowed to disprofess. Spenser.
disprofit |Loss; damage. Foxe.\n\nTo be, or to cause to be, without profit or benefit. [Obs. or Archaic] Bale.
disprofitable |Unprofitable. [Obs.]
disproof |A proving to be false or erroneous; confutation; refutation; as, to offer evidence in disproof of a statement. I need not offer anything farther in support of one, or in disproof of the other. Rogers.
disproperty |To cause to be no longer property; to dispossess of. [R.] Shak.
disproportion |1. Want of proportion in form or quantity; lack of symmetry; as, the arm may be in disproportion to the body; the disproportion of the length of a building to its height. 2. Want of suitableness, adequacy, or due proportion to an end or use; unsuitableness; disparity; as, the disproportion of strength or means to an object.\n\nTo make unsuitable in quantity, form, or fitness to an end; to violate symmetry in; to mismatch; to join unfitly. To shape my legs of an unequal size; To disproportion me in every part. Shak. A degree of strength altogether disproportioned to the extent of its territory. Prescott.
disproportionable |Disproportional; unsuitable in form, size, quantity, or adaptation; disproportionate; inadequate. -- Dis`pro*por\"tion*a*ble*ness, n. Hammond. -- Dis`pro*por\"tion*a*bly, adv.
disproportional |Not having due proportion to something else; not having proportion or symmetry of parts; unsuitable in form, quantity or value; inadequate; unequal; as, a disproportional limb constitutes deformity in the body; the studies of youth should not be disproportional to their understanding.
disproportionality |The state of being disproportional. Dr. H. More.
disproportionally |In a disproportional manner; unsuitably in form, quantity, or value; unequally.
disproportionate |Not proportioned; unsymmetrical; unsuitable to something else in bulk, form, value, or extent; out of proportion; inadequate; as, in a perfect body none of the limbs are disproportionate; it is wisdom not to undertake a work disproportionate means. -- Dis`pro*por\"tion*ate*ly, adv. -- Dis`pro*por\"tion*ate*ness, n.
dispropriate |To cancel the appropriation of; to disappropriate. [R.]
disprovable |Capable of being disproved or refuted. Boyle.
disproval |Act of disproving; disproof. [R.]
disprove |1. To prove to be false or erroneous; to confute; to refute. That false supposition I advanced in order to disprove it. Atterbury. 2. To disallow; to disapprove of. [Obs.] Stirling.
disprover |One who disproves or confutes.
disprovide |Not to provide; to fail to provide. [Obs.] Boyle.
dispunct |Wanting in punctilious respect; discourteous. [Obs.] That were dispunct to the ladies. B. Jonson.\n\nTo expunge. [Obs.] Foxe.
dispunge |To expunge; to erase. [Obs.]\n\nSee Disponge. [Obs.]
dispunishable |Without penal restraint; not punishable. [R.] Swift.
dispurpose |To dissuade; to frustrate; as, to dispurpose plots. [R.] A. Brewer.
dispurse |To disburse. [Obs.] Shak.
dispurvey |To disfurnish; to strip. [Obs.] Heywood.
dispurveyance |Want of provisions; [Obs.] Spenser.
disputable |1. Capable of being disputed; liable to be called in question, controverted, or contested; or doubtful certainty or propriety; controvertible; as, disputable opinions, propositions, points, or questions. Actions, every one of which is very disputable. Jer. Taylor. 2. Disputatious; contentious. [Obs.] Shak.
disputableness |State of being disputable.
disputacity |Proneness to dispute. [Obs.] Bp. Ward.
disputant |Disputing; engaged in controversy. Milton.\n\nOne who disputes; one who argues A singularly eager, acute, and pertinacious disputant. Macaulay.
disputation |1. The act of disputing; a reasoning or argumentation in opposition to something, or on opposite sides; controversy in words; verbal contest respecting the truth of some fact, opinion, proposition, or argument. 2. A rhetorical exercise in which parties reason in opposition to each other on some question proposed.
disputatious |Inclined to dispute; apt to civil or controvert; characterized by dispute; as, a disputatious person or temper. The Christian doctrine of a future life was no recommendation of the new religion to the wits and philosophers of that disputations period. Buckminster. -- Dis`pu*ta\"tious*ly, adv. -- Dis`pu*ta\"tious*ness, n.
disputative |Disposed to dispute; inclined to cavil or to reason in opposition; as, a disputative temper. I. Watts.
dispute |To contend in argument; to argue against something maintained, upheld, or claimed, by another; to discuss; to reason; to debate; to altercate; to wrangle. Therefore disputed [reasoned, Rev. Ver .] he in synagogue with the Jews. Acts xvii. 17.\n\n1. To make a subject of disputation; to argue pro and con; to discuss. The rest I reserve it be disputed how the magistrate is to do herein. Milton. 2. To oppose by argument or assertion; to attempt to overthrow; to controvert; to express dissent or opposition to; to call in question; to deny the truth or validity of; as, to dispute assertions or arguments. To seize goods under the disputed authority of writs of assistance. Bancroft. 3. To strive or contend about; to contest. To dispute the possession of the ground with the Spaniards. Prescott. 4. To struggle against; to resist. [Obs.] Dispute it [grief] like a man. Shak. Syn. -- To controvert; contest; gainsay; doubt; question; argue; debate; discuss; impugn. See Argue.\n\n1. Verbal controversy; contest by opposing argument or expression of opposing views or claims; controversial discussion; altercation; debate. Addicted more To contemplation and profound dispute. Milton. 2. Contest; struggle; quarrel. De Foe. Beyond dispute, Without dispute, indisputably; incontrovertibly. Syn. -- Altercation; controversy; argumentation; debate; discussion; quarrel; disagreement; difference; contention; wrangling. See Altercation.
disputeless |Admitting no dispute; incontrovertible. Bailey.
disputer |One who disputes, or who is given to disputes; a controvertist. Where is the disputer of this world 1 Cor. i. 20.
disputison |Dispute; discussion. [Obs.] Chaucer.
disqualification |1. The act of disqualifying, or state of being disqualified; want of qualification; incompetency; disability; as, the disqualification of men for holding certain offices. 2. That which disqualifies; that which incapacitates or makes unfit; as, conviction of crime is a disqualification of a person for office; sickness is a disqualification for labor. I must still retain the consciousness of those disqualifications which you have been pleased to overlook. Sir J. Shore.
disqualify |1. To deprive of the qualities or properties necessary for any purpose; to render unfit; to incapacitate; -- with for or from before the purpose, state, or act. My common illness disqualifies me for all conversation; I mean my deafness. Swift. Me are not disqualified by their engagements in trade from being received in high society. Southey. 2. To deprive of some power, right, or privilege, by positive restriction; to disable; to debar legally; as, a conviction of perjury disqualifies a man to be a witness.
disquantity |To diminish the quantity of; to lessen. [Obs.] Shak.
disquiet |Deprived of quiet; impatient; restless; uneasy. [R.] Shak.\n\nWant of quiet; want of tranquility in body or mind; uneasiness; restlessness; disturbance; anxiety. Swift.\n\nTo render unquiet; to deprive of peace, rest, or tranquility; to make uneasy or restless; to disturb. Why art thou cast down, O my soul, and why art thou disquieted within me Ps. xlii. 11. As quiet as these disquieted times will permit. Sir W. Scott. Syn. -- To harass; disturb; vex; fret; excite; agitate.
disquietal |The act of disquieting; a state of disquiet. [Obs.] [It] roars and strives 'gainst its disquietal. Dr. H. More.
disquieter |One who, or that which, disquiets, or makes uneasy; a disturber.
disquietful |Producing inquietude or uneasiness. [R.] Barrow.
disquietive |Tending to disquiet. [R.]
disquietly |In a disquiet manner; uneasily; as, he rested disquietly that night. [R.] Wiseman.
disquietment |State of being disquieted; uneasiness; harassment. [R.] Hopkins.
disquietness |Disturbance of quiet in body or mind; restlessness; uneasiness. Hooker.
disquietous |Causing uneasiness. [R.] So distasteful and disquietous to a number of men. Milton.
disquiettude |Want of peace or tranquility; uneasiness; disturbance; agitation; anxiety. Fears and disquietude, and unavoidable anxieties of mind. Abp. Sharp.
disquisition |A formal or systematic inquiry into, or discussion of, any subject; a full examination or investigation of a matter, with the arguments and facts bearing upon it; elaborate essay; dissertation. For accurate research or grave disquisition he was not well qualified. Macaulay.
disquisitional |Pertaining to disquisition; of the nature of disquisition.
disquisitionary |Pertaining to disquisition; disquisitional.
disquisitive |Relating to disquisition; fond discussion or investigation; examining; inquisitive.
disquisitorial |Disquisitory.
disquisitory |Of or pertaining to disquisition; disquisitive. Ed. Rev.
disrange |To disarrange. [Obs.] Wood.
disrank |1. To degrade from rank. [Obs.] 2. To throw out of rank or into confusion. Decker.
disrate |To reduce to a lower rating or rank; to degrade. Marryat.
disray |of Disarray. [Obs.] Holland.
disrealize |To divest of reality; to make uncertain. [Obs.] Udall.
disregard |Not to regard; to pay no heed to; to omit to take notice of; to neglect to observe; to slight as unworthy of regard or notice; as, to disregard the admonitions of conscience. Studious of good, man disregarded fame. Blackmore.\n\nThe act of disregarding, or the state of being disregarded; intentional neglect; omission of notice; want of attention; slight. The disregard of experience. Whewell.
disregarder |One who disregards.
disregardful |Neglect; negligent; heedless; regardless.
disregardfully |Negligently; heedlessly.
disrelish |1. Want of relish; dislike (of the palate or of the mind); distaste; a slight degree of disgust; as, a disrelish for some kinds of food. Men love to hear of their power, but have an extreme disrelish to be told of their duty. Burke. 2. Absence of relishing or palatable quality; bad taste; nauseousness. Milton.\n\n1. Not to relish; to regard as unpalatable or offensive; to feel a degree of disgust at. Pope. 2. To deprive of relish; to make nauseous or disgusting in a slight degree. Milton.
disremember |To fail to remember; to forget. [Obs. or Archaic]
disrepair |A state of being in bad condition, and wanting repair. The fortifications were ancient and in disrepair. Sir W. Scott.
disreputability |The state of being disreputable. [R.]
disreputable |Not reputable; of bad repute; not in esteem; dishonorable; disgracing the reputation; tending to bring into disesteem; as, it is disreputable to associate familiarly with the mean, the lewd, and the profane. Why should you think that conduct disreputable in priests which you probably consider as laudable in yourself Bp. Watson. Syn. -- Dishonorable; discreditable; low; mean; disgraceful; shameful.
disreputably |In a disreputable manner.
disreputation |Loss or want of reputation or good name; dishonor; disrepute; disesteem. \"A disreputation of piety.\" Jer. Taylor.
disrepute |Loss or want of reputation; ill character; disesteem; discredit. At the beginning of the eighteenth century astrology fell into general disrepute. Sir W. Scott. Syn. -- Disesteem; discredit; dishonor; disgrace.\n\nTo bring into disreputation; to hold in dishonor. [R.] More inclined to love them tan to disrepute them. Jer. Taylor.
disrespect |Want of respect or reverence; disesteem; incivility; discourtesy. Impatience of bearing the least affront or disrespect. Pope.\n\nTo show disrespect to. We have disrespected and slighted God. Comber.
disrespectability |Want of respectability. Thackeray.
disrespectable |Not respectable; disreputable. M. Arnold.
disrespecter |One who disrespects.
disrespectful |Wanting in respect; manifesting disesteem or lack of respect; uncivil; as, disrespectful behavior. -- Dis`re*spect\"ful*ly, adv. -- Dis`re*spect\"ful*ness, n.
disrespective |Showing want of respect; disrespectful. [Obs.] Bp. Hall.
disreverence |To treat irreverently or with disrespect. [Obs.] Sir T. More.
disrobe |To divest of a robe; to undress; figuratively, to strip of covering; to divest of that which clothes or decorates; as, autumn disrobes the fields of verdure. Two great peers were disrobed of their glory. Sir H. Wotton.
disrober |One who, or that which, disrobes.
disroof |To unroof. [R.] Carlyle.
disroot |To tear up the roots of, or by the roots; hence, to tear from a foundation; to uproot. A piece of ground disrooted from its situation by subterraneous inundations. Goldsmith.
disrout |To put to rout. Taylor (1630).
disrudder |To deprive of the rudder, as a ship.
disrulily |In a disorderly manner. [Obs.] Rom. of R.
disruly |Unruly; disorderly. [Obs.]
disrupt |Rent off; torn asunder; severed; disrupted.\n\nTo break asunder; to rend. Thomson.
disruption |The act or rending asunder, or the state of being rent asunder or broken in pieces; breach; rent; dilaceration; rupture; as, the disruption of rocks in an earthquake; disruption of a state.
disruptive |Causing, or tending to cause, disruption; caused by disruption; breaking through; bursting; as, the disruptive discharge of an electrical battery. Nichol.
disrupture |Disruption. [R.] Jefferson.
dissatisfaction |The state of being dissatisfied, unsatisfied, or discontented; uneasiness proceeding from the want of gratification, or from disappointed wishes and expectations. The ambitious man has little happiness, but is subject to much uneasiness and dissatisfaction. Addison. Syn. -- Discontent; discontentment; displeasure; disapprobation; distaste; dislike.
dissatisfactory |Causing dissatisfaction; unable to give content; unsatisfactory; displeasing. To have reduced the different qualifications in the different States to one uniform rule, would probably have been as dissatisfactory to some of the States, as difficult for the Convention. A. Hamilton. -- Dis*sat`is*fac\"to*ri*ness, n.
dissatisfy |To render unsatisfied or discontented; to excite uneasiness in by frustrating wishes or expectations; to displease by the want of something requisite; as, to be dissatisfied with one's fortune. The dissatisfied factions of the autocracy. Bancroft.
disseat |To unseat. [R.] Shak.
dissect |1. (Anat.)  To divide into separate parts; to cut in pieces; to separate and expose the parts of, as an animal or a plant, for examination and to show their structure and relations; to anatomize. 2. To analyze, for the purposes of science or criticism; to divide and examine minutely. This paragraph . . . I have dissected for a sample. Atterbury.
dissected |1. Cut into several parts; divided into sections; as, a dissected map. 2. (Bot.)  Cut deeply into many lobes or divisions; as, a dissected leaf.
dissectible |Capable of being dissected, or separated by dissection. Paley.
dissecting |1. Dividing or separating the parts of an animal or vegetable body; as, a dissecting aneurism, one which makes its way between or within the coats of an artery. 2. Of or pertaining to, or received during, a dissection; as, a dissecting wound. 3. Used for or in dissecting; as, a dissecting knife; a dissecting microscope.
dissection |1. The act of dissecting an animal or plant; as, dissection of the human body was held sacrilege till the time of Francis I. 2. Fig.: The act of separating or dividing for the purpose of critical examination. 3. Anything dissected; especially, some part, or the whole, of an animal or plant dissected so as to exhibit the structure; an anatomical so prepared. Dissection wound, a poisoned wound incurred during the dissection of a dead body.
dissector |One who dissects; an anatomist.
disseize |To deprive of seizin or possession; to dispossess or oust wrongfully (one in freehold possession of land); -- followed by of; as, to disseize a tenant of his freehold. [Written also disseise.] Which savage beasts strive as eagerly to keep and hold those golden mines, as the Arimaspians to disseize them thereof. Holland.
disseizee |A person disseized, or put out of possession of an estate unlawfully; -- correlative to disseizor. [Written also disseisee.]
disseizin |The act of disseizing; an unlawful dispossessing and ouster of a person actually seized of the freehold. [Written also disseisin.] Blackstone.
disseizor |One who wrongfully disseizes, or puts another out of possession of a freehold. [Written also disseisor.] Blackstone.
disseizoress |A woman disseizes.
disseizure |Disseizin. Speed.
dissemblance |Want of resemblance; dissimilitude. [R.] Osborne.\n\nThe act or art of dissembling; dissimulation. [Obs.]
dissemble |1. To hide under a false semblance or seeming; to feign (something) not to be what it really is; to put an untrue appearance upon; to disguise; to mask. Dissemble all your griefs and discontents. Shak. Perhaps it was right to dissemble your love, But -- why did you kick me down stairs J. P. Kemble. 2. To put on the semblance of; to make pretense of; to simulate; to feign. He soon dissembled a sleep. Tatler. Syn. -- To conceal; disguise; cloak; cover; equivocate. See Conceal.\n\nTo conceal the real fact, motives, He that hateth dissembleth with his lips. Prov. xxvi. 24. He [an enemy] dissembles when he assumes an air of friendship. C. J. Smith.
dissembler |One who dissembles; one who conceals his opinions or dispositions under a false appearance; a hypocrite. It is the weakest sort of politicians that are the greatest dissemblers. Bacon. Priests, princes, women, no dissemblers here. Pope. Syn. -- Dissembler, Hypocrite. A person is called a dissembler with reference to his concealment of his real character, and a hypocrite with reference to his assumption of a false character. But hypocrite is the stronger word, being commonly used to characterize a person who is habitually insincere and false, especially one who makes professions of goodness when his aims are selfish and his life corrupt.
dissembling |That dissembles; hypocritical; false. -- Dis*sem\"bling*ly, adv.
disseminate |1. To sow broadcast or as seed; to scatter for growth and propagation, like seed; to spread abroad; to diffuse; as, principles, ideas, opinions, and errors are disseminated when they are spread abroad for propagation. 2. To spread or extend by dispersion. A nearly uniform and constant fire or heat disseminated throughout the body of the earth. Woodward. Syn. -- To spread; diffuse; propagate; circulate; disperse; scatter.
disseminated |Occurring in small portions scattered through some other substance.
dissemination |The act of disseminating, or the state of being disseminated; diffusion for propagation and permanence; a scattering or spreading abroad, as of ideas, beliefs, etc. The universal dissemination of those writings. Wayland.
disseminative |Tending to disseminate, or to become disseminated. The effect of heresy is, like the plague, infectious and disseminative. Jer. Taylor.
disseminator |One who, or that which, disseminates, spreads, or propagates; as, disseminators of disease.
dissension |Disagreement in opinion, usually of a violent character, producing warm debates or angry words; contention in words; partisan and contentious divisions; breach of friendship and union; strife; discord; quarrel. Paul and Barnabas had no small dissension and disputation with them. Acts xv. 2. Debates, dissension, uproars are thy joy. Dryden. A seditious person and raiser-up of dissension among the people. Robynson (More's Utopia).
dissensious |Disposed to discord; contentious; dissentious. [R.] Ascham. -- Dis*sen\"sious*ly, adv. Chapman.
dissent |1. To differ in opinion; to be of unlike or contrary sentiment; to disagree; -- followed by from. The bill passed . . . without a dissenting voice. Hallam. Opinions in which multitudes of men dissent from us. Addison. 2. (Eccl.)  To differ from an established church in regard to doctrines, rites, or government. 3. To differ; to be of a contrary nature. Hooker.\n\n1. The act of dissenting; difference of opinion; refusal to adopt something proposed; nonagreement, nonconcurrence, or disagreement. The dissent of no small number [of peers] is frequently recorded. Hallam. 2. (Eccl.)  Separation from an established church, especially that of England; nonconformity. It is the dissidence of dissent and the protestantism of the Protestant religion. Burke. 3. Contrariety of nature; diversity in quality. [Obs.] The dissent of the metals. Bacon. Syn. -- Disagreement; variance; difference; nonconcurrence; nonconformity.
dissentaneous |Disagreeing; contrary; differing; -- opposed to consentaneous. [R.] Barrow.
dissentany |Dissentaneous; inconsistent. [Obs.] Milton.
dissentation |Dissension. [Obs.] W. Browne.
dissenter |1. One who dissents; one who differs in opinion, or declares his disagreement. 2. (Eccl.)  One who separates from the service and worship of an established church; especially, one who disputes the authority or tenets of the Church of England; a nonconformist. Dissenters from the establishment of their several countries. Burke. Robert Brown is said to have the first formal dissenter. Shipley. Note: \"The word is commonly applied only to Protestants. The Roman Catholics are generally referred to as a distinct class.\" Brande & C.
dissenterism |The spirit or principles of dissenters. Ed. Rev.
dissentiate |To throw into a state of dissent. [R.] Feltham.
dissentient |Disagreeing; declaring dissent; dissenting. -- n.  One who dissents. Macaulay.
dissentious |Marked by dissensions; apt to breed discord; quarrelsome; contentious; factious. -- Dis*sen\"tious*ly, adv.
dissentive |Disagreeing; inconsistent. [Obs.] Feltham.
dissepiment |1. A separating tissue; a partition; a septum. 2. (Bot.)  One of the partitions which divide a compound ovary into cells. 3. (Zoöl.)  One of the transverse, calcareous partitions between the radiating septa of a coral.
dissert |To discourse or dispute; to discuss. [R.] We have disserted upon it a little longer than was necessary. Jeffrey.
dissertate |To deal in dissertation; to write dissertations; to discourse. [R.] J. Foster.
dissertation |A formal or elaborate argumentative discourse, oral or written; a disquisition; an essay; a discussion; as, Dissertations on the Prophecies.
dissertational |Relating to dissertations; resembling a dissertation.
dissertationist |A writer of dissertations.
dissertator |One who writers a dissertation; one who discourses. Boyle.
dissertly |See Disertly. [Obs.]
disserve |To fail to serve; to do injury or mischief to; to damage; to hurt; to harm. Have neither served nor disserved the interests of any party. Jer. Taylor.
disservice |Injury; mischief. We shall rather perform good offices unto truth than any disservice unto their relators. Sir T. Browne.
disserviceable |Calculated to do disservice or harm; not serviceable; injurious; harmful; unserviceable. Shaftesbury. -- Dis*serv\"ice*a*ble*ness, n. Norris. -- Dis*serv\"ice*a*bly, adv.
dissettle |To unsettle. [Obs.]
dissettlement |The act of unsettling, or the state of being unsettled. Marvell.
dissever |To part in two; to sever thoroughly; to sunder; to disunite; to separate; to disperse. The storm so dissevered the company . . . that most of therm never met again. Sir P. Sidney. States disserved, discordant, belligerent. D. Webster.\n\nTo part; to separate. Chaucer.
disseverance |The act of disserving; separation.
disseveration |The act of disserving; disseverance. [Obs.]
disseverment |Disseverance. Sir W. Scott.
disshadow |To free from shadow or shade. [Obs.] G. Fletcher.
dissheathe |To become unsheathed. [Obs.] Sir W. Raleigh.
disship |To dismiss from service on board ship. [Obs.] Hakluyt.
disshiver |To shiver or break in pieces. [Obs.]
dissidence |Disagreement; dissent; separation from the established religion. I. Taylor. It is the dissidence of dissent. Burke.
dissident |No agreeing; dissenting; discordant; different. Our life and manners be dissident from theirs. Robynson (More's Utopia).\n\nOne who disagrees or dissents; one who separates from the established religion. The dissident, habituated and taught to think of his dissidencI. Taylor.
dissidently |In a dissident manner.
dissilience |The act of leaping or starting asunder. Johnson.
dissiliency |The act of leaping or starting asunder. Johnson.
dissilient |Starting asunder; bursting and opening with an elastic force; dehiscing explosively; as, a dissilient pericarp.
dissilition |The act of bursting or springing apart. [R.] Boyle.
dissimilar |Not similar; unlike; heterogeneous; as, the tempers of men are as dissimilar as their features. This part very dissimilar to any other. Boyle.
dissimilarity |Want of resemblance; unlikeness; dissimilitude; variety; as, the dissimilarity of human faces and forms. Sir W. Jones.
dissimilarly |In a dissimilar manner; in a varied style. With verdant shrubs dissimilarly gay. C. Smart.
dissimilate |To render dissimilar.
dissimilation |The act of making dissimilar. H. Sweet.
dissimile |Comparison or illustration by contraries.
dissimilitude |1. Want of resemblance; unlikeness; dissimilarity. Dissimilitude between the Divinity and images. Stillingfleet. 2. (Rhet.)  A comparison by contrast; a dissimile.
dissimulate |Feigning; simulating; pretending. [Obs.] Henryson.\n\nTo dissemble; to feign; to pretend.
dissimulation |The act of dissembling; a hiding under a false appearance; concealment by feigning; false pretension; hypocrisy. Let love be without dissimulation. Rom. xii. 9. Dissimulation . . . when a man lets fall signs and arguments that he is not that he is. Bacon. Simulation is a pretense of what is not, and dissimulation a concealment of what is. Tatler.
dissimulator |One who dissimulates; a dissembler.
dissimule |To dissemble. [Obs.] Chaucer.
dissimuler |A dissembler. [Obs.]
dissimulour |A dissembler. [Obs.] Chaucer.
dissipable |Capable of being scattered or dissipated. [R.] The heat of those plants is very dissipable. Bacon.
dissipate |1. To scatter completely; to disperse and cause to disappear; -- used esp. of the dispersion of things that can never again be collected or restored. Dissipated those foggy mists of error. Selden. I soon dissipated his fears. Cook. The extreme tendency of civilization is to dissipate all intellectual energy. Hazlitt. 2. To destroy by wasteful extravagance or lavish use; to squander. The vast wealth . . . was in three years dissipated. Bp. Burnet. Syn. -- To disperse; scatter; dispel; spend; squander; waste; consume; lavish.\n\n1. To separate into parts and disappear; to waste away; to scatter; to disperse; to vanish; as, a fog or cloud gradually dissipates before the rays or heat of the sun; the heat of a body dissipates. 2. To be extravagant, wasteful, or dissolute in the pursuit of pleasure; to engage in dissipation.
dissipated |1. Squandered; scattered. \"Dissipated wealth.\" Johnson. 2. Wasteful of health, money, etc., in the pursuit of pleasure; dissolute; intemperate. A life irregular and dissipated. Johnson.
dissipation |1. The act of dissipating or dispersing; a state of dispersion or separation; dispersion; waste. Without loss or dissipation of the matter. Bacon. The famous dissipation of mankind. Sir M. Hale. 2. A dissolute course of life, in which health, money, etc., are squandered in pursuit of pleasure; profuseness in vicious indulgence, as late hours, riotous living, etc.; dissoluteness. To reclaim the spendthrift from his dissipation and extravagance. P. Henry. 3. A trifle which wastes time or distracts attention. Prevented from finishing them [the letters] a thousand avocations and dissipations. Swift. Dissipation of energy. Same as Degradation of energy, under Degradation.
dissipative |Tending to dissipate. Dissipative system (Mech.), an assumed system of matter and motions in which forces of friction and resistances of other kinds are introduced without regard to the heat or other molecular actions which they generate; -- opposed to conservative system.
dissipativity |The rate at which palpable energy is dissipated away into other forms of energy.
dissite |Lying apart. [Obs.] Lands far dissite and remote asunder. Holland.
disslander |To slander. [Obs.] Legend of Dido.\n\nSlander. [Obs.] E. Hall.
disslanderous |Slanderous. [Obs.]
dissociability |Want of sociability; unsociableness. Bp. Warburton.
dissociable |1. Not They came in two and two, though matched in the most dissociable manner. Spectator. 2. Having a tendency to dissolve social connections; unsuitable to society; unsociable.
dissocial |Unfriendly to society; contracted; selfish; as, dissocial feelings.
dissocialize |To render unsocial.
dissociate |To separate from fellowship or union; to disunite; to disjoin; as, to dissociate the particles of a concrete substance. Before Wyclif's death in 1384, John of Gaunt had openly dissociated himself from the reformer. A. W. Ward.
dissociation |1. The act of dissociating or disuniting; a state of separation; disunion. It will add infinitely dissociation, distraction, and confusion of these confederate republics. Burke. 2. (Chem.)  The process by which a compound body breaks up into simpler constituents; -- said particularly of the action of heat on gaseous or volatile substances; as, the dissociation of the sulphur molecules; the dissociation of ammonium chloride into hydrochloric acid and ammonia.
dissociative |Tending or leading to dissociation.
dissolubility |The quality of being dissoluble; capacity of being dissoluble; capacity of being dissolved by heat or moisture, and converted into a fluid.
dissoluble |1. Capable of being dissolved; having its parts separable by heat or moisture; convertible into a fluid. Woodward. 2. Capable of being disunited.
dissolubleness |The quality of being dissoluble; dissolubility. Boyle.
dissolute |1. With nerves unstrung; weak. [Obs.] Spenser. 2. Loosed from restraint; esp., loose in morals and conduct; recklessly abandoned to sensual pleasures; profligate; wanton; lewd; debauched. \"A wild and dissolute soldier.\" Motley. Syn. -- Uncurbed; unbridled; disorderly; unrestrained; reckless; wild; wanton; vicious; lax; licentious; lewd;
dissolutely |In a dissolute manner.
dissoluteness |State or quality of being dissolute; looseness of morals and manners; addictedness to sinful pleasures; debauchery; dissipation. Chivalry had the vices of dissoluteness. Bancroft.
dissolution |1. The act of dissolving, sundering, or separating into component parts; separation. Dissolutions of ancient amities. Shak. 2. Change from a solid to a fluid state; solution by heat or moisture; liquefaction; melting. 3. Change of form by chemical agency; decomposition; resolution. The dissolution of the compound. South. 4. The dispersion of an assembly by terminating its sessions; the breaking up of a partnership. Dissolution is the civil death of Parliament. Blackstone. 5. The extinction of life in the human body; separation of the soul from the body; death. We expected Immediate dissolution. Milton. 6. The state of being dissolved, or of undergoing liquefaction. A man of continual dissolution and thaw. Shak. 7. The new product formed by dissolving a body; a solution. Bacon. 8. Destruction of anything by the separation of its parts; ruin. To make a present dissolution of the world. Hooker. 9. Corruption of morals; dissipation; dissoluteness. [Obs. or R.] Atterbury.
dissolvability |Capacity of being dissolved; solubility. Richardson.
dissolvable |Capable of being dissolved, or separated into component parts; capable of being liquefied; soluble. -- Dis*solv\"a*ble*ness, n. Though everything which is compacted be in its own nature dissolvable. Cudworth. Such things as are not dissolvable by the moisture of the tongue. Sir I. Newton.
dissolvative |Having the power to dissolve anything; solvent. [Obs.] Frampton.
dissolve |1. To separate into competent parts; to disorganize; to break up; hence, to bring to an end by separating the parts, sundering a relation, etc.; to terminate; to destroy; to deprive of force; as, to dissolve a partnership; to dissolve Parliament. Lest his ungoverned rage dissolve the life. Shak. 2. To break the continuity of; to disconnect; to disunite; to sunder; to loosen; to undo; to separate. Nothing can dissolve us. Shak. Down fell the duke, his joints dissolved asunder. Fairfax. For one people to dissolve the political bands which have connected them with another. The Declaration of Independence. 3. To convert into a liquid by means of heat, moisture, etc.,; to melt; to liquefy; to soften. As if the world were all dissolved to tears. Shak. 4. To solve; to clear up; to resolve. \"Dissolved the mystery.\" Tennyson. Make interpretations and dissolve doubts. Dan. v. 16. 5. To relax by pleasure; to make powerless. Angels dissolved in hallelujahs lie. Dryden. 6. (Law)  To annul; to rescind; to discharge or release; as, to dissolve an injunction. Syn. -- See Adjourn.\n\n1. To waste away; to be dissipated; to be decomposed or broken up. 2. To become fluid; to be melted; to be liquefied. A figure Trenched in ice, which with an hour's heat Dissolves to water, and doth lose his form. Shak. 3. To fade away; to fall to nothing; to lose power. The charm dissolves apace. Shak.
dissolvent |Having power to dissolve power to dissolve a solid body; as, the dissolvent juices of the stomach. Ray.\n\n1. That which has the power of dissolving or melting other substances, esp. by mixture with them; a menstruum; a solvent. Melted in the crucible dissolvents. A. Smith. The secret treaty of December acted as an immediate dissolvent to the truce. Mothley. 2. (Med.)  A remedy supposed capable of dissolving concretions in the body, such as calculi, tubercles, etc.
dissolver |One who, or that which, has power to dissolve or dissipate. Thou kind dissolver of encroaching care. Otway.
dissolving |Melting; breaking up; vanishing. -- Dis*solv\"ing*ly, adv. Dissolving view, a picture which grows dim and is gradually replaced by another on the same field; -- an effect produced by magic lanterns.
dissonance |1. A mingling of discordant sounds; an inharmonious combination of sounds; discord. Filled the air with barbarous dissonance. Milton. 2. Want of agreement; incongruity. Milton.
dissonancy |Discord; dissonance.
dissonant |1. Sounding harshly; discordant; unharmonious. With clamor of voices dissonant and loud. Longfellow. 2. Disagreeing; incongruous; discrepfrom or to. \"Anything dissonant to truth.\" South. What can be dissonant from reason and nature than that a man, naturally inclined to clemency, should show himself unkind and inhuman Hakewill.
disspirit |See Dispirit.
dissuade |1. To advise or exhort against; to try to persuade (one from a course). [Obsolescent] Mr. Burchell, on the contrary, dissuaded her with great ardor: and I stood neuter. Goldsmith. War, therefore, open or concealed, alike My voice dissuades. Milton. 2. To divert by persuasion; to turn from a purpose by reasons or motives; -- with from; as, I could not dissuade him from his purpose. I have tried what is possible to dissuade him. Mad. D' Arblay.
dissuader |One who dissuades; a dehorter.
dissuasion |1. The act of dissuading; exhortation against a thing; dehortation. In spite of all the dissuasions of his friends. Boyle. 2. A motive or consideration tending to dissuade; a dissuasive.
dissuasive |Tending to dissuade or divert from a measure or purpose; dehortatory; as, dissuasive advice. -- n.  A dissuasive argument or counsel; dissuasion; dehortation. Prynne. -- Dis*sua\"sive*ly, adv.
dissunder |To separate; to sunder; to destroy. [R.] Chapman.
dissweeten |To deprive of sweetness. [R.] Bp. Richardson.
dissyllabic |Consisting of two syllabas, a dissyllabic foot in poetry. B. Jons
dissyllabification |A formi
dissyllabify |To form into two syllables. Ogilvie.
dissyllabize |To form into two syllables; to dyssyllabify.
dissyllable |A word of two syllables; as, pa-per.
dissymmetrical |Not having symmetry; asymmetrical; unsymmetrical.
dissymmetry |Absence or defect of symmetry; asymmetry.
dissympathy |Lack of sympathy; want of interest; indifference. [R.]
distad |Toward a distal part; on the distal side of; distally.
distaff |1. The staff for holding a bunch of flax, tow, or wool, from which the thread is drawn in spinning by hand. I will the distaff hold; come thou and spin. Fairfax. 2. Used as a symbol of the holder of a distaff; hence, a woman; women, collectively. His crown usurped, a distaff on the throne. Dryden. Some say the crozier, some say the distaff was too busy. Howell. Note: The plural is regular, but Distaves occurs in Beaumont & Fletcher. Descent by distaff, descent on the mother's side. -- Distaff Day, or Distaff's Day, the morrow of the Epiphany, that is, January 7, because working at the distaff was then resumed, after the Christmas festival; -- called also Rock Day, a distaff being called a rock. Shipley.
distain |To tinge with a different color from the natural or proper one; to stain; to discolor; to sully; to tarnish; to defile; -- used chiefly in poetry. \"Distained with dirt and blood.\" Spenser. [She] hath . . . distained her honorable blood. Spenser. The worthiness of praise distains his worth. Shak.
distal |(a) Remote from the point of attachment or origin; as, the distal end of a bone or muscle; -- opposed to proximal. (b) Pertaining to that which is distal; as, the distal tuberosities of a bone.
distally |Toward a distal part.
distance |1. The space between two objects; the length of a line, especially the shortest line joining two points or things that are separate; measure of separation in place. Every particle attracts every other with a force . . . inversely proportioned to the square of the distance. Sir I. Newton. 2. Remoteness of place; a remote place. Easily managed from a distance. W. Irving. 'T is distance lends enchantment to the view. T. Campbell. [He] waits at distance till he hears from Cato. Addison. 3. (Racing)  A space marked out in the last part of a race course. The horse that ran the whole field out of distance. L'Estrange. Note: In trotting matches under the rules of the American Association, the distance varies with the conditions of the race, being 80 yards in races of mile heaths, best two in three, and 150 yards in races of two-mile heats. At that distance from the winning post in placed the distance post. If any horse has not reached this distance post before the first horse in that heat has reached the winning post, such horse is distanced, and disqualified for cunning again during that race. 4. (Mil.)  Relative space, between troops in ranks, measured from front to rear; -- contrasted with interval, which is measured from right to left. \"Distance between companies in close column is twelve yards.\" Farrow. 5. Space between two antagonists in fencing. Shak. 6. (Painting)  The part of a picture which contains the representation of those objects which are the farthest away, esp. in a landscape. Note: In a picture, the Middle distance is the central portion between the foreground and the distance or the extreme distance. In a perspective drawing, the Point of distance is the point where the visual rays meet. 7. Ideal disjunction; discrepancy; contrariety. Locke. 8. Length or interval of time; period, past or future, between two eras or events. Ten years' distance between one and the other. Prior. The writings of Euclid at the distance of two thousand years. Playfair. 9. The remoteness or reserve which respect requires; hence, respect; ceremoniousness. I hope your modesty Will know what distance to the crown is due. Dryden. 'T is by respect and distance that authority is upheld. Atterbury. 10. A withholding of intimacy; alienation; coldness; disagreement; variance; restraint; reserve. Setting them [factions] at distance, or at least distrust amongst themselves. Bacon. On the part of Heaven, Now alienated, distance and distaste. Milton. 11. Remoteness in succession or relation; as, the distance between a descendant and his ancestor. 12. (Mus.)  The interval between two notes; as, the distance of a fourth or seventh. Angular distance, the distance made at the eye by lines drawn from the eye to two objects. -- Lunar distance. See under Lunar. -- North polar distance (Astron.), the distance on the heavens of a heavenly body from the north pole. It is the complement of the declination. -- Zenith distance (Astron.), the arc on the heavens from a heavenly body to the zenith of the observer. It is the complement of the altitude. -- To keep one's distance, to stand aloof; to refrain from familiarity. If a man makes keep my distance, the comfort is he keeps his at the same time. Swift.\n\n1. To place at a distance or remotely. I heard nothing thereof at Oxford, being then miles distanced thence. Fuller. 2. To cause to appear as if at a distance; to make seem remote. His peculiar art of distancing an object to aggrandize his space. H. Miller. 3. To outstrip by as much as a distance (see Distance, n., 3); to leave far behind; to surpass greatly. He distanced the most skillful of his contemporaries. Milner.
distancy |Distance. [Obs.] Dr. H. More.
distant |1. Separated; having an intervening space; at a distance; away. One board had two tenons, equally distant. Ex. xxxvi. 22. Diana's temple is not distant far. Shak. 2. Far separated; far off; not near; remote; -- in place, time, consanguinity, or connection; as, distant times; distant relatives. The success of these distant enterprises. Prescott. 3. Reserved or repelling in manners; cold; not cordial; somewhat haughty; as, a distant manner. He passed me with a distant bow. Goldsmith. 4. Indistinct; faint; obscure, as from distance. Some distant knowledge. Shak. A distant glimpse. W. Irving. 5. Not conformable; discrepant; repugnant; as, a practice so widely distant from Christianity. Syn. -- Separate; far; remote; aloof; apart; asunder; slight; faint; indirect; indistinct.
distantial |Distant. [Obs.] More distantial from the eye. W. Montagu.
distantly |At a distance; remotely; with reserve.
distaste |1. Aversion of the taste; dislike, as of food or drink; disrelish. Bacon. 2. Discomfort; uneasiness. Prosperity is not without many fears and distastes, and adversity is not without comforts and hopes. Bacon. 3. Alienation of affection; displeasure; anger. On the part of Heaven, Now alienated, distance and distaste. Milton. Syn. -- Disrelish; disinclination; dislike; aversion; displeasure; dissatisfaction; disgust.\n\n1. Not to have relish or taste for; to disrelish; to loathe; to dislike. Although my will distaste what it elected. Shak. 2. To offend; to disgust; to displease. [Obs.] He thought in no policy to distaste the English or Irish by a course of reformation, but sought to please them. Sir J. Davies. 3. To deprive of taste or relish; to make unsavory or distasteful. Drayton.\n\nTo be distasteful; to taste ill or disagreeable. [Obs.] Dangerous conceits are, in their natures, poisons, Which at the are scarce found to distaste. Shak.
distasteful |1. Unpleasant or disgusting to the taste; nauseous; loathsome. 2. Offensive; displeasing to the feelings; disagreeable; as, a distasteful truth. Distasteful answer, and sometimes unfriendly actions. Milton. 3. Manifesting distaste or dislike; repulsive. \"Distasteful looks.\" Shak. Syn. -- Nauseous; unsavory; unpalatable; offensive; displeasing; dissatisfactory; disgusting. - Dis*taste\"ful*ly, adv. -- Dis*taste\"ful*ness, n.
distasteive |Tending to excite distaste. [Obs.] -- n.  That which excites distaste or aversion. [Obs.] Whitlock.
distasture |Something which excites distaste or disgust. [Obs.] Speed.
distemper |1. To temper or mix unduly; to make disproportionate; to change the due proportions of. [Obs.] When . . . the humors in his body ben distempered. Chaucer. 2. To derange the functions of, whether bodily, mental, or spiritual; to disorder; to disease. Shak. The imagination, when completely distempered, is the most incurable of all disordered faculties. Buckminster. 3. To deprive of temper or moderation; to disturb; to ruffle; to make disaffected, ill-humored, or malignant. \"Distempered spirits.\" Coleridge. 4. To intoxicate. [R.] The courtiers reeling, And the duke himself, I dare not say distempered, But kind, and in his tottering chair carousing. Massinger. 5. (Paint.)  To mix (colors) in the way of distemper; as, to distemper colors with size. [R.]\n\n1. An undue or unnatural temper, or disproportionate mixture of parts. Bacon. Note: This meaning and most of the following are to be referred to the Galenical doctrine of the four \"humors\" in man. See Humor. According to the old physicians, these humors, when unduly tempered, produce a disordered state of body and mind. 2. Severity of climate; extreme weather, whether hot or cold. [Obs.] Those countries . . . under the tropic, were of a distemper uninhabitable. Sir W. Raleigh. 3. A morbid state of the animal system; indisposition; malady; disorder; -- at present chiefly applied to diseases of brutes; as, a distemper in dogs; the horse distemper; the horn distemper in cattle. They heighten distempers to diseases. Suckling. 4. Morbid temper of the mind; undue predominance of a passion or appetite; mental derangement; bad temper; ill humor. [Obs.] Little faults proceeding on distemper. Shak. Some frenzy distemper had got into his head. Bunyan. 5. Political disorder; tumult. Waller. 6. (Paint.) (a) A preparation of opaque or body colors, in which the pigments are tempered or diluted with weak glue or size (cf. Tempera) instead of oil, usually for scene painting, or for walls and ceilings of rooms. (b) A painting done with this preparation. Syn. -- Disease; disorder; sickness; illness; malady; indisposition; ailment. See Disease.
distemperance |Distemperature. [Obs.]
distemperate |1. Immoderate. [Obs.] Sir W. Raleigh. 2. Diseased; disordered. [Obs.] Wodroephe.
distemperately |Unduly. [Obs.]
distemperature |1. Bad temperature; intemperateness; excess of heat or cold, or of other qualities; as, the distemperature of the air. [Obs.] 2. Disorder; confusion. Shak. 3. Disorder of body; slight illness; distemper. A huge infectious troop Of pale distemperatures and foes to life. Shak. 4. Perturbation of mind; mental uneasiness. Sprinkled a little patience on the heat of his distemperature. Sir W. Scott.
distemperment |Distempered state; distemperature. [Obs.] Feltham.
distend |1. To extend in some one direction; to lengthen out; to stretch. [R.] But say, what mean those colored streaks in heaven Distended as the brow of God appeased Milton. 2. To stretch out or extend in all directions; to dilate; to enlarge, as by elasticity of parts; to inflate so as to produce tension; to cause to swell; as, to distend a bladder, the stomach, etc. The warmth distends the chinks. Dryden. Syn. -- To dilate; expand; enlarge; swell; inflate.\n\nTo become expanded or inflated; to swell. \"His heart distends with pride.\" Milton.
distensibility |The quality or capacity of being distensible. [R.]
distensible |Capable of being distended or dilated.
distension |Same as Distention.
distensive |Distending, or capable of being distended.
distention |1. The act of distending; the act of stretching in breadth or in all directions; the state of being Distended; as, the distention of the lungs. 2. Breadth; extent or space occupied by the thing distended.
dister |To banish or drive from a country. [Obs.] Howell.
disterminate |Separated by bounds. [Obs.] Bp. Hall.
distermination |Separation by bounds. [Obs.] Hammond.
disthene |Cyanite or kyanite; -- so called in allusion to its unequal hardness in two different directions. See Cyanite.
disthrone |To dethrone. [Obs.]
disthronize |To dethrone. [Obs.] Spenser.
distich |A couple of verses or poetic lines making complete sense; an epigram of two verses.\n\nDisposed in two vertical rows; two-ranked.
distichous |Disposed in two vertical rows; two-ranked.
distichously |In a distichous manner.
distil |See Distill.
distill |1. To drop; to fall in drops; to trickle. Soft showers distilled, and suns grew warm in vain. Pope. 2. To flow gently, or in a small stream. The Euphrates distilleth out of the mountains of Armenia. Sir W. Raleigh. 3. To practice the art of distillation. Shak.\n\n1. To let fall or send down in drops. Or o'er the glebe distill the kindly rain. Pope. The dew which on the tender grass The evening had distilled. Drayton. 2. To obtain by distillation; to extract by distillation, as spirits, essential oil, etc.; to rectify; as, to distill brandy from wine; to distill alcoholic spirits from grain; to distill essential oils from flowers, etc.; to distill fresh water from sea water. \"Distilling odors on me.\" Tennyson. 3. To subject to distillation; as, to distill molasses in making rum; to distill barley, rye, corn, etc. 4. To dissolve or melt. [R.] Swords by the lightning's subtle force distilled. Addison.
distillable |Capable of being distilled; especially, capable of being distilled without chemical change or decomposition; as, alcohol is distillable; olive oil is not distillable.
distillate |The product of distillation; as, the distillate from molasses.
distillation |1. The act of falling in drops, or the act of pouring out in drops. 2. That which falls in drops. [R.] Johnson 3. (Chem.)  The separation of the volatile parts of a substance from the more fixed; specifically, the operation of driving off gas or vapor from volatile liquids or solids, by heat in a retort or still, and the condensation of the products as far as possible by a cool receiver, alembic, or condenser; rectification; vaporization; condensation; as, the distillation of illuminating gas and coal, of alcohol from sour mash, or of boric acid in steam. Note: The evaporation of water, its condensation into clouds, and its precipitation as rain, dew, frost, snow, or hail, is an illustration of natural distillation. 4. The substance extracted by distilling. Shak. Destructive distillation (Chem.), the distillation, especially of complex solid substances, so that the ultimate constituents are separated or evolved in new compounds, -- usually requiring a high degree of heat; as, the destructive distillation of soft coal or of wood. -- Dry distillation, the distillation of substances by themselves, or without the addition of water or of other volatile solvent; as, the dry distillation of citric acid. -- Fractional distillation. (Chem.) See under Fractional.
distillatory |Belonging to, or used in, distilling; as, distillatory vessels. -- n.  A distillatory apparatus; a still.
distiller |1. One who distills; esp., one who extracts alcoholic liquors by distillation. 2. The condenser of a distilling apparatus.
distillery |1. The building and works where distilling, esp. of alcoholic liquors, is carried on. 2. The act of distilling spirits. [R.] Todd.
distillment |Distillation; the substance obtained by distillation. [Obs.] Shak.
distinct |1. Distinguished; having the difference marked; separated by a visible sign; marked out; specified. [Obs.] Wherever thus created -- for no place Is yet distinct by name. Milton. 2. Marked; variegated. [Obs.] The which [place] was dight With divers flowers distinct with rare delight. Spenser. 3. Separate in place; not conjunct; not united by growth or otherwise; -- with from. The intention was that the two armies which marched out together should afterward be distinct. Clarendon. 4. Not identical; different; individual. To offend, and judge, are distinct offices. Shak. 5. So separated as not to be confounded with any other thing; not liable to be misunderstood; not confused; well-defined; clear; as, we have a distinct or indistinct view of a prospect. Relation more particular and distinct. Milton. Syn. -- Separate; unconnected; disjoined; different; clear; plain; conspicuous; obvious.\n\nTo distinguish. [Obs.] Rom. of R.
distinction |1. A marking off by visible signs; separation into parts; division. [Obs.] The distinction of tragedy into acts was not known. Dryden. 2. The act of distinguishing or denoting the differences between objects, or the qualities by which one is known from others; exercise of discernment; discrimination. To take away therefore that error, which confusion breedeth, distinction is requisite. Hooker. 3. That which distinguishes one thing from another; distinguishing quality; sharply defined difference; as, the distinction between real and apparent good. The distinction betwixt the animal kingdom and the inferior parts of matter. Locke. 4. Estimation of difference; regard to differences or distinguishing circumstance. Maids, women, wives, without distinction, fall. Dryden. 5. Conspicuous station; eminence; superiority; honorable estimation; as, a man of distinction. Your country's own means of distinction and defense. D. Webster. Syn. -- Difference; variation, variety; contrast; diversity; contrariety; disagreement; discrimination; preference; superiority; rank; note; eminence.
distinctive |1. Marking or expressing distinction or difference; distinguishing; characteristic; peculiar. The distinctive character and institutions of New England. Bancroft. 2. Having the power to distinguish and discern; discriminating. [Obs.] Sir T. Browne.
distinctively |With distinction; plainly.
distinctiveness |State of being distinctive.
distinctly |1. With distinctness; not confusedly; without the blending of one part or thing another; clearly; plainly; as, to see distinctly. 2. With meaning; significantly. [Obs.] Thou dost snore distinctly; There's meaning in thy snores. Shak. Syn. -- Separately; clearly; plainly; obviously.
distinctness |1. The quality or state of being distinct; a separation or difference that prevents confusion of parts or things. The soul's . . . distinctness from the body. Cudworth. 2. Nice discrimination; hence, clearness; precision; as, he stated his arguments with great distinctness. Syn. -- Plainness; clearness; precision; perspicuity.
distincture |Distinctness. [R.]
distinguish |1. Not set apart from others by visible marks; to make distinctive or discernible by exhibiting differences; to mark off by some characteristic. Not more distinguished by her purple vest, Than by the charming features of her face. Dryden. Milton has distinguished the sweetbrier and the eglantine. Nares. 2. To separate by definition of terms or logical division of a subject with regard to difference; as, to distinguish sounds into high and low. Moses distinguished the causes of the flood into those that belong to the heavens, and those that belong to the earth. T. Burnet. 3. To recognize or discern by marks, signs, or characteristic quality or qualities; to know and discriminate (anything) from other things with which it might be confounded; as, to distinguish the sound of a drum. We are enabled to distinguish good from evil, as well as truth from falsehood. Watts. Nor more can you distinguish of a man, Than of his outward show. Shak. 4. To constitute a difference; to make to differ. Who distinguisheth thee 1 Cor. iv. 7. (Douay version). 5. To separate from others by a mark of honor; to make eminent or known; to confer distinction upon; -- with by or for.\"To distinguish themselves by means never tried before.\" Johnson. Syn. -- To mark; discriminate; differentiate; characterize; discern; perceive; signalize; honor; glorify.\n\n1. To make distinctions; to perceive the difference; to exercise discrimination; -- with between; as, a judge distinguishes between cases apparently similar, but differing in principle. 2. To become distinguished or distinctive; to make one's self or itself discernible. [R.] The little embryo . . . first distinguishes into a little knot. Jer. Taylor.
distinguishable |1. Capable of being distinguished; separable; divisible; discernible; capable of recognition; as, a tree at a distance is distinguishable from a shrub. A simple idea being in itself uncompounded . . . is not distinguishable into different ideas. Locke. 2. Worthy of note or special regard. Swift.
distinguishableness |The quality of being distinguishable.
distinguishably |So as to be distinguished.
distinguished |1. Marked; special. The most distinguished politeness. Mad. D' Arblay. 2. Separated from others by distinct difference; having, or indicating, superiority; eminent or known; illustrious; -- applied to persons and deeds. Syn. -- Marked; noted; famous; conspicuous; celebrated; transcendent; eminent; illustrious; extraordinary; prominent. -- Distinguished, Eminent, Conspicuous, Celebrated, Illustrious. A man is eminent, when he stands high as compared with those around him; conspicuous, when he is so elevated as to be seen and observed; distinguished, when he has something which makes him stand apart from others in the public view; celebrated, when he is widely spoken of with honor and respect; illustrious, when a splendor is thrown around him which confers the highest dignity.
distinguishedly |In a distinguished manner. [R.] Swift.
distinguisher |1. One who, or that which, distinguishes or separates one thing from another by marks of diversity. Sir T. Browne. 2. One who discerns accurately the difference of things; a nice or judicious observer. Dryden.
distinguishing |Constituting difference, or distinction from everything else; distinctive; peculiar; characteristic. The distinguishing doctrines of our holy religion. Locke. Distinguishing pennant (Naut.), a special pennant by which any particular vessel in a fleet is recognized and signaled. Simmonds.
distinguishingly |With distinction; with some mark of preference. Pope.
distinguishment |Observation of difference; distinction. Graunt.
distitle |To deprive of title or right. [R.] B. Jonson.
distoma |A genus of parasitic, trematode worms, having two suckers for attaching themselves to the part they infest. See 1st Fluke, 2.
distort |Distorted; misshapen. [Obs.] Her face was ugly and her mouth distort. Spenser.\n\n1. To twist of natural or regular shape; to twist aside physically; as, to distort the limbs, or the body. Whose face was distorted with pain. Thackeray. 2. To force or put out of the true posture or direction; to twist aside mentally or morally. Wrath and malice, envy and revenge, do darken and distort the understandings of men. Tillotson. 3. To wrest from the true meaning; to pervert; as, to distort passages of Scripture, or their meaning. Syn. -- To twist; wrest; deform; pervert.
distorter |One who, or that which, distorts.
distortion |1. The act of distorting, or twisting out of natural or regular shape; a twisting or writhing motion; as, the distortions of the face or body. 2. A wresting from the true meaning. Bp. Wren. 3. The state of being distorted, or twisted out of shape or out of true position; crookedness; perversion. 4. (Med.)  An unnatural deviation of shape or position of any part of the body producing visible deformity.
distortive |Causing distortion.
distract |1. Separated; drawn asunder. [Obs.] 2. Insane; mad. [Obs.] Drayton.\n\n1. To draw apart or away; to divide; to disjoin. A city . . . distracted from itself. Fuller. 2. To draw (the sight, mind, or attention) in different directions; to perplex; to confuse; as, to distract the eye; to distract the attention. Mixed metaphors . . . distract the imagination. Goldsmith. 3. To agitate by conflicting passions, or by a variety of motives or of cares; to confound; to harass. Horror and doubt distract His troubled thoughts. Milton. 4. To unsettle the reason of; to render insane; to craze; to madden; -- most frequently used in the participle, distracted. A poor mad soul; . . . poverty hath distracted her. Shak.
distracted |Mentally disordered; unsettled; mad. My distracted mind. Pope.
distractedly |Disjointedly; madly. Shak.
distractedness |A state of being distracted; distraction. Bp. Hall.
distracter |One who, or that which, distracts away.
distractful |Distracting. [R.] Heywood.
distractible |Capable of being drawn aside or distracted.
distractile |Tending or serving to draw apart.
distracting |Tending or serving to distract.
distraction |1. The act of distracting; a drawing apart; separation. To create distractions among us. Bp. Burnet. 2. That which diverts attention; a diversion. \"Domestic distractions.\" G. Eliot. 3. A diversity of direction; detachment. [Obs.] His power went out in such distractions as Beguiled all species. Shak. 4. State in which the attention is called in different ways; confusion; perplexity. That ye may attend upon the Lord without distraction. 1 Cor. vii. 3 5. Confusion of affairs; tumult; disorder; as, political distractions. Never was known a night of such distraction. Dryden. 6. Agitation from violent emotions; perturbation of mind; despair. The distraction of the children, who saw both their parents together, would have melted the hardest heart. Tatler. 7. Derangement of the mind; madness. Atterbury. Syn. -- Perplexity; confusion; disturbance; disorder; dissension; tumult; derangement; madness; raving; franticness; furiousness.
distractious |Distractive. [Obs.]
distractive |Causing perplexity; distracting. \"Distractive thoughts.\" Bp. Hall.
distrain |1. To press heavily upon; to bear down upon with violence; hence, to constrain or compel; to bind; to distress, torment, or afflict. [Obs.] \"Distrained with chains.\" Chaucer. 2. To rend; to tear. [Obs.] Neither guile nor force might it [a net] distrain. Spenser. 3. (Law) (a) To seize, as a pledge or indemnification; to take possession of as security for nonpayment of rent, the reparation of an injury done, etc.; to take by distress; as, to distrain goods for rent, or of an amercement. (b) To subject to distress; to coerce; as, to distrain a person by his goods and chattels.\n\nTo levy a distress. Upon whom I can distrain for debt. Camden.
distrainable |Capable of being, or liable to be, distrained. Blackstone.
distrainer |Same as Distrainor.
distrainor |One who distrains; the party distraining goods or chattels. Blackstone.
distraint |The act or proceeding of seizing personal property by distress. Abbott.
distrait |Absent-minded; lost in thought; abstracted.
distraught |1. Torn asunder; separated. [Obs.] \"His greedy throat . . . distraught.\" Spenser. 2. Distracted; perplexed. \"Distraught twixt fear and pity.\" Spenser. As if thou wert distraught and mad with terror. Shak. To doubt betwixt our senses and our souls Which are the most distraught and full of pain. Mrs. Browning.
distraughted |Distracted. [Obs.] Spenser.
distream |To flow. [Poetic] Yet o'er that virtuous blush distreams a tear. Shenstone.
distress |1. Extreme pain or suffering; anguish of body or mind; as, to suffer distress from the gout, or from the loss of friends. Not fearing death nor shrinking for distress. Shak. 2. That which occasions suffering; painful situation; misfortune; affliction; misery. Affliction's sons are brothers in distress. Burns. 3. A state of danger or necessity; as, a ship in distress, from leaking, loss of spars, want of provisions or water, etc. 4. (Law) (a) The act of distraining; the taking of a personal chattel out of the possession of a wrongdoer, by way of pledge for redress of an injury, or for the performance of a duty, as for nonpayment of rent or taxes, or for injury done by cattle, etc. (b) The thing taken by distraining; that which is seized to procure satisfaction. Bouvier. Kent. Burrill. If he were not paid, he would straight go and take a distress of goods and cattle. Spenser. The distress thus taken must be proportioned to the thing distrained for. Blackstone. Abuse of distress. (Law) See under Abuse. Syn. -- Affliction; suffering; pain; agony; misery; torment; anguish; grief; sorrow; calamity; misfortune; trouble; adversity. See Affliction.\n\n1. To cause pain or anguish to; to pain; to oppress with calamity; to afflict; to harass; to make miserable. We are troubled on every side, yet not distressed. 2 Cor. iv. 8. 2. To compel by pain or suffering. Men who can neither be distressed nor won into a sacrifice of duty. A. Hamilton. 3. (Law)  To seize for debt; to distrain. Syn. -- To pain; grieve; harass; trouble; perplex; afflict; worry; annoy.
distressedness |A state of being distressed or greatly pained.
distressful |Full of distress; causing, indicating, or attended with, distress; as, a distressful situation. \"Some distressful stroke.\" Shak. \"Distressful cries.\" Pope. -- Dis*tress\"ful*ly, adv.
distressing |Causing distress; painful; unpleasant.\n\nIn a distressing manner.
distributable |Capable of being distributed. Sir W. Jones.
distributary |Tending to distribute or be distributed; that distributes; distributive.
distribute |1. To divide among several or many; to deal out; to apportion; to allot. She did distribute her goods to all them that were nearest of kindred. Judith xvi. 24. 2. To dispense; to administer; as, to distribute justice. Shak. 3. To divide or separate, as into classes, orders, kinds, or species; to classify; to assort, as specimens, letters, etc. 4. (Printing) (a) To separate (type which has been used) and return it to the proper boxes in the cases. (b) To spread (ink) evenly, as upon a roller or a table. 5. (Logic)  To employ (a term) in its whole extent; to take as universal in one premise. A term is said to be distributed when it is taken universal, so as to stand for everything it is capable of being applied to. Whately. Syn. -- To dispense; deal out; apportion; allot; share; assign; divide.\n\nTo make distribution. Distributing to the necessity of saints. Rom. xii. 13.
distributer |One who, or that which, distributes or deals out anything; a dispenser. Addison.
distribution |1. The act of distributing or dispensing; the act of dividing or apportioning among several or many; apportionment; as, the distribution of an estate among heirs or children. The phenomena of geological distribution are exactly analogous to those of geography. A. R. Wallace. 2. Separation into parts or classes; arrangement of anything into parts; disposition; classification. 3. That which is distributed. \"Our charitable distributions.\" Atterbury. 4. (Logic)  A resolving a whole into its parts. 5. (Print.)  The sorting of types and placing them in their proper boxes in the cases. 6. (Steam Engine)  The steps or operations by which steam is supplied to and withdrawn from the cylinder at each stroke of the piston; viz., admission, suppression or cutting off, release or exhaust, and compression of exhaust steam prior to the next admission. Geographical distribution, the natural arrangements of animals and plants in particular regions or districts. Syn. -- Apportionments; allotment; dispensation; disposal; dispersion; classification; arrangement.
distributional |Of or pertaining to distribution. Huxley.
distributionist |A distributer. [R.] Dickens.
distributive |1. Tending to distribute; serving to divide and assign in portions; dealing to each his proper share. \"Distributive justice.\" Swift. 2. (Logic)  Assigning the species of a general term. 3. (Gram.)  Expressing separation; denoting a taking singly, not collectively; as, a distributive adjective or pronoun, such as each, either, every; a distributive numeral, as (Latin) bini (two by two). Distributive operation (Math.), any operation which either consists of two or more parts, or works upon two or more things, and which is such that the result of the total operation is the same as the aggregated result of the two or more partial operations. Ordinary multiplication is distributive, since a × (b + c) = ab + ac, and (a + b) × c = ac + bc. -- Distributive proportion. (Math.) See Fellowship.\n\nA distributive adjective or pronoun; also, a distributive numeral.
distributively |By distribution; singly; not collectively; in a distributive manner.
distributiveness |Quality of being distributive.
distributor |(a) A machine for distributing type. (b) An appliance, as a roller, in a printing press, for distributing ink. (c) An apparatus for distributing an electric current, either to various points in rotation, as in some motors, or along two or more lines in parallel, as in a distributing system.
district |Rigorous; stringent; harsh. [Obs.] Punishing with the rod of district severity. Foxe.\n\n1. (Feudal Law)  The territory within which the lord has the power of coercing and punishing. 2. A division of territory; a defined portion of a state, town, or city, etc., made for administrative, electoral, or other purposes; as, a congressional district, judicial district, land district, school district, etc. To exercise exclusive legislation . . . over such district not exceeding ten miles square. The Constitution of the United States. 3. Any portion of territory of undefined extent; a region; a country; a tract. These districts which between the tropics lie. Blackstone. Congressional district. See under Congressional. -- District attorney, the prosecuting officer of a district or district court. -- District court, a subordinate municipal, state, or United States tribunal, having jurisdiction in certain cases within a judicial district. -- District judge, one who presides over a district court. -- District school, a public school for the children within a school district. [U.S.] Syn. -- Division; circuit; quarter; province; tract; region; country.\n\nTo divide into districts or limited portions of territory; as, legislatures district States for the choice of representatives.
distriction |Sudden display; flash; glitter. [R.] A smile . . . breaks out with the brightest distriction. Collier.
districtly |Strictly. [Obs.] Foxe.
distringas |A writ commanding the sheriff to distrain a person by his goods or chattels, to compel a compliance with something required of him.
distrouble |To trouble. [Obs.] Spenser.
distrust |To feel absence of trust in; not to confide in or rely upon; to deem of questionable sufficiency or reality; to doubt; to be suspicious of; to mistrust. Not distrusting my health. 2 Mac. ix. 22. To distrust the justice of your cause. Dryden. He that requireth the oath doth distrust that other. Udall. Of all afraid, Distrusting all, a wise, suspicious maid. Collins. Note: Mistrust has been almost wholly driven out by distrust. T. L. K. Oliphant.\n\n1. Doubt of sufficiency, reality, or sincerity; want of confidence, faith, or reliance; as, distrust of one's power, authority, will, purposes, schemes, etc. 2. Suspicion of evil designs. Alienation and distrust . . . are the growth of false principles. D. Webster. 3. State of being suspected; loss of trust. Milton.
distruster |One who distrusts.
distrustful |1. Not confident; diffident; wanting confidence or thrust; modest; as, distrustful of ourselves, of one's powers. Distrustful sense with modest caution speaks. Pope. 2. Apt to distrust; suspicious; mistrustful. Boyle. -- Dis*trust\"ful*ly, adv. -- Dis*trust\"ful*ness, n.
distrusting |That distrusts; suspicious; lacking confidence in. -- Dis*trust\"ing*ly, adv.
distrustless |Free from distrust. Shenstone.
distune |To put out of tune. [Obs.]
disturb |1. To throw into disorder or confusion; to derange; to interrupt the settled state of; to excite from a state of rest. Preparing to disturb With all-cofounding war the realms above. Cowper. The bellow's noise disturbed his quiet rest. Spenser. The utmost which the discontented colonies could do, was to disturb authority. Burke. 2. To agitate the mind of; to deprive of tranquillity; to disquiet; to render uneasy; as, a person is disturbed by receiving an insult, or his mind is disturbed by envy. 3. To turn from a regular or designed course. [Obs.] And disturb His inmost counsels from their destined aim. Milton. Syn. -- To disorder; disquiet; agitate; discompose; molest; perplex; trouble; incommode; ruffle.\n\nDisturbance. [Obs.] Milton.
disturbance |1. An interruption of a state of peace or quiet; derangement of the regular course of things; disquiet; disorder; as, a disturbance of religious exercises; a disturbance of the galvanic current. 2. Confusion of the mind; agitation of the feelings; perplexity; uneasiness. Any man . . . in a state of disturbance and irritation. Burke. 3. Violent agitation in the body politic; public commotion; tumult. The disturbance was made to support a general accusation against the province. Bancroft. 4. (Law)  The hindering or disquieting of a person in the lawful and peaceable enjoyment of his right; the interruption of a right; as, the disturbance of a franchise, of common, of ways, and the like. Blackstone. Syn. -- Tumult; brawl; commotion; turmoil; uproar; hubbub; disorder; derangement; confusion; agitation; perturbation; annoyance.
disturbation |Act of disturbing; disturbance. [Obs.] Daniel.
disturber |1. One who, or that which, disturbs of disquiets; a violator of peace; a troubler. A needless disturber of the peace of God's church and an author of dissension. Hooker. 2. (Law)  One who interrupts or incommodes another in the peaceable enjoyment of his right.
disturn |To turn aside. [Obs.] Daniel.
distyle |Having two columns in front; -- said of a temple, portico, or the like. Distyle in antis, having columns between two antæ. See Anta.
disulphate |(a) A salt of disulphuric or pyrosulphuric acid; a pyrosulphate. (b) An acid salt of sulphuric acid, having only one equivalent of base to two of the acid.
disulphide |A binary compound of sulphur containing two atoms of sulphur in each molecule; -- formerly called disulphuret. Cf. Bisulphide.
disulphuret |See Disulphide.
disulphuric |Applied to an acid having in each molecule two atoms of sulphur in the higher state of oxidation. Disulphuric acid, a thick oily liquid, H2S2O7, called also Nordhausen acid (from Nordhausen in the Harts, where it was originally manufactured), fuming sulphuric acid, and especially pyrosulphuric acid. See under Pyrosulphuric.
disuniform |Not uniform. [Obs.]
disunion |1. The termination of union; separation; disjunction; as, the disunion of the body and the soul. 2. A breach of concord and its effect; alienation. Such a disunion between the two houses as might much clouClarendon. 3. The termination or disruption of the union of the States forming the United States. I have not accustomed myself to hang over the precipice of disunion. D. Webster.
disunionist |An advocate of disunion, specifically, of disunion of the United States.
disunite |1. To destroy the union of; to divide; to part; to sever; to disjoin; to sunder; to separate; as, to disunite particles of matter. 2. To alienate in spirit; to break the concord of. Go on both in hand, O nations, never be disunited, be the praise . . . of all posterity! Milton.\n\nTo part; to fall asunder; to become separated. The joints of the body politic do separate and disunite. South.
disuniter |One who, or that which, disjoins or causes disunion.
disunity |A state of separation or disunion; want of unity. Dr. H. More.
disusage |Gradual cessation of use or custom; neglect of use; disuse. [R.] Hooker.
disuse |1. To cease to use; to discontinue the practice of. 2. To disaccustom; -- with to or from; as, disused to toil. \"Disuse me from . . . pain.\" Donne.\n\nCessation of use, practice, or exercise; inusitation; desuetude; as, the limbs lose their strength by disuse. The disuse of the tongue in the only . . . remedy. Addison. Church discipline then fell into disuse. Southey.
disutilize |To deprive of utility; to render useless. [R.] Mrs. Browning.
disvaluation |Disesteem; depreciation; disrepute. Bacon.
disvalue |To undervalue; to depreciate. Shak.\n\nDisesteem; disregard. B. Jonson.
disvantageous |Disadvantageous. [Obs.] \"Disadvantageous ground.\" Drayton.
disvelop |To develop. [Obs.]
disventure |A disadventure. [Obs.] Shelton.
disvouch |To discredit; to contradict. [Obs.] Shak.
diswarn |To dissuade from by previous warning. [Obs.]
diswitted |Deprived of wits or understanding; distracted. [Obs.] Drayton.
diswont |To deprive of wonted usage; to disaccustom. [R.] Bp. Hall.
disworkmanship |Bad workmanship. [Obs.] Heywood.
disworship |To refuse to worship; to treat as unworthy. [Obs.] Sir T. More.\n\nA deprivation of honor; a cause of disgrace; a discredit. [Obs.] Milton.
disworth |To deprive of worth; to degrade. [Obs.] Feltham.
disyoke |To unyoke; to free from a yoke; to disjoin. [Poetic] R. Browning.
dit |1. A word; a decree. [Obs.] 2. A ditty; a song. [Obs.]\n\nTo close up. [Obs.] Dr. H. More.
ditation |The act of making rich; enrichment. [Obs.] Bp. Hall.
ditch |1. A trench made in the earth by digging, particularly a trench for draining wet land, for guarding or fencing inclosures, or for preventing an approach to a town or fortress. In the latter sense, it is called also a moat or a fosse. 2. Any long, narrow receptacle for water on the surface of the earth.\n\n1. To dig a ditch or ditches in; to drain by a ditch or ditches; as, to ditch moist land. 2. To surround with a ditch. Shak. 3. To throw into a ditch; as, the engine was ditched and turned on its side.\n\nTo dig a ditch or ditches. Swift.
ditcher |One who digs ditches.
dite |To prepare for action or use; to make ready; to dight. [Obs.] His hideous club aloft he dites. Spenser.
diterebene |See Colophene.
dithecal |Having two thecæ, cells, or compartments.
dithecous |Having two thecæ, cells, or compartments.
ditheism |The doctrine of those who maintain the existence of two gods or of two original principles (as in Manicheism), one good and one evil; dualism.
ditheist |One who holds the doctrine of ditheism; a dualist. Cudworth.
ditheistic |Pertaining to ditheism; dualistic.
ditheistical |Pertaining to ditheism; dualistic.
dithionic |Containing two equivalents of sulphur; as, dithionic acid. Dithionic acid (Chem.), an unstable substance, H2S2O6, known only in its solutions, and in certain well-defined salts.
dithyramb |A kind of lyric poetry in honor of Bacchus, usually sung by a band of revelers to a flute accompaniment; hence, in general, a poem written in a wild irregular strain. Bentley.
dithyrambic |Pertaining to, or resembling, a dithyramb; wild and boisterous. \"Dithyrambic sallies.\" Longfellow. -- n.  A dithyrambic poem; a dithyramb.
dithyrambus |See Dithyramb.
dition |Dominion; rule. [Obs.] Evelyn.
ditionary |Under rule; subject; tributary. [Obs.] Chapman.\n\nA subject; a tributary. [Obs.] Eden.
ditokous |(a) Having two kinds of young, as certain annelids. (b) Producing only two eggs for a clutch, as certain birds do.
ditolyl |A white, crystalline, aromatic hydrocarbon, C14H14, consisting of two radicals or residues of toluene.
ditone |The Greek major third, which comprehend two major tones (the modern major third contains one major and one minor whole tone).
ditrichotomous |1. Divided into twos or threes. 2. (Bot.)  Dividing into double or treble ramifications; -- said of a leaf or stem. [R.] Loudon.
ditrochean |Containing two trochees.
ditrochee |A double trochee; a foot made up of two trochees.
ditroite |An igneous rock composed of orthoclase, elæolite, and sodalite.
ditt |See Dit, n., 2. [Obs.] Spenser.
dittander |A kind of peppergrass (Lepidium latifolium).
dittany |(a) A plant of the Mint family (Origanum Dictamnus), a native of Crete. (b) The Dictamnus Fraxinella. See Dictamnus. (c) In America, the Cunila Mariana, a fragrant herb of the Mint family.
dittied |Set, sung, or composed as a ditty; -- usually in composition. Who, with his soft pipe, and smooth-dittied song. Milton.
ditto |The aforesaid thing; the same (as before). Often contracted to do., or to two \"turned commas\" (\"), or small marks. Used in bills, books of account, tables of names, etc., to save repetition. A spacious table in the center, and a variety of smaller dittos in the corners. Dickens.\n\nAs before, or aforesaid; in the same manner; also.
dittology |A double reading, or twofold interpretation, as of a Scripture text. [R.]
ditty |1. A saying or utterance; especially, one that is short and frequently repeated; a theme. O, too high ditty for my simple rhyme. Spenser. 2. A song; a lay; a little poem intended to be sung. \"Religious, martial, or civil ditties.\" Milton.ditties sing. Sandys.\n\nTo sing; to warble a little tune. Beasts fain would sing; birds ditty to their notes. Herbert.
ditty-bag |A sailor's small bag to hold thread, needles, tape, etc.; -- also called sailor's housewife.
ditty-box |A small box to hold a sailor's thread, needless, comb, etc.
diureide |One of a series of complex nitrogenous substances regarded as containing two molecules of urea or their radicals, as uric acid or allantoin. Cf. Ureide.
diuresis |Free excretion of urine.
diuretic |Tending to increase the secretion and discharge of urine. -- n.  A medicine with diuretic properties. Diuretic salt (Med.), potassium acetate; -- so called because of its diuretic properties.
diuretical |Diuretic. [Obs.] Boyle.
diureticalness |The quality of being diuretical; diuretic property.
diurna |A division of Lepidoptera, including the butterflies; -- so called because they fly only in the daytime.
diurnal |1. Relating to the daytime; belonging to the period of daylight, distinguished from the night; -- opposed to Ant: nocturnal; as, diurnal heat; diurnal hours. 2. Daily; recurring every day; performed in a day; going through its changes in a day; constituting the measure of a day; as, a diurnal fever; a diurnal task; diurnal aberration, or diurnal parallax; the diurnal revolution of the earth. Ere twice the horses of the sun shall bring Their fiery torcher his diurnal ring. Shak. 3. (Bot.)  Opening during the day, and closing at night; -- said of flowers or leaves. 4. (Zoöl.)  Active by day; -- applied especially to the eagles and hawks among raptorial birds, and to butterflies (Diurna) among insects. Diurnal aberration (Anat.), the aberration of light arising from the effect of the earth's rotation upon the apparent direction of motion of light. -- Diurnal arc, the arc described by the sun during the daytime or while above the horizon; hence, the arc described by the moon or a star from rising to setting. -- Diurnal circle, the apparent circle described by a celestial body in consequence of the earth's rotation. -- Diurnal motion of the earth, the motion of the earth upon its axis which is described in twentyfour hours. -- Diurnal motion of a heavenly body, that apparent motion of the heavenly body which is due to the earth's diurnal motion. -- Diurnal parallax. See under Parallax. -- Diurnal revolution of a planet, the motion of the planet upon its own axis which constitutes one complete revolution. Syn. -- See Daily.\n\n1. A daybook; a journal. [Obs.] Tatler. 2. (R. C. Ch.)  A small volume containing the daily service for the \"little hours,\" viz., prime, tierce, sext, nones, vespers, and compline. 3. (Zoöl.)  A diurnal bird or insect.
diurnalist |A journalist. [Obs.] Bp. Hall.
diurnally |Daily; every day.
diurnalness |The quality of being diurnal.
diurnation |1. Continuance during the day. [Obs.] 2. (Zoöl.)  The condition of sleeping or becoming dormant by day, as is the case of the bats.
diuturnal |Of long continuance; lasting. [R.] Milton.
diuturnity |Long duration; lastingness. [R.] Sir T. Browne.
diva |A prima donna.
divagation |A wandering about or going astray; digression. Let us be set down at Queen's Crawley without further divagation. Thackeray.
divalent |Having two units of combining power; bivalent. Cf. Valence.
divan |1. A book; esp., a collection of poems written by one author; as, the divan of Hafiz. [Persia] 2. In Turkey and other Oriental countries: A council of state; a royal court. Also used by the poets for a grand deliberative council or assembly. Pope. 3. A chief officer of state. [India] 4. A saloon or hall where a council is held, in Oriental countries, the state reception room in places, and in the houses of the richer citizens. Cushions on the floor or on benches are ranged round the room. 5. A cushioned seat, or a large, low sofa or couch; especially, one fixed to its place, and not movable. 6. A coffee and smoking saloon. [Colloq.]
divaricate |1. To part into two branches; to become bifid; to fork. 2. To diverge; to be divaricate. Woodward.\n\nTo divide into two branches; to cause to branch apart.\n\n1. Diverging; spreading asunder; widely diverging. 2. (Biol.)  Forking and diverging; widely diverging; as the branches of a tree, or as lines of sculpture, or color markings on animals, etc.
divaricately |With divarication.
divarication |1. A separation into two parts or branches; a forking; a divergence. 2. An ambiguity of meaning; a disagreement of difference in opinion. Sir T. Browne. 3. (Biol.)  A divergence of lines of color sculpture, or of fibers at different angles.
divaricator |One of the muscles which open the shell of brachiopods; a cardinal muscle. See Illust. of Brachiopoda.
divast |Devastated; laid waste. [Obs.]
dive |1. To plunge into water head foremost; to thrust the body under, or deeply into, water or other fluid. It is not that pearls fetch a high price because men have dived for them. Whately. Note: The colloquial form dove is common in the United States as an imperfect tense form. All [the walruses] dove down with a tremendous splash. Dr. Hayes. When closely pressed it [the loon] dove . . . and left the young bird sitting in the water. J. Burroughs. 2. Fig.: To plunge or to go deeply into any subject, question, business, etc.; to penetrate; to explore. South.\n\n1. To plunge (a person or thing) into water; to dip; to duck. [Obs.] Hooker. 2. To explore by diving; to plunge into. [R.] The Curtii bravely dived the gulf of fame. Denham. He dives the hollow, climbs the steeps. Emerson.\n\n1. A plunge headforemost into water, the act of one who dives, literally or figuratively. 2. A place of low resort. [Slang] The music halls and dives in the lower part of the city. J. Hawthorne.
divedapper |A water fowl; the didapper. See Dabchick.
divel |To rend apart. [Obs.] Sir T. Browne.
divellent |Drawing asunder. [R.]
divellicate |To pull in pieces. [Obs. or R.]
diver |1. One who, or that which, dives. Divers and fishers for pearls. Woodward. 2. Fig.: One who goes deeply into a subject, study, or business. \"A diver into causes.\" Sir H. Wotton. 3. (Zoöl.)  Any bird of certain genera, as Urinator (formerly Colymbus), or the allied genus Colymbus, or Podiceps, remarkable for their agility in diving. Note: The northern diver (Urinator imber) is the loon; the black diver or velvet scoter (Oidemia fusca) is a sea duck. See Loon, and Scoter.
diverb |A saying in which two members of the sentence are contrasted; an antithetical proverb. [Obs.] Italy, a paradise for horses, a hell for women, as the diverb goes. Burton.
diverberate |To strike or sound through. [R.] Davies (Holy Roode).
diverberation |A sounding through.
diverge |1. To extend from a common point in different directions; to tend from one point and recede from each other; to tend to spread apart; to turn aside or deviate (as from a given direction); -- opposed to converge; as, rays of light diverge as they proceed from the sun. 2. To differ from a typical form; to vary from a normal condition; to dissent from a creed or position generally held or taken.
divergement |Divergence.
divergence |1. A receding from each other in moving from a common center; the state of being divergent; as, an angle is made by the divergence of straight lines. Rays come to the eye in a state of divergency. 2. Disagreement; difference. Related with some divergence by other writers. Sir G. C. Lewis.
divergency |1. A receding from each other in moving from a common center; the state of being divergent; as, an angle is made by the divergence of straight lines. Rays come to the eye in a state of divergency. 2. Disagreement; difference. Related with some divergence by other writers. Sir G. C. Lewis.
divergent |1. Receding farther and farther from each other, as lines radiating from one point; deviating gradually from a given direction; -- opposed to convergent. 2. (Optics)  Causing divergence of rays; as, a divergent lens. 3. Fig.: Disagreeing from something given; differing; as, a divergent statement. Divergent series. (Math.) See Diverging series, under Diverging.
diverging |Tending in different directions from a common center; spreading apart; divergent. Diverging series (Math.), a series whose terms are larger as the series is extended; a series the sum of whose terms does not approach a finite limit when the series is extended indefinitely; -- opposed to a converging series.
divergingly |In a diverging manner.
divers |1. Different in kind or species; diverse. [Obs.] Every sect of them hath a divers posture. Bacon. Thou shalt not sow thy vineyard with divers seeds. Deut. xxii. 9. 2. Several; sundry; various; more than one, but not a great number; as, divers philosophers. Also used substantively or pronominally. Divers of Antonio's creditors. Shak. Note: Divers is now limited to the plural; as, divers ways (not divers way). Besides plurality it ordinarily implies variety of kind.
diverse |1. Different; unlike; dissimilar; distinct; separate. The word . . . is used in a sense very diverse from its original import. J. Edwards. Our roads are diverse: farewell, love! said she. R. Browning. 2. Capable of various forms; multiform. Eloquence is a great and diverse thing. B. Jonson.\n\nIn different directions; diversely.\n\nTo turn aside. [Obs.] The redcross knight diverst, but forth rode Britomart. Spenser.
diversely |1. In different ways; differently; variously. \"Diversely interpreted.\" Bacon. How diversely love doth his pageants play. Spenser. 2. In different directions; to different points. On life's vast ocean diversely we sail. Pope.
diverseness |The quality of being diverse.
diversifiability |The quality or capacity of being diversifiable. Earle.
diversifiable |Capable of being diversified or varied. Boyle.
diversification |1. The act of making various, or of changing form or quality. Boyle. 2. State of diversity or variation; variegation; modification; change; alternation. Infinite diversifications of tints may be produced. Adventurer.
diversified |Distinguished by various forms, or by a variety of aspects or objects; variegated; as, diversified scenery or landscape.
diversifier |One who, or that which, diversifies.
diversiform |Of a different form; of varied forms.
diversify |To make diverse or various in form or quality; to give variety to; to variegate; to distinguish by numerous differences or aspects. Separated and diversified on from another. Locke. Its seven colors, that diversify all the face of nature. I. Taylor.
diversiloquent |Speaking in different ways. [R.]
diversion |1. The act of turning aside from any course, occupation, or object; as, the diversion of a stream from its channel; diversion of the mind from business. 2. That which diverts; that which turns or draws the mind from care or study, and thus relaxes and amuses; sport; play; pastime; as, the diversions of youth. \"Public diversions.\" V. Knox. Such productions of wit and humor as expose vice and folly, furnish useful diversion to readers. Addison. 3. (Mil.)  The act of drawing the attention and force of an enemy from the point where the principal attack is to be made; the attack, alarm, or feint which diverts. Syn. -- Amusement; entertainment; pastime; recreation; sport; game; play; solace; merriment.
diversity |1. A state of difference; dissimilitude; unlikeness. They will prove opposite; and not resting in a bare diversity, rise into a contrariety. South. 2. Multiplicity of difference; multiformity; variety. \"Diversity of sounds.\" Shak. \"Diversities of opinion.\" Secker. 3. Variegation. \"Bright diversities of day.\" Pope. Syn. -- See Variety.
diversivolent |Desiring different things. [Obs.] Webster (White Devil).
diversory |Serving or tending to divert; also, distinguishing. [Obs.]\n\nA wayside inn. [Obs. or R.] Chapman.
divert |1. To turn aside; to turn off from any course or intended application; to deflect; as, to divert a river from its channel; to divert commerce from its usual course. That crude apple that diverted Eve. Milton. 2. To turn away from any occupation, business, or study; to cause to have lively and agreeable sensations; to amuse; to entertain; as, children are diverted with sports; men are diverted with works of wit and humor. We are amused by a tale, diverted by a comedy. C. J. Smith. Syn. -- To please; gratify; amuse; entertain; exhilarate; delight; recreate. See Amuse.\n\nTo turn aside; to digress. [Obs.] I diverted to see one of the prince's palaces. Evelyn.
diverter |One who, or that which, diverts, turns off, or pleases.
divertible |Capable of being diverted.
diverticle |1. A turning; a byway; a bypath. [Obs.] Hales. 2. (Anat.)  A diverticulum.
diverticular |Pertaining to a diverticulum.
diverticulum |A blind tube branching out of a longer one.
divertimento |) A light and pleasing composition.
diverting |Amusing; entertaining. -- Di*vert\"ing*ly, adv. -- Di*vert\"ing*ness, n.
divertise |To divert; to entertain. [Obs.] Dryden.
divertisement |Diversion; amusement; recreation. [R.]
divertissement |A short ballet, or other entertainment, between the acts of a play. Smart.
divertive |Tending to divert; diverting; amusing; interesting. Things of a pleasant and divertive nature. Rogers.
dives |The name popularly given to the rich man in our Lord's parable of the \"Rich Man and Lazarus\" (Luke xvi. 19-31). Hence, a name for a rich worldling.
divest |1. To unclothe; to strip, as of clothes, arms, or equipage; -- opposed to invest. 2. Fig.: To strip; to deprive; to dispossess; as, to divest one of his rights or privileges; to divest one's self of prejudices, passions, etc. Wretches divested of every moral feeling. Goldsmith. The tendency of the language to divest itself of its gutturals. Earle. 3. (Law)  See Devest. Mozley & W.
divestible |Capable of being divested.
divestiture |The act of stripping, or depriving; the state of being divested; the deprivation, or surrender, of possession of property, rights, etc.
