forestay |A large, strong rope, reaching from the foremast head to the bowsprit, to support the mast. See Illust. under Ship.
forester |1. One who has charge of the growing timber on an estate; an officer appointed to watch a forest and preserve the game. 2. An inhabitant of a forest. Wordsworth. 3. A forest tree. [R.] Evelyn. 4. (Zoöl.)  A lepidopterous insect belonging to Alypia and allied genera; as, the eight-spotted forester (A. octomaculata), which in the larval state is injurious to the grapevine.
forestick |Front stick of a hearth fire.
forestry |The art of forming or of cultivating forests; the management of growing timber.
foreswart |See Forswat.\n\nSee Forswat.
foretaste |A taste beforehand; enjoyment in advance; anticipation.\n\n1. To taste before full possession; to have previous enjoyment or experience of; to anticipate. 2. To taste before another. \"Foretasted fruit.\" Milton.
foretaster |One who tastes beforehand, or before another.
foreteach |To teach beforehand. [Obs.]
foretell |To predict; to tell before occurence; to prophesy; to foreshow. Deeds then undone my faithful tongue foretold. Pope. Prodigies, foretelling the future eminence and luster of his character. C. Middleton. Syn. -- To predict; prophesy; prognosticate; augur.\n\nTo utter predictions. Acts iii. 24.
foreteller |One who predicts. Boyle.
forethink |1. To think beforehand; to anticipate in the mind; to prognosticate. [Obs.] The soul of every man Prophetically doth forethink thy fall. Shak. 2. To contrive (something) beforehend. [Obs.] Bp. Hall.\n\nTo contrive beforehand. [Obs.]
forethought |Thought of, or planned, beforehand; aforethought; prepense; hence, deliberate. \"Forethought malice.\" Bacon.\n\nA thinking or planning beforehand; prescience; premeditation; forecast; provident care. A sphere that will demand from him forethought, courage, and wisdom. I. Taylor.
forethoughtful |Having forethought. [R.]
foretime |The past; the time before the present. \"A very dim foretime.\" J. C. Shairp.
foretoken |Prognostic; previous omen. Sir P. Sidney.\n\nTo foreshow; to presignify; to prognosticate. Whilst strange prodigious signs foretoken blood. Daniel.
foretop |1. The hair on the forepart of the head; esp., a tuft or lock of hair which hangs over the forehead, as of a horse. 2. That part of a headdress that is in front; the top of a periwig. 3. (Naut.)  The platform at the head of the foremast.
forever |1. Through eternity; through endless ages, eternally. 2. At all times; always. Note: In England, for and ever are usually written and printed as two separate words; but, in the United States, the general practice is to make but a single word of them. Forever and ever, an emphatic \"forever.\" Syn. -- Constantly; continually; invariably; unchangeably; incessantly; always; perpetually; unceasingly; ceaselessly; interminably; everlastingly; endlessly; eternally.
forevouched |Formerly vouched or avowed; affirmed in advance. [R.] Shak.
foreward |The van; the front. [Obs.] My foreward shall be drawn out all in length, Consisting equally of horse and foot. Shak.
forewarn |To warn beforehand; to give previous warning, admonition, information, or notice to; to caution in advance. We were forewarned of your coming. Shak.
forewaste |See Forewaste. Gascoigne.
forewend |To go before. [Obs.] Spenser.
forewish |To wish beforehand.
forewit |1. A leader, or would-be leader, in matters of knowledge or taste. [Obs.] Nor that the forewits, that would draw the rest unto their liking, always like the best. B. Jonson. 2. Foresight; prudence. Let this forewit guide thy thought. Southwell.
forewite |To foreknow. [Obs.] [Written also forwete.] Chaucer.
forewoman |A woman who is chief; a woman who has charge of the work or workers in a shop or other place; a head woman. Tatler. W. Besant.
foreword |A preface. Furnvall.
foreworn |Worn out; wasted; used up. [Archaic] Old foreworn stories almost forgotten. Brydges.
forewot |, 1st & 3d pers. sing. of Forewite. [Obs.] Chaucer.
foreyard |The lowermost yard on the foremast. Note: [See Illust. of Ship.]
forfalture |Forfeiture. [Obs.]
forfeit |1. Injury; wrong; mischief. [Obs. & R.] To seek arms upon people and country that never did us any forfeit. Ld. Berners. 2. A thing forfeit or forfeited; what is or may be taken from one in requital of a misdeed committed; that which is lost, or the right to which is alienated, by a crime, offense, neglect of duty, or breach of contract; hence, a fine; a mulct; a penalty; as, he who murders pays the forfeit of his life. Thy slanders I forgive; and therewithal Remit thy other forfeits. Shak. 3. Something deposited and redeemable by a sportive fine; -- whence the game of forfeits. Country dances and forfeits shortened the rest of the day. Goldsmith.\n\nLost or alienated for an offense or crime; liable to penal seizure. Thy wealth being forfeit to the state. Shak. To tread the forfeit paradise. Emerson.\n\nTo lose, or lose the right to, by some error, fault, offense, or crime; to render one's self by misdeed liable to be deprived of; to alienate the right to possess, by some neglect or crime; as, to forfeit an estate by treason; to forfeit reputation by a breach of promise; -- with to before the one acquiring what is forfeited. [They] had forfeited their property by their crimes. Burke. Undone and forfeited to cares forever! Shak.\n\n1. To be guilty of a misdeed; to be criminal; to transgress. [Obs.] 2. To fail to keep an obligation. [Obs.] I will have the heart of him if he forfeit. Shak.\n\nIn the condition of being forfeited; subject to alienation. Shak. Once more I will renew His lapsèd powers, though forfeite. Milton.
forfeitable |Liable to be forfeited; subject to forfeiture. For the future, uses shall be subject to the statutes of mortmain, and forfeitable, like the lands themselves. Blackstone.
forfeiter |One who incurs a penalty of forfeiture.
forfeiture |1. The act of forfeiting; the loss of some right, privilege, estate, honor, office, or effects, by an offense, crime, breach of condition, or other act. Under pain of foreiture of the said goods. Hakluyt. 2. That which is forfeited; a penalty; a fine or mulct. What should I gain By the exaction of the forfeiture Shak. Syn. -- Fine; mulct; amercement; penalty.
forfend |To prohibit; to forbid; to avert. [Archaic] Which peril heaven forefend! Shak. Note: This is etymologically the preferable spelling.
forfered |Excessively alarmed; in great fear. [Obs.] \"Forfered of his death.\" Chaucer.
forfete |To incur a penalty; to transgress. [Obs.] And all this suffered our Lord Jesus Christ that never forfeted. Chaucer.
forfex |A pair of shears. Pope.
forficate |Deeply forked, as the tail of certain birds.
forficula |A genus of insects including the earwigs. See Earwig, 1.
forgather |To convene; to gossip; to meet accidentally. [Scot.] Jamieson. Within that circle he forgathered with many a fool. Wilson.
forgave |imp. of Forgive.
forge |1. A place or establishment where iron or other metals are wrought by heating and hammering; especially, a furnace, or a shop with its furnace, etc., where iron is heated and wrought; a smithy. In the quick forge and working house of thought. Shak. 2. The works where wrought iron is produced directly from the ore, or where iron is rendered malleable by puddling and shingling; a shingling mill. 3. The act of beating or working iron or steel; the manufacture of metalic bodies. [Obs.] In the greater bodies the forge was easy. Bacon. American forge, a forge for the direct production of wrought iron, differing from the old Catalan forge mainly in using finely crushed ore and working continuously. Raymond. -- Catalan forge. (Metal.) See under Catalan. -- Forge cinder, the dross or slag form a forge or bloomary. -- Forge rolls, Forge train, the train of rolls by which a bloom is converted into puddle bars. -- Forge wagon (Mil.), a wagon fitted up for transporting a blackmith's forge and tools. -- Portable forge, a light and compact blacksmith's forge, with bellows, etc., that may be moved from place to place.\n\n1. To form by heating and hammering; to beat into any particular shape, as a metal. Mars's armor forged for proof eterne. Shak. 2. To form or shape out in any way; to produce; to frame; to invent. Those names that the schools forged, and put into the mouth of scholars, could never get admittance into common use. Locke. Do forge a life-long trouble for ourselves. Tennyson. 3. To coin. [Obs.] Chaucer. 4. To make falsely; to produce, as that which is untrue or not genuine; to fabricate; to counterfeit, as, a signature, or a signed document. That paltry story is untrue, And forged to cheat such gulls as you. Hudibras. Forged certificates of his . . . moral character. Macaulay. Syn. -- To fabricate; counterfeit; feign; falsify.\n\n1. To commit forgery. 2. (Naut.)  To move heavily and slowly, as a ship after the sails are furled; to work one's way, as one ship in outsailing another; -- used especially in the phrase to forge ahead. Totten. And off she [a ship] forged without a shock. De Quincey.\n\nTo impel forward slowly; as, to forge a ship forward.
forgeman |A skilled smith, who has a hammerer to assist him.
forger |One who forges, makes, of forms; a fabricator; a falsifier. 2. Especially: One guilty of forgery; one who makes or issues a counterfeit document.
forgery |1. The act of forging metal into shape. [Obs.] Useless the forgery Of brazen shield and spear. Milton. 2. The act of forging, fabricating, or producing falsely; esp., the crime of fraudulently making or altering a writing or signature purporting to be made by another; the false making or material alteration of or addition to a written instrument for the purpose of deceit and fraud; as, the forgery of a bond. Bouvier. 3. That which is forged, fabricated, falsely devised, or counterfeited. These are the forgeries of jealously. Shak. The writings going under the name of Aristobulus were a forgery of the second century. Waterland. Syn. -- Counterfeit; Forgery. Counterfeit is chiefly used of imitations of coin, or of paper money, or of securities depending upon pictorial devices and engraved designs for identity or assurance of genuineness. Forgery is more properly applied to making a false imitation of an instrument depending on signatures to show genuineness and validity. Abbott.
forget |1. To lose the remembrance of; to let go from the memory; to cease to have in mind; not to think of; also, to lose the power of; to cease from doing. Bless the Lord, O my soul, and forget not all his benefits. Ps. ciii. 2. Let y right hand forget her cunning. Ps. cxxxvii. 5. Hath thy knee forget to bow Shak. 2. To treat with inattention or disregard; to slight; to neglect. Can a woman forget her sucking child . . . Yes, they may forget, yet will I not forget thee. Is. xlix. 15. To forget one's self. (a) To become unmindful of one's own personality; to be lost in thought. (b) To be entirely unselfish. (c) To be guilty of what is unworthy of one; to lose one's dignity, temper, or self-control.
forget-me-not |A small herb, of the genus Myosotis (M. palustris, incespitosa, etc.), bearing a beautiful blue flower, and extensively considered the emblem of fidelity. Note: Formerly the name was given to the Ajuga Chamæpitus.
forgetful |1. Apt to forget; easily losing remembrance; as, a forgetful man should use helps to strengthen his memory. 2. Heedless; careless; neglectful; inattentive. Be not forgetful to entertain strangers. Heb. xiii. 2. 3. Causing to forget; inducing oblivion; oblivious. [Archaic or Poetic] \"The forgetful wine.\" J. Webster.
forgetfully |In a forgetful manner.
forgetfulness |1. The quality of being forgetful; prononess to let slip from the mind. 2. Loss of remembrance or recollection; a ceasing to remember; oblivion. A sweet forgetfulness of human care. Pope. 3. Failure to bear in mind; careless omission; inattention; as, forgetfulness of duty. Syn. -- Forgetfulnes, Oblivion. Forgetfulness is Anglo-Saxon, and oblivion is Latin. The former commonly has reference to persons, and marks a state of mind, and marks a state of mind; the latter commonly has reference to things, and indicates a condition into which they are sunk. We blame a man for his forgetfulness; we speak of some old custom as buried in oblivion. But this discrimination is not strictly adhered to.
forgetive |Inventive; productive; capable. [Obs.] Shak.
forgettable |Liable to be, or that may be, forgotten. Carlyle.
forgetter |One who forgets; a heedless person. Johnson.
forgettingly |By forgetting.
forging |1. The act of shaping metal by hammering or pressing. 2. The act of counterfeiting. 3. (Mach.)  A piece of forged work in metal; -- a general name for a piece of hammered iron or steel. There are very few yards in the world at which such forgings could be turned out. London Times.
forgivable |Capable of being forgiven; pardonable; venial. Sherwood.
forgive |1. To give wholly; to make over without reservation; to resign. To them that list the world's gay shows I leave, And to great ones such folly do forgive. Spenser. 2. To give up resentment or claim to requital on account of (an offense or wrong); to remit the penalty of; to pardon; -- said in reference to the act forgiven. And their sins should be forgiven them. Mark iv. 12. He forgive injures so readily that he might be said to invite them. Macaulay. 3. To cease to feel resentment against, on account of wrong committed; to give up claim to requital from or retribution upon (an offender); to absolve; to pardon; -- said of the person offending. Father, forgive them; for they know not what they do. Luke xxiii. 34. I as free forgive you, as I would be fforgiven. Shak. Note: Sometimes both the person and the offense follow as objects of the verb, sometimes one and sometimes the other being the indirect object. \"Forgive us our debts as we forgive our debtors.\" Matt. vi. 12. \"Be of good cheer; thy sins be forgiven thee.\" Matt. ix. 2. Syn. -- See excuse.
forgiveness |1. The act of forgiving; the state of being forgiven; as, the forgiveness of sin or of injuries. To the Lord our God belong mercies and forgivenesses. Dan. ix. 9. In whom we have . . . the forgiveness of sin. Eph. i. 7. 2. Disposition to pardon; willingness to forgive. If thou, Lord, shouldest mark iniquities, O Lord, who shall stand But there is forgiveness with thee, that thou mayest be feared. Ps. cxxx. 3, 4.
forgiver |One who forgives. Johnson.
forgiving |Disposed to forgive; inclined to overlook offenses; mild; merciful; compassionate; placable; as, a forgiving temper. -- For*giv\"ing*ly, adv. -- For*giv\"ing*ness, n. J. C. Shairp.
forgo |To pass by; to leave. See 1st Forego. For sith [since] I shall forgoon my liberty At your request. Chaucer. And four [days] since Florimell the court forwent. Spenser. Note: This word in spelling has been confused with, and almost superseded by, forego to go before. Etymologically the form forgo is correct.
forgot |imp. & p. p. of Forget.
forgotten |p. p. of Forget.
forhall |To harass; to torment; to distress. [Obs.] Spenser.
forhend |To seize upon. [Obs.]
forinsecal |Foreign; alien. [Obs.] Bp. Burnet.
forisfamiliate |Literally, to put out of a family; hence, to portion off, so as to exclude further claim of inheritance; to emancipate (as a with his own consent) from paternal authority. Blackstone.\n\nTo renounce a legal title to a further share of paternal inheritance.
forisfamiliation |The act of forisfamiliating.
fork |1. An instrument consisting consisting of a handle with a shank terminating in two or more prongs or tines, which are usually of metal, parallel and slightly curved; -- used from piercing, holding, taking up, or pitching anything. 2. Anything furcate or like of a fork in shape, or furcate at the extremity; as, a tuning fork. 3. One of the parts into which anything is furcated or divided; a prong; a branch of a stream, a road, etc.; a barbed point, as of an arrow. Let it fall . . . though the fork invade The region of my heart. Shak. A thunderbolt with three forks. Addison. 4. The place where a division or a union occurs; the angle or opening between two branches or limbs; as, the fork of a river, a tree, or a road. 5. The gibbet. [Obs.] Bp. Butler. Fork beam (Shipbuilding), a half beam to support a deck, where hatchways occur. -- Fork chuck (Wood Turning), a lathe center having two prongs for driving the work. -- Fork head. (a) The barbed head of an arrow. (b) The forked end of a rod which forms part of a knuckle joint. -- In fork. (Mining) A mine is said to be in fork, or an engine to \"have the water in fork,\" when all the water is drawn out of the mine. Ure. -- The forks of a river or a road, the branches into which it divides, or which come together to form it; the place where separation or union takes place.\n\n1. To shoot into blades, as corn. The corn beginneth to fork. Mortimer. 1 2. To divide into two or more branches; as, a road, a tree, or a stream forks.\n\nTo raise, or pitch with a fork, as hay; to dig or turn over with a fork, as the soil. Forking the sheaves on the high-laden cart. Prof. Wilson. To fork over or out, to hand or pay over, as money. [Slang] G. Eliot.
fork-tailed |Having the outer tail feathers longer than the median ones; swallow-tailed; -- said of many birds. Fork-tailed flycatcher (Zoöl.), a tropical American flycatcher (Milvulus tyrannus). -- Fork-tailed gull (Zoöl.), a gull of the genus Xema, of two species, esp. X. Sabinii of the Arctic Ocean. -- Fork-tailed kite (Zoöl.), a graceful American kite (Elanoides forficatus); -- called also swallow-tailed kite.
forkbeard |(a) A European fish (Raniceps raninus), having a large flat head; -- also called tadpole fish, and lesser forked beard. (b) The European forked hake or hake's-dame (Phycis blennoides); -- also called great forked beard.
forked |1. Formed into a forklike shape; having a fork; dividing into two or more prongs or branches; furcated; bifurcated; zigzag; as, the forked lighting. A serpent seen, with forked tongue. Shak. 2. Having a double meaning; ambiguous; equivocal. Cross forked (Her.), a cross, the ends of whose arms are divided into two sharp points; -- called also cross double fitché. A cross forked of three points is a cross, each of whose arms terminates in three sharp points. -- Forked counsel, advice pointing more than one way; ambiguous advice. [Obs.] B. Jonson. -- Fork\"ed*ly, adv. -- Fork\"ed*ness, n.
forkerve |See Forcarve, v. t.
forkiness |The quality or state or dividing in a forklike manner.
forkless |Having no fork.
forktail |(a) One of several Asiatic and East Indian passerine birds, belonging to Enucurus, and allied genera. The tail is deeply forking. (b) A salmon in its fourth year's growth. [Prov. Eng.]
forky |Opening into two or more parts or shoots; forked; furcated. \"Forky tongues.\" Pope.
forlaft |p. p. of Forleave. Chaucer.
forlay |To lie in wait for; to ambush. An ambushed thief forlays a traveler. Dryden.
forleave |To leave off wholly. [Obs.] Chaucer.
forlend |To give up wholly. [Obs.]
forlese |To lose utterly. [Obs.] haucer.
forlet |To give up; to leave; to abandon. [Obs.] \"To forlet sin.\" Chaucer.
forlie |See Forlie.
forlore |oForlese. [Obs.] The beasts their caves, the birds their neforlore. Fairfax.
forlorn |1. Deserted abandoned; lost. Of fortune and of hope at once forlorn. Spenser. Some say that ravens foster forlorn children. Shak. 2. Destitute; helpless; in pitiful plight; wretched; miserable; almost hopeless; desperate. For here forlorn and lost I tread. Goldsmith. The condition of the besieged in the mean time was forlorn in the extreme. Prescott. She cherished the forlorn hope that he was still living. Thomson. A forlorn hope Etym: [D. verloren hoop, prop., a lost band or troop; verloren, p.p. of verliezen to lose + hoop band; akin to E. heap. See For-, and Heap.] (Mil.), a body of men (called in F. enfants perdus, in G. verloren posten) selected, usually from volunteers, to attempt a breach, scale the wall of a fortress, or perform other extraordinarily perilous service; also, a desperate case or enterprise. Syn. -- Destitute, lost; abandoned; forsaken; solitary; helpless; friendless; hopeless; abject; wretched; miserable; pitiable.\n\n1. A lost, forsaken, or solitary person. Forced to live in Scotland a forlorn. Shak. 2. A forlorn hope; a vanguard. [Obs.] Our forlorn of horse marched within a mile of the enemy. Oliver Cromvell.
forlornly |In a forlorn manner. Pollok.
forlornness |State of being forlorn. Boyle.
forlye |Same as Forlie. [Obs.]
form |A suffix used to denote in the form or shape of, resembling, etc.; as, valiform; oviform.\n\n1. The shape and structure of anything, as distinguished from the material of which it is composed; particular disposition or arrangement of matter, giving it individuality or distinctive character; configuration; figure; external appearance. The form of his visage was changed. Dan. iii. 19. And woven close close, both matter, form, and style. Milton. 2. Constitution; mode of construction, organization, etc.; system; as, a republican form of government. 3. Established method of expression or practice; fixed way of proceeding; conventional or stated scheme; formula; as, a form of prayer. Those whom form of laws Condemned to die. Dryden. 4. Show without substance; empty, outside appearance; vain, trivial, or conventional ceremony; conventionality; formality; as, a matter of mere form. Though well we may not pass upon his life Without the form of justice. Shak. 5. Orderly arrangement; shapeliness; also, comeliness; elegance; beauty. The earth was without form and void. Gen. i. 2. He hath no form nor comeliness. Is. liii. 2. 6. A shape; an image; a phantom. 7. That by which shape is given or determined; mold; pattern; model. 8. A long seat; a bench; hence, a rank of students in a school; a class; also, a class or rank in society. \"Ladies of a high form.\" Bp. Burnet. 9. The seat or bed of a hare. As in a form sitteth a weary hare. Chaucer. 10. (Print.)  The type or other matter from which an impression is to be taken, arranged and secured in a chase. 11. (Fine Arts)  The boundary line of a material object. In painting, more generally, the human body. 12. (Gram.)  The particular shape or structure of a word or part of speech; as, participial forms; verbal forms. 13. (Crystallog.)  The combination of planes included under a general crystallographic symbol. It is not necessarily a closed solid. 14. (Metaph.)  That assemblage or disposition of qualities which makes a conception, or that internal constitution which makes an existing thing to be what it is; -- called essential or substantial form, and contradistinguished from matter; hence, active or formative nature; law of being or activity; subjectively viewed, an idea; objectively, a law. 15. Mode of acting or manifestation to the senses, or the intellect; as, water assumes the form of ice or snow. In modern usage, the elements of a conception furnished by the mind's own activity, as contrasted with its object or condition, which is called the matter; subjectively, a mode of apprehension or belief conceived as dependent on the constitution of the mind; objectively, universal and necessary accompaniments or elements of every object known or thought of. 16. (Biol.)  The peculiar characteristics of an organism as a type of others; also, the structure of the parts of an animal or plant. Good form or Bad form, the general appearance, condition or action, originally of horses, atterwards of persons; as, the members of a boat crew are said to be in good form when they pull together uniformly. The phrases are further used colloquially in description of conduct or manners in society; as, it is not good form to smoke in the presence of a lady.\n\n1. To give form or shape to; to frame; to construct; to make; to fashion. God formed man of the dust of the ground. Gen. ii. 7. The thought that labors in my forming brain. Rowe. 2. To give a particular shape to; to shape, mold, or fashion into a certain state or condition; to arrange; to adjust; also, to model by instruction and discipline; to mold by influence, etc.; to train. 'T is education forms the common mind. Pope. Thus formed for speed, he challenges the wind. Dryden. 3. To go to make up; to act as constituent of; to be the essential or constitutive elements of; to answer for; to make the shape of; -- said of that out of which anything is formed or constituted, in whole or in part. The diplomatic politicians . . . who formed by far the majority. Burke. 4. To provide with a form, as a hare. See Form, n., 9. The melancholy hare is formed in brakes and briers. Drayton. 5. (Gram.)  To derive by grammatical rules, as by adding the proper suffixes and affixes.\n\n1. To take a form, definite shape, or arrangement; as, the infantry should form in column. 2. To run to a form, as a hare. B. Jonson. To form on (Mil.), to form a lengthened line with reference to (any given object) as a basis.
formal |1. Belonging to the form, shape, frame, external appearance, or organization of a thing. 2. Belonging to the constitution of a thing, as distinguished from the matter composing it; having the power of making a thing what it is; constituent; essential; pertaining to oe depending on the forms, so called of the human intellect. Of [the sounds represented by] letters, the material part is breath and voice; the formal is constituted by the motion and figure of the organs of speech. Holder. 3. Done is due form, or with solemnity; according to regular method; not incidental, sudden or irregular; express; as, he gave his formal consent. His obscure funeral . . . No noble rite nor formal ostentation. Shak. 4. Devoted to, or done in accordance with, forms or rules; punctilious; regular; orderly; methodical; of a prescribed form; exact; prim; stiff; ceremonious; as, a man formal in his dress, his gait, his conversation. A cold-looking, formal garden, cut into angles and rhomboids. W. Irwing. She took off the formal cap that confined her hair. Hawthorne. 5. Having the form or appearance without the substance or essence; external; as, formal duty; formal worship; formal courtesy, etc. 6. Dependent in form; conventional. Still in constraint your suffering sex remains, Or bound in formal or in real chains. Pope. 7. Sound; normal. [Obs.] To make of him a formal man again. Shak. Formal cause. See under Cause. Syn. -- Precise; punctilious; stiff; starched; affected; ritual; ceremonial; external; outward. -- Formal, Ceremonious. When applied to things, these words usually denote a mere accordance with the rules of form or ceremony; as, to make a formal call; to take a ceremonious leave. When applied to a person or his manners, they are used in a bad sense; a person being called formal who shapes himself too much by some pattern or set form, and ceremonious when he lays too much stress on the conventional laws of social intercourse. Formal manners render a man stiff or ridiculous; a ceremonious carriage puts a stop to the ease and freedom of social intercourse.
formaldehyde |A colorless, volatile liquid, H2CO, resembling acetic or ethyl aldehyde, and chemically intermediate between methyl alcohol and formic acid.
formalin |An aqueous solution of formaldehyde, used as a preservative in museums and as a disinfectant.
formalism |The practice or the doctrine of strict adherence to, or dependence on, external forms, esp. in matters of religion. Official formalism. Sir H. Rawlinson.
formalist |One overattentive to forms, or too much confined to them; esp., one who rests in external religious forms, or observes strictly the outward forms of worship, without possessing the life and spirit of religion. As far a formalist from wisdom sits, In judging eyes, as libertines from wits. Young.
formality |1. The condition or quality of being formal, strictly ceremonious, precise, etc. 2. Form without substance. Such [books] as are mere pieces of formality, so that if you look on them, you look though them. Fuller. 3. Compliance with formal or conventional rules; ceremony; conventionality. Nor was his attendance on divine offices a matter of formality and custom, but of conscience. Atterbury. 4. An established order; conventional rule of procedure; usual method; habitual mode. He was installed with all the usual formalities. C. Middleton. 5. pl.  The dress prescribed for any body of men, academical, municipal, or sacerdotal. [Obs.] The doctors attending her in their formalities as far as Shotover. Fuller. 6. That which is formal; the formal part. It unties the inward knot of marriage, . . . while it aims to keep fast the outward formality. Milton. 7. The quality which makes a thing what it is; essence. The material part of the evil came from our father upon us, but the formality of it, the sting and the curse, is only by ourselves. Jer. Taylor. The formality of the vow lies in the promise made to God. Bp. Stillingfleet. 8. (Scholastic. Philos.)  The manner in which a thing is conceived or constituted by an act of human thinking; the result of such an act; as, animality and rationality are formalities.
formalize |1. To give form, or a certain form, to; to model. [R.] 2. To render formal.\n\nTo affect formality. [Obs.] ales.
formally |In a formal manner; essentially; characteristically; expressly; regularly; ceremoniously; precisely. That which formally makes this [charity] a Christian grace, is the spring from which it flows. Smalridge. You and your followers do stand formally divided against the authorized guides of the church and rest of the people. Hooker.
format |The shape and size of a book; hence, its external form. The older manuscripts had been written in a much larger format than that found convenient for university work. G. H. Putnam. One might, indeed, protest that the format is a little too luxurious. Nature.
formate |A salt of formic acid. [Written also formiate.]
formation |1. The act of giving form or shape to anything; a forming; a shaping. Beattie. 2. The manner in which a thing is formed; structure; construction; conformation; form; as, the peculiar formation of the heart. 3. A substance formed or deposited. 4. (Geol.) (a) Mineral deposits and rock masses designated with reference to their origin; as, the siliceous formation about geysers; alluvial formations; marine formations. (b) A group of beds of the same age or period; as, the Eocene formation. 5. (Mil.)  The arrangement of a body of troops, as in a square, column, etc. Farrow.
formative |1. Giving form; having the power of giving form; plastic; as, the formative arts. The meanest plant can not be raised without seed, by any formative residing in the soil. Bentley. 2. (Gram.)  Serving to form; derivative; not radical; as, a termination merely formative. 3. (Biol.)  Capable of growth and development; germinal; as, living or formative matter.\n\n(a) That which serves merely to give form, and is no part of the radical, as the prefix or the termination of a word. (b) A word formed in accordance with some rule or usage, as from a root.
forme |Same as Paté or Patté.\n\nFirst. [Obs.] \"Adam our forme father.\" Chaucer.
formed |1. (Astron.)  Arranged, as stars in a constellation; as, formed stars. [R.] 2. (Biol.)  Having structure; capable of growth and development; organized; as, the formed or organized ferments. See Ferment, n. Formed material (Biol.), a term employed by Beale to denote the lifeless matter of a cell, that which is physiologically dead, in distinction from the truly germinal or living matter.
formedon |A writ of right for a tenant in tail in case of a discontinuance of the estate tail. This writ has been abolished.
formell |The female of a hawk or falcon.
former |1. One who forms; a maker; a creator. 2. (Mech.) (a) A shape around which an article is to be shaped, molded, woven wrapped, pasted, or otherwise constructed. (b) A templet, pattern, or gauge by which an article is shaped. (c) A cutting die.\n\n1. Preceding in order of time; antecedent; previous; prior; earlier; hence, ancient; long past. For inquire, I pray thee, of the former age. Job. viii. 8. The latter and former rain. Hosea vi. 3. 3. Near the beginning; preceeding; as, the former part of a discourse or argument. 3. Earlier, as between two things mentioned together; first mentioned. A bad author deserves better usage than a bad critic; a man may be the former merely through the misfortune of an ill judgment; but he can not be latter without both that and an ill temper. Pope. Syn. -- Prior; previous; anterior; antecedent; preceding; foregoing.
formeret |One of the half ribs against the walls in a ceiling vaulted with ribs.
formerly |In time past, either in time immediately preceding or at any indefinite distance; of old; heretofore.
formful |Creative; imaginative. [R.] \"The formful brain.\" Thomson.
formic |Pertaining to, or derived from, ants; as, formic acid; in an extended sense, pertaining to, or derived from, formic acid; as, formic ether. Amido formic acid, carbamic acid. -- Formic acid, a colorless, mobile liquid, HCO.OH, of a sharp, acid taste, occurring naturally in ants, nettles, pine needles, etc., and produced artifically in many ways, as by the oxidation of methyl alcohol, by the reduction of carbonic acid or the destructive distillation of oxalic acid. It is the first member of the fatty acids in the paraffin series, and is homologous with acetic acid.
formica |A Linnæan genus of hymenopterous insects, including the common ants. See Ant.
formicaroid |Like or pertaining to the family Formicaridæ or ant thrushes.
formicary |The nest or dwelling of a swarm of ants; an ant-hill.
formicate |Resembling, or pertaining to, an ant or ants.
formication |A sensation resembling that made by the creeping of ants on the skin. Dunglison.
formicid |Pertaining to the ants. -- n.  One of the family Formicidæ, or ants.
formidability |Formidableness. Walpole.
formidable |Exciting fear or apprehension; impressing dread; adapted to excite fear and deter from approach, encounter, or undertaking; alarming. They seemed to fear the formodable sight. Dryden. I swell my preface into a volume, and make it formidable, when you see so many pages behind. Drydn. Syn. -- Dreadful; fearful; terrible; frightful; shocking; horrible; terrific; tremendous.
formidableness |The quality of being formidable, or adapted to excite dread. Boyle.
formidably |In a formidable manner.
formidolose |Very much afraid. [Obs.] Bailey.
forming |The act or process of giving form or shape to anything; as, in shipbuilding, the exact shaping of partially shaped timbers.
formless |Shapeless; without a determinate form; wanting regularity of shape. -- Form\"less*ly, adv. -- Form\"less*ness, n.
formula |1. A prescribed or set form; an established rule; a fixed or conventional method in which anything is to be done, arranged, or said. 2. (Eccl.)  A written confession of faith; a formal statement of foctrines. 3. (Math.)  A rule or principle expressed in algebraic language; as, the binominal formula. 4. (Med.)  A prescription or recipe for the preparation of a medicinal compound. 5. (Chem.)  A symbolic expression (by means of letters, figures, etc.) of the constituents or constitution of a compound. Note: Chemical formulæ consist of the abbreviations of the names of the elements, with a small figure at the lower right hand, to denote the number of atoms of each element contained. Empirical formula (Chem.), an expression which gives the simple proportion of the constituents; as, the empirical formula of acetic acid is C2H4O2. -- Graphic formula, Rational formula (Chem.), an expression of the constitution, and in a limited sense of the structure, of a compound, by the grouping of its atoms or radicals; as, a rational formula of acetic acid is CH3.(C:O).OH; -- called also structural formula, constitutional formula, etc. See also the formula of Benzene nucleus, under Benzene. -- Molecular formula (Chem.), a formula indicating the supposed molecular constitution of a compound.
formularistic |Pertaining to, or exhibiting, formularization. Emerson.
formularization |The act of formularizing; a formularized or formulated statement or exhibition. C. Kingsley.
formularize |To reduce to a forula; to formulate.
formulary |Stated; prescribed; ritual.\n\n1. A book containing stated and prescribed forms, as of oaths, declarations, prayers, medical formulaæ, etc.; a book of precedents. 2. Prescribed form or model; formula.
formulate |To reduce to, or express in, a formula; to put in a clear and definite form of statement or expression. G. P. Marsh.
formulation |The act, process, or result of formulating or reducing to a formula.
formule |A set or prescribed model; a formula. [Obs.] Johnson.
formulization |The act or process of reducing to a formula; the state of being formulized.
formulize |To reduce to a formula; to formulate. Emerson.
formyl |(a) A univalent radical, H.C:O, regarded as the essential residue of formic acid and aldehyde. (b) Formerly, the radical methyl, CH3.
forncast |Predestined. [Obs.] Chaucer.
fornical |Relating to a fornix.
fornicate |1. Vaulted like an oven or furnace; arched. 2. (Bot.)  Arching over; overarched. Gray.\n\nTo commit fornication; to have unlawful sexual intercourse.
fornicated |1. Vaulted like an oven or furnace; arched. 2. (Bot.)  Arching over; overarched. Gray.
fornication |1. Unlawful sexual intercourse on the part of an unmarried person; the act of such illicit sexual intercourse between a man and a woman as does not by law amount to adultery. Note: In England, the offense, though cognizable in the ecclesiastical courts, was not at common law subject to secular prosecution. In the United States it is indictable in some States at common law, in others only by statute. Whartyon. 2. (Script.) (a) Adultery. (b) Incest. (c) Idolatry.
fornicator |An unmarried person, male or female, who has criminal intercourse with the other sex; one guilty of fornication.
fornicatress |A woman guilty of fornication. Shak.
fornix |(a) An arch or fold; as, the fornix, or vault, of the cranium; the fornix, or reflection, of the conjuctiva. (b) Esp., two longitudinal bands of white nervous tissue beneath the lateral ventricles of the brain.
forold |Very old. [Obs.] A bear's skin, coal-black, forold. Chaucer.
forpass |To pass by or along; to pass over. [Obs.] Spenser.
forpine |To waste away completely by suffering or torment. [Archaic] \"Pale as a forpined ghost.\" Chaucer.
forray |To foray; to ravage; to pillage. For they that morn had forrayed all the land. Fairfax.\n\nThe act of ravaging; a ravaging; a predatory excursion. See Foray.
forrill |Lambskin parchment; vellum; forel. McElrath.
forsake |1. To quit or leave entirely; to desert; to abandon; to depart or withdraw from; to leave; as, false friends and flatterers forsake us in adversity. If his children forsake my law, and walk not in my judgments. Ps. lxxxix. 30. 2. To renounce; to reject; to refuse. If you forsake the offer of their love. Shak. Syn. -- To abandon; quit; desert; fail; relinquish; give up; renounce; reject. See Abandon.
forsaker |One who forsakes or deserts.
forsay |To forbid; to renounce; to forsake; to deny. [Obs.] Spenser.
forshape |To render misshapen. [Obs.] Gower.
forslack |To neglect by idleness; to delay or to waste by sloth. [Obs.] Spenser.
forslouthe |To lose by sloth or negligence. [Obs.] Chaucer.
forslow |To delay; to hinder; to neglect; to put off. [Obs.] Bacon.\n\nTo loiter. [Obs.] Shak.
forslugge |To lsoe by idleness or slotch. [Obs.] Chaucer.
forsooth |In truth; in fact; certainly; very well; -- formerly used as an expression of deference or respect, especially to woman; now used ironically or contemptuously. A fit man, forsooth, to govern a realm! Hayward. Our old English word forsooth has been changed for the French madam. Guardian.\n\nTo address respectfully with the term forsooth. [Obs.] The captain of the \"Charles\" had forsoothed her, though he knew her well enough and she him. Pepys.\n\nA person who used forsooth much; a very ceremonious and deferential person. [R.] You sip so like a forsooth of the city. B. Jonson.
forspeak |1. To forbid; to prohibit. Shak. 2. To bewitch. [Obs.] Drayton.
forspent |Wasted in strength; tired; exhausted. [Archaic] A gentleman almost forspent with speed. Shak.
forstall |To forestall. [Obs.] Spenser.
forster |A forester. [Obs.] Chaucer.
forstraught |Distracted. [Obs.] Chaucer.
forswat |Spent with heat; covered with sweat. [Obs.] P. Sidney.
forswear |1. To reject or renounce upon oath; hence, to renounce earnestly, determinedly, or with protestations. I . . . do forswear her. Shak. 2. To deny upon oath. Like innocence, and as serenely bold As truth, how loudly he forswears thy gold! Dryden. To forswear one's self, to swear falsely; to peforswear thyself.\" Syn. -- See Perjure.\n\nTo swear falsely; to commit perjury. Shak.
forswearer |One who rejects of renounces upon oath; one who swears a false oath.
forswonk |Overlabored; exhausted; worn out. [Obs.] Spenser.
forswore |imp. of Forswear.
forsworn |p. p. of Forswear.
forswornness |State of being forsworn. [R.]
forsythia |A shrub of the Olive family, with yellow blossoms.
fort |A strong or fortified place; usually, a small fortified place, occupied only by troops, surrounded with a ditch, rampart, and parapet, or with palisades, stockades, or other means of defense; a fortification. Detached works, depending solely on their own strength, belong to the class of works termed forts. Farrow.
fortalice |A small outwork of a fortification; a fortilage; -- called also fortelace.
forte |1. The strong point; that in which one excels. fort\"a The construction of a fable seems by no means the forte of our modern poetical writers. Jeffrey. 2. The stronger part of the blade of a sword; the part of half nearest the hilt; -- opposed to foible.\n\nLoudly; strongly; powerfully.
forted |Furnished with, or guarded by, forts; strengthened or defended, as by forts. [R.] Shak.
forth |1. Forward; onward in time, place, or order; in advance from a given point; on to end; as, from that day forth; one, two, three, and so forth. Lucas was Paul's companion, at the leastway from the sixteenth of the Acts forth. Tyndale. From this time forth, I never will speak word. Shak. I repeated the Ave Maria; the inquisitor bad me say forth; I said I was taught no more. Strype. 2. Out, as from a state of concealment, retirement, confinement, nondevelopment, or the like; out into notice or view; as, the plants in spring put forth leaves. When winter past, and summer scarce begun, Invites them forth to labor in the sun. Dryden. 3. Beyond a (certain) boundary; away; abroad; out. I have no mind of feasting forth to-night. Shak. 4. Throughly; from beginning to end. [Obs.] Shak. And so forth, Back and forth, From forth. See under And, Back, and From. -- Forth of, Forth from, out of [Obs.] Shak. -- To bring forth. See under Bring.\n\nForth from; out of. [Archaic] Some forth their cabins peep. Donne.\n\nA way; a passage or ford. [Obs.] Todd.
forthby |See Forby.
forthcoming |Ready or about to appear; making appearance.
forthgoing |A going forth; an utterance. A. Chalmers.\n\nGoing forth.
forthink |To repent; to regret; to be sorry for; to cause regret. [Obs.] \"Let it forthink you.\" Tyndale. That me forthinketh, quod this January. Chaucer.
forthputing |Bold; forward; aggressive.
forthright |Straight forward; in a straight direction. [Archaic] Sir P. Sidney.\n\nDirect; straightforward; as, a forthright man. [Archaic] Lowell. They were Night and Day, and Day and Night, Piligrims wight with steps forthright. Emerson.\n\nA straight path. [Archaic] Here's a maze trod, indeed, Through forthrights and meanders! Shak.
forthrightness |Straightforwardness; explicitness; directness. [Archaic] Dante's concise forthrightness of phrase. Hawthorne.
forthward |Forward. [Obs.] Bp. Fisher.
forthwith |1. Immediately; without delay; directly. Immediately there fell from his eyes as it had been scales; and he received sight forthwith. Acts ix. 18. 2. (Law)  As soon as the thing required may be done by reasonable exertion confined to that object. Bouvier.
forthy |Therefore. [Obs.] Spenser.
forties |See Forty.
fortieth |1. Following the thirty-ninth, or preceded by thirty-nine units, things, or parts. 2. Constituting one of forty equal parts into which anything is divided.\n\nOne of forty equal parts into which one whole is divided; the quotient of a unit divided by forty; one next in order after the thirty-ninth.
fortifiable |Capable of being fortified. Johnson.
fortification |1. The act of fortifying; the art or science of fortifying places in order to defend them against an enemy. 2. That which fortifies; especially, a work or works erected to defend a place against attack; a fortified place; a fortress; a fort; a castle. Fortification agate, Scotch pebble. Syn. -- Fortress; citadel; bulwark. See Fortress.
fortifier |One who, or that which, fortifies, strengthens, supports, or upholds.
fortify |1. To add strength to; to strengthen; to confirm; to furnish with power to resist attack. Timidity was fortified by pride. Gibbon. Pride came to the aid of fancy, and both combined to fortify his resolution. Sir W. Scott. 2. To strengthen and secure by forts or batteries, or by surrounding with a wall or ditch or other military works; to render defensible against an attack by hostile forces.\n\nTo raise defensive works. Milton.
fortilage |A little fort; a blockhouse. [Obs.] Spenser.
fortin |A little fort; a fortlet. [Obs.]
fortissimo |Very loud; with the utmost strength or loudness.
fortition |Casual choice; fortuitous selection; hazard. [R.] No mode of election operating in the spirit of fortition or rotation can be generally good. Burke.
fortitude |1. Power to resist attack; strength; firmness. [Obs.] The fortitude of the place is best known to you. Shak. 2. That strength or firmness of mind which enables a person to encounter danger with coolness and courage, or to bear pain or adversity without murmuring, depression, or despondency; passive courage; resolute endurance; firmness in confronting or bearing up against danger or enduring trouble. Extolling patience as the truest fortitude. Milton. Fortitude is the guard and support of the other virtues. Locke. Syn. -- Courage; resolution; resoluteness; endurance; bravery. See Courage, and Heroism.
fortitudinous |Having fortitude; courageous. [R.] Gibbon.
fortlet |A little fort. [R.] Bailey.
fortnight |The space of fourteen days; two weeks.
fortnightly |Occurring or appearing once in a fortnight; as, a fortnightly meeting of a club; a fortnightly magazine, or other publication. -- adv.  Once in a fortnight; at intervals of a fortnight.
fortread |To tread down; to trample upon. [Obs.] In hell shall they be all fortroden of devils. Chaucer.
fortress |A fortified place; a large and permanent fortification, sometimes including a town; a fort; a castle; a stronghold; a place of defense or security. Syn. -- Fortress, Fortification, Castle, Citadel. A fortress is constructed for military purposes only, and is permanently garrisoned; a fortification is built to defend harbors, cities, etc.; a castle is a fortress of early times which was ordinarily a palatial dwelling; a citadel is the stronghold of a fortress or city, etc.\n\nTo furnish with a fortress or with fortresses; to guard; to fortify. Shak.
fortuitous |1. Happening by chance; coming or occuring unexpectedly, or without any known cause; chance; as, the fortuitous concourse of atoms. It was from causes seemingly fortuitous . . . that all the mighty effects of the Reformation flowed. Robertson. So as to throw a glancing and fortuitous light upon the whole. Hazlitt. 2. (LAw)  Happening independently of human will or means of foresight; resulting from unavoidable physical causes. Abbott. Syn. -- Accidental; casual; contingent; incidental. See Accidental. -- For*tu\"i*tous*ly, adv. -- For*tu\"i*tous*ness, n.
fortuity |Accident; chance; casualty. D. Forbes (1750).
fortunate |1. Coming by good luck or favorable chance; bringing some good thing not foreseen as certain; presaging happiness; auspicious; as, a fortunate event; a fortunate concurrence of circumstances; a fortunate investment. 2. Receiving same unforeseen or unexpected good, or some good which was not dependent on one's own skill or efforts; favored with good forune; lucky. Syn. -- Auspicious; lucky; prosperous; successful; favored; happy. -- Fortunate, Successful, Prosperous. A man is fortunate, when he is favored of fortune, and has unusual blessings fall to his lot; successful when he gains what he aims at; prosperous when he succeeds in those things which men commonly desire. One may be fortunate, in some cases, where he is not successful; he may be successful, but, if he has been mistaken in the value of what he has aimed at, he may for that reason fail to be prosperous.
fortunately |In a fortunate manner; luckily; successfully; happily.
fortunateness |The condition or quality of being fortunate; good luck; success; happiness.
fortune |1. The arrival of something in a sudden or unexpected manner; chance; accident; luck; hap; also, the personified or deified power regarded as determining human success, apportioning happiness and unhappiness, and distributing arbitrarily or fortuitously the lots of life. 'T is more by fortune, lady, than by merit. Shak. O Fortune, Fortune, all men call thee fickle. Shak. 2. That which befalls or is to befall one; lot in life, or event in any particular undertaking; fate; destiny; as, to tell one's fortune. You, who men's fortunes in their faces read. Cowley. 3. That which comes as the result of an undertaking or of a course of action; good or ill success; especially, favorable issue; happy event; success; prosperity as reached partly by chance and partly by effort. Our equal crimes shall equal fortune give. Dryden. There is a tide in the affairs of men, Which, taken at the flood, leads on to fortune. Shak. His father dying, he was driven to seek his fortune. Swift. 4. Wealth; large possessions; large estate; riches; as, a gentleman of fortune. Syn. -- Chance; accident; luck; fate. Fortune book, a book supposed to reveal future events to those who consult it. Crashaw. - Fortune hunter, one who seeks to acquire wealth by marriage. -- Fortune teller, one who professes to tell future events in the life of another. -- Fortune telling, the practice or art of professing to reveal future events in the life of another.\n\n1. To make fortunate; to give either good or bad fortune to. [Obs.] Chaucer. 2. To provide with a fortune. Richardson. 3. To presage; to tell the fortune of. [Obs.] Dryden.\n\nTo fall out; to happen. It fortuned the same night that a Christian, serving a Turk in the camp, secretely gave the watchmen warning. Knolles.
fortuneless |Luckless; also, destitute of a fortune or portion. Spenser.
fortunize |To regulate the fortune of; to make happy. [Obs.] Spenser.
forty |Four times ten; thirtynine and one more.\n\n1. The sum of four tens; forty units or objects. 2. A symbol expressing forty units; as, 40, or xl.
forty-niner |One of those who went to California in the rush for gold in 1849; an argonaut. [Colloq., U. S.]
forty-spot |The Tasmanian forty-spotted diamond bird (Pardalotus quadragintus).
forum |1. A market place or public place in Rome, where causes were judicially tried, and orations delivered to the people. 2. A tribunal; a court; an assembly empowered to hear and decide causes. He [Lord Camden] was . . . more eminent in the senate than in the forum. Brougham.
forwaked |Tired out with excessive waking or watching. [Obs.] Chaucer.
forwander |To wander away; to go astray; to wander far and to weariness. [Obs.]
forward |An agreement; a covenant; a promise. [Obs.] Tell us a tale anon, as forward is. Chaucer.\n\nToward a part or place before or in front; onward; in advance; progressively; -- opposed to backward.\n\n1. Near, or at the fore part; in advance of something else; as, the forward gun in a ship, or the forward ship in a fleet. 2. Ready; prompt; strongly inclined; in an ill sense, overready; to hasty. Only they would that we should remember the poor; the same which I also was forward to do. Gal. ii. 10. Nor do we find him forward to be sounded. Shak. 3. Ardent; eager; earnest; in an ill sense, less reserved or modest than is proper; bold; confident; as, the boy is too forward for his years. I have known men disagreeably forward from their shyness. T. Arnold. 4. Advanced beyond the usual degree; advanced for season; as, the grass is forward, or forward for the season; we have a forward spring. early. The most forward bud Is eaten by the canker ere it blow. Shak.\n\n1. To help onward; to advance; to promote; to accelerate; to quicken; to hasten; as, to forward the growth of a plant; to forward one in improvement. 2. To send forward; to send toward the place of destination; to transmit; as, to forward a letter.
forwarder |1. One who forwards or promotes; a promoter. Udall. 2. One who sends forward anything; (Com.) one who transmits goods; a forwarding merchant. 3. (Bookbinding)  One employed in forwarding.
forwarding |1. The act of one who forwards; the act or occupation of transmitting merchandise or other property for others. 2. (Bookbinding)  The process of putting a book into its cover, and making it ready for the finisher.
forwardly |Eagerly; hastily; obtrusively.
forwardness |The quality of being forward; cheerful readiness; promtness; as, the forwardness of Christians in propagating the gospel. 2. An advanced stage of progress or of preparation; advancement; as, his measures were in great forwardness. Robertson. 3. Eagerness; ardor; as, it is difficult to restrain the forwardness of youth. 3. Boldness; confidence; assurance; want of due reserve or modesty. In France it is usual to bring children into company, and cherish in them, from their infancy, a kind of forwardness and assurance. Addison. 5. A state of advance beyond the usual degree; prematureness; precocity; as, the forwardnessof spring or of corn; the forwardness of a pupil. He had such a dexterous proclivity, as his teachers were fain to restrain his forwardness. Sir H. Wotton. Syn. -- Promptness; promptitude; eagerness; ardor; zeal; assurance; confidence; boldness; impudence; presumption.
forwards |Toward a part or place before or in front; onward; in advance; progressively; -- opposed to backward.\n\nSame as Forward.
forwaste |To desolate or lay waste utterly. [Obs.] Spenser.
forweary |To weary extremely; to dispirit. [Obs.] Spenser.
forweep |To weep much. [Obs.]
forwete |See Forewite. [Obs.] Chaucer.
forwhy |Wherefore; because. [Obs.]
forworn |Much worn. [Obs.] A silly man, in simple weeds forworn. Spenser.
forwot |pres. indic. 1st & 3d pers. sing. of Forwete. [Obs.] Chaucer.
forwrap |To wrap up; to conceal. [Obs.] All mote be said and nought excused, nor hid, nor forwrapped. Chaucer.
foryelde |To repay; to requite. [Obs.] Chaucer.
foryete |To forget. [Obs.] Chaucer.
foryetten |p. p. of Foryete. Chaucer.
forzando |See Sforzato.
fossa |A pit, groove, cavity, or depression, of greater or less depth; as, the temporal fossa on the side of the skull; the nasal fossæ containing the nostrils in most birds.
fossane |A species of civet (Viverra fossa) resembling the genet.
fosse |1. (Fort.)  A ditch or moat. 2. (Anat.)  See Fossa. Fosse road. See Fosseway.
fosset |A faucet. [Obs.] Shak.
fossette |1. A little hollow; hence, a dimple. 2. (Med.)  A small, deep-centered ulcer of the transparent cornea.
fosseway |One of the great military roads constructed by the Romans in England and other parts of Europe; -- so called from the fosse or ditch on each side for keeping it dry.
fossick |1. (Mining)  To search for gold by picking at stone or earth or among roots in isolated spots, picking over abandoned workings, etc.; hence, to steal gold or auriferous matter from another's claim. [Australia] 2.  To search about; to rummage. A man who has fossicked in nature's byways. D. Macdonald.
fossil |1. Dug out of the eart; as, fossil coal; fossil salt. 2. (Paleon.)  Like or pertaining to fossils; contained in rocks. whether petrified or not; as, fossil plants, shells. Fossil copal, a resinous substance, first found in the blue clay at Highgate, near London, and apparently a vegetable resin, partly changed by remaining in the earth. -- Fossil cork, flax, paper, or wood, varieties of amianthus. -- Fossil farina, a soft carbonate of lime. -- Fossil ore, fossiliferous red hematite. Raymond.\n\n1. A substance dug from the earth. [Obs.] Note: Formerly all minerals were called fossils, but the word is now restricted to express the remains of animals and plants found buried in the earth. Ure. 2. (Paleon.)  The remains of an animal or plant found in stratified rocks. Most fossils belong to extinct species, but many of the later ones belong to species still living. 3. A person whose views and opinions are extremely antiquated; one whose sympathies are with a former time rather than with the present. [Colloq.]
fossiliferous |Containing or composed of fossils.
fossilification |The process of becoming fossil.
fossilism |1. The science or state of fossils. Coleridge. 2. The state of being extremely antiquated in views and opinions.
fossilist |One who is versed in the science of fossils; a paleontologist. Joseph Black.
fossilization |The process of converting, or of being converted, into a fossil.
fossilize |1. To convert into a fossil; to petrify; as, to fossilize bones or wood. 2. To cause to become antiquated, rigid, or fixed, as by fossilization; to mummify; to deaden. Ten layers of birthdays on a woman's head Are apt to fossilize her girlish mirth. Mrs. Browning.\n\n1. To become fossil. 2. To become antiquated, rigid, or fixed, beyond the influence of change or progress.
fossilized |Converted into a fossil; antiquated; firmly fixed in views or opinions. A fossilized sample of confused provincialism. Earle.
fossores |A group of hymenopterous insects including the sand wasps. They excavate cells in earth, where they deposit their eggs, with the bodies of other insects for the food of the young when hatched. [Written also Fossoria.]
fossoria |See Fossores.
fossorial |Fitted for digging, adapted for burrowing or digging; as, a fossorial foot; a fossorial animal.
fossorious |Adapted for digging; -- said of the legs of certain insects.
fossulate |Having, or surrounded by, long, narrow depressions or furrows.
foster |1. To feed; to nourish; to support; to bring up. Some say that ravens foster forlorn children. Shak. 2. To cherish; to promote the growth of; to encourage; to sustain and promote; as, to foster genius.\n\nTo be nourished or trained up together. [Obs.] Spenser.\n\nRelating to nourishment; affording, receiving, or sharing nourishment or nurture; -- applied to father, mother, child, brother, etc., to indicate that the person so called stands in the relation of parent, child, brother, etc., as regards sustenance and nurture, but not by tie of blood. Foster babe, or child, an infant of child nursed by a woman not its mother, or bred by a man not its father. -- Foster brother, Foster sister, one who is, or has been, nursed at the same breast, or brought up by the same nurse as another, but is not of the same parentage. -- Foster dam, one who takes the place of a mother; a nurse. Dryden. -- Foster earth, earth by which a plant is nourished, though not its native soil. J. Philips. -- Foster father, a man who takes the place of a father in caring for a child. Bacon. -- Foster land. (a) Land allotted for the maintenance of any one. [Obs.] (b) One's adopted country. -- Foster lean Etym: [foster + AS. læn a loan See Loan.], remuneration fixed for the rearing of a foster child; also, the jointure of a wife. [Obs.] Wharton. -- Foster mother, a woman who takes a mother's place in the nurture and care of a child; a nurse. -- Foster nurse, a nurse; a nourisher. [R.] Shak. -- Foster parent, a foster mother or foster father. -- Foster son, a male foster child.\n\nA forester. [Obs.] Spenser.\n\nOne who, or that which, fosters.
fosterage |The care of a foster child; the charge of nursing. Sir W. Raleigh.
fosterer |One who, or that which, fosters.
fosterling |A foster child.
fosterment |Food; nourishment. [Obs.]
fostress |A woman who feeds and cherishes; a nurse. B. Jonson.
fother |1. A wagonload; a load of any sort. [Obs.] Of dung full many a fother. Chaucer. 2. See Fodder, a unit of weight.\n\nTo stop (a leak in a ship at sea) by drawing under its bottom a thrummed sail, so that the pressure of the water may force it into the crack. Totten.
fotive |Nourishing. [Obs.] T. Carew (1633).
fotmal |Seventy pounds of lead.
foucault current |An eddy current.
fougade |A small mine, in the form of a well sunk from the surface of the ground, charged with explosive and projectiles. It is made in a position likely to be occupied by the enemy.
fougasse |A small mine, in the form of a well sunk from the surface of the ground, charged with explosive and projectiles. It is made in a position likely to be occupied by the enemy.
fought |imp. & p. p. of Fight.
foughten |p. p. of Fight. [Archaic]
foul |A bird. [Obs.] Chaucer.\n\n1. Covered with, or containing, extraneous matter which is injurious, noxious, offensive, or obstructive; filthy; dirty; not clean; polluted; nasty; defiled; as, a foul cloth; foul hands; a foul chimney; foul air; a ship's bottom is foul when overgrown with barnacles; a gun becomes foul from repeated firing; a well is foul with polluted water. My face is foul with weeping. Job. xvi. 16. 2. Scurrilous; obscene or profane; abusive; as, foul words; foul language. 3. Hateful; detestable; shameful; odious; wretched. \"The foul with Sycorax.\" Shak. Who first seduced them to that foul revolt Milton. 4. Loathsome; disgusting; as, a foul disease. 5. Ugly; homely; poor. [Obs.] Chaucer. Let us, like merchants, show our foulest wares. Shak. 6. Not favorable; unpropitious; not fair or advantageous; as, a foul wind; a foul road; cloudy or rainy; stormy; not fair; -- said of the weather, sky, etc. So foul a sky clears not without a storm. Shak. 7. Not conformed to the established rules and customs of a game, conflict, test, etc.; unfair; dishonest; dishonorable; cheating; as, foul play. 8. Having freedom of motion interfered with by collision or entanglement; entangled; -- opposed to clear; as, a rope or cable may get foul while paying it out. Foul anchor. (Naut.) See under Anchor. -- Foul ball (Baseball), a ball that first strikes the ground outside of the foul ball lines, or rolls outside of certain limits. -- Foul ball lines (Baseball), lines from the home base, through the first and third bases, to the boundary of the field. -- Foul berth (Naut.), a berth in which a ship is in danger of fouling another vesel. -- Foul bill, or Foul bill of health, a certificate, duly authenticated, that a ship has come from a place where a contagious disorder prevails, or that some of the crew are infected. -- Foul copy, a rough draught, with erasures and corrections; -- opposed to fair or clean copy. \"Some writers boast of negligence, and others would be ashamed to show their foul copies.\" Cowper. -- Foul proof, an uncorrected proof; a proof containing an excessive quantity of errors. -- Foul strike (Baseball), a strike by the batsman when any part of his person is outside of the lines of his position. -- To fall foul, to fall out; to quarrel. [Obs.] \"If they be any ways offended, they fall foul.\" Burton. -- To fall, or run, foul of. See under Fall. -- To make foul water, to sail in such shallow water that the ship's keel stirs the mud at the bottom.\n\n1. To make filthy; to defile; to daub; to dirty; to soil; as, to foul the face or hands with mire. 2. (Mil.)  To incrust (the bore of a gun) with burnt powder in the process of firing. 3. To cover (a ship's bottom) with anything that impered its sailing; as, a bottom fouled with barnacles. 4. To entangle, so as to impede motion; as, to foul a rope or cable in paying it out; to come into collision with; as, one boat fouled the other in a race.\n\n1. To become clogged with burnt powder in the process of firing, as a gun. 2. To become entagled, as ropes; to come into collision with something; as, the two boats fouled.\n\n1. An entanglement; a collision, as in a boat race. 2. (Baseball)  See Foul ball, under Foul, a.
foul-mouthed |Using language scurrilous, opprobrious, obscene, or profane; abusive. So foul-mouthed a witness never appeared in any cause. Addison.
foul-spoken |Using profane, scurrilous, slanderous, or obscene language. Shak.
foulard |A thin, washable material of silk, or silk and cotton, originally imported from India, but now also made elsewhere.
foulder |To flash, as lightning; to lighten; to gleam; to thunder. [Obs.] \"Flames of fouldering heat.\" Spenser.
foule |Foully. [Obs.] Chaucer.
foully |In a foul manner; filthily; nastily; shamefully; unfairly; dishonorably. I foully wronged him; do forgive me, do. Gay.
foulness |The quality or condition of being foul.
foumart |The European polecat; -- called also European ferret, and fitchew. See Polecat. [Written also foulmart, foulimart, and fulimart.]
found |imp. & p. p. of Find.\n\nTo form by melting a metal, and pouring it into a mold; to cast. \"Whereof to found their engines.\" Milton.\n\nA thin, single-cut file for combmakers.\n\n1. To lay the basis of; to set, or place, as on something solid, for support; to ground; to establish upon a basis, literal or figurative; to fix firmly. I had else been perfect, Whole as the marble, founded as the rock. Shak. A man that all his time Hath founded his good fortunes on your love. Shak. It fell not, for it was founded on a rock. Matt. vii. 25. 2. To take the ffirst steps or measures in erecting or building up; to furnish the materials for beginning; to begin to raise; to originate; as, to found a college; to found a family. There they shall found Their government, and their great senate choose. Milton. Syn. -- To base; ground; institute; establish; fix. See Predicate.
foundation |1. The act of founding, fixing, establishing, or beginning to erect. 2. That upon which anything is founded; that on which anything stands, and by which it is supported; the lowest and supporting layer of a superstructure; groundwork; basis. Behold, I lay in Zion, for a foundation, a stone . . . a precious corner stone, a sure foundation. Is. xxviii. 16. The foundation of a free common wealth. Motley. 3. (Arch.)  The lowest and supporting part or member of a wall, including the base course (see Base course (a), under Base, n.) and footing courses; in a frame house, the whole substructure of masonry. 4. A donation or legacy appropriated to support a charitable institution, and constituting a permanent fund; endowment. He was entered on the foundation of Westminster. Macaulay. 5. That which is founded, or established by endowment; an endowed institution or charity. Against the canon laws of our foundation. Milton. Foundation course. See Base course, under Base, n. -- Foundation muslin, an open-worked gummed fabric used for stiffening dresses, bonnets, etc. -- Foundation school, in England, an endowed school. -- To be on a foundation, to be entitled to a support from the proceeds of an endowment, as a scholar or a fellow of a college.
foundationer |One who derives support from the funds or foundation of a college or school. [Eng.]
foundationless |Having no foundation.
founder |One who founds, establishes, and erects; one who lays a foundation; an author; one from whom anything originates; one who endows.\n\nOne who founds; one who casts metals in various forms; a caster; as, a founder of cannon, bells, hardware, or types. Fonder's dust. Same as Facing, 4. -- Founder's sand, a kind of sand suitable for purposes of molding.\n\n1. (Naut.)  To become filled with water, and sink, as a ship. 2. To fall; to stumble and go lame, as a horse. For which his horse fearé gan to turn, And leep aside, and foundrede as he leep. Chaucer. 3. To fail; to miscarry. \"All his tricks founder.\" Shak.\n\nTo cause internal inflammation and soreness in the feet or limbs of (a horse), so as to disable or lame him.\n\n(a) A lameness in the foot of a horse, occasioned by inflammation; closh. (b) An inflammatory fever of the body, or acute rheumatism; as, chest founder. See Chest ffounder. James White.
founderous |Difficult to travel; likely to trip one up; as, a founderous road. [R.] Burke.
foundershaft |The first shaft sunk. Raymond.
foundery |Same as Foundry.
founding |The art of smelting and casting metals.
foundling |A deserted or exposed infant; a child found without a parent or owner. Foundling hospital, a hospital for foundlings.
foundress |A female founder; a woman who founds or establishes, or who endows with a fund.
foundry |1. The act, process, or art of casting metals. 2. The buildings and works for casting metals. Foundry ladle, a vessel for holding molten metal and conveying it from cupola to the molds.
fount |A font.\n\nA fountain.
fountain |1. A spring of water issuing from the earth. 2. An artificially produced jet or stream of water; also, the structure or works in which such a jet or stream rises or flows; a basin built and constantly supplied with pure water for drinking and other useful purposes, or for ornament. 3. A reservoir or chamber to contain a liquid which can be conducted or drawn off as needed for use; as, the ink fountain in a printing press, etc. 4. The source from which anything proceeds, or from which anything is supplied continuously; origin; source. Judea, the fountain of the gospel. Fuller. Author of all being, Fountain of light, thyself invisible. Milton. Air fountain. See under Air. -- Fountain heead, primary source; original; first principle. Young. -- Fountain inkstand, an inkstand having a continual supply of ink, as from elevated reservoir. -- Fountain lamp, a lamp fed with oil from an elevated reservoir. -- Fountain pen, a pen with a reservoir in the handle which furnishes a supply of ink. -- Fountain pump. (a) A structure for a fountain, having the form of a pump. (b) A portable garden pump which throws a jet, for watering plants, etc. -- Fountain shell (Zoöl.), the large West Indian conch shell (Strombus gigas). -- Fountain of youth, a mythical fountain whose waters were fabled to have the property of renewing youth.
fountainless |Having no fountain; destitute of springs or sources of water. Barren desert, fountainless and dry. Milton.
fountful |Full of fountains. Pope.
four |One more than three; twice two.\n\n1. The sum of four units; four units or objects. 2. A symbol representing four units, as 4 or iv. 3. Four things of the same kind, esp. four horses; as, a chariot and four. All fours. See All fours, in the Vocabulary.
four-cornered |Having four corners or angles.
four-cycle |A four-stroke cycle, as the Otto cycle, for an internal- combustion engine. -- Four\"-cy`cle, a.
four-in-hand |Consisting of four horses controlled by one person; as, a four- in-hand team; drawn by four horses driven by one person; as, a four- in-hand coach. -- n.  A team of four horses driven by one person; also, a vehicle drawn by such a team. As quaint a four-in-hand As you shall see. Tennyson.
four-poster |A large bedstead with tall posts at the corners to support curtains. [Colloq.]
four-way |Allowing passage in either of four directions; as, a four-way cock, or valve. Francis. Four-way cock, a cock connected with four pipes or ports, and having two or more passages in the plug, by which the adjacent pipes or ports may be made to communicate; formerly used as a valve in the steam engine, and now for various other purposes. In the illustration, a leads to the upper end of a steam engine cylinder, and b to the lower end; c is the steam pipe, and d the exhaust pipe.
four-wheeled |Having four wheels.
four-wheeler |A vehicle having four wheels. [Colloq.]
fourb |A trickly fellow; a cheat. [Obs.] Evelyn. Denham.
fourbe |A trickly fellow; a cheat. [Obs.] Evelyn. Denham.
fourche |Having the ends forked or branched, and the ends of the branches terminating abruptly as if cut off; -- said of an ordinary, especially of a cross.
fourchette |1. A table fork. 2. (Anat.) (a) A small fold of membrane, connecting the labia in the posterior part of the vulva. (b) The wishbone or furculum of birds. (c) The frog of the hoof of the horse and allied animals. 3. (Surg.)  An instrument used to raise and support the tongue during the cutting of the frænum. 4. (Glove Making)  The forked piece between two adjacent fingers, to which the front and back portions are sewed. Knight.
fourdrinier |A machine used in making paper; -- so named from an early inventor of improvements in this class of machinery.
fourfold |Four times; quadruple; as, a fourfold division. He snall restore the lamb fourfold. 2 Sam. xii. 6.\n\nFour times as many or as much.\n\nTo make four times as much or as many, as an assessment,; to quadruple.
fourfooted |Having four feet; quadruped; as, fourfooted beasts.
fourhanded |1. Having four hands; quadrumanous. Goldsmith. 2. Requiring four \"hands\" or players; as, a fourhanded game at cards.
fourierism |The coöperative socialistic system of Charles Fourier, a Frenchman, who recommended the reorganization of society into small communities, living in common.
fourierist |One who adopts the views of Fourier.
fourierite |One who adopts the views of Fourier.
fourling |1. One of four children born at the same time. 2. (Crystallog.)  A compound or twin crystal consisting of four individuals.
fourneau |The chamber of a mine in which the powder is placed. FOUR-O'CLOCK Four\"-o'clock`, n. 1. (Bot.)  A plant of the genus Mirabilis. There are about half a dozen species, natives of the warmer parts of America. The common four- o'clock is M. Jalapa. Its flowers are white, yellow, and red, and open toward sunset, or earlier in cloudy weather; hence the name. It is also called marvel of Peru, and afternoon lady. 2. (Zoöl.)  The friar bird; -- so called from its cry, which resembles these words.
fourpence |1. A British silver coin, worth four pence; a groat. 2. A name formerly given in New England to the Spanish half real, a silver coin worth six and a quarter cents.
fourrier |A harbinger. [Obs.]
fourscore |Four times twenty; eighty.\n\nThe product of four times twenty; eighty units or objects.
foursome |Consisting of four; requiring four participants. [Scot. or Golf]\n\nA game between four players, with two on each side and each side playing but one ball, the partners striking alternately. It is called a mixed foursome when each side consists of a man and a woman.
foursquare |Having four sides and four equal angles. Sir W. Raleigh.
fourteen |Four and ten more; twice seven.\n\n1. The sum of ten and four; forteen units or objects. 2. A symbol representing fourteen, as 14 or xiv.
fourteenth |1. Next in order after the thirteenth; as, the fourteenth day of the month. 2. Making or constituting one of fourteen equal parts into which anything may be derived.\n\n1. One of fourteen equal parts into which one whole may be divided; the quotient of a unit divided by fourteen; one next after the thirteenth. 2. (Mus.)  The octave of the seventh.
fourth |1. Next in order after the third; the ordinal of four. 2. Forming one of four equal parts into which anything may be divided.\n\n1. One of four equal parts into which one whole may be divided; the quotient of a unit divided by four; one coming next in order after the third. 2. (Mus.)  The interval of two tones and a semitone, embracing four diatonic degrees of the scale; the subdominant of any key. The Fourth, specifically, un the United States, the fourth day of July, the anniversary of the declaration of American independence; as, to celebrate the Fourth.
fourthly |In the fourth place.
foussa |A viverrine animal of Madagascar (Cryptoprocta ferox). It resembles a cat in size and form, and has retractile claws.
fouter |A despicable fellow. [Prov. Eng.] Brockett.
foutra |A fig; -- a word of contempt. [Obs.] A foutra for the world and wordlings base! Shak.
fouty |Despicable. [Obs.]
fovea |A slight depression or pit; a fossa.
foveate |Having pits or depressions; pitted.
foveola |A small depression or pit; a fovea.
foveolate |Having small pits or depression, as the receptacle in some composite flowers.
foveolated |Foveolate.
fovilla |One of the fine granules contained in the protoplasm of a pollen grain.
fowl |1. Any bird; esp., any large edible bird. Let them have dominion over the fish of the sea, and over the fowl of the air. Gen. i. 26. Behold the fowls of the air; for they sow not. Matt. vi. 26. Like a flight of fowl Scattered by winds and high tempestuous gusts. Shak. 2. Any domesticated bird used as food, as a hen, turkey, duck; in a more restricted sense, the common domestic cock or hen (Gallus domesticus). Barndoor fowl, or Barnyard fowl, a fowl that frequents the barnyard; the common domestic cock or hen.\n\nTo catch or kill wild fowl, for game or food, as by shooting, or by decoys, nets, etc. Such persons as may lawfully hunt, fish, or fowl. Blackstone. Fowling piece, a light gun with smooth bore, adapted for the use of small shot in killing birds or small quadrupeds.
fowler |A sportsman who pursues wild fowl, or takes or kills for food.
fowlerite |A variety of rhodonite, from Franklin Furnace, New Jersey, containing some zinc. FOWLER'S SOLUTION Fow\"ler's so*lu\"tion  . An Fowler, an English physician who first brought it into use.
fox |1. (Zoöl.)  A carnivorous animal of the genus Vulpes, family Canidæ, of many species. The European fox (V. vulgaris or V. vulpes), the American red fox (V. fulvus), the American gray fox (V. Virginianus), and the arctic, white, or blue, fox (V. lagopus) are well-known species. Note: The black or silver-gray fox is a variety of the American red fox, producing a fur of great value; the cross-gray and woods-gray foxes are other varieties of the same species, of less value. The common foxes of Europe and America are very similar; both are celebrated for their craftiness. They feed on wild birds, poultry, and various small animals. Subtle as the fox for prey. Shak. 2. (Zoöl.)  The European dragonet. 3. (Zoöl.)  The fox shark or thrasher shark; -- called also sea fox. See Thrasher shark, under Shark. 4. A sly, cunning fellow. [Colloq.] We call a crafty and cruel man a fox. Beattie. 5. (Naut.)  Rope yarn twisted together, and rubbed with tar; -- used for seizings or mats. 6. A sword; -- so called from the stamp of a fox on the blade, or perhaps of a wolf taken for a fox. [Obs.] Thou diest on point of fox. Shak. 7. pl. (Enthnol.)  A tribe of Indians which, with the Sacs, formerly occupied the region about Green Bay, Wisconsin; -- called also Outagamies. Fox and geese. (a) A boy's game, in which one boy tries to catch others as they run one goal to another. (b) A game with sixteen checkers, or some substitute for them, one of which is called the fox, and the rest the geese; the fox, whose first position is in the middle of the board, endeavors to break through the line of the geese, and the geese to pen up the fox. -- Fox bat (Zoöl.), a large fruit bat of the genus Pteropus, of many species, inhabiting Asia, Africa, and the East Indies, esp. P. medius of India. Some of the species are more than four feet across the outspread wings. See Fruit bat. -- Fox bolt, a bolt having a split end to receive a fox wedge. -- Fox brush (Zoöl.), the tail of a fox. -- Fox evil, a disease in which the hair falls off; alopecy. -- Fox grape (Bot.), the name of two species of American grapes. The northern fox grape (Vitis Labrusca) is the origin of the varieties called Isabella, Concord, Hartford, etc., and the southern fox grape (Vitis vulpina) has produced the Scuppernong, and probably the Catawba. -- Fox hunter. (a) One who pursues foxes with hounds. (b) A horse ridden in a fox chase. -- Fox shark (Zoöl.), the thrasher shark. See Thrasher shark, under Thrasher. -- Fox sleep, pretended sleep. -- Fox sparrow (Zoöl.), a large American sparrow (Passerella iliaca); -- so called on account of its reddish color. -- Fox squirrel (Zoöl.), a large North American squirrel (Sciurus niger, or S. cinereus). In the Southern States the black variety prevails; farther north the fulvous and gray variety, called the cat squirrel, is more common. -- Fox terrier (Zoöl.), one of a peculiar breed of terriers, used in hunting to drive foxes from their holes, and for other purposes. There are rough- and smooth-haired varieties. -- Fox trot, a pace like that which is adopted for a few steps, by a horse, when passing from a walk into a trot, or a trot into a walk. -- Fox wedge (Mach. & Carpentry), a wedge for expanding the split end of a bolt, cotter, dowel, tenon, or other piece, to fasten the end in a hole or mortise and prevent withdrawal. The wedge abuts on the bottom of the hole and the piece is driven down upon it. Fastening by fox wedges is called foxtail wedging. -- Fox wolf (Zoöl.), one of several South American wild dogs, belonging to the genus Canis. They have long, bushy tails like a fox.\n\n1. To intoxicate; to stupefy with drink. I drank . . . so much wine that I was almost foxed. Pepys. 2. To make sour, as beer, by causing it to ferment. 3. To repair the feet of, as of boots, with new front upper leather, or to piece the upper fronts of.\n\nTo turn sour; -- said of beer, etc., when it sours in fermenting.
fox-hunting |Pertaining to or engaged in the hunting of foxes; fond of hunting foxes.
foxearth |A hole in the earth to which a fox resorts to hide himself.
foxed |1. Discolored or stained; -- said of timber, and also of the paper of books or engravings. 2. Repaired by foxing; as, foxed boots.
foxery |Behavior like that of a fox; [Obs.] Chaucer.
foxes |See Fox, n., 7.
foxfish |(a) The fox shark; -- called also sea fox. See Thrasher shark, under Shark. (b) The european dragonet. See Dragonet.
foxglove |Any plant of the genus Digitalis. The common English foxglove (Digitalis purpurea) is a handsome perennial or biennial plant, whose leaves are used as a powerful medicine, both as a sedative and diuretic. See Digitalis. Pan through the pastures oftentimes hath run To pluck the speckled foxgloves from their stem. W. Browne.
foxhound |One of a special breed of hounds used for chasing foxes.
foxiness |1. The state or quality of being foxy, or foxlike; craftiness; shrewdness. 2. The state of being foxed or discolored, as books; decay; deterioration. 3. A coarse and sour taste in grapes.
foxish |Foxlike. [Obs.]
foxlike |Resembling a fox in his characteristic qualities; cunning; artful; foxy.
foxly |Foxlike. [Obs.] \"Foxly craft.\" Latimer.
foxship |Foxiness; craftiness. [R.] Shak.
foxtail |1. The tail or brush of a fox. 2. (Bot.)  The name of several kinds of grass having a soft dense head of flowers, mostly the species of Alopecurus and Setaria. 3. (Metal.)  The last cinders obtained in the fining process. Raymond. Foxtail saw, a dovetail saw. -- Foxtail wedging. See Fox wedge, under Fox.
foxy |1. Like or pertaining to the fox; foxlike in disposition or looks; wily. Modred's narrow, foxy face. Tennyson. 2. Having the color of a fox; of a yellowish or reddish brown color; -- applied sometimes to paintings when they have too much of this color. 3. Having the odor of a fox; rank; strong smeelling. 4. Sour; unpleasant in taste; -- said of wine, beer, etc., not properly fermented; -- also of grapes which have the coarse flavor of the fox grape.
foy |1. Faith; allegiance; fealty. [Obs.] Spenser. 2. A feast given by one about to leave a place. [Obs.] He did at the Dog give me, and some other friends of his, his foy, he being to set sail to-day. Pepys.
foyer |1. A lobby in a theater; a greenroom. 2. The crucible or basin in a furnace which receives the molten metal. Knight.
foyson |See Foison.
foziness |The state of being fozy; spiritlessness; dullness. [Scot.] [The Whigs'] foziness can no longer be concealed. Blackwood's.
fozy |Spongy; soft; fat and puffy. [Scot.]
fra |Fro. [Old Eng. & Scot.]\n\nBrother; -- a title of a monk of friar; as, Fra Angelo. Longfellow.
frab |To scold; to nag. [Prov. Eng.]
frabbit |Crabbed; peevish. [Prov. Eng.]
fracas |An uproar; a noisy quarrel; a disturbance; a brawl.
fracho |A shallow iron pan to hold glass ware while being annealed.
fracid |Rotten from being too ripe; overripe. [Obs.] Blount.
fract |To break; to violate. [Obs.] Shak.
fracted |Having a part displaced, as if broken; -- said of an ordinary. Macaulay.
fraction |1. The act of breaking, or state of being broken, especially by violence. [Obs.] Neither can the natural body of Christ be subject to any fraction or breaking up. Foxe. 2. A portion; a fragment. Some niggard fractions of an hour. Tennyson. 3. (Arith. or Alg.)  One or more aliquot parts of a unit or whole number; an expression for a definite portion of a unit or magnitude. Common, or Vulgar, fraction, a fraction in which the number of equal parts into which the integer is supposed to be divided is indicated by figures or letters, called the denominator, written below a line, over which is the numerator, indicating the number of these parts included in the fraction; as -- Complex fraction, a fraction having a fraction or mixed number in the numerator or denominator, or in both. Davies & Peck. -- Compound fraction, a fraction of a fraction; two or more fractions connected by of. -- Continued fraction, Decimal fraction, Partial fraction, etc. See under Continued, Decimal, Partial, etc. -- Improper fraction, a fraction in which the numerator is greater than the denominator. -- Proper fraction, a fraction in which the numerator is less than the denominator.\n\nTo separate by means of, or to subject to, fractional distillation or crystallization; to fractionate; -- frequently used with out; as, to fraction out a certain grade of oil from pretroleum.
fractional |1. Of or pertaining to fractions or a fraction; constituting a fraction; as, fractional numbers. 2. Relatively small; inconsiderable; insignificant; as, a fractional part of the population. Fractional crystallization (Chem.), a process of gradual and approximate purification and separation, by means of repeated solution and crystallization therefrom. -- Fractional currency, small coin, or paper notes, in circulation, of less value than the monetary unit. -- Fractional distillation (Chem.), a process of distillation so conducted that a mixture of liquids, differing considerably from each other in their boiling points, can be separated into its constituents.
fractionally |By fractions or separate portions; as, to distill a liquid fractionally, that is, so as to separate different portions.
fractionary |Fractional. [Obs.]
fractious |Apt to break out into a passion; apt to scold; cross; snappish; ugly; unruly; as, a fractious man; a fractious horse. Syn. -- Snappish; peevish; waspish; cross; irritable; perverse; pettish. -- Frac\"tious*ly, v. -- Frac\"tious*ness, n.
fractural |Pertaining to, or consequent on, a fracture. [R.]
fracture |1. The act of breaking or snapping asunder; rupture; breach. 2. (Surg.)  The breaking of a bone. 3. (Min.)  The texture of a freshly broken surface; as, a compact fracture; an even, hackly, or conchoidal fracture. Comminuted fracture (Surg.), a fracture in which the bone is broken into several parts. -- Complicated fracture (Surg.), a fracture of the bone combined with the lesion of some artery, nervous trunk, or joint. -- Compound fracture (Surg.), a fracture in which there is an open wound from the surface down to the fracture. -- Simple fracture (Surg.), a fracture in which the bone only is ruptured. It does not communicate with the surface by an open wound. Syn. -- Fracture, Rupture. These words denote different kinds of breaking, according to the objects to which they are applied. Fracture is applied to hard substances; as, the fracture of a bone. Rupture is oftener applied to soft substances; as, the rupture of a blood vessel. It is also used figuratively. \"To be an enemy and once to have been a friend, does it not embitter the rupture\" South.\n\nTo cause a fracture or fractures in; to break; to burst asunder; to crack; to separate the continuous parts of; as, to fracture a bone; to fracture the skull.
fraenulum |A frænum.
fraenum |A connecting fold of membrane serving to support or restrain any part; as, the frænum of the tongue.
fragile |Easily broken; brittle; frail; delicate; easily destroyed. The state of ivy is tough, and not fragile. Bacon. Syn. -- Brittle; infirm; weak; frail; frangible; slight. -- Frag\"ile*ly, adv.
fragility |1. The condition or quality of being fragile; brittleness; frangibility. Bacon. 2. Weakness; feebleness. An appearance of delicacy, and even of fragility, is almost essential to it [beauty]. Burke. 3. Liability to error and sin; frailty. [Obs.] The fragility and youthful folly of Qu. Fabius. Holland.
fragment |A part broken off; a small, detached portion; an imperfect part; as, a fragment of an ancient writing. Gather up the fragments that remain. John vi. 12.
fragmental |1. Fragmentary. 2. (Geol.)  Consisting of the pulverized or fragmentary material of rock, as conglomerate, shale, etc.\n\nA fragmentary rock.
fragmentarily |In a fragmentary manner; piecemeal.
fragmentariness |The quality or property of being in fragnebts, or broken pieces, incompleteness; want of continuity. G. Eliot.
fragmentary |1. Composed of fragments, or broken pieces; disconnected; not complete or entire. Donne. 2. (Geol.)  Composed of the fragments of other rocks.
fragmented |Broken into fragments.
fragmentist |A writer of fragments; as, the fragmentist of Wolfenbüttel. [R.]
fragor |1. A loud and sudden sound; the report of anything bursting; a crash. I. Watts. 2. Note: [Due to confusion with fragrant.]  A strong or sweet scent. [Obs. & Illegitimate.] Sir T. Herbert.
fragrance |The quality of being fragrant; sweetness of smell; a sweet smell; a pleasing odor; perfume. Eve separate he spies, Veiled in a cloud of fragrance. Milton. The goblet crowned, Breathed aromatic fragrancies around. Pope.
fragrancy |The quality of being fragrant; sweetness of smell; a sweet smell; a pleasing odor; perfume. Eve separate he spies, Veiled in a cloud of fragrance. Milton. The goblet crowned, Breathed aromatic fragrancies around. Pope.
fragrant |[fragrans. -antis, p.pr. of fragrare to emit a smell of fragrance: cf. OF. fragrant. Affecting the olfactory nerves agreeably; sweet of smell; odorous; having or emitting an agreeable perfume. Fragrant the fertile earth After soft showers. Milton. Syn. -- Sweet-smelling; odorous; odoriferous; swetacented; redolent; ambrosial; balmy; spicy; aromatic. -- Fra\"grant*ly, adv.
fraight |Same as Fraught. [Obs.] Spenser.
frail |A basket made of rushes, used chiefly for containing figs and raisins. 2. The quantity of raisins -- about thirty-two, fifty-six, or seventy-five pounds, -- contained in a frail. 3. A rush for weaving baskets. Johnson.\n\n1. Easily broken; fragile; not firm or durable; liable to fail and perish; easily destroyed; not tenacious of life; weak; infirm. That I may know how frail I am. Ps. xxxix. 4. An old bent man, worn and frail. Lowell. 2. Tender. [Obs.] Deep indignation and compassion. Spenser. 3. Liable to fall from virtue or be led into sin; not strong against temptation; weak in resolution; also, unchaste; -- often applied to fallen women. Man is frail, and prone to evil. Jer. Taylor.
frailly |Weakly; infirmly.
frailness |Frailty.
frailty |1. The condition quality of being frail, physically, mentally, or morally, frailness; infirmity; weakness of resolution; liableness to be deceived or seduced. God knows our frailty, [and] pities our weakness. Locke. 2. A fault proceeding from weakness; foible; sin of infirmity. Syn. -- Frailness; fragility; imperfection; failing.
fraischeur |Freshness; coolness. [R.] Dryden.
fraise |A large and thick pancake, with slices of bacon in it. [Obs.] Johnson.\n\n1. (Fort.)  A defense consisting of pointed stakes driven into the ramparts in a horizontal or inclined position. 2. (Mech.)  A fluted reamer for enlarging holes in stone; a small milling cutter.\n\nTo protect, as a line of troops, against an onset of cavalry, by opposing bayonets raised obliquely forward. Wilhelm.
fraised |Fortified with a fraise.
fraken |A freckle. [Obs.] A few fraknes in his face. Chaucer.
framable |Capable of being framed.
frambaesia |The yaws. See Yaws.
frame |1. (Arch. & Engin.)  To construct by fitting and uniting the several parts of the skeleton of any structure; specifically, in woodwork, to put together by cutting parts of one member to fit parts of another. See Dovetail, Halve, v. t., Miter, Tenon, Tooth, Tusk, Scarf, and Splice. 2. To originate; to plan; to devise; to contrive; to compose; in a bad sense, to invent or fabricate, as something false. How many excellent reasonings are framed in the mind of a man of wisdom and study in a length of years. I. Watts. 3. To fit to something else, or for some specific end; to adjust; to regulate; to shape; to conform. And frame my face to all occasions. Shak. We may in some measure frame our minds for the reception of happiness. Landor. The human mind is framed to be influenced. I. Taylor. 4. To cause; to bring about; to produce. [Obs.] Fear frames disorder, and disorder wounds. Shak. 5. To support. [Obs. & R.] That on a staff his feeble steps did frame. Spenser. 6. To provide with a frame, as a picture.\n\n1. To shape; to arrange, as the organs of speech. [Obs.] Judg. xii. 6. 2. To proceed; to go. [Obs.] The bauty of this sinful dame Made many princes thither frame. Shak.\n\n1. Anything composed of parts fitted and united together; a fabric; a structure; esp., the constructional system, whether of timber or metal, that gives to a building, vessel, etc., its model and strength; the skeleton of a structure. These are thy glorius works, Parent of good, Almighty! thine this universal frame. Milton. 2. The bodily structure; physical constitution; make or build of a person. Some bloody passion shakes your very frame. Shak. No frames could be strong enough to endure it. Prescott. 3. A kind of open case or structure made for admitting, inclosing, or supporting things, as that which incloses or contains a window, door, picture, etc.; that on which anything is held or stretched; as: (a) The skeleton structure which supports the boiler and machinery of a locomotive upon its wheels. (b) (Founding) A molding box or flask, which being filled with sand serves as a mold for castings. (c) The ribs and stretchers of an umbrella or other structure with a fabric covering. (d) A structure of four bars, adjustable in size, on which cloth, etc., is stretched for quilting, embroidery, etc. (e) (Hort.) A glazed portable structure for protecting young plants from frost. (f) (Print.) A stand to support the type cases for use by the compositor. 4. (Mach.)  A term applied, especially in England, to certain machines built upon or within framework; as, a stocking frame; lace frame; spinning frame, etc. 5. Form; shape; proportion; scheme; structure; constitution; system; as, a frameof government. She that hath a heart of that fine frame To pay this debt of love but to a brother. Shak. Put your discourse into some frame. Shak. 6. Particular state or disposition, as of the mind; humor; temper; mood; as, to be always in a happy frame. 7. Contrivance; the act of devising or scheming. [Obs.] John the bastard Whose spirits toil in frame of villainies. Shak. Balloon frame, Cant frames, etc. See under Balloon, Cant, etc. -- Frame building or house, a building of which the form and support is made of framed timbers. [U.S.] -- Frame level, a mason's level. -- Frame saw, a thin saw stretched in a frame to give it rigidity.
frame-up |A conspiracy or plot, esp. for a malicious or evil purpose, as to incriminate a person on false evidence. [Slang]
framer |One who frames; as, the framer of a building; the framers of the Constitution.
framework |1. The work of framing, or the completed work; the frame or constructional part of anything; as, the framework of society. A staunch and solid piece of framework. Milton. 2. Work done in, or by means of, a frame or loom.
framing |1. The act, process, or style of putting together a frame, or of constructing anything; a frame; that which frames. 2. (Arch. & Engin.)  A framework, or a sy Framing chisel (Carp.), a heavy chisel with a socket shank for making mortises.
frampel |Peevish; cross; vexatious; quarrelsome. [Obs.] Shak. Is Pompey grown so malapert, so frampel Beau. & Fl.
frampoid |Peevish; cross; vexatious; quarrelsome. [Obs.] Shak. Is Pompey grown so malapert, so frampel Beau. & Fl.
franc |A silver coin of France, and since 1795 the unit of the French monetary system. It has been adopted by Belgium and Swizerland. It is equivalent to about nineteen cents, or ten pence, and is divided into 100 centimes.
franc-tireur |A French partisan soldier, or one belonging to a corps of detached light troops engaged in forays, skirmishes, scouting, etc.
franchise |1. Exemption from constraint or oppression; freedom; liberty. [Obs.] Spenser. 2. (LAw)  A particular privilege conferred by grant from a sovereign or a government, and vested in individuals; an imunity or exemption from ordinary jurisdiction; a constitutional or statutory right or privilege, esp. the right to vote. Election by universal suffrage, as modified by the Constitution, is the one crowning franchise of the American people. W. H. Seward. 3. The district or jurisdiction to which a particular privilege extends; the limits of an immunity; hence, an asylum or sanctuary. Churches and mobasteries in Spain are franchises for criminals. London Encyc. 4. Magnanimity; generosity; liberality; frankness; nobility. \"Franchise in woman.\" [Obs.] Chaucer. Elective franchise, the privilege or right of voting in an election of public officers.\n\nTo make free; to enfranchise; to give liberty to. Shak.
franchisement |Release; deliverance; freedom. Spenser.
francic |Pertaining to the Franks, or their language; Frankish.
franciscan |Belonging to the Order of St. Francis of the Franciscans. Franciscan Brothers, pious laymen who devote themselves to useful works, such as manual labor schools, and other educational institutions; -- called also Brothers of the Third Order of St. Francis. -- Franciscan Nuns, nuns who follow the rule of t. Francis, esp. those of the Second Order of St. Francis, -- called also Poor Clares or Minoresses. -- Franciscan Tertiaries, the Third Order of St. Francis.\n\nA monk or friar of the Order of St. Francis, a large and zealous order of mendicant monks founded in 1209 by St. Francis of Assisi. They are called also Friars Minor; and in England, Gray Friars, because they wear a gray habit.
francolin |A spurred partidge of the genus Francolinus and allied genera, of Asia and Africa. The common species (F. vulgaris) was formerly common in southern Europe, but is now nearly restricted to Asia.
francolite |A variety of apatite from Wheal Franco in Devonshire.
frangent |Causing fracture; breaking. [R.] H. Walpole.
frangibility |The state or quality of being frangible. Fox.
frangible |Capable of being broken; brittle; fragile; easily broken.
frangipane |1. A perfume of jasmine; frangipani. 2. A species of pastry, containing cream and almonds.
frangipani |A perfume derived from, or imitating the odor of, the flower of the red jasmine, a West Indian tree of the genus Plumeria.
frangipanni |A perfume derived from, or imitating the odor of, the flower of the red jasmine, a West Indian tree of the genus Plumeria.
frangulic |Pertaining to, or drived from, frangulin, or a species (Rhamnus Frangula) of the buckthorn. Frangulinic acid (Chem.), a yellow crystalline substance, resembling alizarin, and obtained by the decomposition of frangulin.
frangulin |A yellow crystalline dyestuff, regarded as a glucoside, extracted from a species (Rhamnus Frangula) of the buckthorn; -- called also rhamnoxanthin.
frangulinic |Pertaining to, or drived from, frangulin, or a species (Rhamnus Frangula) of the buckthorn. Frangulinic acid (Chem.), a yellow crystalline substance, resembling alizarin, and obtained by the decomposition of frangulin.
franion |A paramour; a loose woman; also, a gay, idle fellow. [Obs.] Spenser.
frank |A pigsty. [Obs.]\n\nTo shut up in a frank or sty; to pen up; hence, to cram; to fatten. [Obs.] Shak.\n\nThe common heron; -- so called from its note. [Prov. Eng.]\n\n1. Unbounded by restrictions, limitations, etc.; free. [R.] \"It is of frank gift.\" Spenser. 2. Free in uttering one's real sentiments; not reserved; using no disguise; candid; ingenuous; as, a frank nature, conversation, manner, etc. 3. Liberal; generous; profuse. [Obs.] Frank of civilities that cost them nothing. L'Estrange. 4. Unrestrained; loose; licentious; -- used in a bad sense. Spenser. Syn. -- Ingenuous; candid; artless; plain; open; unreserved; undisguised; sincere. See Candid, Ingenuous.\n\n1. To send by public conveyance free of expense. Dickens. 2. To extempt from charge for postage, as a letter, package, or packet, etc.\n\nThe privilege of sending letters or other mail matter, free of postage, or without charge; also, the sign, mark, or signature denoting that a letter or other mail matter is to free of postage. I have said so much, that, if I had not a frank, I must burn my letter and begin again. Cowper.\n\n1. (Ethnol.)  A member of one of the German tribes that in the fifth century overran and conquered Gaul, and established the kingdom of France. 2. A native or inhabitant of Western Europe; a European; -- a term used in the Levant. 3. A French coin. See Franc.
frank-chase |The liberty or franchise of having a chase; free chase. Burrill.
frank-fee |A species of tenure in fee simple, being the opposite of ancient demesne, or copyhold. Burrill.
frank-law |The liberty of being sworn in courts, as a juror or witness; one of the ancient privileges of a freeman; free and common law; -- an obsolete expression signifying substantially the same as the American expression civil rights. Abbot.
frank-marriage |A certain tenure in tail special; an estate of inheritance given to a man his wife (the wife being of the blood of the donor), and descendible to the heirs of their two bodies begotten. [Obs.] Blackstone.
frankalmoigne |A tenure by which a religious corporation holds lands given to them and their successors forever, usually on condition of praying for the soul of the donor and his heirs; -- called also tenure by free alms. Burrill.
frankfort black |. A black pigment used in copperplate printing, prepared by burning vine twigs, the lees of wine, etc. McElrath.
frankincense |A fragrant, aromatic resin, or gum resin, burned as an incense in religious rites or for medicinal fumigation. The best kinds now come from East Indian trees, of the genus Boswellia; a commoner sort, from the Norway spruce (Abies excelsa) and other coniferous trees. The frankincense of the ancient Jews is still unidentified.
franking |A method of forming a joint at the intersection of window-sash bars, by cutting away only enough wood to show a miter.
frankish |Like, or pertaining to, the Franks.
franklin |An English freeholder, or substantial householder. [Obs.] Chaucer. The franklin, a small landholder of those days. Sir J. Stephen.
franklin stove |. A kind of open stove introduced by Benjamin Franklin, the peculiar feature of which was that a current of heated air was directly supplied to the room from an air box; -- now applied to other varieties of open stoves.
franklinic |Of or pertaining to Benjamin Franklin. Franklinic electricity, electricity produced by friction; called also statical electricity.
franklinite |A kind of mineral of the spinel group.
frankly |In a frank manner; freely. Very frankly he confessed his treasons. Shak. Syn. -- Openly; ingenuously; plainly; unreservedly; undisguisedly; sincerely; candidly; artlessly; freely; readily; unhesitatingly; liberally; willingly.
frankness |The quality of being frank; candor; openess; ingenuousness; fairness; liberality.
frankpledge |(a) A pledge or surety for the good behavior of freemen, -- each freeman who was a member of an ancient decennary, tithing, or friborg, in England, being a pledge for the good conduct of the others, for the preservation of the public peace; a free surety. (b) The tithing itself. Bouvier. The servants of the crown were not, as now, bound in frankpledge for each other. Macaulay.
frantic |Mad; raving; furious; violent; wild and disorderly; distracted. Die, frantic wretch, for this accursed deed! Shak. Torrents of frantic abuse. Macaulay. -- Fran\"tic*al*ly, adv. -- Fran\"tic*ly, adv. Shak. -- Fran\"tic*ness, n. Johnson.
frap |1. (Naut.)  To draw together; to bind with a view to secure and strengthen, as a vessel by passing cables around it; to tighten; as a tackle by drawing the lines together. Tottem. 2. To brace by drawing together, as the cords of a drum. Knoght.
frape |A crowd, a rabble. [Obs.] ares.
frapler |A blusterer; a rowdy. [Obs.] Unpolished, a frapler, and base. B. Jonson.
frappe |Iced; frozen; artificially cooled; as, wine frappé. -- n.  A frappé mixture or beverage, as a water ice, variously flavored, frozen soft, and served in glasses.
frapping |A lashing binding a thing tightly or binding things together.
frater |A monk; also, a frater house. [R.] Shipley. Frater house, an apartament in a convent used as an eating room; a refectory; -- called also a fratery.
fraternal |Pf, pertaining to, or involving, brethren; becoming to brothers; brotherly; as, fraternal affection; a fraternal embrace. -- Fra*ter\"nal*ly, adv. An abhorred, a cursed, a fraternal war. Milton. Fraternal love and friendship. Addison.
fraternate |To fraternize; to hold fellowship. Jefferson.
fraternation |Fraternization. [R.] Jefferson.
fraternism |Fraternization. [R.] Jefferson.
fraternity |1. The state or quality of being fraternal or brotherly; brotherhood. 2. A body of men associated for their common interest, business, or pleasure; a company; a brotherhood; a society; in the Roman Catholic Chucrch, an association for special religious purposes, for relieving the sick and destitute, etc. 3. Men of the same class, profession, occupation, character, or tastes. With what terms of respect knaves and sots will speak of their own fraternity! South.
fraternization |The act of fraternizing or uniting as brothers. I hope that no French fraternization . . . could so change the hearts of Englishmen. Burke.
fraternize |To associate or hold fellowship as brothers, or as men of like occupation or character; to have brotherly feelings.\n\nTo bring into fellowship or brotherly sympathy. Correspondence for fraternizing the two nations. Burke.
fraternizer |One who fraternizes. Burke.
fratery |A frater house. See under Frater.
fratrage |A sharing among brothers, or brothers' kin. [Obs.] Crabb.
fratricelli |(a) The name which St. Francis of Assisi gave to his followers, early in the 13th century. (b) A sect which seceded from the Franciscan Order, chiefly in Italy and Sicily, in 1294, repudiating the pope as an apostate, maintaining the duty of celibacy and poverty, and discountenancing oaths. Called also Fratricellians and Fraticelli.
fratricidal |Of or pertaining to fratricide; of the nature of fratricide.
fratricide |1. The act of one who murders or kills his own brother. 2. Etym: [L. fratricida: cf. F. fratricide.]  One who murders or kills his own brother.
frau |In Germany, a woman; a married woman; a wife; -- as a title, equivalent to Mrs., Madam.
fraud |1. Deception deliberately practiced with a view to gaining an unlawful or unfair advantage; artifice by which the right or interest of another is injured; injurious stratagem; deceit; trick. If success a lover's toil attends, Few ask, if fraud or force attained his ends. Pope. 2. (Law)  An intentional perversion of truth for the purpose of obtaining some valuable thing or promise from another. 3. A trap or snare. [Obs.] To draw the proud King Ahab into fraud. Milton. Constructive fraud (Law), an act, statement, or omission which operates as a fraud, although perhaps not intended to be such. Mozley & W. -- Pious fraud (Ch. Hist.), a fraud contrived and executed to benefit the church or accomplish some good end, upon the theory that the end justified the means. -- Statute of frauds (Law), an English statute (1676), the principle of which is incorporated in the legislation of all the States of this country, by which writing with specific solemnities (varying in the several statutes) is required to give efficacy to certain dispositions of property. Wharton. Syn. -- Deception; deceit; guile; craft; wile; sham; strife; circumvention; stratagem; trick; imposition; cheat. See Deception.
fraudful |Full of fraud, deceit, or treachery; trickish; treacherous; fraudulent; -- applied to persons or things. I. Taylor. -- Fraud\"ful*ly, adv.
fraudless |Free from fraud. -- Fraud\"less*ly, adv. -- Fraud\"less*ness, n.
fraudulence |The quality of being fraudulent; deliberate deceit; trickishness. Hooker.
fraudulency |The quality of being fraudulent; deliberate deceit; trickishness. Hooker.
fraudulent |1. Using fraud; trickly; deceitful; dishonest. 2. Characterized by,, founded on, or proceeding from, fraund; as, a fraudulent bargain. He, with serpent tongue, . . . His fraudulent temptation thus began. Milton. 3. Obtained or performed by artifice; as, fraudulent conquest. Milton. Syn. -- Deceitful; fraudful; guileful; crafty; wily; cunning; subtle; deceiving; cheating; deceptive; insidious; treacherous; dishonest; designing; unfair.
fraudulently |In a fraudulent manner.
fraught |A freight; a cargo. [Obs.] Shak.\n\nFreighted; laden; filled; stored; charged. A vessel of our country richly fraught. Shak. A discourse fraught with all the commending excellences oSouth. Enterprises fraught with world-wide benefits. I. Taylor.\n\nTo freight; to load; to burden; to fill; to crowd. [Obs.] Upon the tumbling billows fraughted ride The armed ships. Fairfax.
fraughtage |Freight; loading; cargo. [Obs.] Shak.
fraughting |Constituting the freight or cargo. [Obs.] \"The fraughting souls within her.\" Shak.
fraulein |In Germany, a young lady; an unmarried woman; -- as a title, equivalent to Miss.
fraunhofer lines |The lines of the spectrun; especially and properly, the dark lines of the solar spectrum, so called because first accurately observed and interpreted by Fraunhofer, a German physicist.
fraxin |A colorless crystalline substance, regarded as a glucoside, and found in the bark of the ash (Fraxinus) and along with esculin in the bark of the horse-chestnut. It shows a delicate fluorescence in alkaline solutions; -- called also paviin.
fraxinus |A genus of deciduous forest trees, found in the north temperate zone, and including the true ash trees. Note: Fraxinus excelsior is the European ash; F. Americana, the white ash; F. sambucifolia, the black ash or water ash.
fray |Affray; broil; contest; combat. Who began this bloody fray Shak.\n\nTo frighten; to terrify; to alarm. I. Taylor. What frays ye, that were wont to comfort me affrayed Spenser.\n\nTo bear the expense of; to defray. [Obs.] The charge of my most curious and costly ingredients frayed, I shall acknowledge myself amply satisfied. Massinger.\n\nTo rub; to wear off, or wear into shreds, by rubbing; to fret, as cloth; as, a deer is said to fray her head.\n\n1. To rub. We can show the marks he made When 'gainst the oak his antlers frayed. Sir W. Scott. 2. To wear out or into shreads, or to suffer injury by rubbing, as when the threads of the warp or of the woof wear off so that the cross threads are loose; to ravel; as, the cloth frays badly. A suit of frayed magnificience. tennyson.\n\nA fret or chafe, as in cloth; a place injured by rubbing.
fraying |The skin which a deer frays from his horns. B. Jonson.
frazzle |To fray; to wear or pull into tatters or tag ends; to tatter; - -used literally and figuratively. [Prov. Eng. & U. S.] Her hair was of a reddish gray color, and its frazzled and tangled condition suggested that the woman had recently passed through a period of extreme excitement. J. C. Harris.\n\nThe act or result of frazzling; the condition or quality of being frazzled; the tag end; a frayed-out end. [Prov. Eng. & U. S.] My fingers are all scratched to frazzles. Kipling. Gordon had sent word to Lee that he \"had fought his corps to a frazzle.\" Nicolay & Hay (Life of Lincoln).
freak |To variegate; to checker; to streak. [R.] Freaked with many a mingled hue. Thomson.\n\nA sudden causeless change or turn of the mind; a whim of fancy; a capricious prank; a vagary or caprice. She is restless and peevish, and sometimes in a freak will instantly change her habitation. Spectator. Syn. -- Whim; caprice; folly; sport. See Whim.
freaking |Freakish. [Obs.] Pepys.
freakish |Apt to change the mind suddenly; whimsical; capricious. It may be a question whether the wife or the woman was the more freakish of the two. L'Estrange. Freakish when well, and fretful when she's sick. Pope. -- Freak\"ish*ly, adv. -- Freak\"ish*ness, n.
freck |To checker; to diversify. [R. & Poet.] The painted windows, frecking gloom with glow. Lowell.
freckle |1. A small yellowish or brownish spot in the skin, particularly on the face, neck, or hands. 2. Any small spot or discoloration.\n\nTo spinkle or mark with freckle or small discolored spots; to spot.\n\nTo become covered or marked with freckles; to be spotted.
freckled |Marked with freckles; spotted. \"The freckled trout.\" Dryden. The freckled cowslip, burnet, and green clover. Shak.
freckledness |The state of being freckled.
freckly |Full of or marked with freckles; sprinkled with spots; freckled.
fred |Peace; -- a word used in composition, especially in proper names; as, Alfred; Frederic.
fredstole |See Fridstol. Fuller.
free |1. Exempt from subjection to the will of others; not under restraint, control, or compulsion; able to follow one's own impulses, desires, or inclinations; determining one's own course of action; not dependent; at liberty. That which has the power, or not the power, to operate, is that alone which is or is not free. Locke. 2. Not under an arbitrary or despotic government; subject only to fixed laws regularly and fairly administered, and defended by them from encroachments upon natural or acquired rights; enjoying political liberty. 3. Liberated, by arriving at a certain age, from the control of parents, guardian, or master. 4. Not confined or imprisoned; released from arrest; liberated; at liberty to go. Set an unhappy prisoner free. Prior. 5. Not subjected to the laws of physical necessity; capable of voluntary activity; endowed with moral liberty; -- said of the will. Not free, what proof could they have given sincere Of true allegiance, constant faith, or love. Milton. 6. Clear of offense or crime; guiltless; innocent. My hands are guilty, but my heart is free. Dryden. 7. Unconstrained by timidity or distrust; unreserved; ingenuous; frank; familiar; communicative. He was free only with a few. Milward. 8. Unrestrained; immoderate; lavish; licentious; -- used in a bad sense. The critics have been very free in their censures. Felton. A man may live a free life as to wine or women. Shelley. 9. Not close or parsimonious; liberal; open-handed; lavish; as, free with his money. 10. Exempt; clear; released; liberated; not encumbered or troubled with; as, free from pain; free from a burden; -- followed by from, or, rarely, by of. Princes declaring themselves free from the obligations of their treaties. Bp. Burnet. 11. Characteristic of one acting without restraint; charming; easy. 12. Ready; eager; acting without spurring or whipping; spirited; as, a free horse. 13. Invested with a particular freedom or franchise; enjoying certain immunities or privileges; admitted to special rights; -- followed by of. He therefore makes all birds, of every sect, Free of his farm. Dryden. 14. Thrown open, or made accessible, to all; to be enjoyed without limitations; unrestricted; not obstructed, engrossed, or appropriated; open; -- said of a thing to be possessed or enjoyed; as, a free school. Why, sir, I pray, are not the streets as free For me as for you Shak. 15. Not gained by importunity or purchase; gratuitous; spontaneous; as, free admission; a free gift. 16. Not arbitrary or despotic; assuring liberty; defending individual rights against encroachment by any person or class; instituted by a free people; -- said of a government, institutions, etc. 17. (O. Eng. Law)  Certain or honorable; the opposite of base; as, free service; free socage. Burrill. 18. (Law)  Privileged or individual; the opposite of common; as, a free fishery; a free warren. Burrill. 19. Not united or combined with anything else; separated; dissevered; unattached; at liberty to escape; as, free carbonic acid gas; free cells. Free agency, the capacity or power of choosing or acting freely, or without necessity or constraint upon the will. -- Free bench (Eng. Law), a widow's right in the copyhold lands of her husband, corresponding to dower in freeholds. -- Free board (Naut.), a vessel's side between water line and gunwale. -- Free bond (Chem.), an unsaturated or unemployed unit, or bond, of affinity or valence, of an atom or radical. -- Free-borough men (O.Eng. Law). See Friborg. -- Free chapel (Eccles.), a chapel not subject to the jurisdiction of the ordinary, having been founded by the king or by a subject specially authorized. [Eng.] Bouvier. -- Free charge (Elec.), a charge of electricity in the free or statical condition; free electricity. -- Free church. (a) A church whose sittings are for all and without charge. (b) An ecclesiastical body that left the Church of Scotland, in 1843, to be free from control by the government in spiritual matters. -- Free city, or Free town, a city or town independent in its government and franchises, as formerly those of the Hanseatic league. -- Free cost, freedom from charges or expenses. South. -- Free and easy, unconventional; unrestrained; regardless of formalities. [Colloq.] \"Sal and her free and easy ways.\" W. Black. -- Free goods, goods admitted into a country free of duty. -- Free labor, the labor of freemen, as distinguished from that of slaves. -- Free port. (Com.) (a) A port where goods may be received and shipped free of custom duty. (b) A port where goods of all kinds are received from ships of all nations at equal rates of duty. -- Free public house, in England, a tavern not belonging to a brewer, so that the landlord is free to brew his own beer or purchase where he chooses. Simmonds. -- Free school. (a) A school to which pupils are admitted without discrimination and on an equal footing. (b) A school supported by general taxation, by endowmants, etc., where pupils pay nothing for tuition; a public school. -- Free services (O.Eng. Law), such feudal services as were not unbecoming the character of a soldier or a freemen to perform; as, to serve under his lord in war, to pay a sum of money, etc. Burrill. -- Free ships, ships of neutral nations, which in time of war are free from capture even though carrying enemy's goods. -- Free socage (O.Eng. Law), a feudal tenure held by certain services which, though honorable, were not military. Abbott. -- Free States, those of the United States before the Civil War, in which slavery had ceased to exist, or had never existed. -- Free stuff (Carp.), timber free from knots; clear stuff. -- Free thought, that which is thought independently of the authority of others. -- Free trade, commerce unrestricted by duties or tariff regulations. -- Free trader, one who believes in free trade. -- To make free with, to take liberties with; to help one's self to. [Colloq.] -- To sail free (Naut.), to sail with the yards not braced in as sharp as when sailing closehauled, or close to the wind.\n\n1. Freely; willingly. [Obs.] I as free forgive you As I would be forgiven. Shak. 2. Without charge; as, children admitted free.\n\n1. To make free; to set at liberty; to rid of that which confines, limits, embarrasses, oppresses, etc.; to release; to disengage; to clear; -- followed by from, and sometimes by off; as, to free a captive or a slave; to be freed of these inconveniences. Clarendon. Our land is from the rage of tigers freed. Dryden. Arise, . . . free thy people from their yoke. Milton. 2. To remove, as something that confines or bars; to relieve from the constraint of. This master key Frees every lock, and leads us to his person. Dryden. 3. To frank. [Obs.] Johnson.
free coinage |In the fullest sense, the conversion of bullion (of any specified metal) into legal-tender coins for any person who chooses to bring it to the mint; in a modified sense, such coinage when done at a fixed charge proportionate to the cost of the operation.
free silver |The free coinage of silver; often, specif., the free coinage of silver at a fixed ratio with gold, as at the ratio of 16 to 1, which ratio for some time represented nearly or exactly the ratio of the market values of gold and silver respectively.
free will |1. A will free from improper coercion or restraint. To come thus was I not constrained, but did On my free will. Shak. 2. The power asserted of moral beings of willing or choosing without the restraints of physical or absolute necessity.
free-denizen |To make free. [R.]
free-hand |Done by the hand, without support, or the guidance of instruments; as, free-hand drawing. See under Drawing.
free-handed |Open-handed; liberal.
free-hearted |Open; frank; unreserved; liberal; generous; as, free-hearted mirth. -- Free\"-heart`ed*ly, adv. -- Free\"-heart`ed*ness, n.
free-liver |One who gratifies his appetites without stint; one given to indulgence in eating and drinking.
free-living |Unrestrained indulgence of the appetites.
free-love |The doctrine or practice of consorting with the opposite sex, at pleasure, without marriage.
free-lover |One who believes in or practices free-love.
free-martin |An imperfect female calf, twinborn with a male.
free-milling |Yielding free gold or silver; -- said of certain ores which can be reduced by crushing and amalgamation, without roasting or other chemical treatment. Raymond.
free-minded |Not perplexed; having a mind free from care. Bacon.
free-soil |Pertaining to, or advocating, the non-extension of slavery; -- esp. applied to a party which was active during the period 1846-1856. [U.S.] -- Free\"soil`er, n. [U.S.] -- Free\"-soil`ism, n. [U.S.]
free-spoken |Accustomed to speak without reserve. Bacon. -- Free\"-spo`ken-ness, n.
free-swimming |Swimming in the open sea; -- said of certain marine animals.
free-tongued |Speaking without reserve. Bp. Hall.
freebooter |One who plunders or pillages without the authority of national warfare; a member of a predatory band; a pillager; a buccaneer; a sea robber. Bacon.
freebootery |The act, practice, or gains of a freebooter; freebooting. Booth.
freebooting |Robbery; plunder; a pillaging.\n\nActing the freebooter; practicing freebootery; robbing. Your freebooting acquaintance. Sir W. Scott.
