genteel |1. Possessing or exhibiting the qualities popularly regarded as belonging to high birth and breeding; free from vulgarity, or lowness of taste or behavior; adapted to a refined or cultivated taste; polite; well-bred; as, genteel company, manners, address. 2. Graceful in mien or form; elegant in appearance, dress, or manner; as, the lady has a genteel person. Law. 3. Suited to the position of lady or a gentleman; as, to live in a genteel allowance. Syn. -- Polite; well-bred; refined; polished.
genteelish |Somewhat genteel.
genteelly |In a genteel manner.
genteelness |The quality of being genteel.
genterie |Nobility of birth or of character; gentility. [Obs.] Chaucer.
gentian |Any one of a genus (Gentiana) of herbaceous plants with opposite leaves and a tubular four- or five-lobed corolla, usually blue, but sometimes white, yellow, or red. See Illust. of Capsule. Note: Many species are found on the highest mountains of Europe, Asia, and America, and some are prized for their beauty, as the Alpine (Gentiana verna, Bavarica, and excisa), and the American fringed gentians (G. crinita and G. detonsa). Several are used as tonics, especially the bitter roots of Gentiana lutea, the officinal gentian of the pharmacopoeias. Horse gentian, fever root. -- Yellow gentian (Bot.), the officinal gentian (Gentiana lutea). See Bitterwort.
gentianaceous |Of or pertaining to a natural order of plants (Gentianaceæ) of which the gentian is the type.
gentianella |A kind of blue color. Johnson.
gentianic |Pertaining to or derived from the gentian; as, gentianic acid.
gentianine |A bitter, crystallizable substance obtained from gentian.
gentianose |A crystallizable, sugarlike substance, with a slightly sweetish taste, obtained from the gentian.
gentil |Gentle. [Obs.] Chaucer.
gentile |One of a non-Jewish nation; one neither a Jew nor a Christian; a worshiper of false gods; a heathen. Note: The Hebrews included in the term goyim, or nations, all the tribes of men who had not received the true faith, and were not circumcised. The Christians translated goyim by the L. gentes, and imitated the Jews in giving the name gentiles to all nations who were neither Jews nor Christians. In civil affairs, the denomination was given to all nations who were not Romans. Syn. -- Pagan; heathen. See Pagan.\n\n1. Belonging to the nations at large, as distinguished from the Jews; ethnic; of pagan or heathen people. 2. (Gram.)  Denoting a race or country; as, a gentile noun or adjective.
gentile-falcon |See Falcon-gentil.
gentilesse |Gentleness; courtesy; kindness; nobility. [Obs.] Chaucer.
gentilish |Heathenish; pagan.
gentilism |1. Hethenism; paganism; the worship of false gods. 2. Tribal feeling; devotion to one's gens.
gentilitial |1. Peculiar to a people; national. Sir T. Browne. 2. Hereditary; entailed on a family. Arbuthnot.
gentilitious |1. Peculiar to a people; national. Sir T. Browne. 2. Hereditary; entailed on a family. Arbuthnot.
gentility |1. Good extraction; dignity of birth. Macaulay. He . . . mines my gentility with my education. Shak. 2. The quality or qualities appropriate to those who are well born, as self-respect, dignity, courage, courtesy, politeness of manner, a graceful and easy mien and behavior, etc.; good breeding. 3. The class in society who are, or are expected to be, genteel; the gentry. [R.] Sir J. Davies. 4. Paganism; heathenism. [Obs.] Hooker.
gentilize |1. To live like a gentile or heathen. [Obs.] Milton. 2. To act the gentleman; -- with it (see It, 5). [Obs.]\n\nTo render gentile or gentlemanly; as, to gentilize your unworthy sones. [R.] Sylvester.
gentilly |In a gentle or hoble manner; frankly. [Obs.] Chaucer.
gentiopikrin |A bitter, yellow, crystalline substance, regarded as a glucoside, and obtained from the gentian.
gentisin |A tasteless, yellow, crystalline substance, obtained from the gentian; -- called also gentianin.
gentle |1. Well-born; of a good family or respectable birth, though not noble. British society is divided into nobility, gentry, and yeomanry, and families are either noble, gentle, or simple. Johnson's Cyc. The studies wherein our noble and gentle youth ought to bestow their time. Milton. 2. Quiet and refined in manners; not rough, harsh, or stern; mild; meek; bland; amiable; tender; as, a gentle nature, temper, or disposition; a gentle manner; a gentle address; a gentle voice. 3. A compellative of respect, consideration, or conciliation; as, gentle reader. \"Gentle sirs.\" \"Gentle Jew.\" \"Gentle servant.\" Shak. 4. Not wild, turbulent, or refractory; quiet and docile; tame; peaceable; as, a gentle horse. 5. Soft; not violent or rough; not strong, loud, or disturbing; easy; soothing; pacific; as, a gentle touch; a gentle gallop. \"Gentle music.\" Sir J. Davies. O sleep! it is a gentle thing. Coleridge. The gentle craft, the art or trade of shoemaking. Syn. -- Mild; meek; placid; dovelike; quiet; peaceful; pacific; bland; soft; tame; tractable; docile. -- Gentle, Tame, Mild, Meek. Gentle describes the natural disposition; tame, that which is subdued by training; mild implies a temper which is, by nature, not easily provoked; meek, a spirit which has been schooled to mildness by discipline or suffering. The lamb is gentle; the domestic fowl is tame; John, the Apostle, was mild; Moses was meek.\n\n1. One well born; a gentleman. [Obs.] Gentles, methinks you frown. Shak. 2. A trained falcon. See Falcon-gentil. 3. (Zoöl.)  A dipterous larva used as fish bait.\n\n1. To make genteel; to raise from the vulgar; to ennoble. [Obs.] Shak. 2. To make smooth, cozy, or agreeable. [R. or Poet.] To gentle life's descent, We shut our eyes, and think it is a plain. Young. 3. To make kind and docile, as a horse. [Colloq.]
gentle-hearted |Having a kind or gentle disposition. Shak. -- Gen\"tle-heart`ed*ness, n.
gentlefolk |Persons of gentle or good family and breeding. Etym: [Generally in the United States in the plural form.] Shak.
gentlefolks |Persons of gentle or good family and breeding. Etym: [Generally in the United States in the plural form.] Shak.
gentleman |1. A man well born; one of good family; one above the condition of a yeoman. 2. One of gentle or refined manners; a well-bred man. 3. (Her.)  One who bears arms, but has no title. 4. The servant of a man of rank. The count's gentleman, one Cesario. Shak. 5. A man, irrespective of condition; -- used esp. in the plural (= citizens; people), in addressing men in popular assemblies, etc. Note: In Great Britain, the term gentleman is applied in a limited sense to those having coats of arms, but who are without a title, and, in this sense, gentlemen hold a middle rank between the nobility and yeomanry. In a more extended sense, it includes every man above the rank of yeoman, comprehending the nobility. In the United States, the term is applied to men of education and good breeding of every occupation. Gentleman commoner, one of the highest class of commoners at the University of Oxford. -- Gentleman usher, one who ushers visitors into the presence of a sovereign, etc. -- Gentleman usher of the black rod, an usher belonging to the Order of the Garter, whose chief duty is to serve as official messenger of the House of Lords. -- Gentlemen-at-arms, a band of forty gentlemen who attend the sovereign on state occasions; formerly called gentlemen pensioners. [Eng.]
gentlemanhood |The qualities or condition of a gentleman. [R.] Thackeray.
gentlemanlike |Of, pertaining to, resembling, or becoming, a gentleman; well- behaved; courteous; polite.
gentlemanliness |The state of being gentlemanly; gentlemanly conduct or manners.
gentlemanly |Of, pertaining to, resembling, or becoming, a gentleman; well- behaved; courteous; polite.
gentlemanship |The carriage or quality of a gentleman. GENTLEMEN'S AGREEMENT Gen\"tle*men's a*gree\"ment.  An agreement binding only as a matter of honor; often, specif., such an agreement among the heads of industrial or merchantile enterprises, the terms of which could not be included and enforced in a legal contract.
gentleness |The quality or state of being gentle, well-born, mild, benevolent, docile, etc.; gentility; softness of manners, disposition, etc.; mildness.
gentleship |The deportment or conduct of a gentleman. [Obs.] Ascham.
gentlesse |Gentilesse; gentleness. [Obs.]
gentlewoman |1. A woman of good family or of good breeding; a woman above the vulgar. Bacon. 2. A woman who attends a lady of high rank. Shak.
gently |In a gentle manner. My mistress gently chides the fault I made. Dryden.
gentoo |A native of Hindostan; a Hindoo. [Archaic]
gentrie |Nobility of birth or of character; gentility. [Obs.] Chaucer.
gentry |1. Birth; condition; rank by birth. [Obs.] \"Pride of gentrie.\" Chaucer. She conquers him by high almighty Jove, By knighthood, gentry, and sweet friendship's oath. Shak. 2. People of education and good breeding; in England, in a restricted sense, those between the nobility and the yeomanry. Macaulay. 3. Courtesy; civility; complaisance. [Obs.] To show us so much gentry and good will. Shak.
genty |Neat; trim. [Scot.] Burns.
genu |(a) The knee. (b) The kneelike bend, in the anterior part of the callosum of the brain.
genuflect |To bend the knee, as in worship.
genuflection |The act of bending the knee, particularly in worship. Bp. Stillingfleet.
genuine |Belonging to, or proceeding from, the original stock; native; hence, not counterfeit, spurious, false, or adulterated; authentic; real; natural; true; pure; as, a genuine text; a genuine production; genuine materials. \"True, genuine night.\" Dryden. Syn. -- Authentic; real; true; pure; unalloyed; unadulterated. See Authentic. -- Gen\"u*ine*ly, adv. -- Gen\"u*ine*ness, n. The evidence, both internal and external, against the genuineness of these letters, is overwhelming. Macaulay.
genus |1. (Logic)  A class of objects divided into several subordinate species; a class more extensive than a species; a precisely defined and exactly divided class; one of the five predicable conceptions, or sorts of terms. 2. (Biol.)  An assemblage of species, having so many fundamental points of structure in common, that in the judgment of competent scientists, they may receive a common substantive name. A genus is not necessarily the lowest definable group of species, for it may often be divided into several subgenera. In proportion as its definition is exact, it is natural genus; if its definition can not be made clear, it is more or less an artificial genus. Note: Thus in the animal kingdom the lion, leopard, tiger, cat, and panther are species of the Cat kind or genus, while in the vegetable kingdom all the species of oak form a single genus. Some genera are represented by a multitude of species, as Solanum (Nightshade) and Carex (Sedge), others by few, and some by only one known species. Subaltern genus (Logic), a genus which may be a species of a higher genus, as the genus denoted by quadruped, which is also a species of mammal. -- Summum genus Etym: [L.] (Logic), the highest genus; a genus which can not be classed as a species, as being .
genys |See Conys.
geocentric |(a) Having reference to the earth as center; in relation to or seen from the earth, -- usually opposed to heliocentric, as seen from the sun; as, the geocentric longitude or latitude of a planet. (b) Having reference to the center of the earth. Geocentric latitude (of place) the angle included between the radius of the earth through the place and the plane of the equator, in distinction from geographic latitude. It is a little less than the geographic latitude.
geocentrical |(a) Having reference to the earth as center; in relation to or seen from the earth, -- usually opposed to heliocentric, as seen from the sun; as, the geocentric longitude or latitude of a planet. (b) Having reference to the center of the earth. Geocentric latitude (of place) the angle included between the radius of the earth through the place and the plane of the equator, in distinction from geographic latitude. It is a little less than the geographic latitude.
geocentrically |In a geocentric manner.
geochemistry |The study of the chemical composition of, and of actual or possible chemical changes in, the crust of the earth. -- Ge`o*chem\"ic*al (#), a. --Ge`o*chem\"ist (#), n.
geocronite |A lead-gray or grayish blue mineral with a metallic luster, consisting of sulphur, antimony, and lead, with a small proportion of arsenic.
geocyclic |1. Of, pertaining to, or illustrating, the revolutions of the earth; as, a geocyclic machine. 2. Circling the earth periodically.
geode |(a) A nodule of stone, containing a cavity, lined with crystals or mineral matter. (b) The cavity in such a nodule.
geodephagous |Living in the earth; -- applied to the ground beetles.
geodesic |Of or pertaining to geodetic.\n\nA geodetic line or curve.
geodesical |Of or pertaining to geodetic.
geodesist |One versed in geodesy.
geodesy |That branch of applied mathematics which determines, by means of observations and measurements, the figures and areas of large portions of the earth's surface, or the general figure and dimenshions of the earth; or that branch of surveying in which the curvature of the earth is taken into account, as in the surveys of States, or of long lines of coast.
geodetic |Of or pertaining to gebdesy; obtained or determined by the operations of geodesy; engaged in geodesy; geodesic; as, geodetic surveying; geodetic observers. Geodetic line or curve, the shortest line that can be drawn between two points on the elipsoidal surface of the earth; a curve drawn on any given surface so that the osculating plane of the curve at every point shall contain the normal to the surface; the minimum line that can be drawn on any surface between any two points.
geodetical |Of or pertaining to gebdesy; obtained or determined by the operations of geodesy; engaged in geodesy; geodesic; as, geodetic surveying; geodetic observers. Geodetic line or curve, the shortest line that can be drawn between two points on the elipsoidal surface of the earth; a curve drawn on any given surface so that the osculating plane of the curve at every point shall contain the normal to the surface; the minimum line that can be drawn on any surface between any two points.
geodetically |In a geodetic manner; according to geodesy.
geodetics |Same as Geodesy.
geodiferous |Producing geodes; containing geodes.
geoduck |A gigantic clam (Glycimeris generosa) of the Pacific coast of North America, highly valued as an article of food.
geognosis |Knowledge of the earth. [R.] G. Eliot.
geognost |One versed in geognosy; a geologist. [R.]
geognostic |Of or pertaining to geognosy, or to a knowledge of the structure of the earth; geological. [R.]
geognostical |Of or pertaining to geognosy, or to a knowledge of the structure of the earth; geological. [R.]
geognosy |That part of geology which treats of the materials of the earth's structure, and its general exterior and interior constitution.
geogonic |Of or pertaining to geogony, or to the formation of the earth.
geogonical |Of or pertaining to geogony, or to the formation of the earth.
geogony |The branch of science which treats of the formation of the earth.
geographer |One versed in geography.
geographic |Of or pertaining to geography. Geographical distribution. See under Distribution. -- Geographic latitude (of a place), the angle included between a line perpendicular or normal to the level surface of water at rest at the place, and the plane of the equator; differing slightly from the geocentric latitude by reason of the difference between the earth's figure and a true sphere. -- Geographical mile. See under Mile. -- Geographical variation, any variation of a species which is dependent on climate or other geographical conditions.
geographical |Of or pertaining to geography. Geographical distribution. See under Distribution. -- Geographic latitude (of a place), the angle included between a line perpendicular or normal to the level surface of water at rest at the place, and the plane of the equator; differing slightly from the geocentric latitude by reason of the difference between the earth's figure and a true sphere. -- Geographical mile. See under Mile. -- Geographical variation, any variation of a species which is dependent on climate or other geographical conditions.
geographically |In a geographical manner or method; according to geography.
geography |1. The science which treats of the world and its inhabitants; a description of the earth, or a portion of the earth, including its structure, fetures, products, political divisions, and the people by whom it is inhabited. 2. A treatise on this science. Astronomical, or Mathematical, geography treats of the earth as a planet, of its shape, its size, its lines of latitude and longitude, its zones, and the phenomena due to to the earth's diurnal and annual motions. -- Physical geography treats of the conformation of the earth's surface, of the distribution of land and water, of minerals, plants, animals, etc., and applies the principles of physics to the explanation of the diversities of climate, productions, etc. -- Political geography treats of the different countries into which earth is divided with regard to political and social and institutions and conditions.
geolatry |The worship of the earth. G. W. Cox. The Geological Series. Note: The science of geology, as treating of the history of the globe, involves a description of the different strata which compose its crust, their order of succession, characteristic forms of animal and vegetable life, etc. The principal subdivisions of geological time, and the most important strata, with their relative positions, are indicated in the following diagram.
geologer |A geologist.
geologian |A geologist.
geologic |Of or pertaining to geology, or the science of the earth.
geological |Of or pertaining to geology, or the science of the earth.
geologically |In a geological manner.
geologist |One versed in the science of geology.
geologize |To study geology or make geological investigations in the field; to discourse as a geologist. During midsummer geologized a little in Shropshire. Darwin.
geology |1. The science which treats: (a) Of the structure and mineral constitution of the globe; structural geology. (b) Of its history as regards rocks, minerals, rivers, valleys, mountains, climates, life, etc.; historical geology. (c) Of the causes and methods by which its structure, features, changes, and conditions have been produced; dynamical geology. See Chart of The Geological Series. 2. A treatise on the science.
geomalism |The tendency of an organism to respond, during its growth, to the force of gravitation.
geomancer |One who practices, or is versed in, geomancy.
geomancy |A kind of divination by means of figures or lines, formed by little dots or points, originally on the earth, and latterly on paper.
geomantic |Pertaining or belonging to geomancy.
geomantical |Pertaining or belonging to geomancy.
geometer |1. One skilled in geometry; a geometrician; a mathematician. I. Watts. 2. (Zoöl.)  Any species of geometrid moth; a geometrid.
geometral |Pertaining to geometry. [Obs.]
geometric |Pertaining to, or according to the rules or principles of, geometry; determined by geometry; as, a geometrical solution of a problem. Note: Geometric is often used, as opposed to algebraic, to include processes or solutions in which the propositions or principles of geometry are made use of rather than those of algebra. Note: Geometrical is often used in a limited or strictly technical sense, as opposed to mechanical; thus, a construction or solution is geometrical which can be made by ruler and compasses, i. e., by means of right lines and circles. Every construction or solution which requires any other curve, or such motion of a line or circle as would generate any other curve, is not geometrical, but mechanical. By another distinction, a geometrical solution is one obtained by the rules of geometry, or processes of analysis, and hence is exact; while a mechanical solution is one obtained by trial, by actual measurements, with instruments, etc., and is only approximate and empirical. Geometrical curve. Same as Algebraic curve; -- so called because their different points may be constructed by the operations of elementary geometry. -- Geometric lathe, an instrument for engraving bank notes, etc., with complicated patterns of interlacing lines; -- called also cycloidal engine. -- Geometrical pace, a measure of five feet. -- Geometric pen, an instrument for drawing geometric curves, in which the movements of a pen or pencil attached to a revolving arm of ajustable length may be indefinitely varied by changing the toothed wheels which give motion to the arm. -- Geometrical plane (Persp.), the same as Ground plane . -- Geometrical progression, proportion, ratio. See under Progression, Proportion and Ratio. -- Geometrical radius, in gearing, the radius of the pitch circle of a cogwheel. Knight. -- Geometric spider (Zoöl.), one of many species of spiders, which spin a geometrical web. They mostly belong to Epeira and allied genera, as the garden spider. See Garden spider. -- Geometric square, a portable instrument in the form of a square frame for ascertaining distances and heights by measuring angles. -- Geometrical staircase, one in which the stairs are supported by the wall at one end only. -- Geometrical tracery, in architecture and decoration, tracery arranged in geometrical figures.
geometrical |Pertaining to, or according to the rules or principles of, geometry; determined by geometry; as, a geometrical solution of a problem. Note: Geometric is often used, as opposed to algebraic, to include processes or solutions in which the propositions or principles of geometry are made use of rather than those of algebra. Note: Geometrical is often used in a limited or strictly technical sense, as opposed to mechanical; thus, a construction or solution is geometrical which can be made by ruler and compasses, i. e., by means of right lines and circles. Every construction or solution which requires any other curve, or such motion of a line or circle as would generate any other curve, is not geometrical, but mechanical. By another distinction, a geometrical solution is one obtained by the rules of geometry, or processes of analysis, and hence is exact; while a mechanical solution is one obtained by trial, by actual measurements, with instruments, etc., and is only approximate and empirical. Geometrical curve. Same as Algebraic curve; -- so called because their different points may be constructed by the operations of elementary geometry. -- Geometric lathe, an instrument for engraving bank notes, etc., with complicated patterns of interlacing lines; -- called also cycloidal engine. -- Geometrical pace, a measure of five feet. -- Geometric pen, an instrument for drawing geometric curves, in which the movements of a pen or pencil attached to a revolving arm of ajustable length may be indefinitely varied by changing the toothed wheels which give motion to the arm. -- Geometrical plane (Persp.), the same as Ground plane . -- Geometrical progression, proportion, ratio. See under Progression, Proportion and Ratio. -- Geometrical radius, in gearing, the radius of the pitch circle of a cogwheel. Knight. -- Geometric spider (Zoöl.), one of many species of spiders, which spin a geometrical web. They mostly belong to Epeira and allied genera, as the garden spider. See Garden spider. -- Geometric square, a portable instrument in the form of a square frame for ascertaining distances and heights by measuring angles. -- Geometrical staircase, one in which the stairs are supported by the wall at one end only. -- Geometrical tracery, in architecture and decoration, tracery arranged in geometrical figures.
geometrically |According to the rules or laws of geometry.
geometrician |One skilled in geometry; a geometer; a mathematician.
geometrid |Pertaining or belonging to the Geometridæ.\n\nOne of numerous genera and species of moths, of the family Geometridæ; -- so called because their larvæ (called loopers, measuring worms, spanworms, and inchworms) creep in a looping manner, as if measuring. Many of the species are injurious to agriculture, as the cankerworms.
geometrize |To investigate or apprehend geometrical quantities or laws; to make geometrical constructions; to proceed in accordance with the principles of geometry. Nature geometrizeth, and observeth order in all things. Sir T. Browne.
geometry |1. That branch of mathematics which investigates the relations, properties, and measurement of solids, surfaces, lines, and angles; the science which treats of the properties and relations of magnitudes; the science of the relations of space. 2. A treatise on this science. Analytical, or Coördinate, geometry, that branch of mathematical analysis which has for its object the analytical investigation of the relations and properties of geometrical magnitudes. -- Descriptive geometry, that part of geometry which treats of the graphic solution of all problems involving three dimensions. -- Elementary geometry, that part of geometry which treats of the simple properties of straight lines, circles, plane surface, solids bounded by plane surfaces, the sphere, the cylinder, and the right cone. -- Higher geometry, that pert of geometry which treats of those properties of straight lines, circles, etc., which are less simple in their relations, and of curves and surfaces of the second and higher degrees.
geophagism |The act or habit of eating earth. See Dirt eating, under Dirt. Dunglison.
geophagist |One who eats earth, as dirt, clay, chalk, etc.
geophagous |Earth-eating.
geophila |The division of Mollusca which includes the land snails and slugs.
geoponic |Pertaining to tillage of the earth, or agriculture.
geoponical |Pertaining to tillage of the earth, or agriculture.
geoponics |The art or science of cultivating the earth; agriculture. Evelin.
georama |A hollow globe on the inner surface of which a map of the world is depicted, to be examined by one standing inside.
geordie |A name given by miners to George Stephenson's safety lamp. Raymond.
george |1. A figure of St. George (the patron saint of England) on horseback, appended to the collar of the Order of the Garter. See Garter. 2. A kind of brown loaf. [Obs.] Dryden.
george noble |A gold noble of the time of Henry VIII. See Noble, n.
georgian |1. Of or pertaining to Georgia, in Asia, or to Georgia, one of the United States. 2. Of or relating to the reigns of the four Georges, kings of Great Britan; as, the Georgian era.\n\nA native of, or dweller in, Georgia.
georgian architecture |British or British colonial architecture of the period of the four Georges, especially that of the period before 1800.
georgic |A rural poem; a poetical composition on husbandry, containing rules for cultivating lands, etc.; as, the Georgics of Virgil.\n\nRelating to agriculture and rural affairs.
georgical |Relating to agriculture and rural affairs.
georgium sidus |The planet Uranus, so named by its discoverer, Sir W. Herschel.
geoscopy |Knowledge of the earth, ground, or soil, obtained by inspection. Chambers.
geoselenic |Pertaining to the earth and moon; belonging to the joint action or mutual relations of the earth and moon; as, geoselenic phenomena.
geostatic |Relating to the pressure exerted by earth or similar substance. Geostatic arch, an arch having a form adapted to sustain pressure similar to that exerted by earth. Rankine.
geosynclinal |the downward bend or subsidence of the earth's crust, which allows of the gradual accumulation of sediment, and hence forms the first step in the making of a mountain range; -- opposed to geanticlinal.
geothermometer |A thermometer specially constructed for measuring temperetures at a depth below the surface of the ground.
geotic |Belonging to earth; terrestrial. [Obs.] Bailey.
geotropic |Relating to, or showing, geotropism.
geotropism |A disposition to turn or incline towards the earth; the influence of gravity in determining the direction of growth of an organ. Note: In plants, organs which grow towards the center of the earth are said to be positively geotropic, and those growing in the opposite direction negatively geotropic. In animals, geotropism is supposed by some to have an influence either direct or indirect on the plane of division of the ovum.
gephyrea |An order of marine Annelida, in which the body is imperfectly, or not at all, annulated externally, and is mostly without setæ.
gephyrean |Belonging to the Gephyrea. -- n. One of the Gerphyrea.
gephyreoid |Gephyrean.
gepound |See Gipoun. [Obs.] Chaucer.
gerah |A small coin and weight; 1-20th of a shekel. Note: The silver gerah is supposed to have been worth about three cents; the gold about fifty-four cents; the weight equivalent to about thirteen grains.
geraniaceous |Of or pertaining to a natural order of pants (Geraniaceæ) which includes the genera Geranium, Pelargonium, and many others.
geraniine |1. (Med.)  A valuable astringet obtained from the root of the Geranium maculatum or crane's-bill. 2. (Chem.)  A liquid terpene, obtained from the crane's-bill (Geranium maculatum), and having a peculiar mulberry odor. [Written also geranium.]
geranine |1. (Med.)  A valuable astringet obtained from the root of the Geranium maculatum or crane's-bill. 2. (Chem.)  A liquid terpene, obtained from the crane's-bill (Geranium maculatum), and having a peculiar mulberry odor. [Written also geranium.]
geranium |1. (Bot.)  A genus of plants having a beaklike tours or receptacle, around which the seed capsules are arranged, and membranous projections, or stipules, at the joints. Most of the species have showy flowers and a pungent odor. Called sometimes crane's-bill. 2. (Floriculture)  A cultivated pelargonium. Note: Many plants referred to the genus Geranium by the earlier botanists are now separated from it under the name of Pelargonium, which includes all the commonly cultivated \"geraniums\| mostly natives of South Africa."
gerant |The manager or acting partner of a company, joint-stock association, etc.
gerbe |A kind of ornamental firework. Farrow.
gerbil |One of several species of small, jumping, murine rodents, of the genus Gerbillus. In their leaping powers they resemble the jerboa. They inhabit Africa, India, and Southern Europe.
gerbille |One of several species of small, jumping, murine rodents, of the genus Gerbillus. In their leaping powers they resemble the jerboa. They inhabit Africa, India, and Southern Europe.
gerboa |The jerboa.
gere |Gear. [Obs.] Chaucer.
gerent |Bearing; carrying. [Obs.] Bailey.
gerfalcon |See Gyrfalcon.
gerful |Changeable; capricious. [Obs.] Chaucer.
gerland |A garland. [Obs.]
gerlind |A salmon returning from the sea the second time. [Prov. Eng.]
gerlond |A garland. [Obs.]
germ |1. (Biol.)  That which is to develop a new individual; as, the germ of a fetus, of a plant or flower, and the like; the earliest form under which an organism appears. In the entire process in which a new being originates . . . two distinct classes of action participate; namely, the act of generation by which the germ is produced; and the act of development, by which that germ is evolved into the complete organism. Carpenter. 2. That from which anything springs; origin; first principle; as, the germ of civil liberty. Disease germ (Biol.), a name applied to certain tiny bacterial organisms or their spores, such as Anthrax bacillus and the Micrococcus of fowl cholera, which have been demonstrated to be the cause of certain diseases. See Germ theory (bellow). -- Germ cell (Biol.), the germ, egg, spore, or cell from which the plant or animal arises. At one time a part of the body of the parent, it finally becomes detached,and by a process of multiplication and growth gives rise to a mass of cells, which ultimately form a new individual like the parent. See Ovum. -- Germ gland. (Anat.) See Gonad. -- Germ stock (Zoöl.), a special process on which buds are developed in certain animals. See Doliolum. -- Germ theory (Biol.), the theory that living organisms can be produced only by the evolution or development of living germs or seeds. See Biogenesis, and Abiogenesis. As applied to the origin of disease, the theory claims that the zymotic diseases are due to the rapid development and multiplication of various bacteria, the germs or spores of which are either contained in the organism itself, or transferred through the air or water. See Fermentation theory.\n\nTo germinate. [R.] J. Morley.
germ cell |A cell, of either sex, directly concerned in the production of a new organism.
germ plasm |See Plasmogen, and Idioplasm.
germ theory |1. (Biol.)  The theory that living organisms can be produced only by the development of living germs. Cf. Biogenesis, Abiogenesis. 2.  (Med.) The theory which attributes contagious and infectious diseases, suppurative lesions, etc., to the agency of germs. The science of bacteriology was developed after this theory had been established.
germain |See Germane.
german |Nearly related; closely akin. Wert thou a leopard, thou wert german to the lion. Shak. Brother german. See Brother german. -- Cousins german. See the Note under Cousin.\n\n1. A native or one of the people of Germany. 2. The German language. 3. (a) A round dance, often with a waltz movement, abounding in capriciosly involved figures. (b) A social party at which the german is danced. High German, the Teutonic dialect of Upper or Southern Germany, -- comprising Old High German, used from the 8th to the 11th century; Middle H. G., from the 12th to the 15th century; and Modern or New H. G., the language of Luther's Bible version and of modern German literature. The dialects of Central Germany, the basis of the modern literary language, are often called Middle German, and the Southern German dialects Upper German; but High German is also used to cover both groups. -- Low German, the language of Northern Germany and the Netherlands, -- including Friesic; Anglo-Saxon or Saxon; Old Saxon; Dutch or Low Dutch, with its dialect, Flemish; and Plattdeutsch (called also Low German), spoken in many dialects.\n\nOf or pertaining to Germany. German Baptists. See Dunker. -- German bit, a wood-boring tool, having a long elliptical pod and a scew point. -- German carp (Zoöl.), the crucian carp. -- German millet (Bot.), a kind of millet (Setaria Italica, var.), whose seed is sometimes used for food. -- German paste, a prepared food for caged birds. -- German process (Metal.), the process of reducing copper ore in a blast furnace, after roasting, if necessary. Raymond. -- German sarsaparilla, a substitute for sarsaparilla extract. -- German sausage, a polony, or gut stuffed with meat partly cooked. -- German silver (Chem.), a silver-white alloy, hard and tough, but malleable and ductile, and quite permanent in the air. It contains nickel, copper, and zinc in varying proportions, and was originally made from old copper slag at Henneberg. A small amount of iron is sometimes added to make it whiter and harder. It is essentially identical with the Chinese alloy packfong. It was formerly much used for tableware, knife handles, frames, cases, bearings of machinery, etc., but is now largely superseded by other white alloys. -- German steel (Metal.), a metal made from bog iron ore in a forge, with charcoal for fuel. -- German text (Typog.), a character resembling modern German type, used in English printing for ornamental headings, etc., as in the words, Note: This line is German Text. -- German tinder. See Amadou.
germander |A plant of the genus Teucrium (esp. Teucrium Chamædrys or wall germander), mintlike herbs and low shrubs. American germander, Teucrium Canadense. -- Germander chickweed, Veronica agrestis. -- Water germander, Teucrium Scordium. -- Wood germander, Teucrium Scorodonia.
germane |Literally, near akin; hence, closely allied; appropriate or fitting; relevant. The phrase would be more germane to the matter. Shak. [An amendment] must be germane. Barclay (Digest).
germanic |Pertaining to, or containing, germanium.\n\n1. Of or pertaining to Germany; as, the Germanic confederacy. 2. Teutonic. [A loose sense]
germanism |1. An idiom of the German language. 2. A characteristic of the Germans; a characteristic German mode, doctrine, etc.; rationalism. J. W. Alexander.
germanium |A rare element, recently discovered (1885), in a silver ore (argyrodite) at Freiberg. It is a brittle, silver-white metal, chemically intermediate between the metals and nonmetals, resembles tin, and is in general identical with the predicted ekasilicon. Symbol Ge. Atomic weight 72.3.
germanization |The act of Germanizing. M. Arnold.
germanize |To make German, or like what is distinctively German; as, to Germanize a province, a language, a society.\n\nTo reason or write after the manner of the Germans.
germarium |An organ in which the ova are developed in certain Turbellaria.
germen |See Germ.
germicidal |Germicide.
germicide |Destructive to germs; -- applied to any agent which has a destructive action upon living germs, particularly bacteria, or bacterial germs, which are considered the cause of many infectious diseases. -- n.  A germicide agent.
germinal |Pertaining or belonging to a germ; as, the germinal vesicle. Germinal layers (Biol.), the two layers of cells, the ectoblast and entoblast, which form respectively the outer covering and inner wall of the gastrula. A third layer of cells, the mesoblast, which is formed later and lies between these two, is sometimes included. -- Germinal membrane. (Biol.) Same as Blastoderm. -- Germinal spot (Biol.), the nucleolus of the ovum. -- Germinal vesicle, (Biol.) , the nucleus of the ovum of animals.\n\nThe seventh month of the French republican calendar [1792 -- 1806]. It began March 21 and ended April 19. See VendÉmiaire.
germinant |Sprouting; sending forth germs or buds.
germinate |To sprout; to bud; to shoot; to begin to vegetate, as a plant or its seed; to begin to develop, as a germ. Bacon.\n\nTo cause to sprout. Price (1610).
germination |The process of germinating; the beginning of vegetation or growth in a seed or plant; the first development of germs, either animal or vegetable. Germination apparatus, an apparatus for malting grain.
germinative |Pertaining to germination; having power to bud or develop. Germinative spot, Germinative vesicle. (Biol.) Same as Germinal spot, Germinal vesicle, under Germinal.
germiparity |Reproduction by means of germs.
germless |Without germs.
germogen |(a) A polynuclear mass of protoplasm, not divided into separate cells, from which certain ova are developed. Balfour. (b) The primitive cell in certain embryonic forms. Balfour.
germule |A small germ.
gern |To grin or yawn. [Obs.] \"[\/He] gaped like a gulf when he did gern.\" Spenser.
gerner |A garner. [Obs.] Chaucer.
gerocomia |See Gerocomy.
gerocomical |Pertaining to gerocomy. Dr. John Smith.
gerocomy |That part of medicine which treats of regimen for old people.
gerontes |Magistrates in Sparta, who with the ephori and kings, constituted the supreme civil authority.
gerontocracy |Government by old men. [R.] Gladstone.
geropigia |A mixture composed of unfermented grape juice, brandy, sugar, etc., for adulteration of wines. [Written also jerupigia.]
gerrymander |To divide (a State) into districts for the choice of representatives, in an unnatural and unfair way, with a view to give a political party an advantage over its opponent. [Political Cant, U. S.] Note: This was done in Massachusetts at a time when Elbridge Gerry was governor, and was attributed to his influence, hence the name; though it is now known that he was opposed to the measure. Bartlett.
gerund |1. A kind of verbal noun, having only the four oblique cases of the singular number, and governing cases like a participle. 2. (AS. Gram.)  A verbal noun ending in -e, preceded by to and usually denoting purpose or end; -- called also the dative infinitive; as, \"Ic hæbbe mete tô etanne\" (I have meat to eat.) In Modern English the name has been applied to verbal or participal nouns in -ing denoting a transitive action; e. g., by throwing a stone.
gerundial |Pertaining to, or resembling, a gerund; as, a gerundial use.
gerundive |Pertaining to, or partaking of, the nature of the gerund; gerundial. -- n. (Lat. Gram.)  The future passive participle; as, amandus, i. e., to be loved.
gerundively |In the manner of a gerund; as, or in place of, a gerund.
gery |Changeable; fickle. [Obs.] Chaucer.
gesling |A gosling. [Prov. Eng.]
gesse |To guess. [Obs.] Chaucer.
gesso |1. Plaster of Paris, or gypsum, esp. as prepared for use in painting, or in making bas-reliefs and the like; by extension, a plasterlike or pasty material spread upon a surface to fit it for painting or gilding, or a surface so prepared. 2.  A work of art done in gesso. [Obs.]
gesso duro |A variety of gesso which when dried becomes hard and durable, often used in making bas-relief casts, which are colored and mounted in elaborate frames.
gest |A guest. [Obs.] Chaucer.\n\n1. Something done or achieved; a deed or an action; an adventure. [Obs.] Chaucer. 2. An action represented in sports, plays, or on the stage; show; ceremony. [Obs.] Mede. 3. A tale of achievements or adventures; a stock story. [Obs.] Chaucer. Spenser. 4. Gesture; bearing; deportment. [Archaic] Through his heroic grace and honorable gest. Spenser.\n\n1. A stage in traveling; a stop for rest or lodging in a journey or progress; a rest. [Obs.] Kersey. 2. A roll recting the several stages arranged for a royal progress. Many of them are extant in the herald's office. [Obs.] Hanmer.
gestant |Bearing within; laden; burdened; pregnant. [R.] \"Clouds gestant with heat.\" Mrs. Browning.
gestation |1. The act of wearing (clothes or ornaments). [Obs.] 2. The act of carrying young in the womb from conception to delivery; pregnancy. 3. Exercise in which one is borne or carried, as on horseback, or in a carriage, without the exertion of his own powers; passive exercise. Dunglison.
gestatory |1. Pertaining to gestation or pregnancy. 2. Capable of being carried or worn. [Obs. or R.]
geste |To tell stories or gests. [Obs.]
gestic |1. Pertaining to deeds or feats of arms; legendary. And the gay grandsire, skilled in gestic lore. Goldsmith. 2. Relating to bodily motion; consisting of gestures; -- said especially with reference to dancing. Carried away by the enthusiasm of the gestic art. Sir W. Scott.
gesticulate |To make gestures or motions, as in speaking; to use postures. Sir T. Herbert.\n\nTo represent by gesture; to act. [R.] B. Jonson.
gesticulation |1. The act of gesticulating, or making gestures to express passion or enforce sentiments. 2. A gesture; a motion of the body or limbs in speaking, or in representing action or passion, and enforcing arguments and sentiments. Macaulay. 3. Antic tricks or motions. B. Jonson.
gesticulator |One who gesticulates.
gesticulatory |Representing by, or belonging to, gestures. T. Warton.
gestour |A reciter of gests or legendary tales; a story-teller. [Obs.] Minstrels and gestours for to tell tales. Chaucer.
gestural |Relating to gesture.
gesture |1. Manner of carrying the body; position of the body or limbs; posture. [Obs.] Accubation, or lying down at meals, was a gesture used by many nations. Sir T. Browne. 2. A motion of the body or limbs expressive of sentiment or passion; any action or posture intended to express an idea or a passion, or to enforce or emphasize an argument, assertion, or opinion. Humble and reverent gestures. Hooker. Grace was in all her steps, heaven in her eye, In every gesture dignity and love. Milton.\n\nTo accompany or illustrate with gesture or action; to gesticulate. It is not orderly read, nor gestured as beseemeth. Hooker.\n\nTo make gestures; to gesticulate. The players . . . gestured not undecently withal. Holland.
gestureless |Free from gestures.
gesturement |Act of making gestures; gesturing. [Obs.] Bp. Hall.
get |Jet, the mineral. [Obs.] Chaucer.\n\n1. Fashion; manner; custom. [Obs.] Chaucer. 2. Artifice; contrivance. [Obs.] Chaucer.\n\n1. To procure; to obtain; to gain possession of; to acquire; to earn; to obtain as a price or reward; to come by; to win, by almost any means; as, to get favor by kindness; to get wealth by industry and economy; to get favor by kindness; to get wealth by industry and economy; to get land by purchase, etc. 2. Hence, with have and had, to come into or be in possession of; to have. Johnson. Thou hast got the face of man. Herbert. 3. To beget; to procreate; to generate. I had rather to adopt a child than get it. Shak. 4. To obtain mental possession of; to learn; to commit to memory; to memorize; as to get a lesson; also with out; as, to get out one's Greek lesson. It being harder with him to get one sermon by heart, than to pen twenty. Bp. Fell. 5. To prevail on; to induce; to persuade. Get him to say his prayers. Shak. 6. To procure to be, or to cause to be in any state or condition; -- with a following participle. Those things I bid you do; get them dispatched. Shak. 7. To betake; to remove; -- in a reflexive use. Get thee out from this land. Gen. xxxi. 13. He . . . got himself . . . to the strong town of Mega. Knolles. Note: Get, as a transitive verb, is combined with adverbs implying motion, to express the causing to, or the effecting in, the object of the verb, of the kind of motion indicated by the preposition; thus, to get in, to cause to enter, to bring under shelter; as, to get in the hay; to get out, to make come forth, to extract; to get off, to take off, to remove; to get together, to cause to come together, to collect. To get by heart, to commit to memory. -- To get the better of, To get the best of, to obtain an advantage over; to surpass; to subdue. -- To get up, to cause to be established or to exit; to prepare; to arrange; to construct; to invent; as, to get up a celebration, a machine, a book, an agitation. Syn. -- To obtain; gain; win; acquire. See Obtain.\n\n1. To make acquisition; to gain; to profit; to receive accessions; to be increased. We mourn, France smiles; we lose, they daily get. Shak. 2. To arrive at, or bring one's self into, a state, condition, or position; to come to be; to become; -- with a following adjective or past participle belonging to the subject of the verb; as, to get sober; to get awake; to get beaten; to get elected. To get rid of fools and scoundrels. Pope. His chariot wheels get hot by driving fast. Coleridge. Note: It [get] gives to the English language a middle voice, or a power of verbal expression which is neither active nor passive. Thus we say to get acquitted, beaten, confused, dressed. Earle. Note: Get, as an intransitive verb, is used with a following preposition, or adverb of motion, to indicate, on the part of the subject of the act, movement or action of the kind signified by the preposition or adverb; or, in the general sense, to move, to stir, to make one's way, to advance, to arrive, etc.; as, to get away, to leave to escape; to disengage one's self from; to get down, to descend, esp. with effort, as from a literal or figurative elevation; to get along, to make progress; hence, to prosper, succeed, or fare; to get in, to enter; to get out, to extricate one's self, to escape; to get through, to traverse; also, to finish, to be done; to get to, to arrive at, to reach; to get off, to alight, to descend from, to dismount; also, to escape, to come off clear; to get together, to assemble, to convene. To get ahead, to advance; to prosper. -- To get along, to proceed; to advance; to prosper. -- To get a mile (or other distance), to pass over it in traveling. -- To get among, to go or come into the company of; to become one of a number. -- To get asleep, to fall asleep. -- To get astray, to wander out of the right way. -- To get at, to reach; to make way to. To get away with, to carry off; to capture; hence, to get the better of; to defeat. -- To get back, to arrive at the place from which one departed; to return. -- To get before, to arrive in front, or more forward. -- To get behind, to fall in the rear; to lag. -- To get between, to arrive between. -- To get beyond, to pass or go further than; to exceed; to surpass. \"Three score and ten is the age of man, a few get beyond it.\" Thackeray. -- To get clear, to disengage one's self; to be released, as from confinement, obligation, or burden; also, to be freed from danger or embarrassment. -- To get drunk, to become intoxicated. -- To get forward, to proceed; to advance; also, to prosper; to advance in wealth. -- To get home, to arrive at one's dwelling, goal, or aim. -- To get into. (a) To enter, as, \"she prepared to get into the coach.\" Dickens. (b) To pass into, or reach; as, \" as, \" a language has got into the inflated state.\" Keary. -- To get loose or free, to disengage one's self; to be released from confinement. -- To get near, to approach within a small distance. -- To get on, to proceed; to advance; to prosper. -- To get over. (a) To pass over, surmount, or overcome, as an obstacle or difficulty. (b) To recover from, as an injury, a calamity. -- To get through. (a) To pass through something. (b) To finish what one was doing. -- To get up. (a) To rise; to arise, as from a bed, chair, etc. (b) To ascend; to climb, as a hill, a tree, a flight of stairs, etc.\n\nOffspring; progeny; as, the get of a stallion.
get-penny |Something which gets or gains money; a successful affair. [Colloq.] Chapman.
get-up |General composition or structure; manner in which the parts of a thing are combined; make-up; style of dress, etc. [Colloq.] H. Kingsley.
geten |p. p. of Get. Chaucer.
geth |the original third pers. sing. pres. of Go. [Obs.] Chaucer.
gettable |That may be obtained. [R.]
getter |One who gets, gains, obtains, acquires, begets, or procreates.
getterup |One who contrives, makes, or arranges for, anything, as a book, a machine, etc. [Colloq.] A diligent getter-up of miscellaneous works. W. Irving.
getting |1. The act of obtaining or acquiring; acquisition. With all thy getting, get understanding. Prov. iv. 7. 2. That which is got or obtained; gain; profit.
geusdism |The Marxian socialism and programme of reform through revolution as advocated by the French political leader Jules Basile Guesde (pron. ged) (1845- ). -- Guesd\"ist (#), n. & a.
gewgaw |A showy trifle; a toy; a splendid plaything; a pretty but worthless bauble. A heavy gewgaw called a crown. Dryden.\n\nShowy; unreal; pretentious. Seeing his gewgaw castle shine. Tennyson.
geyser |A boiling spring which throws forth at frequent intervals jets of water, mud, etc., driven up by the expansive power of steam. Note: Geysers were first known in Iceland, and later in New Zealand. In the Yellowstone region in the United States they are numerous, and some of them very powerful, throwing jets of boiling water and steam to a height of 200 feet. They are grouped in several areas called geyser basins. The mineral matter, or geyserite, with which geyser water is charged, forms geyser cones about the orifice, often of great size and beauty.
geyserite |A loose hydrated form of silica, a variety of opal, deposited in concretionary cauliflowerlike masses, around some hot springs and geysers.
gharry |Any wheeled cart or carriage. [India]
ghast |To strike aghast; to affright. [Obs.] Ghasted by the noise I made. Full suddenly he fled. Shak.
ghastful |Fit to make one aghast; dismal. [Obs.] -- Ghast\"ful*ly, adv.
ghastliness |The state of being ghastly; a deathlike look.
ghastly |1. Like a ghost in appearance; deathlike; pale; pallid; dismal. Each turned his face with a ghastly pang. Coleridge. His face was so ghastly that it could scarcely be recognized. Macaulay. 2. Horrible; shocking; dreadful; hideous. Mangled with ghastly wounds through plate and mail. Milton.\n\nIn a ghastly manner; hideously. Staring full ghastly like a strangled man. Shak.
ghastness |Ghastliness. [Obs.] Shak.
ghat |1. A pass through a mountain. [India] J. D. Hooker. 2. A range of mountains. Balfour (Cyc. of Ind. ). 3. Stairs descending to a river; a landing place; a wharf. [India] Malcom.
ghaut |1. A pass through a mountain. [India] J. D. Hooker. 2. A range of mountains. Balfour (Cyc. of Ind. ). 3. Stairs descending to a river; a landing place; a wharf. [India] Malcom.
ghawazi |Egyptian dancing girls, of a lower sort than the almeh.
ghazal |A kind of Oriental lyric, and usually erotic, poetry, written in recurring rhymes.
ghazel |A kind of Oriental lyric, and usually erotic, poetry, written in recurring rhymes.
ghazi |Among Mohammedans, a warrior champion or veteran, esp. in the destruction of infidels.
gheber |A worshiper of fire; a Zoroastrian; a Parsee.
ghebre |A worshiper of fire; a Zoroastrian; a Parsee.
ghee |Butter clarified by boiling, and thus converted into a kind of oil. [India] Malcom.
gherkin |1. (Bot.)  A kind of small, prickly cucumber, much used for pickles. 2. (Zoöl.)  See Sea gherkin.
ghess |See Guess. [Obs.]
ghetto |The Jews'quarter in an Italian town or city. I went to the Ghetto, where the Jews dwell. Evelyn.
ghibelline |One of a faction in Italy, in the 12th and 13th centuries, which favored the German emperors, and opposed the Guelfs, or adherents of the poses. Brande & C.
ghole |See Ghoul.
ghost |1. The spirit; the soul of man. [Obs.] Then gives her grieved ghost thus to lament. Spenser. 2. The disembodied soul; the soul or spirit of a deceased person; a spirit appearing after death; an apparition; a specter. The mighty ghosts of our great Harrys rose. Shak. I thought that I had died in sleep, And was a blessed ghost. Coleridge. 3. Any faint shadowy semblance; an unsubstantial image; a phantom; a glimmering; as, not a ghost of a chance; the ghost of an idea. Each separate dying ember wrought its ghost upon the floor. Poe. 4. A false image formed in a telescope by reflection from the surfaces of one or more lenses. Ghost moth (Zoöl.), a large European moth (Hepialus humuli); so called from the white color of the male, and the peculiar hovering flight; -- called also great swift. -- Holy Ghost, the Holy Spirit; the Paraclete; the Comforter; (Theol.) the third person in the Trinity. -- To give up or yield up the ghost, to die; to expire. And he gave up the ghost full softly. Chaucer. Jacob . . . yielded up the ghost, and was gathered unto his people. Gen. xlix. 33.\n\nTo die; to expire. [Obs.] Sir P. Sidney.\n\nTo appear to or haunt in the form of an apparition. [Obs.] Shak.
ghost dance |A religious dance of the North American Indians, participated in by both sexes, and looked upon as a rite of invocation the purpose of which is, through trance and vision, to bring the dancer into communion with the unseen world and the spirits of departed friends. The dance is the chief rite of the Ghost-dance, or Messiah, religion, which originated about 1890 in the doctrines of the Piute Wovoka, the Indian Messiah, who taught that the time was drawing near when the whole Indian race, the dead with the living, should be reunited to live a life of millennial happiness upon a regenerated earth. The religion inculcates peace, righteousness, and work, and holds that in good time, without warlike intervention, the oppressive white rule will be removed by the higher powers. The religion spread through a majority of the western tribes of the United States, only in the case of the Sioux, owing to local causes, leading to an outbreak.
ghostfish |A pale ubspotted variety of the wrymouth.
ghostless |Without life or spirit. [R.]
ghostlike |Like a ghost; ghastly.
ghostliness |The quality of being ghostly.
ghostly |1. Relating to the soul; not carnal or secular; spiritual; as, a ghostly confessor. Save and defend us from our ghostly enemies. Book of Common Prayer [Ch. of Eng. ] One of the gostly children of St. Jerome. Jer. Taylor. 2. Of or pertaining to apparitions. Akenside.\n\nSpiritually; mystically. Chaucer.
ghostology |Ghost lore. [R.] It seemed even more unaccountable than if it had been a thing of ghostology and witchcraft. Hawthorne.
ghoul |An imaginary evil being among Eastern nations, which was supposed to feed upon human bodies. [Written also ghole .] Moore.
ghoulish |Characteristic of a ghoul; vampirelike; hyenalike.
ghyll |A ravine. See Gill a woody glen. [Prov. Eng. & Scot.] Wordsworth.
giallolino |A term variously employed by early writers on art, though commonly designating the yellow oxide of lead, or massicot. Fairholt.
giambeux |Greaves; armor for the legs. [Obs.] Spenser.
giant |1. A man of extraordinari bulk and stature. Giants of mighty bone and bold emprise. Milton. 2. A person of extraordinary strength or powers, bodily or intellectual. 3. Any animal, plant, or thing, of extraordinary size or power. Giant's Causeway, a vast collection of basaltic pillars, in the county of Antrim on the northern coast of Ireland.\n\nLike a giant; extraordinary in size, strength, or power; as, giant brothers; a giant son. Giant cell. (Anat.) See Myeloplax. -- Giant clam (Zoöl.), a bivalve shell of the genus Tridacna, esp. T. gigas, which sometimes weighs 500 pounds. The shells are sometimes used in churches to contain holy water. -- Giant heron (Zoöl.), a very large African heron (Ardeomega goliath). It is the largest heron known. -- Giant kettle, a pothole of very large dimensions, as found in Norway in connection with glaciers. See Pothole. -- Giant powder. See Nitroglycerin. -- Giant puffball (Bot.), a fungus (Lycoperdon giganteum), edible when young, and when dried used for stanching wounds. -- Giant salamander (Zoöl.), a very large aquatic salamander (Megalobatrachus maximus), found in Japan. It is the largest of living Amphibia, becoming a yard long. -- Giant squid (Zoöl.), one of several species of very large squids, belonging to Architeuthis and allied genera. Some are over forty feet long.
giantess |A woman of extraordinary size.
giantize |To play the giant. [R.] Sherwood.
giantly |Appropriate to a giant. [Obs.] Usher.
giantry |The race of giants. [R.] Cotgrave.
giantship |The state, personality, or character, of a giant; -- a compellation for a giant. His giantship is gone somewhat crestfallen. Milton.
giaour |An infidel; -- a term applied by Turks to disbelievers in the Mohammedan religion, especially Christrians. Byron.
gib |A male cat; a tomcat. [Obs.]\n\nTo act like a cat. [Obs.] Beau. & Fl.\n\nA piece or slip of metal or wood, notched or otherwise, in a machine or structure, to hold other parts in place or bind them together, or to afford a bearing surface; -- usually held or adjusted by means of a wedge, key, or screw. Gib and key, or Gib and cotter (Steam Engine), the fixed wedge or gib, and the driving wedge,key, or cotter, used for tightening the strap which holds the brasses at the end of a connecting rod.\n\nTo secure or fasten with a gib, or gibs; to provide with a gib, or gibs. Gibbed lathe, an engine lathe in which the tool carriage is held down to the bed by a gib instead of by a weight.\n\nTo balk. See Jib, v. i. Youatt.
gib boom |See Jib boom.
gib-cat |A male cat, esp. an old one. See lst Gib. n. [Obs.] Shak.
gibaro |The offspring of a Spaniard and an Indian; a Spanish-Indian mestizo. [Sp. Amer.]
gibbartas |One of several finback whales of the North Atlantic; -- called also Jupiter whale. [Written also jubartas, gubertas, dubertus.]
gibber |A balky horse. Youatt.\n\nTo speak rapidly and inarticulately. Shak.
gibberish |Rapid and inarticulate talk; unintelligible language; unmeaning words; jargon. He, like a gypsy, oftentimes would go; All kinds of gibberish he had learnt to known. Drayton. Such gibberish as children may be heard amusing themselves with. Hawthorne.\n\nUnmeaning; as, gibberish language.
gibbet |1. A kind of gallows; an upright post with an arm projecting from the top, on which, formerly, malefactors were hanged in chains, and their bodies allowed to remain asa warning. 2. The projecting arm of a crane, from which the load is suspended; the jib.\n\n1. To hang and expose on a gibbet. 2. To expose to infamy; to blacken. I'll gibbet up his name. Oldham.
gibbier |Wild fowl; game. [Obs.] Addison.
gibbon |Any arboreal ape of the genus Hylobates, of which many species and varieties inhabit the East Indies and Southern Asia. They are tailless and without cheek pouches, and have very long arms, adapted for climbing. Note: The white-handed gibbon (Hylobates lar), the crowned (H. pilatus), the wou-wou or singing gibbon (H. agilis), the siamang, and the hoolock. are the most common species.
gibbose |Humped; protuberant; -- said of a surface which presents one or more large elevations. Brande & C.
gibbostity |The state of being gibbous or gibbose; gibbousness.
gibbous |1. Swelling by a regular curve or surface; protuberant; convex; as, the moon is gibbous between the half-moon and the full moon. The bones will rise, and make a gibbous member. Wiseman. 2. Hunched; hump-backed. [Obs.] Sir T. Browne. -- Gib\"bous*ly, adv. -- Gib\"bous*ness, n.
gibbsite |A hydrate of alumina.
gibe |To cast reproaches and sneering expressions; to rail; to utter taunting, sarcastic words; to flout; to fleer; to scoff. Fleer and gibe, and laugh and flout. Swift.\n\nTo reproach with contemptuous words; to deride; to scoff at; to mock. Draw the beasts as I describe them, From their features, while I gibe them. Swift.\n\nAn expression of sarcastic scorn; a sarcastic jest; a scoff; a taunt; a sneer. Mark the fleers, the gibes, and notable scorns. Shak. With solemn gibe did Eustace banter me. Tennyson.
gibel |A kind of carp (Cyprinus gibelio); -- called also Prussian carp.
giber |One who utters gibes. B. Jonson.
gibfish |The male of the salmon. [Prov. Eng.] Wright.
gibingly |In a gibing manner; scornfully.
giblet |Made of giblets; as, a giblet pie.
giblets |The inmeats, or edible viscera (heart, gizzard, liver, etc.), of poultry.
gibraltar |1. A strongly fortified town on the south coast of Spain, held by the British since 1704; hence, an impregnable stronghold. 2.  A kind of candy sweetmeat, or a piece of it; -- called, in full, Gibraltar rock.
gibstaff |1. A staff to guage water, or to push a boat. 2. A staff formerly used in fighting beasts on the stage. [Obs.] Bailey.
gid |A disease of sheep, characterized by vertigo; the staggers. It is caused by the presence of the CC.
giddily |In a giddy manner.
giddiness |The quality or state of being giddy.
giddy |1. Having in the head a sensation of whirling or reeling about; having lost the power of preserving the balance of the body, and therefore wavering and inclined to fall; lightheaded; dizzy. By giddy head and staggering legs betrayed. Tate. 2. Promoting or inducing giddiness; as, a giddy height; a giddy precipice. Prior. Upon the giddy footing of the hatches. Shak. 3. Bewildering on account of rapid turning; running round with celerity; gyratory; whirling. The giddy motion of the whirling mill. Pope. 4. Characterized by inconstancy; unstable; changeable; fickle; wild; thoughtless; heedless. \"Giddy, foolish hours.\" Rowe. \"Giddy chance.\" Dryden. Young heads are giddy and young hearts are warm. Cowper.\n\nTo reel; to whirl. Chapman.\n\nTo make dizzy or unsteady. [Obs.]
giddy-head |A person without thought fulness, prudence, or judgment. [Colloq.] Burton.
giddy-headed |Thoughtless; unsteady.
giddy-paced |Moving irregularly; flighty; fickle. [R.] Shak.
gie |To guide. See Gye . [Obs.] Chaucer.\n\nTo give. [Scot.] Burns.
gier-eagle |A bird referred to in the Bible (Lev. xi. 18and Deut. xiv. 17) as unclean, probably the Egyptian vulture (Neophron percnopterus).
gier-falcon |The gyrfalcon.
gieseckite |A mineral occurring in greenish gray six-sided prisms, having a greasy luster. It is probably a pseudomorph after elæolite.
gif |If. [Obs.] Note: Gif is the old form of if, and frequently occurs in the earlier English writers. See If.
giffard injector |See under Injector.
giffgaff |Mutial accommodation; mutual giving. [Scot.]
giffy |See Jiffy.
gift |1. Anything given; anything voluntarily transferred by one person to another without compensation; a present; an offering. Shall I receive by gift, what of my own, . . . I can command Milton. 2. The act, right, or power of giving or bestowing; as, the office is in the gift of the President. 3. A bribe; anything given to corrupt. Neither take a gift, for a gift doth blind the eyes of the wise. Deut. xvi. 19. 4. Some quality or endowment given to man by God; a preëminent and special talent or aptitude; power; faculty; as, the gift of wit; a gift for speaking. 5. (Law)  A voluntary transfer of real or personal property, without any consideration. It can be perfected only by deed, or in case of personal property, by an actual delivery of possession. Bouvier. Burrill. Gift rope (Naut), a rope extended to a boat for towing it; a guest rope. Syn. -- Present; donation; grant; largess; benefaction; boon; bounty; gratuity; endowment; talent; faculty. -- Gift, Present, Donation. These words, as here compared, denote something gratuitously imparted to another out of one's property. A gift is something given whether by a superior or an inferior, and is usually designed for the relief or benefit of him who receives it. A present is ordinarly from an equal or inferior, and is always intended as a compliment or expression of kindness. Donation is a word of more dignity, denoting, properly, a gift of considerable value, and ordinarly a gift made either to some public institution, or to an individual on account of his services to the public; as, a donation to a hospital, a charitable society, or a minister.\n\nTo endow with some power or faculty. He was gifted . . . with philosophical sagacity. I. Taylor.
giftedness |The state of being gifted. Echard.
gig |A fiddle. [Obs.]\n\nTo engender. [Obs.] Dryden.\n\nA kind of spear or harpoon. See Fishgig.\n\nTo fish with a gig.\n\nA playful or wanton girl; a giglot.\n\n1. A top or whirligig; any little thing that is whirled round in play. Thou disputest like an infant; go, whip thy gig. Shak. 2. A light carriage, with one pair of wheels, drawn by one horse; a kind of chaise. 3. (Naut.)  A long, light rowboat, generally clinkerbuilt, and designed to be fast; a boat appropriated to the use of the commanding officer; as, the captain's gig. 4. (Mach.)  A rotatory cylinder, covered with wire teeth or teasels, for teaseling woolen cloth. Gig machine, Gigging machine, Gig mill, or Napping machine. See Gig, 4. -- Gig saw. See Jig saw.
gigantean |Like a giant; mighty; gigantic. [Obs.] Dr. H. More.
gigantesque |Befitting a giant; bombastic; magniloquent. The sort of mock-heroic gigantesque With which we bantered little Lilia first. Tennyson.
gigantic |1. Of extraordinary size; like a giant. 2. Such as a giant might use, make, or cause; immense; tremendous; extraordinarly; as, gigantic deeds; gigantic wickedness. Milton. When descends on the Atlantic The gigantic Strom wind of the equinox. Longfellow.
gigantical |Bulky, big. [Obs.] Burton. -- Gi*gan\"tic*al*ly, adv.
giganticide |The act of killing, or one who kills, a giant. Hallam.
gigantine |Gigantic. [Obs.] Bullokar.
gigantology |An account or description of giants.
gigantomachy |A war of giants; especially, the fabulous war of the giants against heaven.
gige |The leather strap by which the shield of a knight was slung across the shoulder, or across the neck and shoulder. Meyrick (Ancient Armor).
gigerium |The muscular stomach, or gizzard, of birds.
gigget |Same as Gigot. Cut the slaves to giggets. Beau. & Fl.
giggle |To laugh with short catches of the breath or voice; to laugh in a light, affected, or silly manner; to titter with childish levity. Giggling and laughing with all their might At the piteous hap of the fairy wight. J. R. Drake.\n\nA kind of laugh, with short catches of the voice or breath; a light, silly laugh.
giggler |One who giggles or titters.
giggly |Prone to giggling. Carlyle.
giggot |See Gigot. [Obs.] Chapman.\n\n1. A leg of mutton. 2. A small piece of flesh; a slice. [Obs.] The rest in giggots cut, they spit. Chapman.
giggyng |The act of fastending the gige or leather strap to the shield. [Obs.] \"Gigging of shields.\" Chaucer.
giglet |A wanton; a lascivious or light, giddy girl. [Obs.] The giglet is willful, and is running upon her fate. Sir W. Scott.
giglot |A wanton; a lascivious or light, giddy girl. [Obs.] The giglet is willful, and is running upon her fate. Sir W. Scott.\n\nGiddi; light; inconstant; wanton. [Obs.] \"O giglot fortune!\" Shak.
gigot |1. A leg of mutton. 2. A small piece of flesh; a slice. [Obs.] The rest in giggots cut, they spit. Chapman.
gigue |A piece of lively dance music, in two strains which are repeated; also, the dance.
gila monster |A large tuberculated lizard (Heloderma suspectum) native of the dry plains of Arizona, New Mexico, etc. It is the only lizard known to have venomous teeth.
gild |1. To overlay with a thin covering of gold; to cover with a golden color; to cause to look like gold. \"Gilded chariots.\" Pope. No more the rising sun shall gild the morn. Pope. 2. To make attractive; to adorn; to brighten. Let oft good humor, mild and gay, Gild the calm evening of your day. Trumbull. 3. To give a fair but deceptive outward appearance to; to embellish; as, to gild a lie. Shak. 4. To make red with drinking. [Obs.] This grand liquior that hath gilded them. Shak.
gildale |A drinking bout in which every one pays an equal share. [Obs.]
gilden |Gilded. Holland.
gilder |One who gilds; one whose occupation is to overlay with gold.\n\nA Dutch coin. See Guilder.
gilding |1. The art or practice of overlaying or covering with gold leaf; also, a thin coating or wash of gold, or of that which resembles gold. 2. Gold in leaf, powder, or liquid, for application to any surface. 3. Any superficial coating or appearance, as opposed to what is solid and genuine. Gilding metal, a tough kind of sheet brass from which cartridge shells are made.
gile |Guile. [Obs.] Chaucer.
gill |1. (Anat.)  An organ for aquatic respiration; a branchia. Fishes perform respiration under water by the gills. Ray. Note: Gills are usually lamellar or filamentous appendages, through which the blood circulates, and in which it is exposed to the action of the air contained in the water. In vertebrates they are appendages of the visceral arches on either side of the neck. In invertebrates they occupy various situations. 2. pl. (Bot.)  The radiating, gill-shaped plates forming the under surface of a mushroom. 3. (Zoöl.)  The fleshy flap that hangs below the beak of a fowl; a wattle. 4. The flesh under or about the chin. Swift. 5. (Spinning)  One of the combs of closely ranged steel pins which divide the ribbons of flax fiber or wool into fewer parallel filaments. Etym: [Prob. so called from F. aiguilles, needles. Ure.] Gill arches, Gill bars. (Anat.) Same as Branchial arches. -- Gill clefts. (Anat.) Same as Branchial clefts. See under Branchial. -- Gill cover, Gill lid. See Operculum. -- Gill frame, or Gill head (Flax Manuf.), a spreader; a machine for subjecting flax to the action of gills. Knight. -- Gill net, a flat net so suspended in the water that its meshes allow the heads of fish to pass, but catch in the gills when they seek to extricate themselves. -- Gill opening, or Gill slit (Anat.), an opening behind and below the head of most fishes, and some amphibians, by which the water from the gills is discharged. In most fishes there is a single opening on each side, but in the sharks and rays there are five, or more, on each side. -- Gill rakes, or Gill rakers (Anat.), horny filaments, or progresses, on the inside of the branchial arches of fishes, which help to prevent solid substances from being carried into gill cavities.\n\nA two-wheeled frame for transporting timber. [Prov. Eng.]\n\nA leech. [Also gell.] [Scot.] Jameison.\n\nA woody glen; a narrow valley containing a stream. [Prov. Eng. & Scot.]\n\nA measure of capacity, containing one fourth of a pint.\n\n1. A young woman; a sweetheart; a flirting or wanton girl. \"Each Jack with his Gill.\" B. Jonson. 2. (Bot.)  The ground ivy (Nepeta Glechoma); -- called also gill over the ground, and other like names. 3. Malt liquor medicated with ground ivy. Gill ale. (a) Ale flavored with ground ivy. (b) (Bot.) Alehoof.
gill-flirt |A thoughtless, giddy girl; a flirt-gill. Sir W. Scott.
gillhouse |A shop where gill is sold. Thee shall each alehouse, thee each gillhouse mourn. Pope.
gillian |A girl; esp., a wanton; a gill. [Obs.] Beau. & Fl.
gillie |A boy or young man; a manservant; a male attendant, in the Scottish Highlands. Sir W. Scott.
gilly |A boy or young man; a manservant; a male attendant, in the Scottish Highlands. Sir W. Scott.
gillyflower |1. A name given by old writers to the clove pink (Dianthus Caryophyllus) but now to the common stock (Matthiola incana), a cruciferous plant with showy and fragrant blossoms, usually purplish, but often pink or white. 2. A kind of apple, of a roundish conical shape, purplish red color, and having a large core. [Written also gilliflower.] Clove gillflower, the clove pink. -- Marsh gillyflower, the ragged robin (Lychnis Flos-cuculi). -- Queen's, or Winter, gillyflower, damewort. -- Sea gillyflower, the thrift (Armeria vulgaris). -- Wall gillyflower, the wallflower (Cheiranthus Cheiri). -- Water gillyflower, the water violet.
gilour |A guiler; deceiver. [Obs.]
gilse |See Grilse.
gilt |A female pig, when young.\n\nimp. & p. p. of Gild.\n\nGilded; covered with gold; of the color of gold; golden yellow. \"Gilt hair\" Chaucer.\n\n1. Gold, or that which resembles gold, laid on the surface of a thing; gilding. Shak. 2. Money. [Obs.] \"The gilt of France.\" Shak.
gilt-edge |1. Having a gilt edge; as, gilt-edged paper. 2. Of the best quality; -- said of negotiable paper, etc. [Slang, U. S.]
gilt-edged |1. Having a gilt edge; as, gilt-edged paper. 2. Of the best quality; -- said of negotiable paper, etc. [Slang, U. S.]
gilthead |A marine fish. The name is applied to two species: (a) The Pagrus, or Chrysophrys, auratus, a valuable food fish common in the Mediterranean (so named from its golden-colored head); -- called also giltpoll. (b) The Crenilabrus melops, of the British coasts; -- called also golden maid, conner, sea partridge.
giltif |Guilty. [Obs.] Chaucer.
gilttail |A yellow-tailed worm or larva.
gim |Neat; spruce. [Prov.]
gimbal |A contrivance for permitting a body to incline freely in all directions, or for suspending anything, as a barometer, ship's compass, chronometer, etc., so that it will remain plumb, or level, when its support is tipped, as by the rolling of a ship. It consists of a ring in which the body can turn on an axis through a diameter of the ring, while the ring itself is so pivoted to its support that it can turn about a diameter at right angles to the first. Gimbal joint (Mach.), a universal joint embodying the principle of the gimbal. -- Gimbal ring, a single gimbal, as that by which the cockeye of the upper millstone is supported on the spindle.
gimbals |A contrivance for permitting a body to incline freely in all directions, or for suspending anything, as a barometer, ship's compass, chronometer, etc., so that it will remain plumb, or level, when its support is tipped, as by the rolling of a ship. It consists of a ring in which the body can turn on an axis through a diameter of the ring, while the ring itself is so pivoted to its support that it can turn about a diameter at right angles to the first. Gimbal joint (Mach.), a universal joint embodying the principle of the gimbal. -- Gimbal ring, a single gimbal, as that by which the cockeye of the upper millstone is supported on the spindle.
gimblet |See Gimlet.
gimcrack |A trivial mechanism; a device; a toy; a pretty thing. Arbuthnot.
gimlet |A small tool for boring holes. It has a leading screw, a grooved body, and a cross handle. Gimlet eye, a squint-eye. [Colloq.] Wright.\n\n1. To pierce or make with a gimlet. 2. (Naut.)  To turn round (an anchor) by the stock, with a motion like turning a gimlet.
gimmal |1. Joined work whose parts move within each other; a pair or series of interlocked rings. 2. A quaint piece of machinery; a gimmer. [Obs.]\n\nMade or consisting of interlocked rings, gimmal mail. In their pale dull mouths the gimmal bit Lies foul with chewed grass. Shak. Gimmal joint. See Gimbal joint, under Gimbal.
gimmer |A piece of mechanism; mechanical device or contrivance; a gimcrack. [Obs.] Bp. Hall. Shak.
gimmor |A piece of mechanism; mechanical device or contrivance; a gimcrack. [Obs.] Bp. Hall. Shak.
gimp |Smart; spruce; trim; nice. [Obs. or Prov. Eng.]\n\nA narrow ornamental fabric of silk, woolen, or cotton, often with a metallic wire, or sometimes a coarse cord, running through it; -- used as trimming for dresses, furniture, etc. Gimp nail, an upholsterer's small nail.\n\nTo notch; to indent; to jag.
gin |Against; near by; towards; as, gin night. [Scot.] A. Ross (1778).\n\nIf. [Scotch] Jamieson.\n\nTo begin; -- often followed by an infinitive without to; as, gan tell. See Gan. [Obs. or Archaic] \"He gan to pray.\" Chaucer.\n\nA strong alcoholic liquor, distilled from rye and barley, and flavored with juniper berries; -- also called Hollands and Holland gin, because originally, and still very extensively, manufactured in Holland. Common gin is usually flavored with turpentine.\n\n1. Contrivance; artifice; a trap; a snare. Chaucer. Spenser. 2. (a) A machine for raising or moving heavy weights, consisting of a tripod formed of poles united at the top, with a windlass, pulleys, ropes, etc. (b) (Mining) A hoisting drum, usually vertical; a whim. 3. A machine for separating the seeds from cotton; a cotton gin. Note: The name is also given to an instrument of torture worked with screws, and to a pump moved by rotary sails. Gin block, a simple form of tackle block, having one wheel, over which a rope runs; -- called also whip gin, rubbish pulley, and monkey wheel. -- Gin power, a form of horse power for driving a cotton gin. -- Gin race, or Gin ring, the path of the horse when putting a gin in motion. Halliwell. -- Gin saw, a saw used in a cotton gin for drawing the fibers through the grid, leaving the seed in the hopper. -- Gin wheel. (a) In a cotton gin, a wheel for drawing the fiber through the grid; a brush wheel to clean away the lint. (b) (Mining) the drum of a whim.\n\n1. To catch in a trap. [Obs.] Beau. & Fl. 2. To clear of seeds by a machine; as, to gin cotton.
ging |Same as Gang, n., 2. [Obs.] There is a knot, a ging, a pack, a conspiracy against me. Shak.
gingal |See Jingal.
ginger |1. (Bot.)  A plant of the genus Zingiber, of the East and West Indies. The species most known is Z. officinale. 2. The hot and spicy rootstock of Zingiber officinale, which is much used in cookery and in medicine. Ginger beer or ale, a mild beer impregnated with ginger. -- Ginger cordial, a liquor made from ginger, raisins, lemon rind, and water, and sometimes whisky or brandy. -- Ginger pop. See Ginger beer (above). -- Ginger wine, wine impregnated with ginger. -- Wild ginger (Bot.), an American herb (Asarum Canadense) with two reniform leaves and a long, cordlike rootstock which has a strong taste of ginger.
gingerbread |A kind of plain sweet cake seasoned with ginger, and sometimes made in fanciful shapes. \"Gingerbread that was full fine.\" Chaucer. Gingerbread tree (Bot.), the doom palm; -- so called from the resemblance of its fruit to gingerbread. See Doom Palm. -- Gingerbread work, ornamentation, in architecture or decoration, of a fantastic, trivial, or tawdry character.
gingerly |Cautiously; timidly; fastidiously; daintily. What is't that you took up so gingerly Shak.
gingerness |Cautiousness; tenderness.
gingham |A kind of cotton or linen cloth, usually in stripes or checks, the yarn of which is dyed before it is woven; -- distinguished from printed cotton or prints.
ginging |The lining of a mine shaft with stones or bricks to prevent caving.
gingival |Of or pertaining to the gums. Holder.
gingle |See Jingle.
ginglyform |Ginglymoid.
ginglymodi |An order of ganoid fishes, including the modern gar pikes and many allied fossil forms. They have rhombic, ganoid scales, a heterocercal tail, paired fins without an axis, fulcra on the fins, and a bony skeleton, with the vertebræ convex in front and concave behind, forming a ball and socket joint. See Ganoidel.
ginglymoid |Pertaining to, or resembling, a ginglymus, or hinge joint; ginglyform.
ginglymoidal |Pertaining to, or resembling, a ginglymus, or hinge joint; ginglyform.
ginglymus |A hinge joint; an articulation, admitting of flexion and extension, or motion in two directions only, as the elbow and the ankle.
ginhouse |A building where cotton is ginned.
ginkgo |A large ornamental tree (Ginkgo biloba) from China and Japan, belonging to the Yew suborder of Coniferæ. Its leaves are so like those of some maidenhair ferns, that it is also called the maidenhair tree.
ginnee |See Jinnee.
ginnet |See Genet, a horse.
ginning |Beginning. [Obs.] Chaucer.
ginny-carriage |A small, strong carriage for conveying materials on a railroad. [Eng.]
ginseng |A plant of the genus Aralia, the root of which is highly valued as a medicine among the Chinese. The Chinese plant (Aralia Schinseng) has become so rare that the American (A. quinquefolia) has largely taken its place, and its root is now an article of export from America to China. The root, when dry, is of a yellowish white color, with a sweetness in the taste somewhat resembling that of licorice, combined with a slight aromatic bitterness.
ginshop |A shop or barroom where gin is sold as a beverage. [Colloq.]
gip |To take out the entrails of (herrings).\n\nA servant. See Gyp. Sir W. Scott.
gipoun |A short cassock. [Written also gepoun, gypoun, jupon, juppon.] [Obs.]
gipser |A kind of pouch formerly worn at the girdle. Ld. Lytton. A gipser all of silk, Hung at his girdle, white as morné milk. Chaucer.
gipsire |A kind of pouch formerly worn at the girdle. Ld. Lytton. A gipser all of silk, Hung at his girdle, white as morné milk. Chaucer.
gipsy |See Gypsy.
gipsy moth |A tussock moth (Ocneria dispar) native of the Old World, but accidentally introduced into eastern Massachusetts about 1869, where its caterpillars have done great damage to fruit, shade, and forest trees of many kinds. The male gypsy moth is yellowish brown, the female white, and larger than the male. In both sexes the wings are marked by dark lines and a dark lunule. The caterpillars, when full- grown, have a grayish mottled appearance, with blue tubercles on the anterior and red tubercles on the posterior part of the body, all giving rise to long yellow and black hairs. They usually pupate in July and the moth appears in August. The eggs are laid on tree trunks, rocks, etc., and hatch in the spring.
gipsyism |See Gypsyism.
giraffe |An African ruminant (Camelopardalis giraffa) related to the deers and antelopes, but placed in a family by itself; the camelopard. It is the tallest of animals, being sometimes twenty feet from the hoofs to the top of the head. Its neck is very long, and its fore legs are much longer than its hind legs.
girandole |1. An ornamental branched candlestick. 2. A flower stand, fountain, or the like, of branching form. 3. (Pyrotechny)  A kind of revolving firework. 4. (Fort.)  A series of chambers in defensive mines. Farrow.
girasol |1. (Bot.)  See Heliotrope. [Obs.] 2. (Min.)  A variety of opal which is usually milk white, bluish white, or sky blue; but in a bright light it reflects a reddish color.
girasole |1. (Bot.)  See Heliotrope. [Obs.] 2. (Min.)  A variety of opal which is usually milk white, bluish white, or sky blue; but in a bright light it reflects a reddish color.
gird |1. A stroke with a rod or switch; a severe spasm; a twinge; a pang. Conscience . . . is freed from many fearful girds and twinges which the atheist feels. Tillotson. 2. A cut; a sarcastic remark; a gibe; a sneer. I thank thee for that gird, good Tranio. Shak.\n\n1. To strike; to smite. [Obs.] To slay him and to girden off his head. Chaucer. 2. To sneer at; to mock; to gibe. Being moved, he will not spare to gird the gods. Shak.\n\nTo gibe; to sneer; to break a scornful jest; to utter severe sarcasms. Men of all sorts take a pride to gird at me. Shak.\n\n1. To encircle or bind with any flexible band. 2. To make fast, as clothing, by binding with a cord, girdle, bandage, etc. 3. To surround; to encircle, or encompass. That Nyseian isle, Girt with the River Triton. Milton. 4. To clothe; to swathe; to invest. I girded thee about with fine linen. Ezek. xvi. 10. The Son . . . appeared Girt with omnipotence. Milton. 5. To prepare; to make ready; to equip; as, to gird one's self for a contest. Thou hast girded me with strength. Ps. xviii. 39. To gird on, to put on; to fasten around or to one securely, like a girdle; as, to gird on armor or a sword. Let not him that girdeth on his harness boast himself as he that putteth it off. 1 Kings xx. 11. -- To gird up, to bind tightly with a girdle; to support and strengthen, as with a girdle. He girded up his loins, and ran before Ahab. 1 Kings xviii. 46. Gird up the loins of your mind. 1 Pet. i. 13. -- Girt up; prepared or equipped, as for a journey or for work, in allusion to the ancient custom of gathering the long flowing garments into the girdle and tightening it before any exertion; hence, adjectively, eagerly or constantly active; strenuous; striving. \"A severer, more girt-up way of living.\" J. C. Shairp.
girder |One who girds; a satirist.\n\n1. One who, or that which, girds. 2. (Arch. & Engin.)  A main beam; a stright, horizontal beam to span an opening or carry weight, such as ends of floor beams, etc.; hence, a framed or built-up member discharging the same office, technically called a compound girder. See Illusts. of Frame, and Doubleframed floor, under Double. Bowstring girder, Box girder, etc. See under Bowstring, Box, etc. -- Girder bridge. See under Bridge. -- Lattice girder, a girder consisting of longitudinal bars united by diagonal crossing bars. -- Half-lattice girder, a girder consisting of horizontal upper and lower bars connected by a series of diagonal bars sloping alternately in opposite directions so as to divide the space between the bars into a series of triangles. Knight. -- Sandwich girder, a girder consisting of two parallel wooden beams, between which is an iron plate, the whole clamped together by iron bolts.
girding |That with which one is girded; a girdle. Instead of a stomacher, a girding of sackcloth. Is. iii. 24.
girdle |A griddle. [Scot. & Prov. Eng.]\n\n1. That which girds, encircles, or incloses; a circumference; a belt; esp., a belt, sash, or article of dress encircling the body usually at the waist; a cestus. Within the girdle of these walls. Shak. Their breasts girded with golden girdles. Rev. xv. 6. 2. The zodiac; also, the equator. [Poetic] Bacon. From the world's girdle to the frozen pole. Cowper. That gems the starry girdle of the year. Campbell. 3. (Jewelry)  The line ofgreatest circumference of a brilliant-cut diamond, at which it is grasped by the setting. See Illust. of Brilliant. Knight. 4. (Mining)  A thin bed or stratum of stone. Raymond. 5. (Zoöl.)  The clitellus of an earthworm. Girdle bone (Anat.), the sphenethmoid. See under Sphenethmoid. -- Girdle wheel, a spinning wheel. -- Sea girdle (Zoöl.), a ctenophore. See Venus's girdle, under Venus. -- Shoulder, Pectoral, and Pelvic, girdle. (Anat.) See under Pectoral, and Pelvic. -- To have under the girdle, to have bound to one, that is, in subjection.\n\n1. To bind with a belt or sash; to gird. Shak. 2. To inclose; to environ; to shut in. Those sleeping stones, That as a waist doth girdle you about. Shak. 3. To make a cut or gnaw a groove around (a tree, etc.) through the bark and alburnum, thus killing it. [U. S.]
girdler |1. One who girdles. 2. A maker of girdles. 3. (Zoöl.)  An American longicorn beetle (Oncideres cingulatus) which lays its eggs in the twigs of the hickory, and then girdles each branch by gnawing a groove around it, thus killing it to provide suitable food for the larvæ.
girdlestead |1. That part of the body where the girdle is worn. [Obs.] Sheathed, beneath his girdlestead. Chapman. 2. The lap. [R.] There fell a flower into her girdlestead. Swinburne.
gire |See Gyre.
girkin |See Gherkin.
girl |1. A young person of either sex; a child. [Obs.] Chaucer. 2. A female child, from birth to the age of puberty; a young maiden. 3. A female servant; a maidservant. [U. S.] 4. (Zoöl.)  A roebuck two years old. [Prov. Eng.]
girlhood |State or time of being a girl.
girlish |Like, or characteristic of, a girl; of or pertaining to girlhood; innocent; artless; immature; weak; as, girlish ways; girlish grief. -- Girl\"ish*ly, adv. -- Girl\"ish*ness, n.
girlond |A garland; a prize. [Obs.] Chapman.
girn |To grin. [Obs.]
girondist |A member of the moderate republican party formed in the French legislative assembly in 1791. The Girondists were so called because their leaders were deputies from the department of La Gironde.\n\nOf or pertaining to the Girondists. [Written also Girondin.]
girrock |A garfish. Johnson.
girt |imp. & p. p. of Gird.\n\nTo gird; to encircle; to invest by means of a girdle; to measure the girth of; as, to girt a tree. We here create thee the first duke of Suffolk, And girt thee with the sword. Shak.\n\nBound by a cable; -- used of a vessel so moored by two anchors that she swings against one of the cables by force of the current or tide.\n\nSame as Girth.
girth |1. A band or strap which encircles the body; especially, one by which a saddle is fastened upon the back of a horse. 2. The measure round the body, as at the waist or belly; the circumference of anything. He's a lu sty, jolly fellow, that lives well, at least three yards in the girth. Addison. 3. A small horizontal brace or girder.\n\nTo bind as with a girth. [R.] Johnson.
girtline |A gantline. Hammock girtline, a line rigged for hanging out hammocks to dry.
gisarm |A weapon with a scythe-shaped blade, and a separate long sharp point, mounted on a long staff and carried by foot soldiers.
gise |To feed or pasture. [Obs.]\n\nGuise; manner. [Obs.] Chaucer.
gisle |A pledge. [Obs.] Bp. Gibson.
gismondine |A native hydrated silicate of alumina, lime, and potash, first noticed near Rome.
gismondite |A native hydrated silicate of alumina, lime, and potash, first noticed near Rome.
gist |1. A resting place. [Obs.] These quails have their set gists; to wit, ordinary resting and baiting places. Holland. 2. The main point, as of a question; the point on which an action rests; the pith of a matter; as, the gist of a question.
git |See Geat.
gitana |A Spanish gypsy.
gitano |A Spanish gypsy.
gite |A gown. [Obs.] She came often in a gite of red. Chaucer.
gith |The corn cockle; also anciently applied to the Nigella, or fennel flower.
gittern |An instrument like a guitar. \"Harps, lutes, and giternes.\" Chaucer.\n\nTo play on gittern. Milton.
gittith |A musical instrument, of unknown character, supposed by some to have been used by the people of Gath, and thence obtained by David. It is mentioned in the title of Psalms viii., lxxxi., and lxxxiv. Dr. W. Smith.
giust |Same as Joust. Spenser.\n\nSame as Joust.  Spenser.
giusto |In just, correct, or suitable time.
give |1. To bestow without receiving a return; to confer without compensation; to impart, as a possession; to grant, as authority or permission; to yield up or allow. For generous lords had rather give than pay. Young. 2. To yield possesion of; to deliver over, as property, in exchange for something; to pay; as, we give the value of what we buy. What shall a man give in exchange for his soul Matt. xvi. 26. 3. To yield; to furnish; to produce; to emit; as, flint and steel give sparks. 4. To communicate or announce, as advice, tidings, etc.; to pronounce; to render or utter, as an opinion, a judgment, a sentence, a shout, etc. 5. To grant power or license to; to permit; to allow; to license; to commission. It is given me once again to behold my friend. Rowe. Then give thy friend to shed the sacred wine. Pope. 6. To exhibit as a product or result; to produce; to show; as, the number of men, divided by the number of ships, gives four hundred to each ship. 7. To devote; to apply; used reflexively, to devote or apply one's self; as, the soldiers give themselves to plunder; also in this sense used very frequently in the past participle; as, the people are given to luxury and pleasure; the youth is given to study. 8. (Logic & Math.)  To set forth as a known quantity or a known relation, or as a premise from which to reason; -- used principally in the passive form given. 9. To allow or admit by way of supposition. I give not heaven for lost. Mlton. 10. To attribute; to assign; to adjudge. I don't wonder at people's giving him to me as a lover. Sheridan. 11. To excite or cause to exist, as a sensation; as, to give offense; to give pleasure or pain. 12. To pledge; as, to give one's word. 13. To cause; to make; -- with the infinitive; as, to give one to understand, to know, etc. But there the duke was given to understand That in a gondola were seen together Lorenzo and his amorous Jessica. Shak. To give away, to make over to another; to transfer. Whatsoever we employ in charitable uses during our lives, is given away from ourselves. Atterbury. -- To give back, to return; to restore. Atterbury. -- To give the bag, to cheat. [Obs.] I fear our ears have given us the bag. J. Webster. -- To give birth to. (a) To bear or bring forth, as a child. (b) To originate; to give existence to, as an enterprise, idea. -- To give chase, to pursue. -- To give ear to. See under Ear. -- To give forth, to give out; to publish; to tell. Hayward. -- To give ground. See under Ground, n. -- To give the hand, to pledge friendship or faith. -- To give the hand of, to espouse; to bestow in marriage. -- To give the head. See under Head, n. -- To give in. (a) To abate; to deduct. (b) To declare; to make known; to announce; to tender; as, to give in one's adhesion to a party. -- To give the lie to (a person), to tell (him) that he lies. -- To give line. See under Line. -- To give off, to emit, as steam, vapor, odor, etc. -- To give one's self away, to make an inconsiderate surrender of one's cause, an unintentional disclosure of one's purposes, or the like. [Colloq.] -- To give out. (a) To utter publicly; to report; to announce or declare. One that gives out himself Prince Florizel. Shak. Give out you are of Epidamnum. Shak. (b) To send out; to emit; to distribute; as, a substance gives out steam or odors. -- To give over. (a) To yield completely; to quit; to abandon. (b) To despair of. (c) To addict, resign, or apply (one's self). The Babylonians had given themselves over to all manner of vice. Grew. -- To give place, to withdraw; to yield one's claim. -- To give points. (a) In games of skill, to equalize chances by conceding a certain advantage; to allow a handicap. (b) To give useful suggestions. [Colloq.] -- To give rein. See under Rein, n. -- To give the sack . Same as To give the bag. -- To give and take. (a) To average gains and losses. (b) To exchange freely, as blows, sarcasms, etc. -- To give time (Law), to accord extension or forbearance to a debtor. Abbott. -- To give the time of day, to salute one with the compliment appropriate to the hour, as \"good morning.\" \"good evening\| etc. -- To give tongue| in hunter's phrase| to bark; -- said of dogs. -- To give up. (a) To abandon; to surrender. \"Don't give up the ship.\" He has . . . given up For certain drops of salt| your city Rome. Shak. (b) To make public; to reveal. I'll not state them By giving up their characters. Beau. & Fl. (c) (Used also reflexively.) -- To give up the ghost. See under Ghost. -- To give one's self up| to abandon hope; to despair; to surrender one's self. -- To give way. (a) To withdraw; to give place. (b) To yield to force or pressure; as| the scaffolding gave way. (c) (Naut.) To begin to row; or to row with increased energy. (d) (Stock Exchange). To depreciate or decline in value; as| railroad securities gave way two per cent. -- To give way together| to row in time; to keep stroke. Syn. -- To Give| Confer| Grant. To give is the generic word| embracing all the rest. To confer was originally used of persons in power| who gave permanent grants or privileges; as| to confer the order of knighthood; and hence it still denotes the giving of something which might have been withheld; as| to confer a favor. To grant is to give in answer to a petition or request| or to one who is in some way dependent or inferior.\n\n1. To give a gift or gifts. 2. To yield to force or pressure; to relax; to become less rigid; as| the earth gives under the feet. 3. To become soft or moist. [Obs.] Bacon . 4. To move; to recede. Now back he gives| then rushes on amain. Daniel. 5. To shed tears; to weep. [Obs.] Whose eyes do never give But through lust and laughter. Shak. 6. To have a misgiving. [Obs.] My mind gives ye're reserved To rob poor market women. J. Webster. 7. To open; to lead. [A Gallicism] This| yielding| gave into a grassy walk. Tennyson. To give back| to recede; to retire; to retreat. They gave back and came no farther. Bunyan. -- To give in| to yield; to succumb; to acknowledge one's self beaten; to cease opposition. The Scots battalion was enforced to give in. Hayward. This consideration may induce a translator to give in to those general phrases. Pope. -- To give off| to cease; to forbear. [Obs.] Locke. -- To give on or upon. (a) To rush; to fall upon. [Obs.] (b) To have a view of; to be in sight of; to overlook; to look toward; to open upon; to front; to face. [A Gallicism| cf. Fr. donner sur.] Rooms which gave upon a pillared porch. Tennyson. The gloomy staircase on which the grating gave. Dickens. -- To give out. (a) To expend all one's strength. Hence| (b) To cease from exertion; to fail; to be exhausted; as| my feet being to give out; the flour has given out. -- To give over| to cease; to discontinue; to desist. It would be well for all authors| if they knew when to give over| and to desist from any further pursuits after fame. Addison. -- To give up| to cease from effort; to yield; to despair; as| he would never give up."
given |p. p. & a. from Give, v. 1. (Math. & Logic)  Granted; assumed; supposed to be known; set forth as a known quantity, relation, or premise. 2. Disposed; inclined; -- used with an adv.; as, virtuously given. Shak. 3. Stated; fixed; as, in a given time. Given name, the Christian name, or name given by one's parents or guardians, as distinguished from the surname, which is inherited. [Colloq.]
giver |One who gives; a donor; a bestower; a grantor; one who imparts or distributes. It is the giver, and not the gift, that engrosses the heart of the Christian. Kollock.
gives |Fetters.
giving |1. The act of bestowing as a gift; a conferring or imparting. 2. A gift; a benefaction. [R.] Pope. 3. The act of softening, breaking, or yielding. \"Upon the first giving of the weather.\" Addison. Giving in, a falling inwards; a collapse. -- Giving out, anything uttered or asserted; an outgiving. His givings out were of an infinite distance From his true meant design. Shak.
gizzard |1. (Anat.)  The second, or true, muscular stomach of birds, in which the food is crushed and ground, after being softened in the glandular stomach (crop), or lower part of the esophagus; the gigerium. 2. (Zoöl.) (a) A thick muscular stomach found in many invertebrate animals. (b) A stomach armed with chitinous or shelly plates or teeth, as in certain insects and mollusks. Gizzard shad (Zoöl.), an American herring (Dorosoma cepedianum) resembling the shad, but of little value. -- To fret the gizzard, to harass; to vex one's self; to worry. [Low] Hudibras. -- To stick in one's gizzard, to be difficult of digestion; to be offensive. [Low]
glabella |The space between the eyebrows, also including the corresponding part of the frontal bone; the mesophryon. -- Gla*bel\"lar, a.
glabellum |The median, convex lobe of the head of a trilobite. See Trilobite.
glabrate |Becoming smooth or glabrous from age. Gray.
glabreate |To make smooth, plain, or bare. [Obs.]
glabriate |To make smooth, plain, or bare. [Obs.]
glabrity |Smoothness; baldness. [R.]
glabrous |Smooth; having a surface without hairs or any unevenness.
glace |Coated with icing; iced; glazed; -- said of fruits, sweetmeats, cake, etc.
glacial |1. Pertaining to ice or to its action; consisting of ice; frozen; icy; esp., pertaining to glaciers; as, glacial phenomena. Lyell. 2. (Chem.)  Resembling ice; having the appearance and consistency of ice; - - said of certain solid compounds; as, glacial phosphoric or acetic acids. Glacial acid (Chem.), an acid of such strength or purity as to crystallize at an ordinary temperature, in an icelike form; as acetic or carbolic acid. -- Glacial drift (Geol.), earth and rocks which have been transported by moving ice, land ice, or icebergs; bowlder drift. -- Glacial epoch or period (Geol.), a period during which the climate of the modern temperate regions was polar, and ice covered large portions of the northern hemisphere to the mountain tops. -- Glacial theory or hypothesis. (Geol.) See Glacier theory, under Glacier.
glacialist |One who attributes the phenomena of the drift, in geology, to glaciers.
glaciate |To turn to ice.\n\n1. To convert into, or cover with, ice. 2. (Geol.)  To produce glacial effects upon, as in the scoring of rocks, transportation of loose material, etc. Glaciated rocks, rocks whose surfaces have been smoothed, furrowed, or striated, by the action of ice.
glaciation |1. Act of freezing. 2. That which is formed by freezing; ice. 3. The process of glaciating, or the state of being glaciated; the production of glacial phenomena.
glacier |An immense field or stream of ice, formed in the region of perpetual snow, and moving slowly down a mountain slope or valley, as in the Alps, or over an extended area, as in Greenland. Note: The mass of compacted snow forming the upper part of a glacier is called the firn, or névé; the glacier proper consist of solid ice, deeply crevassed where broken up by irregularities in the slope or direction of its path. A glacier usually carries with it accumulations of stones and dirt called moraines, which are designated, according to their position, as lateral, medial, or terminal (see Moraine). The common rate of flow of the Alpine glaciers is from ten to twenty inches per day in summer, and about half that in winter. Glacier theory (Geol.), the theory that large parts of the frigid and temperate zones were covered with ice during the glacial, or ice, period, and that, by the agency of this ice, the loose materials on the earth's surface, called drift or diluvium, were transported and accumulated.
glacious |Pertaining to, consisting of or resembling, ice; icy. Sir T. Browne.
glacis |A gentle slope, or a smooth, gently sloping bank; especially (Fort.), that slope of earth which inclines from the covered way toward the exterior ground or country (see Illust. of Ravelin).
glad |1. Pleased; joyous; happy; cheerful; gratified; -- opposed to sorry, sorrowful, or unhappy; -- said of persons, and often followed by of, at, that, or by the infinitive, and sometimes by with, introducing the cause or reason. A wise son maketh a glad father. Prov. x. 1. He that is glad at calamities shall not be unpunished. Prov. xvii. 5. The Trojan, glad with sight of hostile blood. Dryden. He, glad of her attention gained. Milton. As we are now glad to behold your eyes. Shak. Glad am I that your highness is so armed. Shak. Glad on 't, glad of it. [Colloq.] Shak. 2. Wearing a gay or bright appearance; expressing or exciting joy; producing gladness; exhilarating. Her conversation More glad to me than to a miser money is. Sir P. Sidney. Glad evening and glad morn crowned the fourth day. Milton. Syn. -- Pleased; gratified; exhilarated; animated; delighted; happy; cheerful; joyous; joyful; cheering; exhilarating; pleasing; animating. -- Glad, Delighted, Gratified. Delighted expresses a much higher degree of pleasure than glad. Gratified always refers to a pleasure conferred by some human agent, and the feeling is modified by the consideration that we owe it in part to another. A person may be glad or delighted to see a friend, and gratified at the attention shown by his visits.\n\nTo make glad; to cheer; to gladden; to exhilarate. Chaucer. That which gladded all the warrior train. Dryden. Each drinks the juice that glads the heart of man. Pope.\n\nTo be glad; to rejoice. [Obs.] Massinger.
gladden |To make glad; to cheer; to please; to gratify; to rejoice; to exhilarate. A secret pleasure gladdened all that saw him. Addison.\n\nTo be or become glad; to rejoice. The vast Pacific gladdens with the freight. Wordsworth.
gladder |One who makes glad. Chaucer.
glade |1. An open passage through a wood; a grassy open or cleared space in a forest. There interspersed in lawns and opening glades. Pope. 2. An everglade. [Local, U. S.] 3. An opening in the ice of rivers or lakes, or a place left unfrozen; also, smooth ice. [Local, U. S.] Bottom glade. See under Bottom. -- Glade net, in England, a net used for catching woodcock and other birds in forest glades.
gladen |Sword grass; any plant with sword-shaped leaves, esp. the European Iris foetidissima. [Written also gladwyn, gladdon, and glader.]
gladeye |The European yellow-hammer.
gladful |Full of gladness; joyful; glad. [R.] -- Glad\"ful*ness, n. [R.] Spenser. It followed him with gladful glee. Spenser.
gladiate |Sword-shaped; resembling a sword in form, as the leaf of the iris, or of the gladiolus.
gladiator |1. Originally, a swordplayer; hence, one who fought with weapons in public, either on the occasion of a funeral ceremony, or in the arena, for public amusement. 2. One who engages in any fierce combat or controversy.
gladiatorial |Of or pertaining to gladiators, or to contests or combatants in general.
gladiatorian |Of or pertaining to gladiators, or to contests or combatants in general.
gladiatorism |The art or practice of a gladiator.
gladiatorship |Conduct, state, or art, of a gladiator.
gladiatory |Gladiatorial. [R.]
gladiature |Swordplay; fencing; gladiatorial contest. Gayton.
gladiole |A lilylike plant, of the genus Gladiolus; -- called also corn flag.
gladiolus |1. (Bot.)  A genus of plants having bulbous roots and gladiate leaves, and including many species, some of which are cultivated and valued for the beauty of their flowers; the corn flag; the sword lily. 2. (Anat.)  The middle portion of the sternum in some animals; the mesosternum.
gladius |The internal shell, or pen, of cephalopods like the squids.
gladly |1. Preferably; by choice. [Obs.] Chaucer. 2. With pleasure; joyfully; cheerfully; eagerly. The common people heard him gladly. Mark xii. 37.
gladness |State or quality of being glad; pleasure; joyful satisfaction; cheerfulness. They . . . did eat their meat with gladness and singleness of heart. Acts ii. 46. Note: Gladness is rarely or never equivalent to mirth, merriment, gayety, and triumph, and it usually expresses less than delight. It sometimes expresses great joy. The Jews had joy and gladness, a feast and a good day. Esther viii. 17.
gladship |A state of gladness. [Obs.] Gower.
gladsome |1. Pleased; joyful; cheerful. 2. Causing joy, pleasure, or cheerfulness; having the appearance of gayety; pleasing. Of opening heaven they sung, and gladsome day. Prior. -- Glad\"some*ly, adv. -- Glad\"some*ness, n. Hours of perfect gladsomeness. Wordsworth.
gladstone |A four-wheeled pleasure carriage with two inside seats, calash top, and seats for driver and footman.
gladwyn |See Gladen.
glair |1. The white of egg. It is used as a size or a glaze in bookbinding, for pastry, etc. 2. Any viscous, transparent substance, resembling the white of an egg. 3. A broadsword fixed on a pike; a kind of halberd.\n\nTo smear with the white of an egg.
glaire |See Glair.
glaireous |Glairy; covered with glair.
glairin |A glairy viscous substance, which forms on the surface of certain mineral waters, or covers the sides of their inclosures; -- called also baregin.
glairy |Like glair, or partaking of its qualities; covered with glair; viscous and transparent; slimy. Wiseman.
glaive |1. A weapon formerly used, consisting of a large blade fixed on the end of a pole, whose edge was on the outside curve; also, a light lance with a long sharp-pointed head. Wilhelm. 2. A sword; -- used poetically and loosely. The glaive which he did wield. Spenser.
glama |A copious gummy secretion of the humor of the eyelids, in consequence of some disorder; blearedness; lippitude.
glamour |1. A charm affecting the eye, making objects appear different from what they really are. 2. Witchcraft; magic; a spell. Tennyson. 3. A kind of haze in the air, causing things to appear different from what they really are. The air filled with a strange, pale glamour that seemed to lie over the broad valley. W. Black. 4. Any artificial interest in, or association with, an object, through which it appears delusively magnified or glorified. Glamour gift, Glamour might, the gift or power of producing a glamour. The former is used figuratively, of the gift of fascination peculiar to women. It had much of glamour might To make a lady seem a knight. Sir W. Scott.
glamourie |Glamour. [Scot.]
glance |1. A sudden flash of light or splendor. Swift as the lightning glance. Milton. 2. A quick cast of the eyes; a quick or a casual look; a swift survey; a glimpse. Dart not scornful glances from those eyes. Shak. 3. An incidental or passing thought or allusion. How fleet is a glance of the mind. Cowper. 4. (Min.)  A name given to some sulphides, mostly dark-colored, which have a brilliant metallic luster, as the sulphide of copper, called copper glance. Glance coal, anthracite; a mineral composed chiefly of carbon. -- Glance cobalt, cobaltite, or gray cobalt. -- Glance copper, c -- Glance wood, a hard wood grown in Cuba, and used for gauging instruments, carpenters' rules, etc. McElrath.\n\n1. To shoot or emit a flash of light; to shine; to flash. From art, from nature, from the schools, Let random influences glance, Like light in many a shivered lance, That breaks about the dappled pools. Tennyson. 2. To strike and fly off in an oblique direction; to dart aside. \"Your arrow hath glanced\". Shak. On me the curse aslope Glanced on the ground. Milton. 3. To look with a sudden, rapid cast of the eye; to snatch a momentary or hasty view. The poet's eye, in a fine frenzy rolling, Doth glance from heaven to earth, from earth to heaven. Shak. 4. To make an incidental or passing reflection; to allude; to hint; - - often with at. Wherein obscurely Cæsar''s ambition shall be glanced at. Shak. He glanced at a certain reverend doctor. Swift. 5. To move quickly, appearing and disappearing rapidly; to be visible only for an instant at a time; to move interruptedly; to twinkle. And all along the forum and up the sacred seat, His vulture eye pursued the trip of those small glancing feet. Macaulay.\n\n1. To shoot or dart suddenly or obliquely; to cast for a moment; as, to glance the eye. 2. To hint at; to touch lightly or briefly. [Obs.] In company I often glanced it. Shak.
glancing |1. Shooting, as light. When through the gancing lightnings fly. Rowe. 2. Flying off (after striking) in an oblique direction; as, a glancing shot.
glancingly |In a glancing manner; transiently; incidentally; indirectly. Hakewill.
gland |1. (Anat.) (a) An organ for secreting something to be used in, or eliminated from, the body; as, the sebaceous glands of the skin; the salivary glands of the mouth. (b) An organ or part which resembles a secreting, or true, gland, as the ductless, lymphatic, pineal, and pituitary glands, the functions of which are very imperfectly known. Note: The true secreting glands are, in principle, narrow pouches of the mucous membranes, or of the integument, lined with a continuation of the epithelium, or of the epidermis, the cells of which produce the secretion from the blood. In the larger glands, the pouches are tubular, greatly elongated, and coiled, as in the sweat glands, or subdivided and branched, making compound and racemose glands, such as the pancreas. 2. (Bot.) (a) A special organ of plants, usually minute and globular, which often secretes some kind of resinous, gummy, or aromatic product. (b) Any very small prominence. 3. (Steam Mach.)  The movable part of a stuffing box by which the packing is compressed; -- sometimes called a follower. See Illust. of Stuffing box, under Stuffing. 4. (Mach.)  The crosspiece of a bayonet clutch.
glandage |A feeding on nuts or mast. [Obs.] Crabb.
glandered |Affected with glanders; as, a glandered horse. Yu
glanderous |Of or pertaining to glanders; of the nature of glanders. Youatt.
glanders |A highly contagious and very destructive disease of horses, asses, mules, etc., characterized by a constant discharge of sticky matter from the nose, and an enlargement and induration of the glands beneath and within the lower jaw. It may transmitted to dogs, goats, sheep, and to human beings.
glandiferous |Bearing acorns or other nuts; as, glandiferous trees.
glandiform |Having the form of a gland or nut; resembling a gland.
glandular |Containing or supporting glands; consisting of glands; pertaining to glands.
glandulation |The situation and structure of the secretory vessels in plants. Martyn. Glandulation respects the secretory vessels, which are either glandules, follicles, or utricles. J. Lee.
glandule |A small gland or secreting vessel.
glanduliferous |Bearing glandules.
glandulose |Same as Glandulous.
glandulosity |Quality of being glandulous; a collection of glands. [R.] Sir T. Browne.
glandulous |Containing glands; consisting of glands; pertaining to glands; resembling glands.
glans |1. (Anat.)  The vascular body which forms the apex of the penis, and the extremity of the clitoris. 2. (Bot.)  The acorn or mast of the oak and similar fruits. Gray. 3. (Med.) (a) Goiter. (b) A pessary. [Obs.]
glare |1. To shine with a bright, dazzling light. The cavern glares with new-admitted light. Dryden. 2. To look with fierce, piercing eyes; to stare earnestly, angrily, or fiercely. And eye that scorcheth all it glares upon. Byron. 3. To be bright and intense, as certain colors; to be ostentatiously splendid or gay. She glares in balls, front boxes, and the ring. Pope.\n\nTo shoot out, or emit, as a dazzling light. Every eye Glared lightning, and shot forth pernicious fire. Milton.\n\n1. A bright, dazzling light; splendor that dazzles the eyes; a confusing and bewildering light. The frame of burnished steel that cast a glare. Dryden. 2. A fierce, piercing look or stare. About them round, A lion now he stalks with fiery glare. Milton. 3. A viscous, transparent substance. See Glair. 4. A smooth, bright, glassy surface; as, a glare of ice. [U. S. ]\n\nSmooth and bright or translucent; -- used almost exclusively of ice; as, skating on glare ice. [U. S.]
glareous |Glairy. John Georgy (1766).
glariness |A dazzling luster or brilliancy.
glaring |Clear; notorious; open and bold; barefaced; as, a glaring crime. -- Glar\"ing*ly, adv.
glaringness |A dazzling luster or brilliancy.
glary |Of a dazzling luster; glaring; bright; shining; smooth. Bright, crystal glass is glary. Boyle.
glass |1. A hard, brittle, translucent, and commonly transparent substance, white or colored, having a conchoidal fracture, and made by fusing together sand or silica with lime, potash, soda, or lead oxide. It is used for window panes and mirrors, for articles of table and culinary use, for lenses, and various articles of ornament. Note: Glass is variously colored by the metallic oxides; thus, manganese colors it violet; copper (cuprous), red, or (cupric) green; cobalt, blue; uranium, yellowish green or canary yellow; iron, green or brown; gold, purple or red; tin, opaque white; chromium, emerald green; antimony, yellow. 2. (Chem.)  Any substance having a peculiar glassy appearance, and a conchoidal fracture, and usually produced by fusion. 3. Anything made of glass. Especially: (a) A looking-glass; a mirror. (b) A vessel filled with running sand for measuring time; an hourglass; and hence, the time in which such a vessel is exhausted of its sand. She would not live The running of one glass. Shak. (c) A drinking vessel; a tumbler; a goblet; hence, the contents of such a vessel; especially; spirituous liquors; as, he took a glass at dinner. (d) An optical glass; a lens; a spyglass; -- in the plural, spectacles; as, a pair of glasses; he wears glasses. (e) A weatherglass; a barometer. Note: Glass is much used adjectively or in combination; as, glass maker, or glassmaker; glass making or glassmaking; glass blower or glassblower, etc. Bohemian glass, Cut glass, etc. See under Bohemian, Cut, etc. -- Crown glass, a variety of glass, used for making the finest plate or window glass, and consisting essentially of silicate of soda or potash and lime, with no admixture of lead; the convex half of an achromatic lens is composed of crown glass; -- so called from a crownlike shape given it in the process of blowing. -- Crystal glass, or Flint glass. See Flint glass, in the Vocabulary. -- Cylinder glass, sheet glass made by blowing the glass in the form of a cylinder which is then split longitudinally, opened out, and flattened. -- Glass of antimony, a vitreous oxide of antimony mixed with sulphide. -- Glass blower, one whose occupation is to blow and fashion glass. -- Glass blowing, the art of shaping glass, when reduced by heat to a viscid state, by inflating it through a tube. -- Glass cloth, a woven fabric formed of glass fibers. -- Glass coach, a coach superior to a hackney-coach, hired for the day, or any short period, as a private carriage; -- so called because originally private carriages alone had glass windows. [Eng.] Smart. Glass coaches are [allowed in English parks from which ordinary hacks are excluded], meaning by this term, which is never used in America, hired carriages that do not go on stands. J. F. Cooper. -- Glass cutter. (a) One who cuts sheets of glass into sizes for window panes, ets. (b) One who shapes the surface of glass by grinding and polishing. (c) A tool, usually with a diamond at the point, for cutting glass. -- Glass cutting. (a) The act or process of dividing glass, as sheets of glass into panes with a diamond. (b) The act or process of shaping the surface of glass by appylying it to revolving wheels, upon which sand, emery, and, afterwards, polishing powder, are applied; especially of glass which is shaped into facets, tooth ornaments, and the like. Glass having ornamental scrolls, etc., cut upon it, is said to be engraved. -- Glass metal, the fused material for making glass. -- Glass painting, the art or process of producing decorative effects in glass by painting it with enamel colors and combining the pieces together with slender sash bars of lead or other metal. In common parlance, glass painting and glass staining (see Glass staining, below) are used indifferently for all colored decorative work in windows, and the like. -- Glass paper, paper faced with pulvirezed glass, and used for abrasive purposes. -- Glass silk, fine threads of glass, wound, when in fusion, on rapidly rotating heated cylinders. -- Glass silvering, the process of transforming plate glass into mirrors by coating it with a reflecting surface, a deposit of silver, or a mercury amalgam. -- Glass soap, or Glassmaker's soap, the black oxide of manganese or other substances used by glass makers to take away color from the materials for glass. -- Glass staining, the art or practice of coloring glass in its whole substance, or, in the case of certain colors, in a superficial film only; also, decorative work in glass. Cf. Glass painting. -- Glass tears. See Rupert's drop. -- Glass works, an establishment where glass is made. -- Heavy glass, a heavy optical glass, consisting essentially of a borosilicate of potash. -- Millefiore glass. See Millefiore. -- Plate glass, a fine kind of glass, cast in thick plates, and flattened by heavy rollers, -- used for mirrors and the best windows. -- Pressed glass, glass articles formed in molds by pressure when hot. -- Soluble glass (Chem.), a silicate of sodium or potassium, found in commerce as a white, glassy mass, a stony powder, or dissolved as a viscous, sirupy liquid; -- used for rendering fabrics incombustible, for hardening artificial stone, etc.; -- called also water glass. -- Spun glass, glass drawn into a thread while liquid. -- Toughened glass, Tempered glass, glass finely tempered or annealed, by a peculiar method of sudden cooling by plunging while hot into oil, melted wax, or paraffine, etc.; -- called also, from the name of the inventor of the process, Bastie glass. -- Water glass. (Chem.) See Soluble glass, above. -- Window glass, glass in panes suitable for windows.\n\n1. To reflect, as in a mirror; to mirror; -- used reflexively. Happy to glass themselves in such a mirror. Motley. Where the Almighty's form glasses itself in tempests. Byron. 2. To case in glass. [R.] Shak. 3. To cover or furnish with glass; to glaze. Boyle. 4. To smooth or polish anything, as leater, by rubbing it with a glass burnisher.
glass maker |One who makes, or manufactures, glass. -- Glass\" mak`ing, or Glass\"mak`ing, n.
glass-crab |The larval state (Phyllosoma) of the genus Palinurus and allied genera. It is remarkable for its strange outlines, thinness, and transparency. See Phyllosoma.
glass-faced |Mirror-faced; reflecting the sentiments of another. [R.] \"The glass-faced flatterer.\" Shak.
glass-gazing |Given to viewing one's self in a glass or mirror; finical. [Poetic] Shak.
glass-rope |A remarkable vitreous sponge, of the genus Hyalonema, first brought from Japan. It has a long stem, consisting of a bundle of long and large, glassy, siliceous fibers, twisted together.
glass-snail |A small, transparent, land snail, of the genus Vitrina.
glass-snake |A long, footless lizard (Ophiosaurus ventralis), of the Southern United States; -- so called from its fragility, the tail easily breaking into small pieces. It grows to the length of three feet. The name is applied also to similar species found in the Old World.
glass-sponge |A siliceous sponge, of the genus Hyalonema, and allied genera; -- so called from their glassy fibers or spicules; -- called also vitreous sponge. See Glass-rope, and Euplectella.
glassen |Glassy; glazed. [Obs.] And pursues the dice with glassen eyes. B. Jonson.
glasseye |1. (Zoöl.)  A fish of the great lakes; the wall-eyed pike. 2. (Far.)  A species of blindness in horses in which the eye is bright and the pupil dilated; a sort of amaurosis. Youatt.
glassful |The contents of a glass; as much of anything as a glass will hold.\n\nGlassy; shining like glass. [Obs.] \"Minerva's glassful shield.\" Marston.
glasshouse |A house where glass is made; a commercial house that deals in glassware.
