animastic |Pertaining to mind or spirit; spiritual.\n\nPsychology. [Obs.]
animate |1. To give natural life to; to make alive; to quicken; as, the soul animates the body. 2. To give powers to, or to heighten the powers or effect of; as, to animate a lyre. Dryden. 3. To give spirit or vigor to; to stimulate or incite; to inspirit; to rouse; to enliven. The more to animate the people, he stood on high . . . and cried unto them with a loud voice. Knolles. Syn. -- To enliven; inspirit; stimulate; exhilarate; inspire; instigate; rouse; urge; cheer; prompt; incite; quicken; gladden.\n\nEndowed with life; alive; living; animated; lively. The admirable structure of animate bodies. Bentley.
animated |Endowed with life; full of life or spirit; indicating animation; lively; vigorous. \"Animated sounds.\" Pope. \"Animated bust.\" Gray. \"Animated descriptions.\" Lewis.
animatedly |With animation.
animater |One who animates. De Quincey.
animating |Causing animation; life-giving; inspiriting; rousing. \"Animating cries.\" Pope. -- An\"i*ma`ting*ly, adv.
animation |1. The act of animating, or giving life or spirit; the state of being animate or alive. The animation of the same soul quickening the whole frame. Bp. Hall. Perhaps an inanimate thing supplies me, while I am speaking, with whatever I posses of animation. Landor. 2. The state of being lively, brisk, or full of spirit and vigor; vivacity; spiritedness; as, he recited the story with great animation. Suspended animation, temporary suspension of the vital functions, as in persons nearly drowned. Syn. -- Liveliness; vivacity; spirit; buoyancy; airiness; sprightliness; promptitude; enthusiasm; ardor; earnestness; energy. See Liveliness.
animative |Having the power of giving life or spirit. Johnson.
animator |One who, or that which, animates; an animater. Sir T. Browne.
anime |Of a different tincture from the animal itself; -- said of the eyes of a rapacious animal. Brande & C.\n\nA resin exuding from a tropical American tree (Hymenæa courbaril), and much used by varnish makers. Ure.
animism |1. The doctrine, taught by Stahl, that the soul is the proper principle of life and development in the body. 2. The belief that inanimate objects and the phenomena of nature are endowed with personal life or a living soul; also, in an extended sense, the belief in the existence of soul or spirit apart from matter. Tylor.
animist |One who maintains the doctrine of animism.
animistic |Of or pertaining to animism. Huxley. Tylor.
animose |Full of spirit; hot; vehement; resolute. [Obs.] Ash.
animoseness |Vehemence of temper. [Obs.]
animosity |1. Mere spiritedness or courage. [Obs.] Skelton. Such as give some proof of animosity, audacity, and execution, those she [the crocodile] loveth. Holland. 2. Violent hatred leading to active opposition; active enmity; energetic dislike. Macaulay. Syn. -- Enmity; hatred; opposition. -- Animosity, Enmity. Enmity be dormant or concealed; animosity is active enmity, inflamed by collision and mutual injury between opposing parties. The animosities which were continually springing up among the clans in Scotland kept that kingdom in a state of turmoil and bloodshed for successive ages. The animosities which have been engendered among Christian sects have always been the reproach of the church. Such [writings] as naturally conduce to inflame hatreds and make enmities irreconcilable. Spectator. [These] factions . . . never suspended their animosities till they ruined that unhappy government. Hume.
animous |Full of spirit; hot; vehement; resolute. [Obs.] Ash.
animus |Animating spirit; intention; temper. nimus furandi Etym: [L.] (Law), intention of stealing.
anion |An electro-negative element, or the element which, in electro- chemical decompositions, is evolved at the anode; -- opposed to cation. Faraday.
anise |1. (Bot.)  An umbelliferous plant (Pimpinella anisum) growing naturally in Egypt, and cultivated in Spain, Malta, etc., for its carminative and aromatic seeds. 2. The fruit or seeds of this plant.
aniseed |The seed of the anise; also, a cordial prepared from it. \"Oil of aniseed.\" Brande & C.
anisette |A French cordial or liqueur flavored with anise seeds. De Colange.
anisic |Of or derived from anise; as, anisic acid; anisic alcohol.
anisocoria |Inequality of the pupils of the eye.
anisodactyla |(a) A group of herbivorous mammals characterized by having the hoofs in a single series around the foot, as the elephant, rhinoceros, etc. (b) A group of perching birds which are anisodactylous.
anisodactylous |Characterized by unequal toes, three turned forward and one backward, as in most passerine birds.
anisodactyls |(a) A group of herbivorous mammals characterized by having the hoofs in a single series around the foot, as the elephant, rhinoceros, etc. (b) A group of perching birds which are anisodactylous.
anisol |Methyl phenyl ether, C6H5OCH3, got by distilling anisic acid or by the action of methide on potassium phenolate.
anisomeric |Not isomeric; not made of the same components in the same proportions.
anisomerous |Having the number of floral organs unequal, as four petals and six stamens.
anisometric |Not isometric; having unsymmetrical parts; -- said of crystals with three unequal axes. Dana.
anisometropia |Unequal refractive power in the two eyes.
anisopetalous |Having unequal petals.
anisophyllous |Having unequal leaves.
anisopleura |A primary division of gastropods, including those having spiral shells. The two sides of the body are unequally developed.
anisopoda |A division of Crustacea, which, in some its characteristics, is intermediate between Amphipoda and Isopoda.
anisospore |A sexual spore in which the sexes differ in size; -- opposed to isospore.
anisostemonous |Having unequal stamens; having stamens different in number from the petals.
anisosthenic |Of unequal strength.
anisotrope |Not isotropic; having different properties in different directions; thus, crystals of the isometric system are optically isotropic, but all other crystals are anisotropic.
anisotropic |Not isotropic; having different properties in different directions; thus, crystals of the isometric system are optically isotropic, but all other crystals are anisotropic.
anisotropous |Anisotropic.
anisyl |(a) The univalent radical, CH3OC6H4, of which anisol is the hydride. (b) The univalent radical CH3OC6H4CH2; as, anisyl alcohol. (c) The univalent radical CH3OC6H4CO, of anisic acid.
anito |In Guam and the Philippines, an idol, fetich, or spirit.
anker |A liquid measure in various countries of Europe. The Dutch anker, formerly also used in England, contained about 10 of the old wine gallons, or 8
ankerite |A mineral closely related to dolomite, but containing iron.
ankh |A tau cross with a loop at the top, used as an attribute or sacred emblem, symbolizing generation or enduring life. Called also crux ansata.
ankle |The joint which connects the foot with the leg; the tarsus. Ankle bone, the bone of the ankle; the astragalus.
ankled |Having ankles; -- used in composition; as, well-ankled. Beau. & Fl.
anklet |An ornament or a fetter for the ankle; an ankle ring.
ankus |An elephant goad with a sharp spike and hook, resembling a short-handled boat hook. [India] Kipling.
ankylose |Same as Anchylose.
ankylosis |1. (Med.)  Stiffness or fixation of a joint; formation of a stiff joint. Dunglison. 2. (Anat.)  The union of two or more separate bones to from a single bone; the close union of bones or other structures in various animals.\n\nSame as Anchylosis.
ankylostomiasis |A disease due to the presence of the parasites Agchylostoma duodenale, Uncinaria (subgenus Necator) americana, or allied nematodes, in the small intestine. When present in large numbers they produce a severe anæmia by sucking the blood from the intestinal walls.  Called also miner's anæmia, tunnel disease, brickmaker's anæmia, Egyptian chlorosis.
anlace |A broad dagger formerly worn at the girdle. [Written also anelace.]
anlaut |An initial sound, as of a word or syllable. -- Im anlaut, initially; when initial; --used of sounds.
ann |A half years's stipend, over and above what is owing for the incumbency, due to a minister's heirs after his decease.
anna |An East Indian money of account, the sixteenth of a rupee, or about 2
annal |See Annals.
annalist |A writer of annals. The monks . . . were the only annalists in those ages. Hume.
annalistic |Pertaining to, or after the manner of, an annalist; as, the dry annalistic style.\"A stiff annalistic method.\" Sir G. C. Lewis.
annalize |To record in annals. Sheldon.
annals |1. A relation of events in chronological order, each event being recorded under the year in which it happened. \"Annals the revolution.\" Macaulay. \"The annals of our religion.\" Rogers. 2. Historical records; chronicles; history. The short and simple annals of the poor. Gray. It was one of the most critical periods in our annals. Burke. 3. sing.  The record of a single event or item. \"In deathless annal.\" Young. 4. A periodic publication, containing records of discoveries, transactions of societies, etc.; as \"Annals of Science.\" Syn. -- History. See History.
annat |A half years's stipend, over and above what is owing for the incumbency, due to a minister's heirs after his decease.
annates |The first year's profits of a spiritual preferment, anciently paid by the clergy to the pope; first fruits. In England, they now form a fund for the augmentation of poor livings.
annats |The first year's profits of a spiritual preferment, anciently paid by the clergy to the pope; first fruits. In England, they now form a fund for the augmentation of poor livings.
anneal |1. To subject to great heat, and then cool slowly, as glass, cast iron, steel, or other metal, for the purpose of rendering it less brittle; to temper; to toughen. 2. To heat, as glass, tiles, or earthenware, in order to fix the colors laid on them.
annealer |One who, or that which, anneals.
annealing |1. The process used to render glass, iron, etc., less brittle, performed by allowing them to cool very gradually from a high heat. 2. The burning of metallic colors into glass, earthenware, etc.
annectent |Connecting; annexing. Owen.
annelid |Of or pertaining to the Annelida. -- n.  One of the Annelida.
annelida |A division of the Articulata, having the body formed of numerous rings or annular segments, and without jointed legs. The principal subdivisions are the Chætopoda, including the Oligochæta or earthworms and Polychæta or marine worms; and the Hirudinea or leeches. See Chætopoda.
annelidan |Of or pertaining to the Annelida. -- n.  One of the Annelida.
annelidous |Of the nature of an annelid.
annellata |See Annelida.
anneloid |An animal resembling an annelid.
annex |1. To join or attach; usually to subjoin; to affix; to append; -- followed by to. \"He annexed a codicil to a will.\" Johnson. 2. To join or add, as a smaller thing to a greater. He annexed a province to his kingdom. Johnson. 3. To attach or connect, as a consequence, condition, etc.; as, to annex a penalty to a prohibition, or punishment to guilt. Syn. -- To add; append; affix; unite; coalesce. See Add.\n\nTo join; to be united. Tooke.\n\nSomething annexed or appended; as, an additional stipulation to a writing, a subsidiary building to a main building; a wing.
annexation |1. The act of annexing; process of attaching, adding, or appending; the act of connecting; union; as, the annexation of Texas to the United States, or of chattels to the freehold. 2. (a) (Law) The union of property with a freehold so as to become a fixture. Bouvier. (b) (Scots Law) The appropriation of lands or rents to the crown. Wharton.
annexationist |One who favors annexation.
annexer |One who annexes.
annexion |Annexation. [R.] Shak.
annexionist |An annexationist. [R.]
annexment |The act of annexing, or the thing annexed; appendage. [R.] Shak.
annicut |A dam or mole made in the course of a stream for the purpose of regulating the flow of a system of irrigation. [India] Brande & C.
annihilable |Capable of being annihilated.
annihilate |1. To reduce to nothing or nonexistence; to destroy the existence of; to cause to cease to be. It impossible for any body to be utterly annihilated. Bacon. 2. To destroy the form or peculiar distinctive properties of, so that the specific thing no longer exists; as, to annihilate a forest by cutting down the trees. \"To annihilate the army.\" Macaulay. 3. To destroy or eradicate, as a property or attribute of a thing; to make of no effect; to destroy the force, etc., of; as, to annihilate an argument, law, rights, goodness.\n\nAnhilated. [Archaic] Swift.
annihilation |1. The act of reducing to nothing, or nonexistence; or the act of destroying the form or combination of parts under which a thing exists, so that the name can no longer be applied to it; as, the annihilation of a corporation. 2. The state of being annihilated. Hooker.
annihilationist |One who believes that eternal punishment consists in annihilation or extinction of being; a destructionist.
annihilative |Serving to annihilate; destructive.
annihilator |One who, or that which, annihilates; as, a fire annihilator.
annihilatory |Annihilative.
anniversarily |Annually. [R.] Bp. Hall.
anniversary |Returning with the year, at a stated time; annual; yearly; as, an anniversary feast. Anniversary day (R. C. Ch.). See Anniversary, n., 2. -- Anniversary week, that week in the year in which the annual meetings of religious and benevolent societies are held in Boston and New York. [Eastern U. S.]\n\n1. The annual return of the day on which any notable event took place, or is wont to be celebrated; as, the anniversary of the Declaration of Independence. 2. (R. C. Ch.)  The day on which Mass is said yearly for the soul of a deceased person; the commemoration of some sacred event, as the dedication of a church or the consecration of a pope. 3. The celebration which takes place on an anniversary day. Dryden.
anniverse |Anniversary. [Obs.] Dryden.
anno domini |In the year of the Christian era; as, a. d. 1887.
annodated |Curved somewhat in the form of the letter S. Cussans.
annominate |To name. [R.]
annomination |1. Paronomasia; punning. 2. Alliteration. [Obs.] Tyrwhitt.
annotate |To explain or criticize by notes; as, to annotate the works of Bacon.\n\nTo make notes or comments; -- with on or upon.
annotation |A note, added by way of comment, or explanation; -- usually in the plural; as, annotations on ancient authors, or on a word or a passage.
annotationist |An annotator. [R.]
annotative |Characterized by annotations; of the nature of annotation.
annotator |A writer of annotations; a commentator.
annotatory |Pertaining to an annotator; containing annotations. [R.]
annotine |A bird one year old, or that has once molted.
annotinous |A year old; in Yearly growths.
annotto |A red or yellowish-red dyeing material, prepared from the pulp surrounding the seeds of a tree (Bixa orellana) belonging to the tropical regions of America. It is used for coloring cheese, butter, etc. [Written also Anatto, Anatta, Annatto, Annotta, etc.]
announce |1. To give public notice, or first notice of; to make known; to publish; to proclaim. Her [Q. Elizabeth's] arrival was announced through the country by a peal of cannon from the ramparts. Gilpin. 2. To pronounce; to declare by judicial sentence. Publish laws, announce Or life or death. Prior. Syn. -- To proclaim; publish; make known; herald; declare; promulgate. -- To Publish, Announce, Proclaim, Promulgate. We publish what we give openly to the world, either by oral communication or by means of the press; as, to publish abroad the faults of our neighbors. We announce what we declare by anticipation, or make known for the first time; as, to announce the speedy publication of a book; to announce the approach or arrival of a distinguished personage. We proclaim anything to which we give the widest publicity; as, to proclaim the news of victory. We promulgate when we proclaim more widely what has before been known by some; as, to promulgate the gospel.
announcement |The act of announcing, or giving notice; that which announces; proclamation; publication.
announcer |One who announces.
annoy |A feeling of discomfort or vexation caused by what one dislikes; also, whatever causes such a feeling; as, to work annoy. Worse than Tantalus' is her annoy. Shak.
annoyance |1. The act of annoying, or the state of being annoyed; molestation; vexation; annoy. A deep clay, giving much annoyance to passengers. Fuller. For the further annoyance and terror of any besieged place, they would throw into it dead bodies. Wilkins. 2. That which annoys. A grain, a dust, a gnat, a wandering hair, Any annoyance in that precious sense. Shak.
annoyer |One who, or that which, annoys.
annoyful |Annoying. [Obs.] Chaucer.
annoying |That annoys; molesting; vexatious. -- An*noy\"ing*ly, adv.
annoyous |Troublesome; annoying. [Obs.] Chaucer.
annual |1. Of or pertaining to a year; returning every year; coming or happening once in the year; yearly. The annual overflowing of the river [Nile]. Ray. 2. Performed or accomplished in a year; reckoned by the year; as, the annual motion of the earth. A thousand pound a year, annual support. Shak. 2. Lasting or continuing only one year or one growing season; requiring to be renewed every year; as, an annual plant; annual tickets. Bacon.\n\n1. A thing happening or returning yearly; esp. a literary work published once a year. 2. Anything, especially a plant, that lasts but one year or season; an annual plant. Oaths . . . in some sense almost annuals; . . . and I myself can remember about forty different sets. Swift. 3. (R. C. Ch.)  A Mass for a deceased person or for some special object, said daily for a year or on the anniversary day.
annualist |One who writes for, or who edits, an annual. [R.]
annually |Yearly; year by year.
annuary |Annual. [Obs.] -- n.  A yearbook.
annueler |A priest employed in saying annuals, or anniversary Masses. [Obs.] Chaucer.
annuent |Nodding; as, annuent muscles (used in nodding).
annuitant |One who receives, or its entitled to receive, an annuity. Lamb.
annuity |A sum of money, payable yearly, to continue for a given number of years, for life, or forever; an annual allowance.
annul |1. To reduce to nothing; to obliterate. Light, the prime work of God, to me's extinct. And all her various objects of delight Annulled. Milton. 2. To make void or of no effect; to nullify; to abolish; to do away with; -- used appropriately of laws, decrees, edicts, decisions of courts, or other established rules, permanent usages, and the like, which are made void by component authority. Do they mean to annul laws of inestimable value to our liberties Burke. Syn. -- To abolish; abrogate; repeal; cancel; reverse; rescind; revoke; nullify; destroy. See Abolish.
annular |1. Pertaining to, or having the form of, a ring; forming a ring; ringed; ring-shaped; as, annular fibers. 2. Banded or marked with circles. Annular eclipse (Astron.), an eclipse of the sun in which the moon at the middle of the eclipse conceals the central part of the sun's disk, leaving a complete ring of light around the border.
annularity |Annular condition or form; as, the annularity of a nebula. J. Rogers.
annularry |In an annular manner.
annulary |Having the form of a ring; annular. Ray.
annulata |A class of articulate animals, nearly equivalent to Annelida, including the marine annelids, earthworms, Gephyrea, Gymnotoma, leeches, etc. See Annelida.
annulate |One of the Annulata.\n\n1. Furnished with, or composed of, rings; ringed; surrounded by rings of color. 2. (Zoöl.)  Of or pertaining to the Annulata.
annulated |1. Furnished with, or composed of, rings; ringed; surrounded by rings of color. 2. (Zoöl.)  Of or pertaining to the Annulata.
annulation |A circular or ringlike formation; a ring or belt. Nicholson.
annulet |1. A little ring. Tennyson. 2. (Arch.)  A small, flat fillet, encircling a column, etc., used by itself, or with other moldings. It is used, several times repeated, under the Doric capital. 3. (Her.)  A little circle borne as a charge. 4. (Zoöl.)  A narrow circle of some distinct color on a surface or round an organ.
annullable |That may be Annulled.
annuller |One who annuls. [R.]
annulment |The act of annulling; abolition; invalidation.
annuloid |Of or pertaining to the Annuloida.
annuloida |A division of the Articulata, including the annelids and allied groups; sometimes made to include also the helminths and echinoderms. [Written also Annuloidea.]
annulosa |A division of the Invertebrata, nearly equivalent to the Articulata. It includes the Arthoropoda and Anarthropoda. By some zoölogists it is applied to the former only.
annulosan |One of the Annulosa.
annulose |1. Furnished with, or composed of, rings or ringlike segments; ringed. 2. (Zoöl.)  Of or pertaining to the Annulosa.
annulus |1. A ring; a ringlike part or space. 2. (Geom.) (a) A space contained between the circumferences of two circles, one within the other. (b) The solid formed by a circle revolving around a line which is the plane of the circle but does not cut it. 3. (Zoöl.)  Ring-shaped structures or markings, found in, or upon, various animals.
annumerate |To add on; to count in. [Obs.] Wollaston.
annumeration |Addition to a former number. [Obs.] Sir T. Browne.
annunciable |That may be announced or declared; declarable. [R.]
annunciate |To announce.\n\nForetold; preannounced. [Obs.] Chaucer.
annunciation |1. The act of announcing; announcement; proclamation; as, the annunciation of peace. 2. (Eccl.) (a) The announcement of the incarnation, made by the angel Gabriel to the Virgin Mary. (b) The festival celebrated (March 25th) by the Church of England, of Rome, etc., in memory of the angel's announcement, on that day; Lady Day.
annunciation lily |The common white lily (Lilium candidum). So called because it is usually introduced by painters in pictures of the Annunciation.
annunciative |Pertaining to annunciation; announcing. [R.] Dr. H. More.
annunciator |1. One who announces. Specifically: An officer in the church of Constantinople, whose business it was to inform the people of the festivals to be celebrated. 2. An indicator (as in a hotel) which designates the room where attendance is wanted.
annunciatory |Pertaining to, or containing, announcement; making known. [R.]
ano |A black bird of tropical America, the West Indies and Florida (Crotophaga ani), allied to the cuckoos, and remarkable for communistic nesting.
anoa |A small wild ox of Celebes (Anoa depressicornis), allied to the buffalo, but having long nearly straight horns.
anode |The positive pole of an electric battery, or more strictly the electrode by which the current enters the electrolyte on its way to the other pole; -- opposed to cathode.
anodon |A genus of fresh-water bivalves, having to teeth at the hinge. [Written also Anodonta.]
anodyne |Serving to assuage pain; soothing. The anodyne draught of oblivion. Burke. Note: \"The word [in a medical sense] in chiefly applied to the different preparations of opium, belladonna, hyoscyamus, and lettuce.\" Am. Cyc.\n\nAny medicine which allays pain, as an opiate or narcotic; anything that soothes disturbed feelings.
anodynous |Anodyne.
anoetic |1. Unthinkable. [Rare] 2.  (Psychol.) Not subject to conscious attention; having an indefinite, relatively passive, conscious being; characteristic of the \"fringe\" or \"margin\" of consciousness. Presentation considered as having an existence relatively independent of thought, may be called sentience, or anoetic consciousness. Thought and sentience are fundamentally distinct mental functions. G. F. Stout.
anoil |The anoint with oil. [Obs.] Holinshed.
anoint |1. To smear or rub over with oil or an unctuous substance; also, to spread over, as oil. And fragrant oils the stiffened limbs anoint. Dryden. He anointed the eyes of the blind man with the clay. John ix. 6. 2. To apply oil to or to pour oil upon, etc., as a sacred rite, especially for consecration. Then shalt thou take the anointing oil, and pour it upon his [Aaron's] head and anoint him. Exod. xxix. 7. Anoint Hazael to be king over Syria. 1 Kings xix. 15. The Lord's Anointed, Christ or the Messiah; also, a Jewish or other king by \"divine right.\" 1 Sam. xxvi. 9.\n\nAnointed. [Obs.] Chaucer.
anointer |One who anoints.
anointment |The act of anointing, or state of being anointed; also, an ointment. Milton.
anolis |A genus of lizards which belong to the family Iguanidæ. They take the place in the New World of the chameleons in the Old, and in America are often called chameleons.
anomal |Anything anomalous. [R.]
anomaliped |Having anomalous feet.\n\nOne of a group of perching birds, having the middle toe more or less united to the outer and inner ones.
anomalipede |Having anomalous feet.
anomalism |An anomaly; a deviation from rule. Hooker.
anomalistic |1. Irregular; departing from common or established rules. 2. (Astron.)  Pertaining to the anomaly, or angular distance of a planet from its perihelion. Anomalistic month. See under Month. -- Anomalistic revolution, the period in which a planet or satellite goes through the complete cycles of its changes of anomaly, or from any point in its elliptic orbit to the same again. -- Anomalistic, or Periodical year. See under Year.
anomalistical |1. Irregular; departing from common or established rules. 2. (Astron.)  Pertaining to the anomaly, or angular distance of a planet from its perihelion. Anomalistic month. See under Month. -- Anomalistic revolution, the period in which a planet or satellite goes through the complete cycles of its changes of anomaly, or from any point in its elliptic orbit to the same again. -- Anomalistic, or Periodical year. See under Year.
anomalistically |With irregularity.
anomaloflorous |Having anomalous flowers.
anomalous |Deviating from a general rule, method, or analogy; abnormal; irregular; as, an anomalous proceeding.
anomalously |In an anomalous manner.
anomalousness |Quality of being anomalous.
anomaly |1. Deviation from the common rule; an irregularity; anything anomalous. We are enabled to unite into a consistent whole the various anomalies and contending principles that are found in the minds and affairs of men. Burke. As Professor Owen has remarked, there is no greater anomaly in nature than a bird that can not fly. Darwin. 2. (Astron.) (a) The angular distance of a planet from its perihelion, as seen from the sun. This is the true anomaly. The eccentric anomaly is a corresponding angle at the center of the elliptic orbit of the planet. The mean anomaly is what the anomaly would be if the planet's angular motion were uniform. (b) The angle measuring apparent irregularities in the motion of a planet. 3. (Nat. Hist.)  Any deviation from the essential characteristics of a specific type.
anomia |A genus of bivalve shells, allied to the oyster, so called from their unequal valves, of which the lower is perforated for attachment.
anomophyllous |Having leaves irregularly placed.
anomoura |A group of decapod Crustacea, of which the hermit crab in an example.
anomura |A group of decapod Crustacea, of which the hermit crab in an example.
anomural |Irregular in the character of the tail or abdomen; as, the anomural crustaceans. [Written also anomoural, anomouran.]
anomuran |Irregular in the character of the tail or abdomen; as, the anomural crustaceans. [Written also anomoural, anomouran.]\n\nOne of the Anomura.
anomy |Disregard or violation of law. [R.] Glanvill.
anon |1. Straightway; at once. [Obs.] The same is he that heareth the word, and anon with joy receiveth it. Matt. xiii. 20. 2. Soon; in a little while. As it shall better appear anon. Stow. 3. At another time; then; again. Sometimes he trots, . . . anon he rears upright. Shak. Anon right, at once; right off. [Obs.] Chaucer. -- Ever and anon, now and then; frequently; often. A pouncet box, which ever and anon He gave his nose. Shak.
anona |A genus of tropical or subtropical plants of the natural order Anonaceæ, including the soursop.
anonaceous |Pertaining to the order of plants including the soursop, custard apple, etc.
anonym |1. One who is anonymous; also sometimes used for \"pseudonym.\" 2. A notion which has no name, or which can not be expressed by a single English word. [R.] J. R. Seeley.
anonymity |The quality or state of being anonymous; anonymousness; also, that which anonymous. [R.] He rigorously insisted upon the rights of anonymity. Carlyle.
anonymous |Nameless; of unknown name; also, of unknown \/or unavowed authorship; as, an anonymous benefactor; an anonymous pamphlet or letter.
anonymously |In an anonymous manner; without a name. Swift.
anonymousness |The state or quality of being anonymous. Coleridge.
anopheles |A genus of mosquitoes which are secondary hosts of the malaria parasites, and whose bite is the usual, if not the only, means of infecting human beings with malaria. Several species are found in the United States. They may be distinguished from the ordinary mosquitoes of the genus Culex by the long slender palpi, nearly equaling the beak in length, while those of the female Culex are very short. They also assume different positions when resting, Culex usually holding the body parallel to the surface on which it rests and keeping the head and beak bent at an angle, while Anopheles holds the body at an angle with the surface and the head and beak in line with it. Unless they become themselves infected by previously biting a subject affected with malaria, the insects cannot transmit the disease.
anophyte |A moss or mosslike plant which cellular stems, having usually an upward growth and distinct leaves.
anopla |One of the two orders of Nemerteans. See Nemertina.
anoplothere |A genus of extinct quadrupeds of the order Ungulata, whose were first found in the gypsum quarries near Paris; characterized by the shortness and feebleness of their canine teeth (whence the name).
anoplotherium |A genus of extinct quadrupeds of the order Ungulata, whose were first found in the gypsum quarries near Paris; characterized by the shortness and feebleness of their canine teeth (whence the name).
anoplura |A group of insects which includes the lice.
anopsia |Want or defect of sight; blindness.
anopsy |Want or defect of sight; blindness.
anorexia |Want of appetite, without a loathing of food. Coxe.
anorexy |Want of appetite, without a loathing of food. Coxe.
anormal |Not according to rule; abnormal. [Obs.]
anorn |To adorn. [Obs.] Bp. Watson.
anorthic |Having unequal oblique axes; as, anorthic crystals.
anorthite |A mineral of the feldspar family, commonly occurring in small glassy crystals, also a constituent of some igneous rocks. It is a lime feldspar. See Feldspar.
anorthoclase |A feldspar closely related to orthoclase, but triclinic. It is chiefly a silicate of sodium, potassium, and aluminium. Sp. gr., 2.57 -- 2.60.
anorthopia |Distorted vision, in which straight lines appear bent.
anorthoscope |An optical toy for producing amusing figures or pictures by means of two revolving disks, on one of which distorted figures are painted.
anorthosite |A granular igneous rock composed almost exclusively of a soda- lime feldspar, usually labradorite.
anosmia |Loss of the sense of smell.
another |1. One more, in addition to a former number; a second or additional one, similar in likeness or in effect. Another yet! -- a seventh! I 'll see no more. Shak. Would serve to scale another Hero's tower. Shak. 2. Not the same; different. He winks, and turns his lips another way. Shak. 3. Any or some; any different person, indefinitely; any one else; some one else. Let another man praise thee, and not thine own mouth. Prov. xxvii. 2. While I am coming, another steppeth down before me. John v. 7. Note: As a pronoun another may have a possessive another's, pl. others, poss. pl. other'. It is much used in opposition to one; as, one went one way, another another. It is also used with one, in a reciprocal sense; as, \"love one another,\" that is, let each love the other or others. \"These two imparadised in one another's arms.\" Milton.
another-gaines |Of another kind. [Obs.] Sir P. Sidney.
another-gates |Of another sort. [Obs.] \"Another-gates adventure.\" Hudibras.
another-guess |Of another sort. [Archaic] It used to go in another-guess manner. Arbuthnot.
anotta |See Annotto.
anoura |See Anura.
anourous |See Anurous.
anoxaemia |An abnormal condition due to deficient aëration of the blood, as in balloon sickness, mountain sickness. -- An`ox*æ\"mic, *e\"mic (#), a.
anoxemia |An abnormal condition due to deficient aëration of the blood, as in balloon sickness, mountain sickness. -- An`ox*æ\"mic, *e\"mic (#), a.
ansa |A name given to either of the projecting ends of Saturn's ring.
ansated |Having a handle. Johnson.
anserated |Having the extremities terminate in the heads of eagles, lions, etc.; as, an anserated cross.
anseres |A Linnæan order of aquatic birds swimming by means of webbed feet, as the duck, or of lobed feet, as the grebe. In this order were included the geese, ducks, auks, divers, gulls, petrels, etc.
anseriformes |A division of birds including the geese, ducks, and closely allied forms.
anserine |1. Pertaining to, or resembling, a goose, or the skin of a goose. 2. (Zoöl.)  Pertaining to the Anseres.
anserous |Resembling a goose; silly; simple. Sydney Smith.
answer |1. To speak in defense against; to reply to in defense; as, to answer a charge; to answer an accusation. 2. To speak or write in return to, as in return to a call or question, or to a speech, declaration, argument, or the like; to reply to (a question, remark, etc.); to respond to. She answers him as if she knew his mind. Shak. So spake the apostate angel, though in pain: . . . And him thus answered soon his bold compeer. Milton. 3. To respond to satisfactorily; to meet successfully by way of explanation, argument, or justification, and the like; to refute. No man was able to answer him a word. Matt. xxii. 46. These shifts refuted, answer thine appellant. Milton. The reasoning was not and could not be answered. Macaulay. 4. To be or act in return or response to. Hence: (a) To be or act in compliance with, in fulfillment or satisfaction of, as an order, obligation, demand; as, he answered my claim upon him; the servant answered the bell. This proud king . . . studies day and night To answer all the debts he owes unto you. Shak. (b) To render account to or for. I will . . . send him to answer thee. Shak. (c) To atone; to be punished for. And grievously hath Cæzar answered it. Shak. (d) To be opposite to; to face. The windows answering each other, we could just discern the glowing horizon them. Gilpin. (e) To be or act an equivalent to, or as adequate or sufficient for; to serve for; to repay. [R.] Money answereth all things. Eccles. x. 19. (f) To be or act in accommodation, conformity, relation, or proportion to; to correspond to; to suit. Weapons must needs be dangerous things, if they answered the bulk of so prodigious a person. Swift.\n\n1. To speak or write by way of return (originally, to a charge), or in reply; to make response. There was no voice, nor any that answered. 1 Kings xviii. 26. 2. To make a satisfactory response or return. Hence: To render account, or to be responsible; to be accountable; to make amends; as, the man must answer to his employer for the money intrusted to his care. Let his neck answer for it, if there is any martial law. Shak. 3. To be or act in return. Hence: (a) To be or act by way of compliance, fulfillment, reciprocation, or satisfaction; to serve the purpose; as, gypsum answers as a manure on some soils. Do the strings answer to thy noble hand Dryden. (b) To be opposite, or to act in opposition. (c) To be or act as an equivalent, or as adequate or sufficient; as, a very few will answer. (d) To be or act in conformity, or by way of accommodation, correspondence, relation, or proportion; to conform; to correspond; to suit; -- usually with to. That the time may have all shadow and silence in it, and the place answer to convenience. Shak. If this but answer to my just belief, I 'll remember you. Shak. As in water face answereth to face, so the heart of man to man. Pro\n\n1. A reply to a change; a defense. At my first answer no man stood with me. 2 Tim. iv. 16. 2. Something said or written in reply to a question, a call, an argument, an address, or the like; a reply. A soft answer turneth away wrath. Prov. xv. 1. I called him, but he gave me no answer. Cant. v. 6. 3. Something done in return for, or in consequence of, something else; a responsive action. Great the slaughter is Here made by the Roman; great the answer be Britons must take. Shak. 4. A solution, the result of a mathematical operation; as, the answer to a problem. 5. (Law)  A counter-statement of facts in a course of pleadings; a confutation of what the other party has alleged; a responsive declaration by a witness in reply to a question. In Equity, it is the usual form of defense to the complainant's charges in his bill. Bouvier. Syn. -- Reply; rejoinder; response. See Reply.
answerable |1. Obliged to answer; liable to be called to account; liable to pay, indemnify, or make good; accountable; amenable; responsible; as, an agent is answerable to his principal; to be answerable for a debt, or for damages. Will any man argue that . . . he can not be justly punished, but is answerable only to God Swift. 2. Capable of being answered or refuted; admitting a satisfactory answer. The argument, though subtle, is yet answerable. Johnson. 3. Correspondent; conformable; hence, comparable. What wit and policy of man is answerable to their discreet and orderly course Holland. This revelation . . . was answerable to that of the apostle to the Thessalonians. Milton. 4. Proportionate; commensurate; suitable; as, an achievement answerable to the preparation for it. 5. Equal; equivalent; adequate. [Archaic] Had the valor of his soldiers been answerable, he had reached that year, as was thought, the utmost bounds of Britain. Milton.
answerableness |The quality of being answerable, liable, responsible, or correspondent.
answerably |In an answerable manner; in due proportion or correspondence; suitably.
answerer |One who answers.
answerless |Having no answer, or impossible to be answered. Byron. AN 'T An 't.  An it, that is, and it or if it. See An, conj. [Obs.] AN'T An't.  A contraction for are and am not; also used for is not; -- now usually written ain't. [Colloq. & illiterate speech.]
ant |A hymenopterous insect of the Linnæan genus Formica, which is now made a family of several genera; an emmet; a pismire. Note: Among ants, as among bees, there are neuter or working ants, besides the males and females; the former are without wings. Ants live together in swarms, usually raising hillocks of earth, variously chambered within, where they maintain a perfect system of order, store their provisions, and nurture their young. There are many species, with diverse habits, as agricultural ants, carpenter ants, honey ants, foraging ants, amazon ants, etc. The white ants or Termites belong to the Neuroptera. Ant bird (Zoöl.), one of a very extensive group of South American birds (Formicariidæ), which live on ants. The family includes many species, some of which are called ant shrikes, ant thrushes, and ant wrens. -- Ant rice (Bot.), a species of grass (Aristida oligantha) cultivated by the agricultural ants of Texas for the sake of its seed.
ant bird |See Ant bird, under Ant, n.
ant cow |Any aphid from which ants obtain honeydew.
ant egg |One of the small white egg-shaped pupæ or cocoons of the ant, often seen in or about ant-hills, and popularly supposed to be eggs.
ant thrush |(a) One of several species of tropical birds, of the Old World, of the genus Pitta, somewhat resembling the thrushes, and feeding chiefly on ants. (b) See Ant bird, under Ant.
ant- |See Anti-, prefix.
ant-bear |An edentate animal of tropical America (the Tamanoir), living on ants. It belongs to the genus Myrmecophaga.
ant-cattle |Various kinds of plant lice or aphids tended by ants for the sake of the honeydew which they secrete. See Aphips.
ant-eater |One of several species of edentates and monotremes that feed upon ants. See Ant-bear, Pangolin, Aard-vark, and Echidna.
ant-hill |A mound thrown up by ants or by termites in forming their nests.
ant-lion |A neuropterous insect, the larva of which makes in the sand a pitfall to capture ants, etc. The common American species is Myrmeleon obsoletus, the European is M. formicarius.
anta |A species of pier produced by thickening a wall at its termination, treated architecturally as a pilaster, with capital and base. Note: Porches, when columns stand between two antæ, are called in Latin in antis.
antacid |A remedy for acidity of the stomach, as an alkali or absorbent. -- a.  Counteractive of acidity.
antacrid |Corrective of acrimony of the humors.
antae |See Anta.
antaean |Pertaining to Antæus, a giant athlete slain by Hercules.
antagonism |Opposition of action; counteraction or contrariety of things or principles. Note: We speak of antagonism between two things, to or against a thing, and sometimes with a thing.
antagonist |1. One who contends with another, especially in combat; an adversary; an opponent. Antagonist of Heaven's Almigthy King. Milton. Our antagonists in these controversies. Hooker. 2. (Anat.)  A muscle which acts in opposition to another; as a flexor, which bends a part, is the antagonist of an extensor, which extends it. 3. (Med.)  A medicine which opposes the action of another medicine or of a poison when absorbed into the blood or tissues. Syn. -- Adversary; enemy; opponent; toe; competitor. See Adversary.\n\nAntagonistic; opposing; counteracting; as, antagonist schools of philosophy.
antagonistic |Opposing in combat, combating; contending or acting against; as, antagonistic forces. -- An*tag`o*nis\"tic*al*ly, adv. They were distinct, adverse, even antagonistic. Milman.
antagonistical |Opposing in combat, combating; contending or acting against; as, antagonistic forces. -- An*tag`o*nis\"tic*al*ly, adv. They were distinct, adverse, even antagonistic. Milman.
antagonize |To contend with; to oppose actively; to counteract.\n\nTo act in opposition.
antagony |Contest; opposition; antagonism. [Obs.] Antagony that is between Christ and Belial. Milton.
antalgic |Alleviating pain. -- n.  A medicine to alleviate pain; an anodyne. [R.]
antalkali |Anything that neutralizes, or that counteracts an alkaline tendency in the system. Hoopplw.
antalkaline |Anything that neutralizes, or that counteracts an alkaline tendency in the system. Hoopplw.\n\nOf power to counteract alkalies.
antambulacral |Away from the ambulacral region.
antanaclasis |(a) A figure which consists in repeating the same word in a different sense; as, Learn some craft when young, that when old you may live without craft. (b) A repetition of words beginning a sentence, after a long parenthesis; as, Shall that heart (which not only feels them, but which has all motions of life placed in them), shall that heart, etc.
antanagoge |A figure which consists in answering the charge of an adversary, by a counter charge.
antaphrodisiac |Capable of blunting the venereal appetite. -- n.  Anything that quells the venereal appetite.
antaphroditic |1. Antaphrodisiac. 2. Antisyphilitic. [R.]\n\nAn antaphroditic medicine.
antapoplectic |Good against apoplexy. -- n.  A medicine used against apoplexy.
antarchism |Opposition to government in general. [R.]
antarchist |One who opposes all government. [R.]
antarchistic |Opposed to all human government. [R.]
antarchistical |Opposed to all human government. [R.]
antarctic |Opposite to the northern or arctic pole; relating to the southern pole or to the region near it, and applied especially to a circle, distant from the pole 23º 28min. Thus we say the antarctic pole, circle, ocean, region, current, etc.
antares |The principal star in Scorpio: -- called also the Scorpion's Heart.
antarthritic |A remedy against gout.
antasthmatic |Opposing, or fitted to relieve, asthma. -- n.  A remedy for asthma.
ante |Each player's stake, which is put into the pool before (ante) the game begins.\n\nTo put up (an ante).
ante mortem |Before death; -- generally used adjectivelly; as, an ante- mortem statement; ante-mortem examination. The ante-mortem statement, or dying declaration made in view of death, by one injured, as to the cause and manner of the injury, is often receivable in evidence against one charged with causing the death.
ante- |A Latin preposition and prefix; akin to Gr. anti, Goth. and-, anda- (only in comp.), AS. and-, ond-, (only in comp.: cf. Answer, Along), G. ant-, ent- (in comp.). The Latin ante is generally used in the sense of before, in regard to position, order, or time, and the Gr. opposite, or in the place of.
anteact |A preceding act.
anteal |Being before, or in front. [R.] J. Fleming.
antecedaneous |Antecedent; preceding in time. \"Capable of antecedaneous proof.\" Barrow.
antecede |To go before in time or place; to precede; to surpass. Sir M. Hale.
antecedence |1. The act or state of going before in time; precedence. H. Spenser. 2. (Astron.)  An apparent motion of a planet toward the west; retrogradation.
antecedency |The state or condition of being antecedent; priority. Fothherby.
antecedent |1. Going before in time; prior; anterior; preceding; as, an event antecedent to the Deluge; an antecedent cause. 2. Presumptive; as, an antecedent improbability. Syn. -- Prior; previous; foregoing.\n\n1. That which goes before in time; that which precedes. South. The Homeric mythology, as well as the Homeric language, has surely its antecedents. Max Miller. 2. One who precedes or goes in front. [Obs.] My antecedent, or my gentleman usher. Massinger. 3. pl.  The earlier events of one's life; previous principles, conduct, course, history. J. H. Newman. If the troops . . . prove worthy of their antecedents, the victory is surely ours. Gen. G. McClellan. 4. (Gram.)  The noun to which a relative refers; as, in the sentence \"Solomon was the prince who built the temple,\" prince is the antecedent of who. 5. (Logic) (a) The first or conditional part of a hypothetical proposition; as, If the earth is fixed, the sun must move. (b) The first of the two propositions which constitute an enthymeme or contracted syllogism; as, Every man is mortal; therefore the king must die. 6. (Math.)  The first of the two terms of a ratio; the first or third of the four terms of a proportion. In the ratio a:b, a is the antecedent, and b the consequent.
antecedently |Previously; before in time; at a time preceding; as, antecedently to conversion. Barrow.
antecessor |1. One who goes before; a predecessor. The successor seldom prosecuting his antecessor's devices. Sir E. Sandys. 2. An ancestor; a progenitor. [Obs.]
antechamber |1. A chamber or apartment before the chief apartment and leading into it, in which persons wait for audience; an outer chamber. See Lobby. 2. A space viewed as the outer chamber or the entrance to an interior part. The mouth, the antechamber to the digestive canal. Todd & Bowman.
antechapel |The outer part of the west end of a collegiate or other chapel. Shipley.
antechoir |(a) A space inclosed or reserved at the entrance to the choir, for the clergy and choristers. (b) Where a choir is divided, as in some Spanish churches, that division of it which is the farther from the sanctuary.
antecians |See Ant.
antecommunion |A name given to that part of the Anglican liturgy for the communion, which precedes the consecration of the elements.
antecursor |A forerunner; a precursor. [Obs.]
antedate |1. Prior date; a date antecedent to another which is the actual date. 2. Anticipation. [Obs.] Donne.\n\n1. To date before the true time; to assign to an earlier date; thus, to antedate a deed or a bond is to give it a date anterior to the true time of its execution. 2. To precede in time. 3. To anticipate; to make before the true time. And antedate the bliss above. Pope. Who rather rose the day to antedate. Wordsworth.
antediluvial |Before the flood, or Deluge, in Noah's time.
antediluvian |Of or relating to the period before the Deluge in Noah's time; hence, antiquated; as, an antediluvian vehicle. -- n.  One who lived before the Deluge.
antefact |Something done before another act. [Obs.]
antefix |(a) An ornament fixed upon a frieze. (b) An ornament at the eaves, concealing the ends of the joint tiles of the roof. (c) An ornament of the cymatium of a classic cornice, sometimes pierced for the escape of water.
anteflexion |A displacement forward of an organ, esp. the uterus, in such manner that its axis is bent upon itself. T. G. Thomas.
antelope |One of a group of ruminant quadrupeds, intermediate between the deer and the goat. The horns are usually annulated, or ringed. There are many species in Africa and Asia. The antelope and wolf both fierce and fell. Spenser. Note: The common or bezoar antelope of India is Antilope bezoartica. The chamois of the Alps, the gazelle, the addax, and the eland are other species. See Gazelle. The pronghorn antelope (Antilocapra Americana) is found in the Rocky Mountains. See Pronghorn.
antelucan |Held or being before light; -- a word applied to assemblies of Christians, in ancient times of persecution, held before light in the morning. \"Antelucan worship.\" De Quincey.
antemeridian |Being before noon; in or pertaining to the forenoon. (Abbrev. a. m.)
antemetic |Tending to check vomiting. -- n.  A remedy to check or allay vomiting.
antemosaic |Being before the time of Moses.
antemundane |Being or occurring before the creation of the world. Young.
antemural |An outwork of a strong, high wall, with turrets, in front gateway (as of an old castle), for defending the entrance.
antenatal |Before birth. Shelley.
antenicene |Of or in the Christian church or era, anterior to the first council of Nice, held a. d. 325; as, antenicene faith.
antenna |A movable, articulated organ of sensation, attached to the heads of insects and Crustacea. There are two in the former, and usually four in the latter. They are used as organs of touch, and in some species of Crustacea the cavity of the ear is situated near the basal joint. In insects, they are popularly called horns, and also feelers. The term in also applied to similar organs on the heads of other arthropods and of annelids.
antennal |Belonging to the antennæ. Owen.
antenniferous |Bearing or having antennæ.
antenniform |Shaped like antennæ.
antennule |A small antenna; -- applied to the smaller pair of antennæ or feelers of Crustacea.
antenumber |A number that precedes another. [R.] Bacon.
antenuptial |Preceding marriage; as, an antenuptial agreement. Kent.
anteorbital |Same as Antorbital.
antepaschal |Pertaining to the time before the Passover, or before Easter.
antepast |A foretaste. Antepasts of joy and comforts. Jer. Taylor.
antependium |The hangings or screen in front of the altar; an altar cloth; the frontal. Smollett.
antepenult |The last syllable of a word except two, as -syl in monosyllable.
antepenultima |The last syllable of a word except two, as -syl in monosyllable.
antepenultimate |Of or pertaining to the last syllable but two. -- n.  The antepenult.
antephialtic |Good against nightmare. -- n.  A remedy nightmare. Dunglison.
antepileptic |Good against epilepsy. -- n.  A medicine for epilepsy.
antepone |To put before; to prefer. [Obs.] Bailey.
anteport |An outer port, gate, or door.
anteportico |An outer porch or vestibule.
anteposition |The placing of a before another, which, by ordinary rules, ought to follow it.
anteprandial |Preceding dinner.
antepredicament |A prerequisite to a clear understanding of the predicaments and categories, such as definitions of common terms. Chambers.
anterior |1. Before in time; antecedent. Antigonus, who was anterior to Polybius. Sir G. C. Lewis. 2. Before, or toward the front, in place; as, the anterior part of the mouth; -- opposed to posterior. Note: In comparative anatomy, anterior often signifies at or toward the head, cephalic; and in human anatomy it is often used for ventral. Syn. -- Antecedent; previous; precedent; preceding; former; foregoing.
anteriority |The state of being anterior or preceding in time or in situation; priority. Pope.
anteriorly |In an anterior manner; before.
antero- |A combining form meaning anterior, front; as, antero-posterior, front and back; antero-lateral, front side, anterior and at the side.
anteroom |A room before, or forming an entrance to, another; a waiting room.
antes |See Anta.
antestature |A small intrenchment or work of palisades, or of sacks of earth.
antestomach |A cavity which leads into the stomach, as in birds. Ray.
antetemple |The portico, or narthex in an ancient temple or church.
anteversion |A displacement of an organ, esp. of the uterus, in such manner that its whole axis is directed further forward than usual.
antevert |1. To prevent. [Obs.] Bp. Hall. 2. (Med.)  To displace by anteversion.
anthelion |A halo opposite the sun, consisting of a colored ring or rings around the shadow of the spectator's own head, as projected on a cloud or on an opposite fog bank.
anthelix |Same as Antihelix.
anthelmintic |Good against intestinal worms. -- An anthelmintic remedy. [Written also anthelminthic.]
anthem |1. Formerly, a hymn sung in alternate parts, in present usage, a selection from the Psalms, or other parts of the Scriptures or the liturgy, set to sacred music. 2. A song or hymn of praise. Milton.\n\nTo celebrate with anthems. [Poet.] Sweet birds antheming the morn. Keats.
anthemion |A floral ornament. See Palmette.
anthemis |Chamomile; a genus of composite, herbaceous plants.
anthemwise |Alternately. [Obs.] Bacon.
anther |That part of the stamen containing the pollen, or fertilizing dust, which, when mature, is emitted for the impregnation of the ovary. -- An\"ther*al, a.
antheridium |The male reproductive apparatus in the lower, consisting of a cell or other cavity in which spermatozoids are produced; -- called also spermary. -- An`ther*id\"i*al, a.
antheriferous |(a) Producing anthers, as plants. (b) Supporting anthers, as a part of a flower. Gray.
antheriform |Shaped like an anther; anther-shaped.
antherogenous |Transformed from anthers, as the petals of a double flower.
antheroid |Resembling an anther.
antherozoid |One of the mobile male reproductive bodies in the antheridia of cryptogams.
antherozooid |One of the mobile male reproductive bodies in the antheridia of cryptogams.
anthesis |The period or state of full expansion in a flower. Gray.
anthobian |A beetle which feeds on flowers.
anthobranchia |A division of nudibranchiate Mollusca, in which the gills form a wreath or cluster upon the posterior part of the back. See Nudibranchiata, and Doris.
anthocarpous |Having some portion of the floral envelopes attached to the pericarp to form the fruit, as in the checkerberry, the mulberry, and the pineapple.
anthocyanin |Same as Anthokyan.
anthodium |The inflorescence of a compound flower in which many florets are gathered into a involucrate head.
anthography |A description of flowers.
anthoid |Resembling a flower; flowerlike.
anthokyan |The blue coloring matter of certain flowers. Same as Cyanin.
antholite |A fossil plant, like a petrified flower.
anthological |Pertaining to anthology; consisting of beautiful extracts from different authors, especially the poets. He published a geographical and anthological description of all empires and kingdoms . . . in this terrestrial globe. Wood.
anthologist |One who compiles an anthology.
anthology |1. A discourses on flowers. [R.] 2. A collection of flowers; a garland. [R.] 3. A collection of flowers of literature, that is, beautiful passages from authors; a collection of poems or epigrams; -- particularly applied to a collection of ancient Greek epigrams. 4. (Gr. Ch.)  A service book containing a selection of pieces for the festival services.
anthomania |A extravagant fondness for flowers. [R.] ANTHONY'S FIRE An\"tho*ny's Fire`.  See Saint Anthony's Fire, under Saint.
anthophagous |Eating flowers; -- said of certain insects.
anthophilous |Lit., fond of flowers; hence, feeding upon, or living among, flowers.
anthophore |The stipe when developed into an internode between calyx and corolla, as in the Pink family. Gray.
anthophorous |Flower bearing; supporting the flower.
anthophyllite |A mineral of the hornblende group, of a yellowish gray or clove brown color. -- An`tho*phyl*lit\"ic, a.
anthorism |A description or definition contrary to that which is given by the adverse party. [R.]
anthotaxy |The arrangement of flowers in a cluster; the science of the relative position of flowers; inflorescence.
anthozoa |The class of the Coelenterata which includes the corals and sea anemones. The three principal groups or orders are Acyonaria, Actinaria, and Madreporaria.
anthozoan |Pertaining to the Anthozoa. -- n.  One of the Anthozoa.
anthozoic |Of or pertaining to the Anthozoa.
anthracene |A solid hydrocarbon, C6H4.C2H2.C6H4, which accompanies naphthalene in the last stages of the distillation of coal tar. Its chief use is in the artificial production of alizarin. [Written also anthracin.]
anthracene oil |A heavy green oil (partially solidifying on cooling), which distills over from coal tar at a temperature above 270º. It is the principal source of anthracene.
anthracic |Of or relating to anthrax; as, anthracic blood.
anthraciferous |Yielding anthracite; as, anthraciferous strata.
anthracite |A hard, compact variety of mineral coal, of high luster, differing from bituminous coal in containing little or no bitumen, in consequence of which it burns with a nearly non luminous flame. The purer specimens consist almost wholly of carbon. Also called glance coal and blind coal.
anthracitic |Of, pertaining to, or like, anthracite; as, anthracitic formations.
anthracnose |Any one of several fungus diseases, caused by parasitic species of the series Melanconiales, attacking the bean, grape, melon, cotton, and other plants. In the case of the grape, brown concave spots are formed on the stem and fruit, and the disease is called bird's-eye rot.
anthracoid |Resembling anthrax in action; of the nature of anthrax; as, an anthracoid microbe.
anthracomancy |Divination by inspecting a burning coal.
anthracometer |An instrument for measuring the amount of carbonic acid in a mixture.
anthracometric |Of or pertaining to an anthracometer.
anthraconite |A coal-black marble, usually emitting a fetid smell when rubbed; -- called also stinkstone and swinestone.
anthracosis |A chronic lung disease, common among coal miners, due to the inhalation of coal dust; -- called also collier's lung and miner's phthisis.
anthraquinone |A hydrocarbon, C6H4.C2O2.C6H4, subliming in shining yellow needles. It is obtained by oxidation of anthracene.
anthrax |1. (Med.) (a) A carbuncle. (b) A malignant pustule. 2. (Biol.)  A microscopic, bacterial organism (Bacillus anthracis), resembling transparent rods. [See Illust. under Bacillus.] 3. An infectious disease of cattle and sheep. It is ascribed to the presence of a rod-shaped bacterium (Bacillus anthracis), the spores of which constitute the contagious matter. It may be transmitted to man by inoculation. The spleen becomes greatly enlarged and filled with bacteria. Called also splenic fever.
anthrax vaccine |A fluid vaccine obtained by growing a bacterium (Bacterium anthracis) in beef broth. It is used to immunize animals, esp. cattle.
anthrenus |A genus of small beetles, several of which, in the larval state, are very destructive to woolen goods, fur, etc. The common \"museum pest\" is A. varius; the carpet beetle is A. scrophulariæ. The larvæ are commonly confounded with moths.
anthropic |Like or related to man; human. [R.] Owen.
anthropical |Like or related to man; human. [R.] Owen.
anthropidae |The group that includes man only.
anthropocentric |Assuming man as the center or ultimate end; -- applied to theories of the universe or of any part of it, as the solar system. Draper.
anthropogenic |Of or pertaining to anthropogeny.
anthropogeny |The science or study of human generation, or the origin and development of man.
anthropogeography |The science of the human species as to geographical distribution and environment. Broadly, it includes industrial, commercial, and political geography, and that part of ethnology which deals with distribution and physical environment. -- An`thro*po*ge*og\"ra*pher (#), n. -- An`thro*po*ge`o*graph\"ic*al (#), a.
anthropoglot |An animal which has a tongue resembling that of man, as the parrot.
anthropography |That branch of anthropology which treats of the actual distribution of the human race in its different divisions, as distinguished by physical character, language, institutions, and customs, in contradistinction to ethnography, which treats historically of the origin and filiation of races and nations. P. Cyc.
anthropoid |Resembling man; -- applied especially to certain apes, as the ourang or gorilla. -- n.  An anthropoid ape.
anthropoidal |Anthropoid.
anthropoidea |The suborder of primates which includes the monkeys, apes, and man.
anthropolatry |Man worship.
anthropolite |A petrifaction of the human body, or of any portion of it.
anthropologic |Pertaining to anthropology; belonging to the nature of man. \"Anthropologic wisdom.\" Kingsley. -- An`thro*po*log\"ic*al*ly, adv.
anthropological |Pertaining to anthropology; belonging to the nature of man. \"Anthropologic wisdom.\" Kingsley. -- An`thro*po*log\"ic*al*ly, adv.
anthropologist |One who is versed in anthropology.
anthropology |1. The science of the structure and functions of the human body. 2. The science of man; -- sometimes used in a limited sense to mean the study of man as an object of natural history, or as an animal. 3. That manner of expression by which the inspired writers attribute human parts and passions to God.
anthropomancy |Divination by the entrails of human being.
anthropometric |Pertaining to anthropometry.
anthropometrical |Pertaining to anthropometry.
anthropomorpha |The manlike, or anthropoid, apes.
anthropomorphic |Of or pertaining to anthromorphism. Hadley. -- An`thro*po*mor\"phic*al*ly, adv.
anthropomorphism |1. The representation of the Deity, or of a polytheistic deity, under a human form, or with human attributes and affections. 2. The ascription of human characteristics to things not human.
anthropomorphist |One who attributes the human form or other human attributes to the Deity or to anything not human.
anthropomorphite |One who ascribes a human form or human attributes to the Deity or to a polytheistic deity. Taylor. Specifically, one of a sect of ancient heretics who believed that God has a human form, etc. Tillotson.
anthropomorphitic |to anthropomorphism. Kitto.
anthropomorphitism |Anthropomorphism. Wordsworth.
anthropomorphize |To attribute a human form or personality to. You may see imaginative children every day anthropomorphizing. Lowell.
anthropomorphology |The application to God of terms descriptive of human beings.
anthropomorphosis |Transformation into the form of a human being.
anthropomorphous |Having the figure of, or resemblance to, a man; as, an anthromorphous plant. \"Anthromorphous apes.\" Darwin.
anthroponomics |The science of the laws of the development of the human organism in relation to other organisms and to environment. -- An`thro*po*nom\"ic*al (#), a.
anthroponomy |The science of the laws of the development of the human organism in relation to other organisms and to environment. -- An`thro*po*nom\"ic*al (#), a.
anthropopathic |Of or pertaining to anthropopathy. [R.] -- An`thro*po*path\"ic*al*ly, adv. The daring anthropopathic imagery by which the prophets often represent God as chiding, upbraiding, threatening. H. Rogers.
anthropopathical |Of or pertaining to anthropopathy. [R.] -- An`thro*po*path\"ic*al*ly, adv. The daring anthropopathic imagery by which the prophets often represent God as chiding, upbraiding, threatening. H. Rogers.
anthropopathism |The ascription of human feelings or passions to God, or to a polytheistic deity. In its recoil from the gross anthropopathy of the vulgar notions, it falls into the vacuum of absolute apathy. Hare.
anthropopathite |One who ascribes human feelings to deity.
anthropopathy |The ascription of human feelings or passions to God, or to a polytheistic deity. In its recoil from the gross anthropopathy of the vulgar notions, it falls into the vacuum of absolute apathy. Hare.
anthropophagi |Man eaters; cannibals. Shak.
anthropophagic |Relating to cannibalism or anthropophagy.
anthropophagical |Relating to cannibalism or anthropophagy.
anthropophaginian |One who east human flesh. [Ludicrous] Shak.
anthropophagite |A cannibal. W. Taylor.
anthropophagous |Feeding on human flesh; cannibal.
anthropophagy |The eating of human flesh; cannibalism.
anthropophuism |Human nature. [R.] Gladstone.
anthroposcopy |The art of discovering or judging of a man's character, passions. and inclinations from a study of his visible features. [R.]
anthroposophy |Knowledge of the nature of man; hence, human wisdom.
anthropotomical |Pertaining to anthropotomy, or the dissection of human bodies.
anthropotomist |One who is versed in anthropotomy, or human anatomy.
anthropotomy |The anatomy or dissection of the human body; androtomy. Owen.
anthypnotic |See Antihypnotic.
anthypochondriac |See Antihypochondriac.
anthysteric |See Antihysteric.
anti |A prefix meaning against, opposite or opposed to, contrary, or in place of; -- used in composition in many English words. It is often shortened to ant-; as, antacid, antarctic.
anti-american |Opposed to the Americans, their aims, or interests, or to the genius of American institutions. Marshall.
anti-federalist |One of party opposed to a federative government; -- applied particularly to the party which opposed the adoption of the constitution of the United States. Pickering.
anti-gallican |Opposed to what is Gallic or French.
anti-imperialism |Opposition to imperialism; -- applied specif., in the United States, after the Spanish-American war (1898), to the attitude or principles of those opposing territorial expansion; in England, of those, often called Little Englanders, opposing the extension of the empire and the closer relation of its parts, esp. in matters of commerce and imperial defense. -- An`ti-im*pe\"ri*al*ist, n. -- An`ti- im*pe`ri*al*is\"tic (#), a.
anti-semitism |Opposition to, or hatred of, Semites, esp. Jews. -- An`ti- Sem\"ite (#), n. -- An`ti-Sem*it\"ic (#), a.
anti-trade |A tropical wind blowing steadily in a direction opposite to the trade wind.
antiae |The two projecting feathered angles of the forehead of some birds; the frontal points.
antialbumid |A body formed from albumin by pancreatic and gastric digestion. It is convertible into antipeptone.
antialbumose |See Albumose.
antiaphrodisiac |Same as Antaphrodisiac.
antiapoplectic |Same as Antapoplectic.
antiar |A Virulent poison prepared in Java from the gum resin of one species of the upas tree (Antiaris toxicaria).
antiarin |A poisonous principle obtained from antiar. Watts.
antiasthmatic |Same as Antasthmatic.
antiattrition |Anything to prevent the effects of friction, esp. a compound lubricant for machinery, etc., often consisting of plumbago, with some greasy material; antifriction grease.
antibacchius |A foot of three syllables, the first two long, and the last short.
antibacterial |(a) Inimical to bacteria; -- applied esp. to serum for protection against bacterial diseases. (b) Opposed to the bacterial theory of disease.
antibillous |Counteractive of bilious complaints; tending to relieve biliousness.
antibody |Any of various bodies or substances in the blood which act in antagonism to harmful foreign bodies, as toxins or the bacteria producing the toxins. Normal blood serum apparently contains variousantibodies, and the introduction of toxins or of foreign cells also results in the development of their specific antibodies.
antibrachial |Of or pertaining to the antibrachium, or forearm.
antibrachium |That part of the fore limb between the brachium and the carpus; the forearm.
antibromic |An agent that destroys offensive smells; a deodorizer.
antibubonic |Good or used against bubonic plague; as, antibubonic serum, obtained from immunized horses; antibubonic vaccine, a sterilized bouillon culture of the plague bacillus; antibubonic measures.
antiburgher |One who seceded from the Burghers (1747), deeming it improper to take the Burgess oath.
antic |1. Old; antique. (Zoöl.)  \"Lords of antic fame.\" Phaer. 2. Odd; fantastic; fanciful; grotesque; ludicrous. The antic postures of a merry-andrew. Addison. The Saxons . . . worshiped many idols, barbarous in name, some monstrous, all antic for shape. Fuller.\n\n1. A buffoon or merry-andrew; one that practices odd gesticulations; the Fool of the old play. 2. An odd imagery, device, or tracery; a fantastic figure. Woven with antics and wild imagery. Spenser. 3. A grotesque trick; a piece of buffoonery; a caper. And fraught with antics as the Indian bird That writhes and chatters in her wiry cage. Wordsworth. 4. (Arch.)  A grotesque representation. [Obs.] 5. An antimask. [Obs. or R.] Performed by knights and ladies of his court In nature of an antic. Ford.\n\nTo make appear like a buffoon. [Obs.] Shak.\n\nTo perform antics.
antic-mask |An antimask. B. Jonson.
anticatarrhal |Efficacious against catarrh. -- n.  An anticatarrhal remedy.
anticathode |The part of a vacuum tube opposite the cathode. Upon it the cathode rays impinge.
anticausodic |Same as Anticausotic.
anticausotic |Good against an inflammatory fever. -- n.  A remedy for such a fever.
antichamber |See Antechamber.
antichlor |Any substance (but especially sodium hyposulphite) used in removing the excess of chlorine left in paper pulp or stuffs after bleaching.
antichrist |A denier or opponent of Christ. Specif.: A great antagonist, person or power, expected to precede Christ's second coming.
antichristian |Opposed to the Christian religion.
antichristianism |Opposition or contrariety to the Christian religion.
antichristianity |Opposition or contrariety to the Christian religion.
antichristianly |In an antichristian manner.
antichronical |Deviating from the proper order of time. -- An`ti*chron\"ic*al*ly, adv.
antichronism |Deviation from the true order of time; anachronism. [R.] Selden.
antichthon |1. A hypothetical earth counter to ours, or on the opposite side of the sun. Grote. 2. pl.  Inhabitants of opposite hemispheres. Whewell.
anticipant |Anticipating; expectant; -- with of. Wakening guilt, anticipant of hell. Southey.
anticipate |1. To be before in doing; to do or take before another; to preclude or prevent by prior action. To anticipate and prevent the duke's purpose. R. Hall. He would probably have died by the hand of the executioner, if indeed the executioner had not been anticipated by the populace. Macaulay. 2. To take up or introduce beforehand, or before the proper or normal time; to cause to occur earlier or prematurely; as, the advocate has anticipated a part of his argument. 3. To foresee (a wish, command, etc.) and do beforehand that which will be desired. 4. To foretaste or foresee; to have a previous view or impression of; as, to anticipate the pleasures of a visit; to anticipate the evils of life. Syn. -- To prevent; obviate; preclude; forestall; expect. -- To Anticipate, Expect. These words, as here compared, agree in regarding some future event as about to take place. Expect is the stringer. It supposes some ground or reason in the mind for considering the event as likely to happen. Anticipate is, literally, to take beforehand, and here denotes simply to take into the mind as conception of the future. Hence, to say, \"I did not anticipate a refusal,\" expresses something less definite and strong than to say, \" did not expect it.\" Still, anticipate is a convenient word to be interchanged with expect in cases where the thought will allow. Good with bad Expect to hear; supernal grace contending With sinfulness of men. Milton. I would not anticipate the relish of any happiness, nor feel the weight of any misery, before it actually arrives. Spectator. Timid men were anticipating another civil war. Macaulay.
anticipation |1. The act of anticipating, taking up, placing, or considering something beforehand, or before the proper time in natural order. So shall my anticipation prevent your discovery. Shak. 2. Previous view or impression of what is to happen; instinctive prevision; foretaste; antepast; as, the anticipation of the joys of heaven. The happy anticipation of renewed existence in company with the spirits of the just. Thodey. 3. Hasty notion; intuitive preconception. Many men give themselves up to the first anticipations of their minds. Locke. 4. (Mus.)  The commencing of one or more tones of a chord with or during the chord preceding, forming a momentary discord. Syn. -- Preoccupation; preclusion; foretaste; prelibation; antepast; pregustation; preconception; expectation; foresight; forethought.
anticipative |Anticipating, or containing anticipation. \"Anticipative of the feast to come.\" Cary. -- An*tic\"i*pa*tive*ly, adv.
anticipator |One who anticipates.
anticipatory |Forecasting; of the nature of anticipation. Owen. Here is an anticipatory glance of what was to be. J. C. Shairp.
anticivic |Opposed to citizenship.
anticivism |Opposition to the body politic of citizens. [Obs.] Carlyle.
anticlastic |Having to opposite curvatures, that is, curved longitudinally in one direction and transversely in the opposite direction, as the surface of a saddle.
anticlimax |A sentence in which the ideas fall, or become less important and striking, at the close; -- the opposite of climax. It produces a ridiculous effect. Example: Next comes Dalhousie, the great god of war, Lieutenant-colonel to the Earl ANTICLINAL An`ti*cli\"nal, a. Etym: [Pref. anti- + Gr.  Inclining or dipping in opposite directions. See Synclinal. Anticlinal line, Anticlinal axis (Geol.), a line from which strata dip in opposite directions, as from the ridge of a roof. -- Anticlinal vertebra (Anat.), one of the dorsal vertebræ, which in many animals has an upright spine toward which the spines of the neighboring vertebræ are inclined.
anticlinal |The crest or line in which strata slope or dip in opposite directions.
anticline |A structure of bedded rocks in which the beds on both sides of an axis or axial plane dip away from the axis; an anticlinal.
anticlinorium |The upward elevation of the crust of the earth, resulting from a geanticlinal.
anticly |Oddly; grotesquely.
anticness |The quality of being antic. Ford.
anticoherer |A device, one form of which consists of a scratched deposit of silver on glass, used in connection with the receiving apparatus for reading wireless signals. The electric waves falling on this contrivance increase its resistance several times. The anticoherer can be used in conjunction with a telephone.
anticonstitutional |Opposed to the constitution; unconstitutional.
anticontagious |Opposing or destroying contagion.
anticonvulsive |Good against convulsions. J. Floyer.
anticor |A dangerous inflammatory swelling of a horse's breast, just opposite the heart.
anticous |Facing toward the axis of the flower, as in the introrse anthers of the water lily.
anticyclone |A movement of the atmosphere opposite in character, as regards direction of the wind and distribution of barometric pressure, to that of a cyclone. -- An`ti*cy*clon\"ic, a. -- An`ti*cy*clon\"ic*al*ly, adv.
antidiphtheritic |Destructive to, or hindering the growth of, diphtheria bacilli. -- n.  An antidiphtheritic agent.
