hogpen |A pen or sty for hogs.
hogreeve |A civil officer charged with the duty of impounding hogs running at large. [New Eng.] Bartlett.
hogringer |One who puts rings into the snouts of hogs. HOG'S-BACK Hog's\"-back`, n. (Geol.)  A hogback.
hogscore |A distance lime brawn across the rink or course between the middle line and the tee. [Scot.]
hogshead |1. An English measure of capacity, containing 63 wine gallons, or about 52 Note: The London hogshead of beer was 54 beer gallons, the London hogshead of ale was 48 ale gallons. Elsewhere in England the ale and beer hogsheads held 51 gallons. These measures are no longer in use, except for cider. 2. A large cask or barrel, of indefinite contents; esp. one containing from 100 to 140 gallons. [U. S.]
hogskin |Leather tanned from a hog's skin. Also used adjectively.
hogsty |A pen, house, or inclosure, for hogs.
hogwash |Swill. Arbuthnot.
hogweed |(a) A common weed (Ambrosia artemisiæge). See Ambrosia, 3. (b) In England, the Heracleum Sphondylium.
hoiden |1. A rude, clownish youth. [Obs.] Milton. 2. A rude, bold girl; a romp. H. Kingsley.\n\nRustic; rude; bold. Younq.\n\nTo romp rudely or indecently. Swift.
hoidenhood |State of being a hoiden.
hoidenish |Like, or appropriate to, a hoiden.
hoise |To hoist. [Obs.] They . . . hoised up the mainsail to the wind. Acts xxvii. 40.
hoist |To raise; to lift; to elevate; esp., to raise or lift to a desired elevation, by means of tackle, as a sail, a flag, a heavy package or weight. They land my goods, and hoist my flying sails. Pope. Hoisting him into his father's throne. South. Hoisting engine, a steam engine for operating a hoist.\n\n1. That by which anything is hoisted; the apparatus for lifting goods. 2. The act of hoisting; a lift. [Collog.] 3. (fly, or horizontal length when flying from a staff. (b) The height of a fore-and-aft sail next the mast or stay. Totten. Hoist bridge, a drawbridge that is lifted instead of being swung or drawn aside.\n\nHoisted. [Obs.] 'Tis the sport to have the enginer Hoist with his own petar. Shak.
hoistaway |A mechanical lift. See Elevator.
hoistway |An opening for the hoist, or
hoit |To leap; to caper; to romp noisily. [Obs.] Beau. & Fl.
hoity-toity |Thoughtless; giddy; flighty; also, haughty; patronizing; as, to be in hoity-toity spirits, or to assume hoity-toity airs; used also as an exclamation, denoting surprise or disapprobation, with some degree of contempt. Hoity-toity! What have I to do with dreams Congreve.
hokeday |Same as Hockday.
hoker |Scorn; derision; abusive talk. [Obs.] -- Ho\"ker*ly, adv. [Obs.] Chaucer.
hol |Whole. [Obs.] Chaucer.
holarctic |Of or pert. to the arctic regions collectively; specif. (Zoögeography),  designating a realm or region including the northern parts of the Old and the New World. It comprises the Palearctic and Nearctic regions or subregions.
holaspidean |Having a single series of large scutes on the posterior side of the tarsus; -- said of certain birds.
holcad |A large ship of burden, in ancient Greece. Mitford.
hold |The whole interior portion of a vessel below the lower deck, in which the cargo is stowed.\n\n1. To cause to remain in a given situation, position, or relation, within certain limits, or the like; to prevent from falling or escaping; to sustain; to restrain; to keep in the grasp; to retain. The loops held one curtain to another. Ex. xxxvi. 12. Thy right hand shall hold me. Ps. cxxxix. 10. They all hold swords, being expert in war. Cant. iii. In vain he seeks, that having can not hold. Spenser. France, thou mayst hold a serpent by the tongue, . . . A fasting tiger safer by the tooth, Than keep in peace that hand which thou dost hold. Shak. 2. To retain in one's keeping; to maintain possession of, or authority over; not to give up or relinquish; to keep; to defend. We mean to hold what anciently we claim Of deity or empire. Milton. 3. To have; to possess; to be in possession of; to occupy; to derive title to; as, to hold office. This noble merchant held a noble house. Chaucer. Of him to hold his seigniory for a yearly tribute. Knolles. And now the strand, and now the plain, they held. Dryden. 4. To impose restraint upon; to limit in motion or action; to bind legally or morally; to confine; to restrain. We can not hold mortality's strong hand. Shak. Death! what do'st O,hold thy blow. Grashaw. He hat not sufficient judgment and self-command to hold his tongue. Macaulay. 5. To maintain in being or action; to carry on; to prosecute, as a course of conduct or an argument; to continue; to sustain. Hold not thy peace, and be not still. Ps. lxxxiii. 1. Seedtime and harvest, heat and hoary frost, Shall hold their course. Milton. 6. To prosecute, have, take, or join in, as something which is the result of united action; as to, hold a meeting, a festival, a session, etc.; hence, to direct and bring about officially; to conduct or preside at; as, the general held a council of war; a judge holds a court; a clergyman holds a service. I would hold more talk with thee. Shak. 7. To receive and retain; to contain as a vessel; as, this pail holds milk; hence, to be able to receive and retain; to have capacity or containing power for. Broken cisterns that can hold no water. Jer. ii. 13. One sees more devils than vast hell can hold. Shak. 8. To accept, as an opinion; to be the adherent of, openly or privately; to persist in, as a purpose; to maintain; to sustain. Stand fast and hold the traditions which ye have been taught. 2 Thes. ii.15. But still he held his purpose to depart. Dryden. 9. To consider; to regard; to esteem; to account; to think; to judge. I hold him but a fool. Shak. I shall never hold that man my friend. Shak. The Lord will not hold him guiltless that taketh his name in vain. Ex. xx. 7. 10. To bear, carry, or manage; as he holds himself erect; he holds his head high. Let him hold his fingers thus. Shak. To hold a wager, to lay or hazard a wager. Swift. -- To hold forth, to offer; to exhibit; to propose; to put forward. \"The propositions which books hold forth and pretend to teach.\" Locke. -- To held in, to restrain; to curd. -- To hold in hand, to toy with; to keep in expectation; to have in one's power. [Obs.] O, fie! to receive favors, return falsehoods, And hold a lady in hand. Beaw. & Fl. --To hold in play, to keep under control; to dally with. Macaulay. -- To hold off, to keep at a distance. -- To hold on, to hold in being, continuance or position; as, to hold a rider on. -- To hold one's day, to keep one's appointment. [Obs.] Chaucer. -- To hold one's own. (a) To keep good one's present condition absolutely or relatively; not to fall off, or to lose ground; as, a ship holds her own when she does not lose ground in a race or chase; a man holds his own when he does not lose strength or weight. -- To hold one's peace, to keep silence.- To hold out. (a) To extend; to offer. \"Fortune holds out these to you as rewards.\" B. Jonson. (b) To continue to do or to suffer; to endure. \"He can not long hold out these pangs.\" Shak. -- To hold up. (a) To raise; to lift; as, hold up your head. (b) To support; to sustain. \"He holds himself up in virtue.\"Sir P. Sidney. (c) To exhibit; to display; as, he was held up as an example. (d) To rein in; to check; to halt; as, hold up your horses. -- To hold water. (a) Literally, to retain water without leaking; hence (Fig.), to be whole, sound, consistent, without gaps or holes; -- commonly used in a negative sense; as, his statements will not hold water. [Collog.] (b) (Naut.) To hold the oars steady in the water, thus checking the headway of a boat.\n\nIn general, to keep one's self in a given position or condition; to remain fixed. Hence: 1. Not to more; to halt; to stop;-mostly in the imperative. And damned be him that first cries, \"Hold, enough!\" Shak. 2. Not to give way; not to part or become separated; to remain unbroken or unsubdued. Our force by land hath nobly held. Shak. 3. Not to fail or be found wanting; to continue; to last; to endure a test or trial; to abide; to persist. While our obedience holds. Milton. The rule holds in land as all other commodities. Locke. 4. Not to fall away, desert, or prove recreant; to remain attached; to cleave;-often with with, to, or for. He will hold to the one and despise the other. Matt. vi. 24 5. To restrain one's self; to refrain. His dauntless heart would fain have held From weeping, but his eyes rebelled. Dryden. 6. To derive right or title; -- generally with of. My crown is absolute, and holds of none. Dryden. His imagination holds immediately from nature. Hazlitt. Hold on! Hold up! wait; stop; forbear. [Collog] -- To hold forth, to speak in public; to harangue; to preach. L'Estrange. -- To hold in, to restrain one's self; as, he wanted to laugh and could hardly hold in. -- To hold off, to keep at a distance. -- To hold on, to keep fast hold; to continue; to go on. \"The trade held on for many years,\" Swift. -- To hold out, to last; to endure; to continue; to maintain one's self; not to yield or give way. -- To hold over, to remain in office, possession, etc., beyond a certain date. -- To hold to or with, to take sides with, as a person or opinion. -- To hold together, to be joined; not to separate; to remain in union. Dryden. Locke. -- To hold up. (a) To support one's self; to remain unbent or unbroken; as, to hold up under misfortunes. (b) To cease raining; to cease to stop; as, it holds up. Hudibras. (c) To keep up; not to fall behind; not to lose ground. Collier.\n\n1. The act of holding, as in or with the hands or arms; the manner of holding, whether firm or loose; seizure; grasp; clasp; gripe; possession; -- often used with the verbs take and lay. Ne have I not twelve pence within mine hold. Chaucer. Thou should'st lay hold upon him. B. Jonson. My soul took hold on thee. Addison. Take fast hold of instruction. Pror. iv. 13. 2. The authority or ground to take or keep; claim. The law hath yet another hold on you. Shak. 3. Binding power and influence. Fear . . . by which God and his laws take the surest hold of. Tillotson. 4. Something that may be grasped; means of support. If a man be upon an high place without rails or good hold, he is ready to fall. Bacon. 5. A place of confinement; a prison; confinement; custody; guard. They . . . put them in hold unto the next day. Acts. iv. 3. King Richard, he is in the mighty hold Of Bolingbroke. Shak. 6. A place of security; a fortified place; a fort; a castle; -- often called a stronghold. Chaucer. New comers in an ancient hold Tennyson. 7. (Mus.)  A character [thus pause, and corona.
holdback |1. Check; hindrance; restraint; obstacle. The only holdback is the affection . . . that we bear to our wealth. Hammond. 2. The projection or loop on the thill of a vehicle. to which a strap of the harness is attached, to hold back a carriage when going down hill, or in backing; also, the strap or part of the harness so used.
holder |One who is employed in the hold of a vessel.\n\n1. One who, or that which, holds. 2. One who holds land, etc., under another; a tenant. 3. (Com.)  The payee of a bill of exchange or a promissory note, or the one who owns or holds it. Note: Holder is much used as the second part of a compound; as, shareholder, officeholder, stockholder,etc.
holder-forth |One who speaks in public; an haranguer; a preacher. Addison.
holdfast |1. Something used to secure and hold in place something else, as a long fiat-headed nail, a catch a hook, a clinch, a clamp, etc.; hence, a support. \"His holdfast was gone.\" Bp. Montagu. 2. (Bot.)  A conical or branching body, by which a seaweed is attached to its support, and differing from a root in that it is not specially absorbent of moisture.
holding |1. The act or state of sustaining, grasping, or retaining. 2. A tenure; a farm or other estate held of another. 3. That which holds, binds, or influences. Burke. 4. The burden or chorus of a song. [Obs.] Shak. Holding note (Mus.), a note sustained in one part, while the other parts move.
hole |Whole. [Obs.] Chaucer.\n\n1. A hollow place or cavity; an excavation; a pit; an opening in or through a solid body, a fabric, etc.; a perforation; a rent; a fissure. The holes where eyes should be. Shak. The blind walls Were full of chinks and holes. Tennyson. The priest took a chest, and bored a hole in the lid. 2 Kings xii. 9. 2. An excavation in the ground, made by an animal to live in, or a natural cavity inhabited by an animal; hence, a low, narrow, or dark lodging or place; a mean habitation. Dryden. The foxes have holes, . . . but the Son of man hath not where to lay his head. Luke ix. 58. Syn. -- Hollow; concavity; aperture; rent; fissure; crevice; orifice; interstice; perforation; excavation; pit; cave; den; cell. Hole and corner, clandestine, underhand. [Colloq.] \"The wretched trickery of hole and corner buffery. \" Dickens. -- Hole board (Fancy Weaving), a board having holes through which cords pass which lift certain warp threads; -- called also compass board.\n\n1. To cut, dig, or bore a hole or holes in; as, to hole a post for the insertion of rails or bars. Chapman. 2. To drive into a hole, as an animal, or a billiard ball.\n\nTo go or get into a hole. B. Jonson.
hole in the air |= Air hole, above.
holethnic |Of or pertaining to a holethnos or parent race. The holethnic history of the Arians. London Academy.
holethnos |A parent stock or race of people, not yet divided into separate branches or tribes.
holibut |See Halibut.
holidam |See Halidom.
holiday |1. A consecrated day; religious anniversary; a day set apart in honor of some person, or in commemoration of some event. See Holyday. 2. A day of exemption from labor; a day of amusement and gayety; a festival day. And young and old come forth to play On a sunshine holiday. Milton. 3. (Law)  A day fixed by law for suspension of business; a legal holiday. Note: In the United States legal holidays, so called, are determined by law, commonly by the statutes of the several States. The holidays most generally observed are: the 22d day of February (Washington's birthday), the 30th day of May (Memorial day), the 4th day of July (Independence day), the 25th day of December (Christmas day). In most of the States the 1st day of January is a holiday. When any of these days falls on Sunday, usually the Monday following is observed as the holiday. In many of the States a day in the spring (as Good Friday, or the first Thursday in April), and a day in the fall (as the last Thursday in November) are now regularly appointed by Executive proclamation to be observed, the former as a day of fasting and prayer, the latter as a day of thanksgiving and are kept as holidays. In England, the days of the greater church feasts (designated in the calendar by a red letter, and commonly called red-letter days) are observed as general holidays. Bank holidays are those on which, by act of Parliament, banks may suspend business. Although Sunday is a holiday in the sense of a day when business is legally suspended, it is not usually included in the general term, the phrase \"Sundays and holidays\" being more common. The holidays, any fixed or usual period for relaxation or festivity; especially, Christmas and New Year's day with the intervening time.\n\n1. Of or pertaining to a festival; cheerful; joyous; gay. Shak. 2. Occurring rarely; adapted for a special occasion. Courage is but a holiday kind of virtue, to be seldom exercised. Dryden.
holily |1. Piously; with sanctity; in a holy manner. 2. Sacredly; inviolably. [R.] Shak.
holiness |1. The state or quality of being holy; perfect moral integrity or purity; freedom from sin; sanctity; innocence. Who is like thee, glorious in holiness! Ex. xv. 11. 2. The state of being hallowed, or consecrated to God or to his worship; sacredness. Israel was holiness unto the Lord. Jer.ii.3. His holiness, a title of the pope; -- formerly given also to Greek bishops and Greek emperors. Syn. -- Piety; devotion; godliness; sanctity; sacredness; righteousness.
holing |Undercutting in a bed of coal, in order to bring down the upper mass. Raymond.
holla |Hollo.\n\nSee Hollo, v. i.
holland |A kind of linen first manufactured in Holland; a linen fabric used for window shades, children's garments, etc.; as, brown or unbleached hollands.
hollandaise |A sauce consisting essentially of a seasoned emulsion of butter and yolk of eggs with a little lemon juice or vinegar.
hollandaise sauce |A sauce consisting essentially of a seasoned emulsion of butter and yolk of eggs with a little lemon juice or vinegar.
hollander |1. A native or one of the people of Holland; a Dutchman. 2. A very hard, semi-glazed, green or dark brown brick, which will not absorb water; -- called also, Dutch clinker. Wagner.
hollandish |Relating to Holland; Dutch.
hollands |1. Gin made in Holland. 2. pl.  See Holland.
hollo |Ho there; stop; attend; hence, a loud cry or a call to attract attention; a halloo. And every day, for food or play, Came to the mariner's hollo. Coleridge.\n\nTo call out or exclaim; to halloo.
holloa |Same as Hollo.
hollow |1. Having an empty space or cavity, natural or artificial, within a solid substance; not solid; excavated in the interior; as, a hollow tree; a hollow sphere. Hollow with boards shalt thou make it. Ex. xxvii. 8.. 2. Depressed; concave; gaunt; sunken. With hollow eye and wrinkled brow. Shak. 3. Reverberated from a cavity, or resembling such a sound; deep; muffled; as, a hollow roar. Dryden. 4. Not sincere or faithful; false; deceitful; not sound; as, a hollow heart; a hollow friend. Milton. Hollow newel (Arch.), an opening in the center of a winding staircase in place of a newel post, the stairs being supported by the wall; an open newel; also, the stringpiece or rail winding around the well of such a staircase. -- Hollow quoin (Engin.), a pier of stone or brick made behind the lock gates of a canal, and containing a hollow or recess to receive the ends of the gates. -- Hollow root. (Bot.) See Moschatel. -- Hollow square. See Square. -- Hollow ware, hollow vessels; -- a trade name for cast-iron kitchen utensils, earthenware, etc. Syn.- Concave; sunken; low; vacant; empty; void; false; faithless; deceitful; treacherous.\n\n1. A cavity, natural or artificial; an unfilled space within anything; a hole, a cavern; an excavation; as the hollow of the hand or of a tree. 2. A low spot surrounded by elevations; a depressed part of a surface; a concavity; a channel. Forests grew Upon the barren hollows. Prior. I hate the dreadful hollow behind the little wood. Tennyson.\n\nTo make hollow, as by digging, cutting, or engraving; to excavate. \"Trees rudely hollowed.\" Dryden.\n\nWholly; completely; utterly; -- chiefly after the verb to beat, and often with all; as, this story beats the other all hollow. See All, adv. [Collog.] The more civilized so-called Caucasian races have beaten the Turks hollow in the struggle for existence. Darwin.\n\nHollo.\n\nTo shout; to hollo. Whisperings and hollowings are alike to a deaf ear. Fuller.\n\nTo urge or call by shouting. He has hollowed the hounds. Sir W. Scott.
hollow-hearted |Insincere; deceitful; not sound and true; having a cavity or decayed spot within. Syn. -- Faithless; dishonest; false; treacherous.
hollow-horned |Having permanent horns with a bony core, as cattle.
hollowly |Insincerely; deceitfully. Shak.
hollowness |1. State of being hollow. Bacon. 2. Insincerity; unsoundness; treachery. South.
holluschickie |A young male fur seal, esp. one from three to six years old; -- called also bachelor, because prevented from breeding by the older full-grown males. The holluschickie are the seals that may legally be killed for their skins. But he'll lie down on the killing grounds where the holluschickie go. Kipling.
holly |Wholly. [Obs.] Chaucer.\n\n1. (Bot.)  A tree or shrub of the genus Ilex. The European species (Ilex Aguifolium) is best known, having glossy green leaves, with a spiny, waved edge, and bearing berries that turn red or yellow about Michaelmas. Note: The holly is much used to adorn churches and houses, at Christmas time, and hence is associated with scenes of good will and rejoicing. It is an evergreen tree, and has a finegrained, heavy, white wood. Its bark is used as a febrifuge, and the berries are violently purgative and emetic. The American holly is the Ilex opaca, and is found along the coast of the United States, from Maine southward. Gray. 2. (Bot.)  The holm oak. See 1st Holm. Holly-leaved oak (Bot.), the black scrub oak. See Scrub oak. -- Holly rose (Bot.), a West Indian shrub, with showy, yellow flowers (Turnera ulmifolia). -- Sea holly (Bot.), a species of Eryngium. See Eryngium.
hollyhock |A species of Althæa (A. rosea), bearing flowers of various colors; -- called also rose mallow.
holm |A common evergreen oak, of Europe (Quercus Ilex); -- called also ilex, and holly.\n\n1. An islet in a river. J. Brand. 2. Low, flat land. Wordsworth. The soft wind blowing over meadowy holms. Tennyson. Holm thrush (Zoöl.), the missel thrush.
holmia |An oxide of holmium.
holmium |A rare element said to be contained in gadolinite. -- Hol\"mic, a.
holmos |A name given to a vase having a rounded body; esp.: (a) A closed vessel of nearly spherical form on a high stem or pedestal. Fairholt. (b) A drinking cup having a foot and stem.
holo- |A combining form fr. Gr. \"o`los whole.
holoblast |an ovum composed entirely of germinal matter. See Meroblast.
holoblastic |Undergoing complete segmentation; composed entirely of germinal matter, the whole of the yolk undergoing fission; -- opposed to meroblastic.
holocaust |1. A burnt sacrifice; an offering, the whole of which was consumed by fire, among the Jews and some pagan nations. Milton. 2. Sacrifice or loss of many lives, as by the burning of a theater or a ship. Note: [An extended use not authorized by careful writers.]
holocephali |An order of elasmobranch fishes, including, among living species, only the chimæras; -- called also Holocephala. See Chimæra; also Illustration in Appendix.
holocryptic |Wholly or completely concealing; incapable of being deciphered. Holocryptic cipher, a cipher so constructed as to afford no clew to its meaning to one ignorant of the key.
holocrystalline |Completely crystalline; -- said of a rock like granite, all the constituents of which are crystalline.
holograph |A document, as a letter, deed, or will, wholly in the handwriting of the person from whom it proceeds and whose act it purports to be.
holographic |Of the nature of a holograph; pertaining to holographs.
holohedral |Having all the planes required by complete symmetry, -- in opposition to hemihedral.
holohemihedral |Presenting hemihedral forms, in which all the sectants have halt the whole number of planes. Dana.
holometabola |Those insects which have a complete metamorphosis; metabola.
holometabolic |Having a complete metamorphosis;-said of certain insects, as the butterflies and bees.
holometer |An instrument for making of angular measurements.
holophanerous |Same as Holometabolic.
holophotal |Causing no loss of light; -- applied to reflectors which throw back the rays of light without perceptible loss.
holophote |A lamp with lenses or reflectors to collect the rays of light and throw them in a given direction; -- used in lighthouses.
holophrastic |Expressing a phrase or sentence in a single word, -- as is the case in the aboriginal languages of America.
holophytic |Wholly or distinctively vegetable. Holophytic nutrition (, that form of nutrition, characteristic of vegetable organisms, in which carbonic acid, ammonia, and nitrates are absorbed as food, in distinction from the animal mode of nutrition, by the ingestion of albuminous matter.
holorhinal |Having the nasal bones contiguous.
holosiderite |Meteoric iron; a meteorite consisting of metallic iron without stony matter.
holostean |Pertaining to the Holostei.
holostei |An extensive division of ganoids, including the gar pike, bowfin, etc.; the bony ganoids. See Illustration in Appendix.
holosteric |Wholly solid; -- said of a barometer constructed of solid materials to show the variations of atmospheric pressure without the use of liquids, as the aneroid.
holostomata |An artificial division of gastropods, including those that have an entire aperture.
holostomate |Same as Holostomatous.
holostomatous |Having an entire aperture; -- said of many univalve shells.
holostome |One of the Holostomata.
holostraca |A division of phyllopod Crustacea, including those that are entirely covered by a bivalve shell.
holothure |A holothurian.
holothurian |( -- n.  One of the Holothurioidea. Note: Some of the species of Holothurians are called sea cucumbers, sea slugs, trepang, and bêche de mèr. Many are used as food, esp. by the Chinese. See Trepang.
holothurioidea |One of the classes of echinoderms. Note: They have a more or less elongated body, often flattened beneath, and a circle of tentacles, which are usually much branched, surrounding the mouth; the skin is more or less flexible, and usually contains calcareous plates of various characteristic forms, sometimes becoming large and scalelike. Most of the species have five bands (ambulacra) of sucker-bearing feet along the sides; in others these are lacking. In one group (Pneumonophora) two branching internal gills are developed; in another (Apneumona) these are wanting. Called also Holothurida, Holothuridea, and Holothuroidea.
holotricha |A group of ciliated Infusoria, having cilia all over the body.
holour |A whoremonger. [Obs.] Chaucer.
holp |imp. & p. p. of Help. [Obs.] Shak.
holpen |imp. & p. p. of Help. [Obs.] Shak.
holsom |Wholesome. [Obs.] Chaucer.
holstein |One of a breed of cattle, originally from Schleswig-Holstein, valued for the large amount of milk produced by the cows. The color is usually black and white in irregular patches.
holster |A leather case for a pistol, carried by a horseman at the bow of his saddle.
holstered |Bearing holsters. Byron.
holt |3d pers. sing. pres. of Hold, contr. from holdeth. [Obs.] Chaucer.\n\n1. A piece of woodland; especially, a woody hill. \"Every holt and heath.\" Chaucer. She sent her voice though all the holt Before her, and the park. Tennyson. 2. A deep hole in a river where there is protection for fish; also, a cover, a hole, or hiding place. \" The fox has gone to holt.\" C. Kingsley.
holwe |Hollow. [Obs.] Chaucer.
holy |1. Set apart to the service or worship of God; hallowed; sacred; reserved from profane or common use; holy vessels; a holy priesthood. \"Holy rites and solemn feasts.\" Milton. 2. Spiritually whole or sound; of unimpaired innocence and virtue; free from sinful affections; pure in heart; godly; pious; irreproachable; guiltless; acceptable to God. Now through her round of holy thought The Church our annual steps has brought. Keble. Holy Alliance (Hist.), a league ostensibly for conserving religion, justice, and peace in Europe, but really for repressing popular tendencies toward constitutional government, entered into by Alexander I. of Russia, Francis I. of Austria, and Frederic William III. of Prussia, at Paris, on the 26th of September, 1815, and subsequently joined by all the sovereigns of Europe, except the pope and the king of England. -- Holy bark. See Cascara sagrada. -- Holy Communion. See Eucharist. -- Holy family (Art), a picture in which the infant Christ, his parents, and others of his family are represented. -- Holy Father, a title of the pope. -- Holy Ghost (Theol.),the third person of the Trinity; the Comforter; the Paraclete. -- Holy Grail. See Grail. -- Holy grass (Bot.), a sweet-scented grass (Hierochloa borealis and H. alpina). In the north of Europe it was formerly strewed before church doors on saints' days; whence the name. It is common in the northern and western parts of the United States. Called also vanilla, or Seneca, grass. -- Holy Innocents' day, Childermas day. -- Holy Land, Palestine, the birthplace of Christianity. -- Holy office, the Inquisition. -- Holy of holies (Script.), the innermost apartment of the Jewish tabernacle or temple, where the ark was kept, and where no person entered, except the high priest once a year. -- Holy One. (a) The Supreme Being; -- so called by way of emphasis. \" The Holy One of Israel.\" Is. xliii. 14. (b) One separated to the service of God. -- Holy orders. See Order. -- Holy rood, the cross or crucifix, particularly one placed, in churches. over the entrance to the chancel. -- Holy rope, a plant, the hemp agrimony. -- Holy Saturday (Eccl.), the Saturday immediately preceding the festival of Easter; the vigil of Easter. -- Holy Spirit, same as Holy Ghost (above). -- Holy Spirit plant. See Dove plant. -- Holy thistle (Bot.), the blessed thistle. See under Thistle. -- Holy Thursday. (Eccl.) (a) (Episcopal Ch.) Ascension day. (b) (R. C. Ch.) The Thursday in Holy Week; Maundy Thursday. -- Holy war, a crusade; an expedition carried on by Christians against the Saracens in the Holy Land, in the eleventh, twelfth, and thirteenth centuries, for the possession of the holy places. -- Holy water (Gr. & R. C. Churches), water which has been blessed by the priest for sacred purposes. -- Holy-water stoup, the stone stoup or font placed near the entrance of a church, as a receptacle for holy water. -- Holy Week (Eccl.), the week before Easter, in which the passion of our Savior is commemorated. -- Holy writ, the sacred Scriptures. \" Word of holy writ.\" Wordsworth.
holy cross |The cross as the symbol of Christ's crucifixion. Congregation of the Holy Cross (R. C. Ch.), a community of lay brothers and priests, in France and the United States, engaged chiefly in teaching and manual Labor. Originally called Brethren of St. Joseph. The Sisters of the Holy Cross engage in similar work. Addis & Arnold. -- Holy-cross day, the fourteenth of September, observed as a church festival, in memory of the exaltation of our Savior's cross.
holyday |1. A religious festival. 2. A secular festival; a holiday. Note: Holiday is the preferable and prevailing spelling in the second sense. The spelling holy day or holyday in often used in the first sense.
holystone |A stone used by seamen for scrubbing the decks of ships. Totten.\n\nTo scrub with a holystone, as the deck of a vessel.
homacanth |Having the dorsal fin spines symmetrical, and in the same line; -- said of certain fishes.
homage |1. (Feud. Law)  A symbolical acknowledgment made by a feudal tenant to, and in the presence of, his lord, on receiving investiture of fee, or coming to it by succession, that he was his man, or vassal; profession of fealty to a sovereign. 2. Respect or reverential regard; deference; especially, respect paid by external action; obeisance. All things in heaven and earth do her [Law] homage. Hooker. I sought no homage from the race that write. Pope. 3. Reverence directed to the Supreme Being; reverential worship; devout affection. Chaucer. Syn. -- Fealty; submission; reverence; honor; respect. -- Homage, Fealty. Homage was originally the act of a feudal tenant by which he declared himself, on his knees, to be the hommage or bondman of the lord; hence the term is used to denote reverential submission or respect. Fealty was originally the fidelity of such a tenant to his lord, and hence the term denotes a faithful and solemn adherence to the obligations we owe to superior power or authority. We pay our homage to men of preëminent usefulness and virtue, and profess our fealty to the principles by which they have been guided. Go, go with homage yon proud victors meet ! Go, lie like dogs beneath your masters' feet ! Dryden. Man, disobeying, Disloyal, breaks his fealty, and sins Against the high supremacy of heaven. Milton.\n\n1. To pay reverence to by external action. [R.] 2. To cause to pay homage. [Obs.] Cowley.
homageable |Subject to homage. Howell.
homager |One who does homage, or holds land of another by homage; a vassal. Bacon.
homalographic |Same as Homolographic.
homaloid |Flat; even; -- a term applied to surfaces and to spaces, whether real or imagined, in which the definitions, axioms, and postulates of Euclid respecting parallel straight lines are assumed to hold true.
homaloidal |Flat; even; -- a term applied to surfaces and to spaces, whether real or imagined, in which the definitions, axioms, and postulates of Euclid respecting parallel straight lines are assumed to hold true.
homarus |A genus of decapod Crustacea, including the common lobsters. -- Hom\"a*roid, a.
homatropine |An alkaloid, prepared from atropine, and from other sources. It is chemically related to atropine, and is used for the same purpose.
homaxonial |Relating to that kind of homology or symmetry, the mathematical conception of organic form, in which all axes are equal. See under Promorphology.
home |See Homelyn.\n\n1. One's own dwelling place; the house in which one lives; esp., the house in which one lives with his family; the habitual abode of one's family; also, one's birthplace. The disciples went away again to their own home. John xx. 10. Home is the sacred refuge of our life. Dryden. Home! home! sweet, sweet home! There's no place like home. Payne. 2. One's native land; the place or country in which one dwells; the place where one's ancestors dwell or dwelt. \"Our old home [England].\" Hawthorne. 3. The abiding place of the affections, especially of the domestic affections. He entered in his house -- his home no more, For without hearts there is no home. Byron. 4. The locality where a thing is usually found, or was first found, or where it is naturally abundant; habitat; seat; as, the home of the pine. Her eyes are homes of silent prayer. Tennyson. Flandria, by plenty made the home of war. Prior. 5. A place of refuge and rest; an asylum; as, a home for outcasts; a home for the blind; hence, esp., the grave; the final rest; also, the native and eternal dwelling place of the soul. Man goeth to his long home, and the mourners go about the streets. Eccl. xii. 5. 6. (Baseball)  The home base; he started for home. At home.(a) At one's own house, or lodgings. (b) In one's own town or country; as, peace abroad and at home. (c) Prepared to receive callers. -- Home department, the department of executive administration, by which the internal affairs of a country are managed. [Eng.] To be at home on any subject, to be conversant or familiar with it. -- To feel at home, to be at one's ease. -- To make one's self at home, to conduct one's self with as much freedom as if at home. Syn. -- Tenement; house; dwelling; abode; domicile.\n\n1. Of or pertaining to one's dwelling or country; domestic; not foreign; as home manufactures; home comforts. 2. Close; personal; pointed; as, a home thrust. Home base (Baseball), the base at which the batsman stands and which is the last goal in making a run. -- Home farm, grounds, etc., the farm, grounds, etc., adjacent to the residence of the owner. -- Home lot, an inclosed plot on which the owner's home stands. [U. S.] -- Home rule, rule or government of an appendent or dependent country, as to all local and internal legislation, by means of a governing power vested in the people within the country itself, in contradistinction to a government established by the dominant country; as, home rule in Ireland. Also used adjectively; as, home- rule members of Parliament. -- Home ruler, one who favors or advocates home rule. -- Home run (Baseball), a complete circuit of the bases made before the batted ball is returned to the home base. -- Home stretch (Sport.), that part of a race course between the last curve and the winning post. -- Home thrust, a well directed or effective thrust; one that wounds in a vital part; hence, in controversy, a personal attack.\n\n1. To one's home or country; as in the phrases, go home, come home, carry home. 2. Close; closely. How home the charge reaches us, has been made out. South. They come home to men's business and bosoms. Bacon. 3. To the place where it belongs; to the end of a course; to the full length; as, to drive a nail home; to ram a cartridge home. Wear thy good rapier bare and put it home. Shak. Note: Home is often used in the formation of compound words, many of which need no special definition; as, home-brewed, home-built, home- grown, etc. To bring home. See under Bring. -- To come home.(a) To touch or affect personally. See under Come. (b) (Naut.) To drag toward the vessel, instead of holding firm, as the cable is shortened; -- said of an anchor. -- To haul home the sheets of a sail (Naut.), to haul the clews close to the sheave hole. Totten.
home-bound |Kept at home.
home-bred |1. Bred at home; domestic; not foreign. \" Home-bred mischief.\" Milton. Benignity and home-bred sense. Wordsworth. 2. Not polished; rude; uncultivated. Only to me home-bred youths belong. Dryden.
home-coming |Return home. Kepeth this child, al be it foul or fayr, And eek my wyf, unto myn hoom-cominge. Chaucer.
home-driven |Driven to the end, as a nail; driven close.
home-dwelling |Keeping at home.
home-felt |Felt in one's own breast; inward; private. \"Home-felt quiet. Pope.
home-keeping |Staying at home; not gadding. Home-keeping youth have ever homely wits. Shak.\n\nA staying at home.
home-speaking |Direct, forcible, and effective speaking. Milton.
homeborn |1. Native; indigenous; not foreign. Donne. Pope. 2. Of or pertaining to the home or family. Fireside enjoyments, homeborn happiness. Cowper.
homefield |Afield adjacent to its owner's home. Hawthorne.
homeless |Destitute of a home. -- Home\"less*ness, n.
homelike |Like a home; comfortable; cheerful; cozy; friendly.
homelily |Plainly; inelegantly. [R.]
homeliness |1. Domesticity; care of home. [Obs.] \"Wifely homeliness.\" Chaucer. 2. Familiarity; intimacy. [Obs.] Chaucer. 3. Plainness; want of elegance or beauty. 4. Coarseness; simplicity; want of refinement; as, the homeliness of manners, or language. Addison.
homeling |A person or thing belonging to a home or to a particular country; a native; as, a word which is a homeling. Trench.
homely |1. Belonging to, or having the characteristics of, home; domestic; familiar; intimate. [Archaic] With all these men I was right homely, and communed with, them long and oft. Foxe. Their homely joys, and destiny obscure. Gray. 2. Plain; unpretending; rude in appearance; unpolished; as, a homely garment; a homely house; homely fare; homely manners. Now Strephon daily entertains His Chloe in the homeliest strains. Pope. 3. Of plain or coarse features; uncomely; -- contrary to handsome. None so homely but loves a looking-glass. South.\n\nPlainly; rudely; coarsely; as, homely dressed. [R.] Spenser.
homelyn |The European sand ray (Raia maculata); -- called also home, mirror ray, and rough ray.
homemade |Made at home; of domestic manufacture; made either in a private family or in one's own country. Locke.
homeopath |A practitioner of homeopathy. [Written also homoeopath.]
homeopathic |Of or pertaining to homeopathy; according to the principles of homeopathy. [Also homoepathic.]
homeopathically |According to the practice of homeopathy. [Also homoepathically.]
homeopathist |A believer in, or practitioner of, homeopathy. [Written also homoepathist.]
homeopathy |The art of curing, founded on resemblances; the theory and its practice that disease is cured (tuto, cito, et jucunde) by remedies which produce on a healthy person effects similar to the symptoms of the complaint under which the patient suffers, the remedies being usually administered in minute doses. This system was founded by Dr. Samuel Hahnemann, and is opposed to allopathy, or heteropathy. [Written also homoepathy.]
homer |A carrier pigeon remarkable for its ability to return home from a distance.\n\nSee Hoemother.\n\nA Hebrew measure containing, as a liquid measure, ten baths, equivalent to fifty-five gallons, two quarts, one pint; and, as a dry measure, ten ephahs, equivalent to six bushels, two pecks, four quarts. [Written also chomer, gomer.]
homeric |Of or pertaining to Homer, the most famous of Greek poets; resembling the poetry of Homer. Homeric verse, hexameter verse; -- so called because used by Homer in his epics.
homesick |Pining for home; in a nostalgic condition. -- Home\"sick`ness, n.
homespun |1. Spun or wrought at home; of domestic manufacture; coarse; plain. \"Homespun country garbs.\" W. Irving. 2. Plain in manner or style; not elegant; rude; coarse. \"Our homespun English proverb.\" Dryden. \"Our homespun authors.\" Addison.\n\n1. Cloth made at home; as, he was dressed in homespun. 2. An unpolished, rustic person. [Obs.] Shak.
homestall |Place of a home; homestead. Cowper.
homestead |1. The home place; a home and the inclosure or ground immediately connected with it. Dryden. 2. The home or seat of a family; place of origin. We can trace them back to a homestead on the Rivers Volga and Ural. W. Tooke. 3. (Law)  The home and appurtenant land and buildings owned by the head of a family, and occupied by him and his family. Homestead law. (a) A law conferring special privileges or exemptions upon owners of homesteads; esp., a law exempting a homestead from attachment or sale under execution for general debts. Such laws, with limitations as to the extent or value of the property, exist in most of the States. Called also homestead exemption law. (b) Also, a designation of an Act of Congress authorizing and regulating the sale of public lands, in parcels of 160 acres each, to actual settlers. [U.S.]
homesteader |One who has entered upon a portion of the public land with the purpose of acquiring ownership of it under provisions of the homestead law, so called; one who has acquired a homestead in this manner. [Local, U.S.]
homeward |Being in the direction of home; as, the homeward way.\n\nToward home; in the direction of one's house, town, or country. Homeward bound, bound for home; going homeward; as, the homeward bound fleet.
homewards |Toward home; in the direction of one's house, town, or country. Homeward bound, bound for home; going homeward; as, the homeward bound fleet.
homicidal |Pertaining to homicide; tending to homicide; murderous.
homicide |1. The killing of one human being by another. Note: Homicide is of three kinds: justifiable, as when the killing is performed in the exercise of a right or performance of a duty; excusable, as when done, although not as duty or right, yet without culpable or criminal intent; and felonious, or involving what the law terms malice; the latter may be either manslaughter or murder. Bouvier. 2. One who kills another; a manslayer. Chaucer. Shak.
homiform |In human form. [Obs.] Cudworth.
homilete |A homilist.
homiletic |1. Of or pertaining to familiar intercourse; social; affable; conversable; companionable. [R.] His virtues active, chiefly, and homiletical, not those lazy, sullen ones of the cloister. Atterbury. 2. Of or pertaining to homiletics; hortatory.
homiletical |1. Of or pertaining to familiar intercourse; social; affable; conversable; companionable. [R.] His virtues active, chiefly, and homiletical, not those lazy, sullen ones of the cloister. Atterbury. 2. Of or pertaining to homiletics; hortatory.
homiletics |The art of preaching; that branch of theology which treats of homilies or sermons, and the best method of preparing and delivering them.
homilist |One who prepares homilies; one who preaches to a congregation.
homilite |A borosilicate of iron and lime, near datolite in form and composition.
homily |1. A discourse or sermon read or pronounced to an audience; a serious discourse. Shak. 2. A serious or tedious exhortation in private on some moral point, or on the conduct of life. As I have heard my father Deal out in his long homilies. Byron. Book of Homilies. A collection of authorized, printed sermons, to be read by ministers in churches, esp. one issued in the time of Edward VI., and a second, issued in the reign of Elizabeth; -- both books being certified to contain a \"godly and wholesome doctrine.\",
  "classific |Characterizing a class or classes; relating to classification.
homing |Home-returning; -- used specifically of carrier pigeons.
hominy |Maize hulled and broken, and prepared for food by being boiled in water. [U.S.] [Written also homony.]
homish |Like a home or a home circle. Quiet, cheerful, homish hospital life. E. E. Hale.
hommock |A small eminence of a conical form, of land or of ice; a knoll; a hillock. See Hummock. Bartram.
hommocky |Filled with hommocks; piled in the form of hommocks; -- said of ice.
homo- |A combining form from Gr. \"omo`s, one and the same, common, joint.
homocategoric |Belonging to the same category of individuality; -- a morphological term applied to organisms so related.
homocentric |Having the same center.
homocercal |Having the tail nearly or quite symmetrical, the vertebral column terminating near its base; -- opposed to heterocercal.
homocercy |The possession of a homocercal tail.
homocerebrin |A body similar to, or identical with, cerebrin.
homochromous |Having all the florets in the same flower head of the same color.
homodemic |A morphological term signifying development, in the case of multicellular organisms, from the same unit deme or unit of the inferior orders of individuality.
homodermic |Relating to homodermy; originating from the same germ layer.
homodermy |Homology of the germinal layers.
homodont |Having all the teeth similar in front, as in the porpoises; -- opposed to heterodont.
homodromal |1. (Bot.)  Running in the same direction; -- said of stems twining round a support, or of the spiral succession of leaves on stems and their branches. 2. (Mech.)  Moving in the same direction; -- said of a lever or pulley in which the resistance and the actuating force are both on the same side of the fulcrum or axis.
homodromous |1. (Bot.)  Running in the same direction; -- said of stems twining round a support, or of the spiral succession of leaves on stems and their branches. 2. (Mech.)  Moving in the same direction; -- said of a lever or pulley in which the resistance and the actuating force are both on the same side of the fulcrum or axis.
homodynamic |Homodynamous. Quain.
homodynamous |Pertaining to, or involving, homodynamy; as, successive or homodynamous parts in plants and animals.
homodynamy |The homology of metameres. See Metamere. Gegenbaur.
homoeomeria |The state or quality of being homogeneous in elements or first principles; likeness or identity of parts.
homoeomeric |Pertaining to, or characterized by, sameness of parts; receiving or advocating the doctrine of homogeneity of elements or first principles.
homoeomerical |Pertaining to, or characterized by, sameness of parts; receiving or advocating the doctrine of homogeneity of elements or first principles.
homoeomerous |Having the main artery of the leg parallel with the sciatic nerve; -- said of certain birds.
homoeomery |Same as Homoeomeria. [Obs.] Cudworth.
homoeomorphism |A near similarity of crystalline forms between unlike chemical compounds. See Isomorphism.
homoeomorphous |Manifesting homoeomorphism.
homoeopathic |Same as Homeopathic, Homeopathist, Homeopathy.
homoeopathist |Same as Homeopathic, Homeopathist, Homeopathy.
homoeopathy |Same as Homeopathic, Homeopathist, Homeopathy.
homoeothermal |See Homoiothermal.
homoeozoic |Pertaining to, or including, similar forms or kinds of life; as, homoeozoic belts on the earth's surface. E. Forbes.
homogamous |Having all the flowers alike; -- said of such composite plants as Eupatorium, and the thistels.
homogamy |The condition of being homogamous.
homogangliate |Having the ganglia of the nervous system symmetrically arranged, as in certain invertebrates; -- opposed to heterogangliate.
homogene |Homogeneous. [Obs.] B. Jonson.
homogeneal |Homogeneous.
homogenealness |Homogeneousness.
homogeneity |Same as Homogeneousness.
homogeneous |1. Of the same kind of nature; consisting of similar parts, or of elements of the like nature; -- opposed to heterogeneous; as, homogeneous particles, elements, or principles; homogeneous bodies. 2. (Alg.)  Possessing the same number of factors of a given kind; as, a homogeneous polynomial.
homogeneousness |Sameness 9kind or nature; uniformity of structure or material.
homogenesis |That method of reproduction in which the successive generations are alike, the offspring, either animal or plant, running through the same cycle of existence as the parent; gamogenesis; -- opposed to heterogenesis.
homogenetic |Homogenous; -- applied to that class of homologies which arise from similarity of structure, and which are taken as evidences of common ancestry.
homogenous |Having a resemblance in structure, due to descent from a common progenitor with subsequent modification; homogenetic; -- applied both to animals and plants. See Homoplastic.
homogeny |1. Joint nature. [Obs.] Bacon. 2. (Biol.)  The correspondence of common descent; -- a term used to supersede homology by Lankester, who also used homoplasy to denote any superinduced correspondence of position and structure in parts embryonically distinct (other writers using the term homoplasmy). Thus, there is homogeny between the fore limb of a mammal and the wing of a bird; but the right and left ventricles of the heart in both are only in homoplasy with each other, these having arisen independently since the divergence of both groups from a univentricular ancestor.
homogonous |Having all the flowers of a plant alike in respect to the stamens and pistils.
homogony |The condition of having homogonous flowers.
homograph |One of two or more words identical in orthography, but having different derivations and meanings; as, fair, n., a market, and fair, a., beautiful.
homographic |1. Employing a single and separate character to represent each sound; -- said of certain methods of spelling words. 2. (Geom.)  Possessing the property of homography.
homography |1. That method of spelling in which every sound is represented by a single character, which indicates that sound and no other. 2. (Geom.)  A relation between two figures, such that to any point of the one corresponds one and but one point in the other, and vise versa. Thus, a tangent line rolling on a circle cuts two fixed tangents of the circle in two sets of points that are homographic.
homoioptoton |A figure in which the several parts of a sentence end with the same case, or inflection generally.
homoiothermal |Maintaining a uniform temperature; hæmatothermal; homothermic; -- applied to warm-bodied animals, because they maintain a nearly uniform temperature in spite of the great variations in the surrounding air; in distinct from the cold-blooded (poikilothermal) animals, whose body temperature follows the variations in temperature of the surrounding medium.
homoiousian |One of the semi-Arians of the 4th century, who held that the Son was of like, but not the same, essence or substance with the Father; -- opposed to homoousian.\n\nOf or pertaining to Homoiousians, or their belief.
homologate |To approve; to allow; to confirm; as, the court homologates a proceeding. Wheaton.
homologation |Confirmation or ratification (as of something otherwise null and void), by a court or a grantor.
homological |Pertaining to homology; having a structural affinity proceeding from, or base upon, that kind of relation termed homology. -- Ho`mo*log\"ic*al*ly, adv.
homologinic |Pertaining to, or characterized by, homology; as, homologinic qualities, or differences.
homologize |To determine the homologies or structural relations of.
homologon |See Homologue.
homologoumena |Those books of the New Testament which were acknowledged as canonical by the early church; -- distinguished from antilegomena.
homologous |Having the same relative position, proportion, value, or structure. Especially: (a) (Geom.) Corresponding in relative position and proportion. In similar polygons, the corresponding sides, angles, diagonals, etc., are homologous. Davies & Peck (Math. Dict. ). (b) (Alg.)  Having the same relative proportion or value, as the two antecedents or the two consequents of a proportion. (c) (Chem.) Characterized by homology; belonging to the same type or series; corresponding in composition and properties. See Homology, 3. (d) (Biol.) Being of the same typical structure; having like relations to a fundamental type to structure; as, those bones in the hand of man and the fore foot of a horse are homologous that correspond in their structural relations, that is, in thier relations to the type structure of the fore limb in vertebrates. Homologous stimulus. (Physiol.) See under Stimulus.
homolographic |Preserving the mutual relations of parts, especially as to size and form; maintaining relative proportion. Homolographic projection, a method of constructing geographical charts or maps, so that the surfaces, as delineated on a plane, have the same relative size as the real surfaces; that is, so that the relative actual areas of the different countries are accurately represented by the corresponding portions of the map.
homologue |That which is homologous to something else; as, the corresponding sides, etc., of similar polygons are the homologues of each other; the members or terms of an homologous series in chemistry are the homologues of each other; one of the bones in the hand of man is the homologue of that in the paddle of a whale.
homology |1. The quality of being homologous; correspondence; relation; as, the homologyof similar polygons. 2. (Biol.)  Correspondence or relation in type of structure in contradistinction to similarity of function; as, the relation in structure between the leg and arm of a man; or that between the arm of a man, the fore leg of a horse, the wing of a bird, and the fin of a fish, all these organs being modifications of one type of structure. Note: Homology indicates genetic relationship, and according to Haeckel special homology should be defined in terms of identity of embryonic origin. See Homotypy, and Homogeny. 3. (Chem.)  The correspondence or resemblance of substances belonging to the same type or series; a similarity of composition varying by a small, regular difference, and usually attended by a regular variation in physical properties; as, there is an homology between methane, CH4, ethane, C2H6, propane, C3H8, etc., all members of the paraffin series. In an extended sense, the term is applied to the relation between chemical elements of the same group; as, chlorine, bromine, and iodine are said to be in homology with each other. Cf. Heterology. General homology (Biol.), the higher relation which a series of parts, or a single part, bears to the fundamental or general type on which the group is constituted. Owen. -- Serial homology (Biol.), representative or repetitive relation in the segments of the same organism, -- as in the lobster, where the parts follow each other in a straight line or series. Owen. See Homotypy. -- Special homology (Biol.), the correspondence of a part or organ with those of a different animal, as determined by relative position and connection. Owen.
homomallous |Uniformly bending or curving to one side; -- said of leaves which grow on several sides of a stem.
homomorphic |Characterized by homomorphism.
homomorphism |1. (Biol.)  Same as Homomorphy. 2. (Bot.)  The possession, in one species of plants, of only one kind of flowers; -- opposed to heteromorphism, dimorphism, and trimorphism. 3. (Zoöl.)  The possession of but one kind of larvæ or young, as in most insects.
homomorphous |Characterized by homomorphism.
homomorphy |Similarity of form; resemblance in external characters, while widely different in fundamental structure; resemblance in geometric ground form. See Homophyly, Promorphology.
homonomous |Of or pertaining to homonomy.
homonomy |The homology of parts arranged on transverse axes. Haeckel.
homonym |A word having the same sound as another, but differing from it in meaning; as the noun bear and the verb bear. [Written also homonyme.]
homonymous |1. Having the same name or designation; standing in the same relation; -- opposed to heteronymous. 2. Having the same name or designation, but different meaning or relation; hence, equivocal; ambiguous.
homonymously |1. In an homonymous manner; so as to have the same name or relation. 2. Equivocally; ambiguously.
homonymy |1. Sameness of name or designation; identity in relations. Holland. Homonymy may be as well in place as in persons. Fuller. 2. Sameness of name or designation of things or persons which are different; ambiguity.
homooergan |Same as Homoplast.
homoorgan |Same as Homoplast.
homoousian |One of those, in the 4th century, who accepted the Nicene creed, and maintained that the Son had the same essence or substance with the Father; -- opposed to homoiousian.\n\nOf or pertaining to the Homoousians, or to the doctrines they held.
homophone |1. A letter or character which expresses a like sound with another. Gliddon. 2. A word having the same sound as another, but differing from it in meaning and usually in spelling; as, all and awl; bare and bear; rite, write, right, and wright.
homophonic |1. (Mus.) (a) Originally, sounding alike; of the same pitch; unisonous; monodic. (b) Now used for plain harmony, note against note, as opposed to polyphonic harmony, in which the several parts move independently, each with its own melody. 2. Expressing the same sound by a different combination of letters; as, bay and bey.
homophonous |1. (Mus.) (a) Originally, sounding alike; of the same pitch; unisonous; monodic. (b) Now used for plain harmony, note against note, as opposed to polyphonic harmony, in which the several parts move independently, each with its own melody. 2. Expressing the same sound by a different combination of letters; as, bay and bey.
homophony |1. Sameness of sound. 2. (Mus.) (a) Sameness of sound; unison. (b) Plain harmony, as opposed to polyphony. See Homophonous.
homophylic |Relating to homophily.
homophyly |That form of homology due to common ancestry (phylogenetic homology), in opposition to homomorphy, to which genealogic basis is wanting. Haeckel.
homoplasmy |Resemblance between different plants or animals, in external shape, in general habit, or in organs, which is not due to descent from a common ancestor, but to similar surrounding circumstances.
homoplast |One of the plastids composing the idorgan of Haeckel; -- also called homoörgan.
homoplastic |Of or pertaining to homoplasty; as, homoplasticorgans; homoplastic forms.
homoplasty |The formation of homologous tissues.
homoplasy |See Homogeny.
homopolic |In promorphology, pertaining to or exhibiting that kind of organic form, in which the stereometric ground form is a pyramid, with similar poles. See Promorphology.
homopter |One of the Homoptera.
homoptera |A suborder of Hemiptera, in which both pairs of wings are similar in texture, and do not overlap when folded, as in the cicada. See Hemiptera.
homopteran |An homopter.
homopterous |Of or pertaining to the Homoptera.
homostyled |Having only one form of pistils; -- said of the flowers of some plants. Darwin.
homosystemic |Developing, in the case of multicellular organisms, from the same embryonic systems into which the secondary unit (gastrula or plant enbryo) differentiates.
homotaxia |Same as Homotaxis.
homotaxial |Relating to homotaxis.
homotaxic |Relating to homotaxis.
homotaxis |Similarly in arrangement of parts; -- the opposite of heterotaxy.
homotaxy |Same as Homotaxis.
homothermic |Warm-blooded; homoiothermal; hæmatothermal.
homothermous |Warm-blooded; homoiothermal; hæmatothermal.
homotonous |Of the same tenor or tone; equable; without variation.
homotropal |1. Turned in the same direction with something else. 2. (Bot.)  Having the radicle of the seed directed towards the hilum.
homotropous |1. Turned in the same direction with something else. 2. (Bot.)  Having the radicle of the seed directed towards the hilum.
homotypal |Of the same type of structure; pertaining to a homotype; as, homotypal parts.
homotype |That which has the same fundamental type of structure with something else; thus, the right arm is the homotype of the right leg; one arm is the homotype of the other, etc. Owen.
homotypic |Same as Homotypal.
homotypical |Same as Homotypal.
homotypy |A term suggested by Haeckel to be instead of serial homology. See Homotype.
homunculus |A little man; a dwarf; a manikin. Sterne.
hond |Hand. [Obs.] Chaucer.
hone |To pine; to lament; to long. Lamb.\n\nA kind of swelling in the cheek.\n\nA stone of a fine grit, or a slab, as of metal, covered with an abrading substance or powder, used for sharpening cutting instruments, and especially for setting razors; an oilstone. Tusser. Hone slateSee Polishing slate. -- Hone stone, one of several kinds of stone used for hones. See Novaculite.\n\nTo sharpen on, or with, a hone; to rub on a hone in order to sharpen; as, to hone a razor.
honest |1. Decent; honorable; suitable; becoming. Chaucer. Belong what honest clothes you send forth to bleaching! Shak. 2. Characterized by integrity or fairness and straightas, an honest judge or merchant; an honest statement; an honest bargain; an honest business; an honest book; an honest confession. An honest man's the noblest work of God. Pope. An honest physician leaves his patient when he can contribute no farther to his health. Sir W. Temple. Look ye out among you seven men of honest report. Acts vi. 3. Provide things honest in the sight of all men. Rom. xii. 17. 3. Open; frank; as, an honest countenance. 4. Chaste; faithfuk; virtuous. Wives may be merry, and yet honest too. Shak. Syn. -- Upright; ingenuous; honorable; trusty; faithful; equitable; fair; just; rightful; sincere; frank; candid; genuine.\n\nTo adorn; to grace; to honor; to make becoming, appropriate, or honorable. [Obs.] Abp. Sandys.
honestation |The act of honesting; grace; adornment. [Obs.] W. Montagu.
honestetee |Honesty; honorableness. [Obs.] Chaucer.
honestly |1. Honorably; becomingly; decently. [Obs.] Chaucer. 2. In an honest manner; as, a contract honestly made; to live honestly; to speak honestly. Shak. To come honestly by. (a) To get honestly. (b) A circumlocution for to inherit; as, to come honestly by a feature, a mental trait, a peculiarity.
honesty |1. Honor; honorableness; dignity; propriety; suitableness; decency. [Obs.] Chaucer. She derives her honesty and achieves her goodness. Shak. 2. The quality or state of being honest; probity; fairness and straightforwardness of conduct, speech, etc.; integrity; sincerity; truthfulness; freedom from fraud or guile. That we may lead a quiet and peaceable life in all godliness and honesty. 1 Tim. ii. 2. 3. Chastity; modesty. Chaucer. To lay . . . siege to the honesty of this Ford's wife. Shak. 4. (Bot.)  Satin flower; the name of two cruciferous herbs having large flat pods, the round shining partitions of which are more beautiful than the blossom; -- called also lunary and moonwort. Lunaria biennis is common honesty; L. rediva is perennial honesty. Syn. -- Integrity; probity; uprightness; trustiness; faithfulness; honor; justice; equity; fairness; candor; plain-dealing; veracity; sincerity.
honewort |An umbelliferous plant of the genus Sison (S.Amomum); -- so called because used to cure a swelling called a hone.
honey |1. A sweet viscid fluid, esp. that collected by bees from flowers of plants, and deposited in the cells of the honeycomb. 2. That which is sweet or pleasant, like honey. The honey of his language. Shak. 3. Sweet one; -- a term of endearment. Chaucer. Honey, you shall be well desired in Cyprus. Shak. Note: Honey is often used adjectively or as the first part of compound; as, honeydew or honey dew; honey guide or honeyguide; honey locust or honey-locust. Honey ant (Zoöl.), a small ant (Myrmecocystus melliger), found in the Southwestern United States, and in Mexico, living in subterranean formicares. There are larger and smaller ordinary workers, and others, which serve as receptacles or cells for the storage of honey, their abdomens becoming distended to the size of a currant. These, in times of scarcity, regurgitate the honey and feed the rest. -- Honey badger (Zoöl.), the ratel. -- Honey bear. (Zoöl.) See Kinkajou. -- Honey buzzard (Zoöl.), a bird related to the kites, of the genus Pernis. The European species is P. apivorus; the Indian or crested honey buzzard is P. ptilorhyncha. They feed upon honey and the larvæ of bees. Called also bee hawk, bee kite. -- Honey creeper (Zoöl.), one of numerous species of small, bright, colored, passerine birds of the family Coerebidæ, abundant in Central and South America. -- Honey easter (Zoöl.), one of numerous species of small passerine birds of the family Meliphagidæ, abundant in Australia and Oceania; - - called also honeysucker. -- Honey flower (Bot.), an evergreen shrub of the genus Melianthus, a native of the Cape of Good Hope. The flowers yield much honey. -- Honey guide (Zoöl.), one of several species of small birds of the family Indicatoridæ, inhabiting Africa and the East Indies. They have the habit of leading persons to the nests to wild bees. Called also honeybird, and indicator. -- Honey harvest, the gathering of honey from hives, or the honey which is gathered. Dryden. -- Honey kite. (Zoöl.) See Honey buzzard (above). -- Honey locust (Bot.), a North American tree (Gleditschia triacanthos), armed with thorns, and having long pods with a sweet pulp between the seeds. -- Honey month. Same as Honeymoon. -- Honey weasel (Zoöl.), the ratel.\n\nTo be gentle, agreeable, or coaxing; to talk fondly; to use endearments; also, to be or become obsequiously courteous or complimentary; to fawn. \"Honeying and making love.\" Shak. Rough to common men, But honey at the whisper of a lord. Tennyson.\n\nTo make agreeable; to cover or sweeten with, or as with, honey. Canst thou not honey me with fluent speech Marston.
honey-bag |The receptacle for honey in a honeybee. Shak. Grew.
honey-mouthed |Soft to sweet in speech; persuasive. Shak.
honey-sweet |Sweet as honey. Chaucer.
honey-tongued |Sweet speaking; persuasive; seductive. Shak.
honeybee |Any bee of the genus Apis, which lives in communities and collects honey, esp. the common domesticated hive bee (Apis mellifica), the Italian bee (A. ligustica), and the Arabiab bee (A. fasciata). The two latter are by many entomologists considered only varieties of the common hive bee. Each swarm of bees consists of a large number of workers (barren females), with, ordinarily, one queen or fertile female, but in the swarming season several young queens, and a number of males or drones, are produced.
honeyberry |(a) An Old World hackberry (Celtis australis). (b) In the West Indies, the genip (Melicocca bijuga).
honeybird |The honey guide.
honeycomb |1. A mass of hexagonal waxen cells, formed by bees, and used by them to hold their honey and their eggs. 2. Any substance, as a easting of iron, a piece of worm-eaten wood, or of triple, etc., perforated with cells like a honeycomb. Honeycomb moth (Zoöl.), the wax moth. -- Honeycomb stomach. (Anat.) See Reticulum.
honeycombed |Formed or perforated like a honeycomb. Each bastion was honeycombed with casements. Motley.
honeydew |1. A sweet, saccharine substance, found on the leaves of trees and other plants in small drops, like dew. Two substances have been called by this name; one exuded from the plants, and the other secreted by certain insects, esp. aphids. 2. A kind of tobacco moistened with molasses.
honeyed |1. Covered with honey. 2. Sweet, as, honeyed words. Milton.
honeyless |Destitute of honey. Shak.
honeymoon |The first month after marriage. Addison.
honeystone |See Mellite.
honeysucker |See Honey eater, under Honey.
honeysuckle |One of several species of flowering plants, much admired for their beauty, and some for their fragrance. Note: The honeysuckles are properly species of the genus Lonicera; as, L. Caprifolium, and L. Japonica, the commonly cultivated fragrant kinds; L. Periclymenum, the fragrant woodbine of England; L. grata, the American woodbine, and L. sempervirens, the red-flowered trumpet honeysuckle. The European fly honeysuckle is L. Xylosteum; the American, L. ciliata. The American Pinxter flower (Azalea nudiflora) is often called honeysuckle, or false honeysuckle. The name Australian honeysuckle is applied to one or more trees of the genus Banksia. See French honeysuckle, under French.
honeysuckled |Covered with honeysuckles.
honeyware |See Badderlocks.
honeywort |A European plant of the genus Cerinthe, whose flowers are very attractive to bees. Loudon.
hong |A mercantile establishment or factory for foreign trade in China, as formerly at Canton; a succession of offices connected by a common passage and used for business or storage. Hong merchant, one of the few Chinese merchants who, previous to the treaty of 1842, formed a guild which had the exclusive privilege of trading with foreigners.\n\nTo hang. [Obs.] Chaucer.
honied |See Honeyed.
honiton lace |. A kind of pillow lace, remarkable for the beauty of its figures; -- so called because chiefly made in Honiton, England.
honk |The cry of a wild goose. -- Honk\"ing, n.
honor |1. Esteem due or paid to worth; high estimation; respect; consideration; reverence; veneration; manifestation of respect or reverence. A prophet is not without honor, save in his own country. Matt. xiii. 57. 2. That which rightfully attracts esteem, respect, or consideration; self-respect; dignity; courage; fidelity; especially, excellence of character; high moral worth; virtue; nobleness; specif., in men, integrity; uprightness; trustworthness; in women, purity; chastity. If she have forgot Honor and virtue. Shak. Godlike erect, with native honor clad. Milton. 3. A nice sense of what is right, just, and true, with course of life correspondent thereto; strict conformity to the duty imposed by conscience, position, or privilege. Say, what is honor 'T is the finest sense Of justice which the human mind can frame, Intent each lurking frailty to disclaim, And guard the way of life from all offense Suffered or done. Wordsworth. I could not love thee, dear, so much, Loved I not honor more. Lovelace. 4. That to which esteem or consideration is paid; distinguished position; high rank. \"Restored me to my honors.\" Shak. I have given thee . . . both riches, and honor. 1 Kings iii. 13. Thou art clothed with honor and majesty. Ps. civ. 1. 5. Fame; reputation; credit. Some in theiractions do woo, and affect honor and reputation. Bacon. If my honor is meant anything distinct from conscience, 't is no more than a regard to the censure and esteem of the world. Rogers. 6. A token of esteem paid to worth; a mark of respect; a ceremonial sign of consideration; as, he wore an honor on his breast; military honors; civil honors. \"Their funeral honors.\" Dryden. 7. A cause of respect and fame; a glory; an excellency; an ornament; as, he is an honor to his nation. 8. A title applied to the holders of certain honorable civil offices, or to persons of rank; as, His Honor the Mayor. See Note under Honorable. 9. (Feud. Law)  A seigniory or lordship held of the king, on which other lordships and manors depended. Cowell. 10. pl.  Academic or university prizes or distinctions; as, honors in classics. 11. pl. (Whist)  The ace, king, queen, and jack of trumps. The ten and nine are sometimes called Dutch honors. R. A. Proctor. Affair of honor, a dispute to be decided by a duel, or the duel itself. -- Court of honor, a court or tribunal to investigate and decide questions relating to points of honor; as a court of chivalry, or a military court to investigate acts or omissions which are unofficerlike or ungentlemanly in their nature. -- Debt of honor, a debt contracted by a verbal promise, or by betting or gambling, considered more binding than if recoverable by law. -- Honor bright! An assurance of truth or fidelity. [Colloq.] -- Honor court (Feudal Law), one held in an honor or seignory. -- Honor point. (Her.) See Escutcheon. -- Honors of war (Mil.), distinctions granted to a vanquished enemy, as of marching out from a camp or town armed, and with colors flying. -- Law, or Code, of honor, certain rules by which social intercourse is regulated among persons of fashion, and which are founded on a regard to reputation. Paley. -- Maid of honor, a lady of rank, whose duty it is to attend the queen when she appears in public. -- On one's honor, on the pledge of one's honor; as, the members of the House of Lords in Great Britain, are not under oath, but give their statements or verdicts on their honor. -- Point of honor, a scruple or nice distinction in matters affecting one's honor; as, he raised a point of honor. -- To do the honors, to bestow honor, as on a guest; to act as host or hostess at an entertainment. \"To do the honors and to give the word.\" Pope. -- To do one honor, to confer distinction upon one. -- To have the honor, to have the privilege or distinction. -- Word of honor, an engagement confirmed by a pledge of honor.\n\n1. To regard or treat with honor, esteem, or respect; to revere; to treat with deference and submission; when used of the Supreme Being, to reverence; to adore; to worship. Honor thy father and thy mother. Ex. xx. 12. That all men should honor the Son, even as they honor the Father. John v. 23. It is a custom More honor'd in the breach than the observance. Shak. 2. To dignify; to raise to distinction or notice; to bestow honor upon; to elevate in rank or station; to ennoble; to exalt; to glorify; hence, to do something to honor; to treat in a complimentary manner or with civility. Thus shall it be done to the man whom the king delighten to honor. Esther vi. 9. The name of Cassius honors this corruption. Shak. 3. (Com.)  To accept and pay when due; as, to honora bill of exchange.
honorable |1. Worthy of honor; fit to be esteemed or regarded; estimable; illustrious. Thy name and honorable family. Shak. 2. High-minded; actuated by principles of honor, or a scrupulous regard to probity, rectitude, or reputation. 3. Proceeding from an upright and laudable cause, or directed to a just and proper end; not base; irreproachable; fair; as, an honorable motive. Is this proceeding just and honorable Shak. 4. Conferring honor, or produced by noble deeds. Honorable wounds from battle brought. Dryden. 5. Worthy of respect; regarded with esteem; to be commended; consistent with honor or rectitude. Marriage is honorable in all. Heb. xiii. 4. 6. Performed or accompanied with marks of honor, or with testimonies of esteem; an honorable burial. 7. Of reputable association or use; respectable. Let her descend: my chambers are honorable. Shak. 8. An epithet of respect or distinction; as, the honorable Senate; the honorable gentleman. Note: Honorable is a title of quality, conferred by English usage upon the younger children of earls and all the children of viscounts and barons. The maids of honor, lords of session, and the supreme judges of England and Ireland are entitled to the prefix. In American usage, it is a title of courtesy merely, bestowed upon those who hold, or have held, any of the higher public offices, esp. governors, judges, members of Congress or of the Senate, mayors. Right honorable. See under Right.
honorableness |1. The state of being honorable; eminence; distinction. 2. Conformity to the principles of honor, probity, or moral rectitude; fairness; uprightness; reputableness.
honorably |1. In an honorable manner; in a manner showing, or consistent with, honor. The reverend abbot . . . honorably received him. Shak. Why did I not more honorably starve Dryden. 2. Decently; becomingly. [Obs.] \"Do this message honorably.\" Shak. Syn. -- Magnanimously; generously; nobly; worthily; justly; equitably; fairly; reputably.
honorarium |1. A fee offered to professional men for their services; as, an honorarium of one thousand dollars. S. Longfellow. 2. (Law)  An honorary payment, usually in recognition of services for which it is not usual or not lawful to assign a fixed business price. Heumann.
honorary |1. A fee offered to professional men for their services; as, an honorarium of one thousand dollars. S. Longfellow. 2. (Law)  An honorary payment, usually in recognition of services for which it is not usual or not lawful to assign a fixed business price. Heumann.\n\n1. Done as a sign or evidence of honor; as, honorary services. Macaulay. 2. Conferring honor, or intended merely to confer honor without emolument; as, an honorary degree. \"Honorary arches.\" Addison. 3. Holding a title or place without rendering service or receiving reward; as, an honorary member of a society.
honorer |One who honors.
honorific |Conferring honor; tending to honor. London. Spectator.
honorless |Destitute of honor; not honored. Bp. Warburton.
hont |See under Hunt. [Obs.] Chaucer.
honved |1. The Hungarian army in the revolutionary war of 1848-49. 2.  = Honvédség.
honvedseg |See Army organization, above.
hoo |1. See Ho. [Obs.] Chaucer. 2. Hurrah! -- an exclamation of triumphant joy. Shak.
hood |1. State; condition. [Obs.] How could thou ween, through that disguised hood To hide thy state from being understood Spenser. 2. A covering or garment for the head or the head and shoulders, often attached to the body garment; especially: (a) A soft covering for the head, worn by women, which leaves only the face exposed. (b) A part of a monk's outer garment, with which he covers his head; a cowl. \"All hoods make not monks.\" Shak. (c) A like appendage to a cloak or loose overcoat, that may be drawn up over the head at pleasure. (d) An ornamental fold at the back of an academic gown or ecclesiastical vestment; as, a master's hood. (e) A covering for a horse's head. (f) (Falconry) A covering for a hawk's head and eyes. See Illust. of Falcon. 3. Anything resembling a hood in form or use; as: (a) The top or head of a carriage. (b) A chimney top, often contrived to secure a constant draught by turning with the wind. (c) A projecting cover above a hearth, forming the upper part of the fireplace, and confining the smoke to the flue. (d) The top of a pump. (e) (Ord.) A covering for a mortar. (f) (Bot.) The hood-shaped upper petal of some flowers, as of monkshood; -- called also helmet. Gray. (g) (Naut.) A covering or porch for a companion hatch. 4. (Shipbuilding)  The endmost plank of a strake which reaches the stem or stern.\n\n1. To cover with a hood; to furnish with a hood or hood-shaped appendage. The friar hooded, and the monarch crowned. Pope. 2. To cover; to hide; to blind. While grace is saying, I'll hood mine eyes Thus with my hat, and sigh and say, \"Amen.\" Shak. Hooding end (Shipbuilding), the end of a hood where it enters the rabbet in the stem post or stern post.
hood molding |A projecting molding over the head of an arch, forming the outermost member of the archivolt; -- called also hood mold.
hood moulding |A projecting molding over the head of an arch, forming the outermost member of the archivolt; -- called also hood mold.
hoodcap |See Hooded seal, under Hooded.
hooded |1. Covered with a hood. 2. Furnished with a hood or something like a hood. 3. Hood-shaped; esp. (Bot.), rolled up like a cornet of paper; cuculate, as the spethe of the Indian turnip. 4. (Zoöl.) (a) Having the head conspicuously different in color from the rest of the plumage; -- said of birds. (b) Having a hoodlike crest or prominence on the head or neck; as, the hooded seal; a hooded snake. Hooded crow, a European crow (Corvus cornix); -- called also hoody, dun crow, and royston crow. -- Hooded gull, the European black-headed pewit or gull. -- Hooded merganser. See Merganser. -- Hooded seal, a large North Atlantic seal (Cystophora cristata). The male has a large, inflatible, hoodlike sac upon the head. Called also hoodcap. -- Hooded sheldrake, the hooded merganser. See Merganser. -- Hooded snake. See Cobra de capello, Asp, Haje, etc. -- Hooded warbler, a small American warbler (Sylvania mitrata).
hoodless |Having no hood.
hoodlum |A young rowdy; a rough, lawless fellow. [Colloq. U.S.]
hoodman |The person blindfolded in the game called hoodman-blind. [Obs.] Shak.
hoodman-blind |An old term for blindman's buff. Shak.
hoodoo |One who causes bad luck. [Colloq.]
hoodwink |1. To blind by covering the eyes. We will blind and hoodwink him. Shak. 2. To cover; to hide. [Obs.] Shak. 3. To deceive by false appearance; to impose upon. \"Hoodwinked with kindness.\" Sir P. Sidney.
hoody |The hooded crow; also, in Scotland, the hooded gull.
hoof |1. The horny substance or case that covers or terminates the feet of certain animals, as horses, oxen, etc. On burnished hooves his war horse trode. Tennyson. 2. A hoofed animal; a beast. Our cattle also shall go with us; there shall not a hoof be left behind. Ex. x. 26. 3. (Geom.)  See Ungula.\n\n1. To walk as cattle. [R.] William Scott. 2. To be on a tramp; to foot. [Slang, U.S.] To hoof it, to foot it.
hoofbound |Having a dry and contracted hoof, which occasions pain and lameness.
hoofed |Furnished with hoofs. Grew.
hoofless |Destitute of hoofs.
hook |1. A piece of metal, or other hard material, formed or bent into a curve or at an angle, for catching, holding, or sustaining anything; as, a hook for catching fish; a hook for fastening a gate; a boat hook, etc. 2. That part of a hinge which is fixed to a post, and on which a door or gate hangs and turns. 3. An implement for cutting grass or grain; a sickle; an instrument for cutting or lopping; a billhook. Like slashing Bentley with his desperate hook. Pope. 4. (Steam Engin.)  See Eccentric, and V-hook. 5. A snare; a trap. [R.] Shak. 6. A field sown two years in succession. [Prov. Eng.] 7. pl.  The projecting points of the thigh bones of cattle; -- called also hook bones. By hook or by crook, one way or other; by any means, direct or indirect. Milton. \"In hope her to attain by hook or crook.\" Spenser. -- Off the hooks, unhinged; disturbed; disordered. [Colloq.] \"In the evening, by water, to the Duke of Albemarle, whom I found mightly off the hooks that the ships are not gone out of the river.\" Pepys. -- On one's own hook, on one's own account or responsibility; by one's self. [Colloq. U.S.] Bartlett. -- To go off the hooks, to die. [Colloq.] Thackeray. -- Bid hook, a small boat hook. -- Chain hook. See under Chain. -- Deck hook, a horizontal knee or frame, in the bow of a ship, on which the forward part of the deck rests. -- Hook and eye, one of the small wire hooks and loops for fastening together the opposite edges of a garment, etc. -- Hook bill (Zoöl.), the strongly curved beak of a bird. -- Hook ladder, a ladder with hooks at the end by which it can be suspended, as from the top of a wall. -- Hook motion (Steam Engin.), a valve gear which is reversed by V hooks. -- Hook squid, any squid which has the arms furnished with hooks, instead of suckers, as in the genera Enoploteuthis and Onychteuthis. -- Hook wrench, a wrench or spanner, having a hook at the end, instead of a jaw, for turning a bolthead, nut, or coupling.\n\n1. To catch or fasten with a hook or hooks; to seize, capture, or hold, as with a hook, esp. with a disguised or baited hook; hence, to secure by allurement or artifice; to entrap; to catch; as, to hook a dress; to hook a trout. Hook him, my poor dear, . . . at any sacrifice. W. Collins. 2. To seize or pierce with the points of the horns, as cattle in attacking enemies; to gore. 3. To steal. [Colloq. Eng. & U.S.] To hook on, to fasten or attach by, or as by, hook.\n\nTo bend; to curve as a hook.
hook-billed |Having a strongly curved bill.
hook-nosed |Having a hooked or aquiline nose. Shak.
hookah |A pipe with a long, flexible stem, so arranged that the smoke is cooled by being made to pass through water.
hooked |1. Having the form of a hookl curvated; as, the hooked bill of a bird. 2. Provided with a hook or hooks. \"The hooked chariot.\" Milton.
hookedness |The state of being bent like a hook; incurvation.
hooker |1. One who, or that which, hooks. 2. (Naut.) (a) A Dutch vessel with two masts. (b) A fishing boat with one mast, used on the coast of Ireland. (c) A sailor's contemptuous term for any antiquated craft. HOOKE'S GEARING Hooke's\" gear\"ing. Etym: [So called from the inventor.] (Mach.)  Spur gearing having teeth slanting across the face of the wheel, sometimes slanting in opposite directions from the middle. HOOKE'S JOINT Hooke's joint. Etym: [So called from the inventor.] (Mach.)  A universal joint. See under Universal.
hookey |See Hockey.
hooklet |A little hook.
hooky |Full of hooks; pertaining to hooks.
hool |Whole. [Obs.] Chaucer.
hoolock |A small black gibbon (Hylobates hoolock), found in the mountains of Assam.
hoom |Home. Chaucer.
hoonoomaun |An Indian monkey. See Entellus. [Written also hoonuman.]
hoop |1. A pliant strip of wood or metal bent in a circular form, and united at the ends, for holding together the staves of casks, tubs, etc. 2. A ring; a circular band; anything resembling a hoop, as the cylinder (cheese hoop) in which the curd is pressed in making cheese. 3. A circle, or combination of circles, of thin whalebone, metal, or other elastic material, used for expanding the skirts of ladies' dresses; crinoline; -- used chiefly in the plural. Though stiff with hoops, and armed with ribs of whale. Pope. 4. A quart pot; -- so called because originally bound with hoops, like a barrel. Also, a portion of the contents measured by the distance between the hoops. [Obs.] 5. An old measure of capacity, variously estimated at from one to four pecks. [Eng.] Halliwell. Bulge hoop, Chine hoop, Quarter hoop, the hoop nearest the middle of a cask, that nearest the end, and the intermediate hoop between these two, respectively. -- Flat hoop, a wooden hoop dressed flat on both sides. -- Half-round hoop, a wooden hoop left rounding and undressed on the outside. -- Hoop iron, iron in thin narrow strips, used for making hoops. -- Hoop lock, the fastening for uniting the ends of wooden hoops by notching and interlocking them. -- Hoop skirt, a framework of hoops for expanding the skirts of a woman's dress; -- called also hoop petticoat. -- Hoop snake (Zoöl.), a harmless snake of the Southern United States (Abaster erythrogrammus); -- so called from the mistaken notion that it curves itself into a hoop, taking its tail into its mouth, and rolls along with great velocity. -- Hoop tree (Bot.), a small West Indian tree (Melia sempervirens), of the Mahogany family.\n\n1. To bind or fasten with hoops; as, to hoop a barrel or puncheon. 2. To clasp; to encircle; to surround. Shak.\n\n1. To utter a loud cry, or a sound imitative of the word, by way of call or pursuit; to shout. [Usually written whoop.] 2. To whoop, as in whooping cough. See Whoop. Hooping cough. (Med.) See Whooping cough.\n\n1. To drive or follow with a shout. \"To be hooped out of Rome.\" Shak. 2. To call by a shout or peculiar cry.\n\n1. A shout; a whoop, as in whooping cough. 2. (Zoöl.)  The hoopoe. See Hoopoe.
hooper |One who hoops casks or tubs; a cooper.\n\nThe European whistling, or wild, swan (Olor cygnus); -- called also hooper swan, whooping swan, and elk.
hoopoe |A European bird of the genus Upupa (U. epops), having a beautiful crest, which it can erect or depress at pleasure. Called also hoop, whoop. The name is also applied to several other species of the same genus and allied genera.
hoopoo |A European bird of the genus Upupa (U. epops), having a beautiful crest, which it can erect or depress at pleasure. Called also hoop, whoop. The name is also applied to several other species of the same genus and allied genera.
hoosier |A nickname given to an inhabitant of the State of Indiana. [U.S.]
hoosier state |Indiana; -- a nickname of obscure origin.
hoot |1. To cry out or shout in contempt. Matrons and girls shall hoot at thee no more. Dryden. 2. To make the peculiar cry of an owl. The clamorous owl that nightly hoots. Shak.\n\nTo assail with contemptuous cries or shouts; to follow with derisive shouts. Partridge and his clan may hoot me for a cheat. Swift.\n\n1. A derisive cry or shout. Glanvill. 2. The cry of an owl. Hoot owl (Zoöl.), the barred owl (Syrnium nebulosum). See Barred owl.
hoove |A disease in cattle consisting in inflammation of the stomach by gas, ordinarily caused by eating too much green food; tympany; bloating.
hooven |Affected with hoove; as, hooven, or hoven, cattle.
hop |1. To move by successive leaps, as toads do; to spring or jump on one foot; to skip, as birds do. [Birds] hopping from spray to spray. Dryden. 2. To walk lame; to limp; to halt. Dryden. 3. To dance. Smollett.\n\n1. A leap on one leg, as of a boy; a leap, as of a toad; a jump; a spring. 2. A dance; esp., an informal dance of ball. [Colloq.] Hop, skip (or step), and jump, a game or athletic sport in which the participants cover as much ground as possible by a hop, stride, and jump in succession. Addison.\n\n1. (Bot.)  A climbing plant (Humulus Lupulus), having a long, twining, annual stalk. It is cultivated for its fruit (hops). 2. The catkin or strobilaceous fruit of the hop, much used in brewing to give a bitter taste. 3. The fruit of the dog-rose. See Hip. Hop back. (Brewing) See under 1st Back. -- Hop clover (Bot.), a species of yellow clover having heads like hops in miniature (Trifolium agrarium, and T. procumbens). -- Hop flea (Zoöl.), a small flea beetle (Haltica concinna), very injurious to hops. -- Hop fly (Zoöl.), an aphid (Phorodon humuli), very injurious to hop vines. -- Hop froth fly (Zoöl.), an hemipterous insect (Aphrophora interrupta), allied to the cockoo spits. It often does great damage to hop vines. -- Hop hornbeam (Bot.), an American tree of the genus Ostrya (O.Virginica) the American ironwood; also, a European species (O. vulgaris). -- Hop moth (Zoöl.), a moth (Hypena humuli), which in the larval state is very injurious to hop vines. -- Hop picker, one who picks hops. -- Hop pole, a pole used to support hop vines. -- Hop tree (Bot.), a small American tree (Ptelia trifoliata), having broad, flattened fruit in large clusters, sometimes used as a substitute for hops. -- Hop vine (Bot.), the climbing vine or stalk of the hop.\n\nTo impregnate with hops. Mortimer.\n\nTo gather hops. [Perhaps only in the form Hopping, vb. n.]
hop-thumb |See Hop-o'-my-thumb.
hopbind |The climbing stem of the hop. Blackstone.
hopbine |The climbing stem of the hop. Blackstone.
hope |1. A sloping plain between mountain ridges. [Obs.] 2. A small bay; an inlet; a haven. [Scot.] Jamieson.\n\n1. A desire of some good, accompanied with an expectation of obtaining it, or a belief that it is obtainable; an expectation of something which is thought to be desirable; confidence; pleasing expectancy. The hypocrite's hope shall perish. Job vii. 13. He wished, but not with hope. Milton. New thoughts of God, new hopes of Heaven. Keble. 2. One who, or that which, gives hope, furnishes ground of expectation, or promises desired good. The Lord will be the hope of his people. Joel iii. 16. A young gentleman of great hopes, whose love of learning was highly commendable. Macaulay. 3. That which is hoped for; an object of hope. Lavina is thine elder brother's hope. Shak.\n\n1. To entertain or indulge hope; to cherish a desire of good, or of something welcome, with expectation of obtaining it or belief that it is obtainable; to expect; -- usually followed by for. \"Hope for good success.\" Jer. Taylor. But I will hope continually. Ps. lxxi. 14. 2. To place confidence; to trust with confident expectation of good; -- usually followed by in. \"I hope in thy word.\" Ps. cxix. 81. Why art thou cast down, O my soul and why art thou disquieted within me Hope thou in God. Ps. xlii. 11.\n\n1. To desire with expectation or with belief in the possibility or prospect of obtaining; to look forward to as a thing desirable, with the expectation of obtaining it; to cherish hopes of. We hope no other from your majesty. Shak. [Charity] hopeth all things. 1 Cor. xiii. 7. 2. To expect; to fear. [Obs.] \"I hope he will be dead.\" Chaucer. Note: Hope is often used colloquially regarding uncertainties, with no reference to the future. \"I hope she takes me to be flesh and blood.\" Mrs. Centlivre.
hopeful |1. Full of hope, or agreeable expectation; inclined to hope; expectant. Men of their own natural inclination hopeful and strongly conceited. Hooker. 2. Having qualities which excite hope; affording promise of good or of success; as, a hopeful youth; a hopeful prospect. \"Hopeful scholars.\" Addison. -- Hope\"ful*ly, adv. -- Hope\"ful*ness, n.
hopeite |A hydrous phosphate of zinc in transparent prismatic crystals.
hopeless |1. Destitute of hope; having no expectation of good; despairing. I am a woman, friendless, hopeless. Shak. 2. Giving no ground of hope; promising nothing desirable; desperate; as, a hopeless cause. The hopelessword of \"never to return\" Breathe I against thee, upon pain of life. Shak. 3. Unhoped for; despaired of. [Obs.] Marston. -- Hope\"less*ly, adv. -- Hope\"less*ness, n.
hoper |One who hopes. Swift.
hopingly |In a hopeful manner. Hammond.
hoplite |A heavy-armed infantry soldier. Milford. HOP-O'-MY-THUMB; HOP-THUMB Hop\"-o'-my-thumb\| Hop\"-thumb\"| n.  A very diminutive person. [Colloq.] liwell."
hopped |Impregnated with hops.
hopper |1. One who, or that which, hops. 2. A chute, box, or receptacle, usually funnel-shaped with an opening at the lower part, for delivering or feeding any material, as to a machine; as, the wooden box with its trough through which grain passes into a mill by joining or shaking, or a funnel through which fuel passes into a furnace, or coal, etc., into a car. 3. (Mus.)  See Grasshopper, 2. 4. pl.  A game. See Hopscotch. Johnson. 5. (Zoöl.) (a) See Grasshopper, and Frog hopper, Grape hopper, Leaf hopper, Tree hopper, under Frog, Grape, Leaf, and Tree. (b) The larva of a cheese fly. 6. (Naut.)  A vessel for carrying waste, garbage, etc., out to sea, so constructed as to discharge its load by a mechanical contrivance; -- called also dumping scow. Bell and hopper (Metal.), the apparatus at the top of a blast furnace, through which the charge is introduced, while the gases are retained. -- Hopper boy, a rake in a mill, moving in a circle to spread meal for drying, and to draw it over an opening in the floor, through which it falls. -- Hopper closet, a water-closet, without a movable pan, in which the receptacle is a funnel standing on a draintrap. -- Hopper cock, a faucet or valve for flushing the hopper of a water-closet.
hopperdozer |An appliance for the destruction of insects, consisting of a shallow iron box, containing kerosene or coated with tar or other sticky substance, which may be mounted on wheels.
hopperings |Gravel retaining in the hopper of a cradle.
hoppestere |An unexplained epithet used by Chaucer in reference to ships. By some it is defined as \"dancing (on the wave)\"; by others as \"opposing,\" \"warlike.\" T. R. Lounsbury.
hoppet |1. A hand basket; also, a dish used by miners for measuring ore. [Prov. Eng.] 2. An infant in arms. [Prov. Eng.] Halliwell.
hopping |The act of one who, or that which, hops; a jumping, frisking, or dancing. Hopping Dick (Zoöl.), a thrush of Jamaica (Merula leucogenys), resembling the English blackbird in its familiar manners, agreeable song, and dark plumage.\n\nA gathering of hops.
hopple |1. To impede by a hopple; to tie the feet of (a horse or a cow) loosely together; to hamper; to hobble; as, to hopple an unruly or straying horse. 2. Fig.: To entangle; to hamper. Dr. H. More.\n\nA fetter for horses, or cattle, when turned out to graze; -- chiefly used in the plural.
hopplebush |Same as Hobblebush.
hoppo |(a) A collector of customs, as at Canton; an overseer of commerce. (b) A tribunal or commission having charge of the revenue derived from trade and navigation. [China] Hoppo men, Chinese customhouse officers.
hopscotch |A child's game, in which a player, hopping on one foot, drives a stone from one compartment to another of a figure traced or scotched on the ground; -- called also hoppers.
hopyard |A field where hops are raised.
horal |Of or pertaining to an hour, or to hours. Prior.
horaly |Hourly. [Obs.]
horary |1. Of or pertaining to an hour; noting the hours. Spectator. 2. Occurring once an hour; continuing an hour; hourly; ephemeral. Horary, or soon decaying, fruits of summer. Sir T. Browne. Horary circles. See Circles.
horatian |Of or pertaining to Horace, the Latin poet, or resembling his style.
horde |A wandering troop or gang; especially, a clan or tribe of a nomadic people migrating from place to place for the sake of pasturage, plunder, etc.; a predatory multitude. Thomson.
hordeic |Pertaining to, or derived from, barley; as, hordeic acid, an acid identical or isomeric with lauric acid.
hordein |A peculiar starchy matter contained in barley. It is complex mixture. [R.]
hordeolum |A small tumor upon the eyelid, resembling a grain of barley; a sty.
hordock |An unidentified plant mentioned by Shakespeare, perhaps equivalent to burdock.
hore |Hoar. [Obs.] Chaucer.
horehound |A plant of the genus Marrubium (M. vulgare), which has a bitter taste, and is a weak tonic, used as a household remedy for colds, coughing, etc. [Written also hoarhound.] Fetid horehound, or Black horehound, a disagreeable plant resembling horehound (Ballota nigra). -- Water horehound, a species of the genus Lycopus, resembling mint, but not aromatic.
horizon |1. The circle which bounds that part of the earth's surface visible to a spectator from a given point; the apparent junction of the earth and sky. And when the morning sun shall raise his car Above the border of this horizon. Shak. All the horizon round Invested with bright rays. Milton. 2. (Astron.) (a) A plane passing through the eye of the spectator and at right angles to the vertical at a given place; a plane tangent to the earth's surface at that place; called distinctively the sensible horizon. (b) A plane parallel to the sensible horizon of a place, and passing through the earth's center; -- called also rational or celestial horizon. (c) (Naut.) The unbroken line separating sky and water, as seen by an eye at a given elevation, no land being visible. 3. (Geol.)  The epoch or time during which a deposit was made. The strata all over the earth, which were formed at the same time, are said to belong to the same geological horizon. Le Conte. 4. (Painting)  The chief horizontal line in a picture of any sort, which determines in the picture the height of the eye of the spectator; in an extended landscape, the representation of the natural horizon corresponds with this line. Apparent horizon. See under Apparent. -- Artificial horizon, a level mirror, as the surface of mercury in a shallow vessel, or a plane reflector adjusted to the true level artificially; -- used chiefly with the sextant for observing the double altitude of a celestial body. -- Celestial horizon. (Astron.) See def. 2, above. -- Dip of the horizon (Astron.), the vertical angle between the sensible horizon and a line to the visible horizon, the latter always being below the former. -- Rational horizon, and Sensible horizon. (Astron.) See def. 2, above. -- Visible horizon. See definitions 1 and 2, above.
horizontal |1. Pertaining to, or near, the horizon. \"Horizontal misty air.\" Milton. 2. Parallel to the horizon; on a level; as, a horizontalline or surface. 3. Measured or contained in a plane of the horizon; as, horizontal distance. Horizontal drill, a drilling machine having a horizontal drill spindle. -- Horizontal engine, one the piston of which works horizontally. -- Horizontal fire (Mil.), the fire of ordnance and small arms at point-blank range or at low angles of elevation. -- Horizontal force (Physics), the horizontal component of the earth's magnetic force. -- Horizontal line (Descriptive Geometry & Drawing), a constructive line, either drawn or imagined, which passes through the point of sight, and is the chief line in the projection upon which all verticals are fixed, and upon which all vanishing points are found. -- Horizontal parallax. See under Parallax. -- Horizontal plane (Descriptive Geometry), a plane parallel to the horizon, upon which it is assumed that objects are projected. See Projection. It is upon the horizontal plane that the ground plan of the buildings is supposed to be drawn. -- Horizontal projection, a projection made on a plane parallel to the horizon. -- Horizontal range (Gunnery), the distance in a horizontal plane to which a gun will throw a projectile. -- Horizontal water wheel, a water wheel in which the axis is vertical, the buckets or floats revolving in a horizontal plane, as in most turbines.
horizontality |The state or quality of being horizontal. Kirwan.
horizontally |In a horizontal direction or position; on a level; as, moving horizontally.
hormogonium |A chain of small cells in certain algæ, by which the plant is propogated.
hormone |A chemical substance formed in one organ and carried in the circulation to another organ on which it exerts a stimulating effect; thus, according to Starling, the gastric glands are stimulated by a hormone from the pyloric mucous membrane.
horn |1. A hard, projecting, and usually pointed organ, growing upon the heads of certain animals, esp. of the ruminants, as cattle, goats, and the like. The hollow horns of the Ox family consist externally of true horn, and are never shed. 2. The antler of a deer, which is of bone throughout, and annually shed and renewed. 3. (Zoöl.)  Any natural projection or excrescence from an animal, resembling or thought to resemble a horn in substance or form; esp.: (a) A projection from the beak of a bird, as in the hornbill. (b) A tuft of feathers on the head of a bird, as in the horned owl. (c) A hornlike projection from the head or thorax of an insect, or the head of a reptile, or fish. (d) A sharp spine in front of the fins of a fish, as in the horned pout. 4. (Bot.)  An incurved, tapering and pointed appendage found in the flowers of the milkweed (Asclepias). 5. Something made of a horn, or in resemblance of a horn; as: (a) A wind instrument of music; originally, one made of a horn (of an ox or a ram); now applied to various elaborately wrought instruments of brass or other metal, resembling a horn in shape. \"Wind his horn under the castle wall.\" Spenser. See French horn, under French. (b) A drinking cup, or beaker, as having been originally made of the horns of cattle. \"Horns of mead and ale.\" Mason. (c) The cornucopia, or horn of plenty. See Cornucopia. \"Fruits and flowers from Amalthæa's horn.\" Milton. (d) A vessel made of a horn; esp., one designed for containing powder; anciently, a small vessel for carrying liquids. \"Samuel took the hornof oil and anointed him [David].\" 1 Sam. xvi. 13. (e) The pointed beak of an anvil. (f) The high pommel of a saddle; also, either of the projections on a lady's saddle for supporting the leg. (g) (Arch.) The Ionic volute. (h) (Naut.) The outer end of a crosstree; also, one of the projections forming the jaws of a gaff, boom, etc. (i) (Carp.) A curved projection on the fore part of a plane. (j) One of the projections at the four corners of the Jewish altar of burnt offering. \"Joab . . . caught hold on the horns of the altar.\" 1 Kings ii. 28. 6. One of the curved ends of a crescent; esp., an extremity or cusp of the moon when crescent-shaped. The moon Wears a wan circle round her blunted horns. Thomson. 7. (Mil.)  The curving extremity of the wing of an army or of a squadron drawn up in a crescentlike form. Sharpening in mooned horns Their phalanx. Milton. 8. The tough, fibrous material of which true horns are composed, being, in the Ox family, chiefly albuminous, with some phosphate of lime; also, any similar substance, as that which forms the hoof crust of horses, sheep, and cattle; as, a spoon of horn. 9. (Script.)  A symbol of strength, power, glory, exaltation, or pride. The Lord is . . . the horn of my salvation. Ps. xviii. 2. 10. An emblem of a cuckold; -- used chiefly in the plural. \"Thicker than a cuckold's horn.\" Shak. Horn block, the frame or pedestal in which a railway car axle box slides up and down; -- also called horn plate. -- Horn of a dilemma. See under Dilemma. -- Horn distemper, a disease of cattle, affecting the internal substance of the horn. -- Horn drum, a wheel with long curved scoops, for raising water. -- Horn lead (Chem.), chloride of lead. -- Horn maker, a maker of cuckolds. [Obs.] Shak. -- Horn mercury. (Min.) Same as Horn quicksilver (below). -- Horn poppy (Bot.), a plant allied to the poppy (Glaucium luteum), found on the sandy shores of Great Britain and Virginia; -- called also horned poppy. Gray. -- Horn pox (Med.), abortive smallpox with an eruption like that of chicken pox. -- Horn quicksilver (Min.), native calomel, or bichloride of mercury. -- Horn shell (Zoöl.), any long, sharp, spiral, gastropod shell, of the genus Cerithium, and allied genera. -- Horn silver (Min.), cerargyrite. -- Horn slate, a gray, siliceous stone. -- To haul in one's horns, to withdraw some arrogant pretension. [Colloq.] -- To raise, or lift, the horn (Script.), to exalt one's self; to act arrogantly. \"'Gainst them that raised thee dost thou lift thy horn\" Milton. -- To take a horn, to take a drink of intoxicating liquor. [Low]\n\n1. To furnish with horns; to give the shape of a horn to. 2. To cause to wear horns; to cuckold. [Obs.] Shak.
horn-mad |Quite mad; -- raving crazy. Did I tell you about Mr. Garrick, that the town are horn-mad after Gray.
hornbeak |A fish. See Hornfish.
hornbeam |A tree of the genus Carpinus (C. Americana), having a smooth gray bark and a ridged trunk, the wood being white and very hard. It is common along the banks of streams in the United States, and is also called ironwood. The English hornbeam is C. Betulus. The American is called also blue beech and water beech. Hop hornbeam. (Bot.) See under Hop.
hornbill |Any bird of the family Bucerotidæ, of which about sixty species are known, belonging to numerous genera. They inhabit the tropical parts of Asia, Africa, and the East Indies, and are remarkable for having a more or less horn-like protuberance, which is usually large and hollow and is situated on the upper side of the beak. The size of the hornbill varies from that of a pigeon to that of a raven, or even larger. They feed chiefly upon fruit, but some species eat dead animals.
hornblende |The common black, or dark green or brown, variety of amphibole. (See Amphibole.) It belongs to the aluminous division of the species, and is also characterized by its containing considerable iron. Also used as a general term to include the whole species. Hornblende schist (Geol.), a hornblende rock of schistose structure.
hornblendic |Composed largely of hornblende; resembling or relating to hornblende.
hornblower |One who, or that which, blows a horn.
hornbook |1. The first book for children, or that from which in former times they learned their letters and rudiments; -- so called because a sheet of horn covered the small, thin board of oak, or the slip of paper, on which the alphabet, digits, and often the Lord's Prayer, were written or printed; a primer. \"He teaches boys the hornbook.\" Shak. 2. A book containing the rudiments of any science or branch of knowledge; a manual; a handbook.
hornbug |A large nocturnal beetle of the genus Lucanus (as L. capreolus, and L. dama), having long, curved upper jaws, resembling a sickle. The grubs are found in the trunks of old trees.
horned |Furnished with a horn or horns; furnished with a hornlike process or appendage; as, horned cattle; having some part shaped like a horn. The horned moon with one bright star Within the nether tip. Coleridge. Horned bee (Zoöl.), a British wild bee (Osmia bicornis), having two little horns on the head. -- Horned dace (Zoöl.), an American cyprinoid fish (Semotilus corporialis) common in brooks and ponds; the common chub. See Illust. of Chub. -- Horned frog (Zoöl.), a very large Brazilian frog (Ceratophrys cornuta), having a pair of triangular horns arising from the eyelids. -- Horned grebe (Zoöl.), a species of grebe (Colymbus auritus), of Arctic Europe and America, having two dense tufts of feathers on the head. -- Horned horse (Zoöl.), the gnu. -- Horned lark (Zoöl.), the shore lark. -- Horned lizard (Zoöl.), the horned toad. -- Horned owl (Zoöl.), a large North American owl (Bubo Virginianus), having a pair of elongated tufts of feathers on the head. Several distinct varieties are known; as, the Arctic, Western, dusky, and striped horned owls, differing in color, and inhabiting different regions; -- called also great horned owl, horn owl, eagle owl, and cat owl. Sometimes also applied to the long-eared owl. See Eared owl, under Eared. -- Horned poppy. (Bot.) See Horn poppy, under Horn. -- Horned pout (Zoöl.), an American fresh-water siluroid fish; the bullpout. -- Horned rattler (Zoöl.), a species of rattlesnake (Crotalus cerastes), inhabiting the dry, sandy plains, from California to Mexico. It has a pair of triangular horns between the eyes; -- called also sidewinder. -- Horned ray (Zoöl.), the sea devil. -- Horned screamer (Zoöl.), the kamichi. -- Horned snake (Zoöl.), the cerastes. -- Horned toad (Zoöl.), any lizard of the genus Phrynosoma, of which nine or ten species are known. These lizards have several hornlike spines on the head, and a broad, flat body, covered with spiny scales. They inhabit the dry, sandy plains from California to Mexico and Texas. Called also horned lizard. -- Horned viper. (Zoöl.) See Cerastes.
hornedness |The condition of being horned.
hornel |The European sand eel. [Scot.]
horner |1. One who works or deal in horn or horns. [R.] Grew. 2. One who winds or blows the horn. [Obs.] Sherwood. 3. One who horns or cuckolds. [Obs.] Massinger. 4. (Zoöl.)  The British sand lance or sand eel (Ammodytes lanceolatus).
hornet |A large, strong wasp. The European species (Vespa crabro) is of a dark brown and yellow color. It is very pugnacious, and its sting is very severe. Its nest is constructed of a paperlike material, and the layers of comb are hung together by columns. The American white- faced hornet (V. maculata) is larger and has similar habits. Hornet fly (Zoöl.), any dipterous insect of the genus Asilus, and allied genera, of which there are numerous species. They are large and fierce flies which capture bees and other insects, often larger than themselves, and suck their blood. Called also hawk fly, robber fly. -- To stir up a hornet's nest, to provoke the attack of a swarm of spiteful enemies or spirited critics. [Colloq.]
hornfish |The garfish or sea needle.
hornfoot |Having hoofs; hoofed.
hornify |To horn; to cuckold. [Obs.] Beau. & Fl.
horning |Appearance of the moon when increasing, or in the form of a crescent. J. Gregory. Letters of horning (Scots Law), the process or authority by which a person, directed by the decree of a court of justice to pay or perform anything, is ordered to comply therewith. Mozley & W.
hornish |Somewhat like horn; hard.
hornito |A low, oven-shaped mound, common in volcanic regions, and emitting smoke and vapors from its sides and summit. Humboldt.
hornless |Having no horn.
hornotine |A yearling; a bird of the year.
hornowl |See Horned Owl.
hornpike |The garfish. [Prov. Eng.]
hornpipe |(a) An instrument of music formerly popular in Wales, consisting of a wooden pipe, with holes at intervals. It was so called because the bell at the open end was sometimes made of horn. (b) A lively tune played on a hornpipe, for dancing; a tune adapted for such playing. Many a hornpipe he tuned to his Phyllis. Sir W. Raleigh. (c) A dance performed, usually by one person, to such a tune, and popular among sailors.
hornpout |See Horned pout, under Horned.
hornsnake |A harmless snake (Farancia abacura), found in the Southern United States. The color is bluish black above, red below.
hornstone |A siliceous stone, a variety of quartz, closely resembling flint, but more brittle; -- called also chert.
horntail |Any one of family (Uroceridæ) of large hyminopterous insects, allied to the sawflies. The larvæ bore in the wood of trees. So called from the long, stout ovipositors of the females.
hornwork |An outwork composed of two demibastions joined by a curtain. It is connected with the works in rear by long wings.
hornwort |An aquatic plant (Ceratophyllum), with finely divided leaves.
hornwrack |A bryozoan of the genus Flustra.
horny |1. Having horns or hornlike projections. Gay. 2. Composed or made of horn, or of a substance resembling horn; of the nature of horn. \"The horny . . . coat of the eye.\" Ray. 3. Hard; callous. \"His horny fist.\" Dryden.
horny-handed |Having the hands horny and callous from labor.
hornyhead |Any North American river chub of the genus Hybopsis, esp. H. biguttatus.
horography |1. An account of the hours. Chaucer. 2. The art of constructing instruments for making the hours, as clocks, watches, and dials.
horologe |1. A servant who called out the hours. [Obs.] 2. An instrument indicating the time of day; a timepiece of any kind; a watch, clock, or dial. Shak.
horologer |A maker or vender of clocks and watches; one skilled in horology.
horological |Relating to a horologe, or to horology.
horologiographer |A maker of clocks, watches, or dials.
horologiographic |Of or pertaining to horologiography. Chambers.
horologiography |1. An account of instruments that show the hour. 2. The art of constructing clocks or dials; horography.
horologist |One versed in horology.
horology |The science of measuring time, or the principles and art of constructing instruments for measuring and indicating portions of time, as clocks, watches, dials, etc.
horometer |An instrument for measuring time.
horometrical |Belonging to horometry.
horometry |The art, practice, or method of measuring time by hours and subordinate divisions. \"The horometry of antiquity.\" Sir T. Browne.
horopter |The line or surface in which are situated all the points which are seen single while the point of sight, or the adjustment of the eyes, remains unchanged. The sum of all the points which are seen single, while the point of sight remains unchanged, is called the horopter. J. Le Conte.
horopteric |Of or pertaining to the horopter.
horoscope |1. (Astrol.) (a) The representation made of the aspect of the heavens at the moment of a person's birth, by which the astrologer professed to foretell the events of the person's life; especially, the sign of the zodiac rising above the horizon at such a moment. (b) The diagram or scheme of twelve houses or signs of the zodiac, into which the whole circuit of the heavens was divided for the purposes of such prediction of fortune. 2. The planisphere invented by Jean Paduanus. 3. A table showing the length of the days and nights at all places. Heyse.
horoscoper |One versed in horoscopy; an astrologer.
horoscopist |One versed in horoscopy; an astrologer.
horoscopy |1. The art or practice of casting horoscopes, or observing the disposition of the stars, with a view to prediction events. 2. Aspect of the stars at the time of a person's birth.
horrendous |Fearful; frightful. [Obs.] I. Watts.
horrent |Standing erect, as bristles; covered with bristling points; bristled; bristling. Rough and horrent with figures in strong relief. De Quincey. With bright emblazonry and horrent arms. Milton.
horrible |Exciting, or tending to excite, horror or fear; dreadful; terrible; shocking; hideous; as, a horrible sight; a horrible story; a horrible murder. A dungeon horrible on all sides round. Milton. Syn. -- Dreadful; frightful; fearful; terrible; awful; terrific; shocking; hideous; horrid.
horribleness |The state or quality of being horrible; dreadfulness; hideousness. The horribleness of the mischief. Sir P. Sidney.
horribly |In a manner to excite horror; dreadfully; terribly.
horrid |1. Rough; rugged; bristling. [Archaic] Horrid with fern, and intricate with thorn. Dryden. 2. Fitted to excite horror; dreadful; hideous; shocking; hence, very offensive. Not in the legions Of horrid hell. Shak. The horrid things they say. Pope. Syn. -- Frightful; hideous; alarming; shocking; dreadful; awful; terrific; horrible; abominable.
horridly |In a horrid manner. Shak.
horridness |The quality of being horrid.
horrific |Causing horror; frightful. Let . . . nothing ghastly or horrific be supposed. I. Taylor.
horrification |That which causes horror. [R.] Miss Edgeworth.
horrify |To cause to feel horror; to strike or impress with horror; as, the sight horrified the beholders. E. Irving.
horripilation |A real or fancied bristling of the hair of the head or body, resulting from disease, terror, chilliness, etc.
horrisonant |Horrisonous. [Obs.]
horrisonous |Sounding dreadfully; uttering a terrible sound. [Obs.] Bailey.
horror |1. A bristling up; a rising into roughness; tumultuous movement. [Archaic] Such fresh horror as you see driven through the wrinkled waves. Chapman. 2. A shaking, shivering, or shuddering, as in the cold fit which precedes a fever; in old medical writings, a chill of less severity than a rigor, and more marked than an algor. 3. A painful emotion of fear, dread, and abhorrence; a shuddering with terror and detestation; the feeling inspired by something frightful and shocking. How could this, in the sight of heaven, without horrors of conscience be uttered Milton. 4. That which excites horror or dread, or is horrible; gloom; dreariness. Breathes a browner horror on the woods. Pope. The horrors, delirium tremens. [Colloq.]
horror-sticken |Struck with horror; horrified. Blank and horror-stricken faces. C. Kingsley.
horror-struck |Horror-stricken; horrified. M. Arnold.
hors de combat |Out of the combat; disabled from fighting. HORS D'OEUVRE Hors` d'ouvre\"; pl. Hors d'ouveres (#). [F., lit., outside of work.] 1. Something unusual or extraordinary. [R.] 2.  A dish served as a relish, usually at the beginning of a meal.
horse |1. (Zoöl.)  A hoofed quadruped of the genus Equus; especially, the domestic horse (E. caballus), which was domesticated in Egypt and Asia at a very early period. It has six broad molars, on each side of each jaw, with six incisors, and two canine teeth, both above and below. The mares usually have the canine teeth rudimentary or wanting. The horse differs from the true asses, in having a long, flowing mane, and the tail bushy to the base. Unlike the asses it has callosities, or chestnuts, on all its legs. The horse excels in strength, speed, docility, courage, and nobleness of character, and is used for drawing, carrying, bearing a rider, and like purposes. Note: Many varieties, differing in form, size, color, gait, speed, etc., are known, but all are believed to have been derived from the same original species. It is supposed to have been a native of the plains of Central Asia, but the wild species from which it was derived is not certainly known. The feral horses of America are domestic horses that have run wild; and it is probably true that most of those of Asia have a similar origin. Some of the true wild Asiatic horses do, however, approach the domestic horse in several characteristics. Several species of fossil (Equus) are known from the later Tertiary formations of Europe and America. The fossil species of other genera of the family Equidæ are also often called horses, in general sense. 2. The male of the genus horse, in distinction from the female or male; usually, a castrated male. 3. Mounted soldiery; cavalry; -- used without the plural termination; as, a regiment of horse; -- distinguished from foot. The armies were appointed, consisting of twenty-five thousand horse and foot. Bacon. 4. A frame with legs, used to support something; as, a clotheshorse, a sawhorse, etc. 5. A frame of timber, shaped like a horse, on which soldiers were made to ride for punishment. 6. Anything, actual or figurative, on which one rides as on a horse; a hobby. 7. (Mining)  A mass of earthy matter, or rock of the same character as the wall rock, occurring in the course of a vein, as of coal or ore; hence, to take horse -- said of a vein -- is to divide into branches for a distance. 8. (Naut.) (a) See Footrope, a. (b) A breastband for a leadsman. (c) An iron bar for a sheet traveler to slide upon. (d) A jackstay. W. C. Russell. Totten. Note: Horse is much used adjectively and in composition to signify of, or having to do with, a horse or horses, like a horse, etc.; as, horse collar, horse dealer or horsehorsehoe, horse jockey; and hence, often in the sense of strong, loud, coarse, etc.; as, horselaugh, horse nettle or horse-nettle, horseplay, horse ant, etc. Black horse, Blood horse, etc. See under Black, etc. -- Horse aloes, caballine aloes. -- Horse ant (Zoöl.), a large ant (Formica rufa); -- called also horse emmet. -- Horse artillery, that portion of the artillery in which the cannoneers are mounted, and which usually serves with the cavalry; flying artillery. -- Horse balm (Bot.), a strong-scented labiate plant (Collinsonia Canadensis), having large leaves and yellowish flowers. -- Horse bean (Bot.), a variety of the English or Windsor bean (Faba vulgaris), grown for feeding horses. -- Horse boat, a boat for conveying horses and cattle, or a boat propelled by horses. -- Horse bot. (Zoöl.) See Botfly, and Bots. -- Horse box, a railroad car for transporting valuable horses, as hunters. [Eng.] -- Horse breaker or trainer, one employed in subduing or training horses for use. -- Horse car. (a) A railroad car drawn by horses. See under Car. (b) A car fitted for transporting horses. -- Horse cassia (Bot.), a leguminous plant (Cassia Javanica), bearing long pods, which contain a black, catharic pulp, much used in the East Indies as a horse medicine. -- Horse cloth, a cloth to cover a horse. -- Horse conch (Zoöl.), a large, spiral, marine shell of the genus Triton. See Triton. -- Horse courser. (a) One that runs horses, or keeps horses for racing. Johnson. (b) A dealer in horses. [Obs.] Wiseman. -- Horse crab (Zoöl.), the Limulus; -- called also horsefoot, horsehoe crab, and king crab. -- Horse crevallé (Zoöl.), the cavally. -- Horse emmet (Zoöl.), the horse ant. -- Horse finch (Zoöl.), the chaffinch. [Prov. Eng.] -- Horse gentian (Bot.), fever root. -- Horse iron (Naut.), a large calking iron. -- Horse latitudes, a space in the North Atlantic famous for calms and baffling winds, being between the westerly winds of higher latitudes and the trade winds. Ham. Nav. Encyc. -- Horse mackrel. (Zoöl.) (a) The common tunny (Orcynus thunnus), found on the Atlantic coast of Europe and America, and in the Mediterranean. (b) The bluefish (Pomatomus saltatrix). (c) The scad. (d) The name is locally applied to various other fishes, as the California hake, the black candlefish, the jurel, the bluefish, etc. -- Horse marine (Naut.), an awkward, lubbery person; one of a mythical body of marine cavalry. [Slang] -- Horse mussel (Zoöl.), a large, marine mussel (Modiola modiolus), found on the northern shores of Europe and America. -- Horse nettle (Bot.), a coarse, prickly, American herb, the Solanum Carolinense. -- Horse parsley. (Bot.) See Alexanders. -- Horse purslain (Bot.), a coarse fleshy weed of tropical America (Trianthema monogymnum). -- Horse race, a race by horses; a match of horses in running or trotting. -- Horse racing, the practice of racing with horses. -- Horse railroad, a railroad on which the cars are drawn by horses; -- in England, and sometimes in the United States, called a tramway. -- Horse run (Civil Engin.), a device for drawing loaded wheelbarrows up an inclined plane by horse power. -- Horse sense, strong common sense. [Colloq. U.S.] -- Horse soldier, a cavalryman. -- Horse sponge (Zoöl.), a large, coarse, commercial sponge (Spongia equina). -- Horse stinger (Zoöl.), a large dragon fly. [Prov. Eng.] -- Horse sugar (Bot.), a shrub of the southern part of the United States (Symplocos tinctoria), whose leaves are sweet, and good for fodder. -- Horse tick (Zoöl.), a winged, dipterous insect (Hippobosca equina), which troubles horses by biting them, and sucking their blood; -- called also horsefly, horse louse, and forest fly. -- Horse vetch (Bot.), a plant of the genus Hippocrepis (H. comosa), cultivated for the beauty of its flowers; -- called also horsehoe vetch, from the peculiar shape of its pods. -- Iron horse, a locomotive. [Colloq.] -- Salt horse, the sailor's name for salt beef. -- To look a gift horse in the mouth, to examine the mouth of a horse which has been received as a gift, in order to ascertain his age; -- hence, to accept favors in a critical and thankless spirit. Lowell. -- To take horse. (a) To set out on horseback. Macaulay. (b) To be covered, as a mare. (c) See definition 7 (above).\n\n1. To provide with a horse, or with horses; to mount on, or as on, a horse. \"Being better horsed, outrode me.\" Shak. 2. To sit astride of; to bestride. Shak. 3. To cover, as a mare; -- said of the male. 4. To take or carry on the back; as, the keeper, horsing a deer. S. Butler. 5. To place on the back of another, or on a wooden horse, etc., to be flogged; to subject to such punishment.\n\nTo get on horseback. [Obs.] Shelton.
horse guards |A body of cavalry so called; esp., a British regiment, called the Royal Horse Guards, which furnishes guards of state for the sovereign. The Horse Guards, a name given to the former headquarters of the commander in chief of the British army, at Whitehall in London.
horse power |. 1. The power which a horse exerts. 2. (Mach.)  A unit of power, used in stating the power required to drive machinery, and in estimating the capabilities of animals or steam engines and other prime movers for doing work. It is the power required for the performance of work at the rate of 33,000 English units of work per minute; hence, it is the power that must be exerted in lifting 33,000 pounds at the rate of one foot per minute, or 550 pounds at the rate of one foot per second, or 55 pounds at the rate of ten feet per second, etc. Note: The power of a draught horse, of average strength, working eight hours per day, is about four fifths of a standard horse power. Brake horse power, the net effective power of a prime mover, as a steam engine, water wheel, etc., in horse powers, as shown by a friction brake. See Friction brake, under Friction. -- Indicated horse power, the power exerted in the cylinder of an engine, stated in horse powers, estimated from the diameter and speed of the piston, and the mean effective pressure upon it as shown by an indicator. See Indicator. -- Nominal horse power (Steam Engine), a term still sometimes used in England to express certain proportions of cylinder, but having no value as a standard of measurement. 3. A machine worked by a horse, for driving other machinery; a horse motor.
horse-chestnut |(a) The large nutlike seed of a species of Æsculus (Æ. Hippocastanum), formerly ground, and fed to horses, whence the name. (b) The tree itself, which was brought from Constantinople in the beginning of the sixteenth century, and is now common in the temperate zones of both hemispheres. The native American species are called buckeyes.
horse-drench |1. A dose of physic for a horse. Shak. 2. The appliance by which the dose is administred.
horse-jockey |1. A professional rider and trainer of race horses. 2. A trainer and dealer in horses.
horse-leech |1. (Zoöl.)  A large blood-sucking leech (Hæmopsis vorax), of Europe and Northern Africa. It attacks the lips and mouths of horses. 2. A farrier; a veterinary surgeon.
horse-leechery |The business of a farrier; especially, the art of curing the diseases of horses.
horse-litter |A carriage hung on poles, and borne by and between two horses. Milton.
horse-radish |A plant of the genus Nasturtium (N. Armoracia), allied to scurvy grass, having a root of a pungent taste, much used, when grated, as a condiment and in medicine. Gray. Horse-radish tree. (Bot.) See Moringa.
horseback |1. The back of a horse. 2. An extended ridge of sand, gravel, and bowlders, in a half- stratified condition. Agassiz. On horseback, on the back of a horse; mounted or riding on a horse or horses; in the saddle. The long journey was to be performed on horseback. Prescott.
horsefish |(a) The moonfish (Selene setipinnis). (b) The sauger.
horseflesh |1. The flesh of horses. The Chinese eat horseflesh at this day. Bacon. 2. Horses, generally; the qualities of a horse; as, he is a judge of horseflesh. [Colloq.] Horseflesh ore (Min.), a miner's name for bornite, in allusion to its peculiar reddish color on fresh facture.
horsefly |1. (Zoöl.)  Any dipterous fly of the family Tabanidæ, that stings horses, and sucks their blood. Note: Of these flies there are numerous species, both in Europe and America. They have a large proboscis with four sharp lancets for piercing the skin. Called also breeze fly. See Illust. under Diptera, and Breeze fly. 2. (Zoöl.)  The horse tick or forest fly (Hippobosca).
horsefoot |1. (Bot.)  The coltsfoot. 2. (Zoöl.)  The Limulus or horseshoe crab.
horsehair |A hair of a horse, especially one from the mane or tail; the hairs of the mane or tail taken collectively; a fabric or tuft made of such hairs. Horsehair worm (Zoöl.), the hair worm or gordius.
horsehead |The silver moonfish (Selene vomer).
horsehide |1. The hide of a horse. 2. Leather made of the hide of a horse.
horseknop |Knapweed.
horselaugh |A loud, boisterous laugh; a guffaw. Pope.
horseless |Being without a horse; specif., not requiring a horse; -- said of certain vehicles in which horse power has been replaced by electricity, steam, etc.; as, a horseless carriage or truck.
horseman |1. A rider on horseback; one skilled in the management of horses; a mounted man. 2. (Mil.)  A mounted soldier; a cavalryman. 3. (Zoöl.) (a) A land crab of the genus Ocypoda, living on the coast of Brazil and the West Indies, noted for running very swiftly. (b) A West Indian fish of the genus Eques, as the light-horseman (E. lanceolatus).
horsemanship |The act or art of riding, and of training and managing horses; manege.
horsemint |(a) A coarse American plant of the Mint family (Monarda punctata). (b) In England, the wild mint (Mentha sylvestris).
horsenail |A thin, pointed nail, with a heavy flaring head, for securing a horsehoe to the hoof; a horsehoe nail.
horseplay |Rude, boisterous play. Too much given to horseplay in his raillery. Dryden.
horsepond |A pond for watering horses.
horserake |A rake drawn by a horse.
horseshoe |1. A shoe for horses, consisting of a narrow plate of iron in form somewhat like the letter U, nailed to a horse's hoof. 2. Anything shaped like a horsehoe crab. 3. (Zoöl.)  The Limulus of horsehoe crab. Horsehoe head (Med.), an old name for the condition of the skull in children, in which the sutures are too open, the coronal suture presenting the form of a horsehoe. Dunglison. -- Horsehoe magnet, an artificial magnet in the form of a horsehoe. -- Horsehoe nail. See Horsenail. -- Horsehoe nose (Zoöl.), a bat of the genus Rhinolophus, having a nasal fold of skin shaped like a horsehoe.
horseshoeing |The act or employment of shoeing horses.
horseshoer |One who shoes horses.
horsetail |1. (Bot.)  A leafless plant, with hollow and rushlike stems. It is of the genus Equisetum, and is allied to the ferns. See Illust. of Equisetum. 2. A Turkish standard, denoting rank. Note: Commanders are distinguished by the number of horsetails carried before them. Thus, the sultan has seven, the grand vizier five, and the pashas three, two, or one. Shrubby horsetail. (Bot.) See Joint-fir.
horseweed |A composite plant (Erigeron Canadensis), which is a common weed.
horsewhip |A whip for horses.\n\nTo flog or chastise with a horsewhip.
horsewoman |A woman who rides on horseback.
horsewood |A West Indian tree (Calliandra latifolia) with showy, crimson blossoms.
horseworm |The larva of a botfly.
horsiness |1. The condition or quality of being a horse; that which pertains to a horse. Tennyson. 2. Fondness for, or interest in, horses.
horsly |Horselike. [Obs.] Chaucer.
horsy |Pertaining to, or suggestive of, a horse, or of horse racing; as, horsy manners; garments of fantastically horsy fashions. [Colloq.]
hortation |The act of exhorting, inciting, or giving advice; exhortation. [R.]
hortative |Giving exhortation; advisory; exhortative. Bullokar.\n\nAn exhortation. [Obs.]
