klinometer |See Clinometer.
klipdachs |A small mammal (Hyrax Capensis), found in South Africa. It is of about the size of a rabbit, and closely resembles the daman. Called also rock rabbit.
klipdas |A small mammal (Hyrax Capensis), found in South Africa. It is of about the size of a rabbit, and closely resembles the daman. Called also rock rabbit.
klipfish |Dried cod, exported from Norway. [Written also clipfish.]
klipspringer |A small, graceful South African antelope (Nanotragus oreotragus), which, like the chamois, springs from one crag to another with great agility; -- called also kainsi. [Written also klippspringer.]
kloof |A glen; a ravine closed at its upper end. [South Africa]
klopemania |See Kleptomania.
knab |1. To seize with the teeth; to gnaw. \"Knabbing crusts.\" [Obs.] L'Estrange. 2. To nab. See Nab, v. t. [Colloq.]
knabble |To bite or nibble. [Obs.] Horses will knabble at walls, and rats gnaw iron. Sir T. Browne.
knack |1. To crack; to make a sharp, abrupt noise to chink. [Obs. or Prov. Eng.] Bp. Hall. 2. To speak affectedly. [Prov. Eng.] Halliwell.\n\n1. A petty contrivance; a toy; a plaything; a knickknack. A knack, a toy, a trick, a baby's cap. Shak. 2. A readiness in performance; aptness at doing something; skill; facility; dexterity. The fellow . . . has not the knack with his shears. B. Jonson. The dean was famous in his time, And had a kind of knack at rhyme. Swift. 3. Something performed, or to be done, requiring aptness and dexterity; a trick; a device. \"The knacks of japers.\" Chaucer. For how should equal colors do the knack ! Pope.
knack-kneed |See Knock-kneed.
knacker |1. One who makes knickknacks, toys, etc. Mortimer. 2. One of two or more pieces of bone or wood held loosely between the fingers, and struck together by moving the hand; -- called also clapper. Halliwell.\n\n1. a harness maker. [Obs. or Prov. Eng.] Halliwell. 2. One who slaughters worn-out horses and sells their flesh for dog's meat. [Eng.]
knackish |Trickish; artful. [Obs.] -- Knack\"ish*ness, n. [Obs.] Dr. H. More.
knacky |Having a knack; cunning; crafty; trickish. [Prov. Eng. & Scot.] Halliwell.
knag |1. A knot in wood; a protuberance. Wright. 2. A wooden peg for hanging things on. Wright. 3. The prong of an antler Holland. 4. The rugged top of a hill. [Prov. Eng.] Halliwell.
knagged |Full of knots; knaggy.
knaggy |Knotty; rough; figuratively, rough in temper. Fuller. -- Knag\"gi*ness, n.
knap |A protuberance; a swelling; a knob; a button; hence, rising ground; a summit. See Knob, and Knop. The highest part and knap of the same island. Holland.\n\n1. To bite; to bite off; to break short. [Obs. or Prov. Eng. ] He will knap the spears apieces with his teeth. Dr. H. More. He breaketh the bow, and knappeth the spear in sunder. Ps. xlvi. 9 (Book of Common Prayer.) 2. To strike smartly; to rap; to snap. Bacon.\n\nTo make a sound of snapping. Wiseman.\n\nA sharp blow or slap. Halliwell.
knapbottle |The bladder campion (Silene inflata).
knappish |Snappish; peevish. [Obs.] Grafton.
knapple |To break off with an abrupt, sharp noise; to bite; to nibble. [Obs. or Prov. Eng.]
knappy |Having knaps; full of protuberances or humps; knobby. [Obs.] Huloet.
knapsack |A case of canvas or leather, for carrying on the back a soldier's necessaries, or the clothing, etc., of a traveler. And each one fills his knapsack or his scrip With some rare thing that on the field is found. Drayton.
knapweed |The black centaury (Centaurea nigra); -- so called from the knoblike heads of flowers. Called also bullweed.
knar |See Gnar. [Obs.] Chaucer.
knarl |A knot in wood. See Gnarl.
knarled |Knotted. See Gnarled.
knarred |Knotty; gnarled. The knarred and crooked cedar knees. Longfellow.
knarry |Knotty; gnarled. Chaucer.
knave |1. A boy; especially, a boy servant. [Obs.] Wyclif. Chaucer. O murderous slumber, Lay'st thou thy leaden mace upon my boy That plays thee music Gentle knave, good night. Shak. 2. Any male servant; a menial. [Obs.] Chaucer. He's but Fortune's knave, A minister of her will. Shak. 3. A tricky, deceitful fellow; a dishonest person; a rogue; a villain. \"A pair of crafty knaves.\" Shak. In defiance of demonstration, knaves will continue to proselyte fools. Ames. Note: \"How many serving lads must have been unfaithful and dishonest before knave -which meant at first no more than boy -- acquired the meaning which it has now !\" Trench. 4. A playing card marked with the figure of a servant or soldier; a jack. Knave child, a male child. [Obs.] Chaucer. Syn. -- Villain; cheat; rascal; rogue; scoundrel; miscreant.
knavery |1. The practices of a knave; petty villainy; fraud; trickery; a knavish action. This is flat knavery, to take upon you another man's name. Shak. 2. pl.  Roguish or mischievous tricks. Shak.
knaveship |A small due, in meal, established by usage, which is paid to the under miller. [Scot.]
knavess |A knavish woman. Carlyle.
knavish |1. Like or characteristic of a knave; given to knavery; trickish; fraudulent; dishonest; villainous; as, a knavish fellow, or a knavish trick. \"Knavish politicians.\" Macaulay. 2. Mischievous; roguish; waggish. Cupid is knavish lad, Thus to make poor females mad. Shak.
knavishly |1. In a knavish manner; dishonestly; fraudulently. Holland. 2. Mischievously; waggishly; roguishly. \"Knavishly witty.\" Gayton.
knavishness |The quality or state of being knavish; knavery; dishonesty.
knaw |See Gnaw. [Obs.] Sir T. More.
knawel |A low, spreading weed (Scleranthus annuus), common in sandy soil.
knead |1. To work and press into a mass, usually with the hands; esp., to work, as by repeated pressure with the knuckles, into a well mixed mass, as the materials of bread, cake, etc.; as, to knead dough. The kneading, the making of the cake, the heating of the oven, and the baking. Shak. 2. Fig.: To treat or form as by kneading; to beat. I will knead him : I'll make him supple. Shak. Kneading trough, a trough or tray in which dough is kneaded. Ex. viii. 3.
kneadable |That may be kneaded; capable of being worked into a mass.
kneader |One who kneads.
kneadingly |In the manner of one kneading.
knebelite |A mineral of a gray, red, brown, or green color, and glistening luster. It is a silicate of iron and manganese.
kneck |The twisting of a rope or cable, as it is running out. [Eng.]
knee |1. In man, the joint in the middle part of the leg. 2. (Anat.) (a) The joint, or region of the joint, between the thigh and leg. (b) In the horse and allied animals, the carpal joint, corresponding to the wrist in man. 3. (Mech. & Shipbuilding)  A piece of timber or metal formed with an angle somewhat in the shape of the human knee when bent. 4. A bending of the knee, as in respect or courtesy. Give them title, knee, and approbation. Shak. Knee breeches. See under Breeches. -- Knee holly, Knee holm (Bot.), butcher's broom. -- Knee jerk (Physiol.) a jerk or kick produced by a blow or sudden strain upon the patellar tendon of the knee, which causes a sudden contraction of the quadriceps muscle; one of the so-called tendon reflexes. -- Knee joint. See in the Vocabulary. -- Knee timber, timber with knees or angles in it. -- Knee tribute, or Knee worship, tribute paid by kneeling; worship by genuflection. [Obs.] \"Knee tribute yet unpaid.\" Milton.\n\nTo supplicate by kneeling. [Obs.] Fall down, and knee The way into his mercy. Shak
knee jerk |A jerk or kick produced by a blow or sudden strain upon the patellar tendon of the knee, which causes a sudden contraction of the quadriceps muscle.
knee-crooking |Obsequious; fawning; cringing. \"Knee-crooking knave.\" Shak.
knee-deep |1. Rising to the knees; knee-high; as, water or snow knee-deep. Grass knee-deep within a month. Milton. 2. Sunk to the knees; as, men knee-deep in water. Where knee-deep the trees were standing. Longfellow.
knee-high |Rising or reaching upward to the knees; as, the water is knee- high.
kneebrush |1. (Zoöl.)  A tuft or brush of hair on the knees of some species of antelopes and other animals; -- chiefly used in the plural. 2. (Zoöl.)  A thick mass or collection of hairs on the legs of bees, by aid of which they carry the collected pollen to the hive or nest; -- usually in the plural.
kneecap |1. (Anat.)  The kneepan. 2. A cap or protection for the knee.
kneed |1. Having knees;- used chiefly in composition; as, in-kneed; out- kneed; weak-kneed. 2. (Bot.)  Geniculated; forming an obtuse angle at the joints, like the knee when a little bent; as, kneed grass.
kneejoint |1. The joint of the knee. 2. (Mach.)  A toggle joint; -- so called because consisting of two pieces jointed to each other end to end, making an angle like the knee when bent.
kneejointed |Geniculate; kneed. See Kneed, a., 2.
kneel |To bend the knee; to fall or rest on the knees; -- sometimes with down. And he kneeled down, and cried with a loud voice, Lord, lay not this sin to their charge. Acts vii. 60. As soon as you are dressed, kneel and say the Lord's Prayer. Jer. Taylor.
kneeler |1. One who kneels or who worships by or while kneeling. Tennyson. 2. A cushion or stool to kneel on. 3. (Eccl. Hist.)  A name given to certain catechumens and penitents who were permitted to join only in parts of church worship.
kneelingly |In a kneeling position.
kneepan |A roundish, flattened, sesamoid bone in the tendon in front of the knee joint; the patella; the kneecap.
kneepiece |A piece shaped like a knee; as, the kneepieces or ears of a boat. KNEIPPISM; KNEIPP'S CURE; KNEIPP CURE Kneipp\"ism, n. Also Kneipp's, or Kneipp, cure.  Treatment of disease by forms of hydrotherapy, as walking barefoot in the morning dew, baths, wet compresses, cold affusions, etc.; -- so called from its originator, Sebastian Kneipp (1821-97), a German priest.
knell |The stoke of a bell tolled at a funeral or at the death of a person; a death signal; a passing bell; hence, figuratively, a warning of, or a sound indicating, the passing away of anything. The dead man's knell Is there scarce asked for who. Shak. The curfew tolls the knell of parting day. Gray.\n\nTo sound as a knell; especially, to toll at a death or funeral; hence, to sound as a warning or evil omen. Not worth a blessing nor a bell to knell for thee. Beau. & Fl. Yet all that poets sing, and grief hath known, Of hopes laid waste, knells in that word, \"alone\". Ld. Lytton.\n\nTo summon, as by a knell. Each matin bell, the baron saith, Knells us back to a world of death. Coleridge.
knelt |of Kneel.
knew |of Know.
knicker |A small ball of clay, baked hard and oiled, used as a marble by boys in playing. [Prov. Eng. & U. S.] Halliwell. Bartlett.
knickerbocker |A linsey-woolsey fabric having a rough knotted surface on the right side; used for women's dresses.
knickerbockers |The name for a style of short breeches; smallclothes.
knickknack |A trifle or toy; a bawble; a gewgaw.
knickknackatory |A collection of knickknacks. Richardson.
knickknackery |Knickknacks.
knife |1. An instrument consisting of a thin blade, usually of steel and having a sharp edge for cutting, fastened to a handle, but of many different forms and names for different uses; as, table knife, drawing knife, putty knife, pallet knife, pocketknife, penknife, chopping knife, etc. 2. A sword or dagger. The coward conquest of a wretch's knife. Shak. Knife grass (Bot.) a tropical American sedge (Scleria latifolia), having leaves with a very sharp and hard edge, like a knife. -- War to the knife, mortal combat; a conflict carried to the last extremity.\n\n1. (Hort.)  To prune with the knife. 2. To cut or stab with a knife. [Low]
knife switch |A switch consisting of one or more knifelike pieces hinged at one end and making contact near the other with flat gripping springs.
knife-edge |A piece of steel sharpened to an acute edge or angle, and resting on a smooth surface, serving as the axis of motion of a pendulum, scale beam, or other piece required to oscillate with the least possible friction. Knife-edge file. See Illust. of File.
knifeboard |A board on which knives are cleaned or polished.
knifeedge |A piece of steel sharpened to an acute edge or angle, and resting on a smooth surface, serving as the axis of motion of a pendulum, scale beam, or other piece required to oscillate with the least possible friction. Knife-edge file. See Illust. of File.
knight |1. A young servant or follower; a military attendant. [Obs.] 2. (a) In feudal times, a man-at-arms serving on horseback and admitted to a certain military rank with special ceremonies, including an oath to protect the distressed, maintain the right, and live a stainless life. (b) One on whom knighthood, a dignity next below that of baronet, is conferred by the sovereign, entitling him to be addressed as Sir; as, Sir John. [Eng.] Hence: (c) A champion; a partisan; a lover. \"Give this ring to my true knight.\" Shak \"In all your quarrels will I be your knight.\" Tennyson. Knights, by their oaths, should right poor ladies' harms. Shak. Note: Formerly, when a knight's name was not known, it was customary to address him as Sir Knight. The rank of a knight is not hereditary. 3. A piece used in the game of chess, usually bearing a horse's head. 4. A playing card bearing the figure of a knight; the knave or jack. [Obs.] Carpet knight. See under Carpet. -- Knight of industry. See Chevalier d'industrie, under Chevalier. -- Knight of Malta, Knight of Rhodes, Knight of St. John of Jerusalem. See Hospitaler. -- Knight of the post, one who gained his living by giving false evidence on trials, or false bail; hence, a sharper in general. Nares. \"A knight of the post, . . . quoth he, for so I am termed; a fellow that will swear you anything for twelve pence.\" -- Nash. -- Knight of the shire, in England, one of the representatives of a county in Parliament, in distinction from the representatives of cities and boroughs. -- Knights commanders, Knights grand cross, different classes of the Order of the Bath. See under Bath, and Companion. Knights of labor, a secret organization whose professed purpose is to secure and maintain the rights of workingmen as respects their relations to their employers. [U. S.] -- Knights of Pythias, a secret order, founded in Washington, d.C., in 1864, for social and charitable purposes. -- Knights of the Round Table, knights belonging to an order which, according to the legendary accounts, was instituted by the mythical King Arthur. They derived their common title from the table around which they sat on certain solemn days. Brande & C.\n\nTo dub or create (one) a knight; -- done in England by the sovereign only, who taps the kneeling candidate with a sword, saying: Rise, Sir ---. A soldier, by the honor-giving hand Of Cknighted in the field. Shak.
knight bachelor |A knight of the most ancient, but lowest, order of English knights, and not a member of any order of chivalry. See Bachelor, 4.
knight banneret |A knight who carried a banner, who possessed fiefs to a greater amount than the knight bachelor, and who was obliged to serve in war with a greater number of attendants. The dignity was sometimes conferred by the sovereign in person on the field of battle.
knight baronet |See Baronet.
knight marshal |An officer in the household of the British sovereign, who has cognizance of transgressions within the royal household and verge, and of contracts made there, a member of the household being one of the parties. Wharton.
knight service |A tenure of lands held by knights on condition of performing military service. See Chivalry, n., 4. KNIGHT SERVICE; KNIGHT'S SERVICE Knight service. Also Knight's service. 1.  (Feud. Law) The military service by rendering which a knight held his lands; also, the tenure of lands held on condition of performing military service. By far the greater part of England [in the 13th century] is held of the king by knight's service. . . . In order to understand this tenure we must form the conception of a unit of military service. That unit seems to be the service of one knight or fully armed horseman (servitium unius militis) to be done to the king in his army for forty days in the year, if it be called for. . . . The limit of forty days seems to have existed rather in theory than practice. Pollock & Mait. 2.  Service such as a knight can or should render; hence, good or valuable service. KNIGHT'S FEE Knight's fee. (Feudal Law)  The fee of a knight; specif., the amount of land the holding of which imposed the obligation of knight service, being sometimes a hide or less, sometimes six or more hides.
knight templar |See Commandery, n., 3, and also Templar, n., 1 and 3.
knight-er-ratic |Pertaining to a knight-errant or to knight-errantry. [R.] Quart. Rev.
knight-errant |A wandering knight; a knight who traveled in search of adventures, for the purpose of exhibiting military skill, prowess, and generosity.
knight-errantry |The character or actions of wandering knights; the practice of wandering in quest of adventures; chivalry; a quixotic or romantic adventure or scheme. The rigid guardian [i. e., conscience] of a blameless heart Is weak with rank knight-erratries o'errun. Young.
knightage |To body of knights, taken collectively.
knighthead |A bollard timber. See under Bollard.
knighthood |1. The character, dignity, or condition of a knight, or of knights as a class; hence, chivalry. \"O shame to knighthood.\" Shak. If you needs must write, write Cæsar's praise; You 'll gain at least a knighthood, or the bays. Pope. 2. The whole body of knights. The knighthood nowadays are nothing like the knighthood of old time. Chapman. Note: \"When the order of knighthood was conferred with full solemnity in the leisure of a court or court or city, imposing preliminary ceremonies were required of the candidate. He prepared himself by prayer and fasting, watched his arms at night in a chapel, and was then admitted with the performance of religious rites. Knighthood was conferred by the accolade, which, from the derivation of the name, would appear to have been originally an embrace; but afterward consisted, as it still does, in a blow of the flat of a sword on the back of the kneeling candidate.\" Brande & C.
knightless |Unbecoming a knight. [Obs.] \"Knightless guile.\" Spenser.
knightliness |The character or bearing suitable for a knight; chivalry. Spenser.
knightly |Of or pertaining to a knight; becoming a knight; chivalrous; as, a knightly combat; a knightly spirit. For knightly jousts and fierce encounters fit. Spenser. [Excuses] full knightly without scorn. Tennyson.\n\nIn a manner becoming a knight. And why thou comest thus knightly clad in arms. Shak.
knit |1. To form into a knot, or into knots; to tie together, as cord; to fasten by tying. A great sheet knit at the four corners. Acts x. 11. When your head did but ache, I knit my handkercher about your brows. Shak. 2. To form, as a textile fabric, by the interlacing of yarn or thread in a series of connected loops, by means of needles, either by hand or by machinery; as, to knit stockings. 3. To join; to cause to grow together. Nature can not knit the bones while the parts are under a discharge. Wiseman. 4. To unite closely; to connect; to engage; as, hearts knit together in love. Thy merit hath my duty strongly knit. Shak. Come , knit hands, and beat the ground, In a light fantastic round. Milton. A link among the days, toknit The generations each to each. Tennyson. 5. To draw together; to contract into wrinkles. knits his brow and shows an angry eye. Shak.\n\n1. To form a fabric by interlacing yarn or thread; to weave by making knots or loops. 2. To be united closely; to grow together; as, broken bones will in time knit and become sound. To knit up, to wind up; to conclude; to come to a close. \"It remaineth to knit up briefly with the nature and compass of the seas.\" [Obs.] Holland.\n\nUnion knitting; texture. Shak.
knitback |The plant comfrey; -- so called from its use as a restorative. Dr. Prier.
knitch |A number of things tied or knit together; a bundle; a fagot. [Obs. or Prov. Eng.] Halliwell. When they [stems of asphodel] be dried, they ought to be made up into knitchets, or handfuls. Holland.
knitchet |A number of things tied or knit together; a bundle; a fagot. [Obs. or Prov. Eng.] Halliwell. When they [stems of asphodel] be dried, they ought to be made up into knitchets, or handfuls. Holland.
knits |Small particles of ore. Raymond.
knitster |A woman who knits. [Prov. Eng.] Halliwell.
knitter |One who, or that which, knits, joins, or unites; a knitting machine. Shak.
knitting |1. The work of a knitter; the network formed by knitting. 2. Union formed by knitting, as of bones. Knitting machine, one of a number of contrivances for mechanically knitting stockings, jerseys, and the like. -- Knitting , a stiff rod, as of steel wire, with rounded ends for knitting yarn or threads into a fabric, as in stockings. -- Knitting sheath, a sheath to receive the end of a needle in knitting.
knittle |1. A string that draws together a purse or bag. [Prov. Eng.] Wright. 2. pl. (Naut.)  See Nettles.
knives |of Knife. See Knife.
knob |1. A hard protuberance; a hard swelling or rising; a bunch; a lump; as, a knob in the flesh, or on a bone. 2. A knoblike ornament or handle; as, the knob of a lock, door, or drawer. Chaucer. 3. A rounded hill or mountain; as, the Pilot Knob. [U. S.] Bartlett. 4. (Arch.)  See Knop. Knob latch, a latch which can be operated by turning a knob, without using a key.\n\nTo grow into knobs or bunches; to become knobbed. [Obs.] Drant.
knobbed |Containing knobs; full of knobs; ending in a nob. See Illust of Antenna. The horns of a roe deer of Greenland are pointed at the top, and knobbed or tuberous at the bottom. Grew.
knobber |See Knobbler.
knobbing |Rough dressing by knocking off knobs or projections.
knobbler |The hart in its second year; a young deer. [Written also knobber.] Halliwell. He has hallooed the hounds upon a velvet-headed knobbler. Sir W. Scott.
knobbling fire |. A bloomery fire. See Bloomery.
knobby |1. Full of, or covered with, knobs or hard protuberances. Dr. H. More. 2. Irregular; stubborn in particulars. [Obs.] The informers continued in a knobby kind of obstinacy. Howell. 3. Abounding in rounded hills or mountains; hilly. [U.S.] Bartlett.
knobkerrie |A short club with a knobbed end used as a missile weapon by Kafir and other native tribes of South Africa.
knobstick |One who refuses to join, or withdraws from, a trades union. [Cant, Eng.]
knock |1. To drive or be driven against something; to strike against something; to clash; as, one heavy body knocks against another. Bacon. 2. To strike or beat with something hard or heavy; to rap; as, to knock with a club; to knock on the door. For harbor at a thousand doors they knocked. Dryden. Seek, and ye shall find; knock, and it shall be opened unto you. Matt. vii. 7. To knock about, to go about, taking knocks or rough usage; to wander about; to saunter. [Colloq.] \"Knocking about town.\" W. Irving. -- To knock up, to fail of strength; to become wearied or worn out, as with labor; to give out. \"The horses were beginning to knock up under the fatigue of such severe service.\" De Quincey. -- To knock off, to cease, as from work; to desist. -- To knock under, to yield; to submit; to acknowledge one's self conquered; -- an expression probably borrowed from the practice of knocking under the table with the knuckles, when conquered. \"Colonel Esmond knocked under to his fate.\" Thackeray.\n\n1. To strike with something hard or heavy; to move by striking; to drive (a thing) against something; as, to knock a ball with a bat; to knock the head against a post; to knock a lamp off the table. When heroes knock their knotty heads together. Rowe. 2. To strike for admittance; to rap upon, as a door. Master, knock the door hard. Shak. To knock down. (a) To strike down; to fell; to prostrate by a blow or by blows; as, to knock down an assailant. (b) To assign to a bidder at an auction, by a blow or knock; to knock off. -- To knock in the head, or on the head, to stun or kill by a blow upon the head; hence, to put am end to; to defeat, as a scheme or project; to frustrate; to quash. [Colloq.] -- To knock off. (a) To force off by a blow or by beating. (b) To assign to a bidder at an auction, by a blow on the counter. (c) To leave off (work, etc.). [Colloq.] -- To knock out, to force out by a blow or by blows; as, to knock out the brains. -- To knock up. (a) To arouse by knocking. (b) To beat or tire out; to fatigue till unable to do more; as, the men were entirely knocked up. [Colloq.] \"The day being exceedingly hot, the want of food had knocked up my followers.\" Petherick. (c) (Bookbinding) To make even at the edges, or to shape into book form, as printed sheets.\n\n1. A blow; a stroke with something hard or heavy; a jar. 2. A stroke, as on a door for admittance; a rap. \" A knock at the door.\" Longfellow. A loud cry or some great knock. Holland. Knock off, a device in a knitting machine to remove loops from the needles.
knock-knee |A condition in which the knees are bent in so as to touch each other in walking; inknee.
knock-kneed |Having the legs bent inward so that the knees touch in walking. [Written also knack-kneed.]
knock-off |That knocks off; of or pertaining to knocking off.\n\nAct or place of knocking off; that which knocks off; specif. (Mach.),  a cam or the like for disconnecting something, as a device in a knitting machine to remove loops from the needles.
knock-out |Act of knocking out, or state of being knocked out.\n\nThat knocks out; characterized by knocking out; as, a knock-out blow; a knock-out key for knocking out a drill from a collet.
knock-out drops |Drops of some drug put in one's drink to stupefy him for purpose of robbery, etc. [Slang, U. S.]
knockabout |1. Marked by knocking about or roughness. 2.  Of noisy and violent character. [Theat. Slang] 3.  Characterized by, or suitable for, knocking about, or traveling or wandering hither and thither. 4.  That does odd jobs; -- said of a class of hands or laborers on a sheep station. [Collog., Australia]\n\n1. (Naut.) A small yacht, generally from fifteen to twenty-five feet in length, having a mainsail and a jib.  All knockabouts have ballast and either a keel or centerboard.  The original type was twenty-one feet in length.  The next larger type is called a raceabout. 2. A knockabout performer or performance. [Theat. Slang] 3. A man hired on a sheep station to do odd jobs. [Colloq., Australia]
knockdown |A felling by a knock, as of a combatant, or of an animal.\n\nOf force sufficient to fell or completely overthrow; as, a knockdown blow; a knockdown argument. [Colloq.]
knocker |One who, or that which, knocks; specifically, an instrument, or kind of hammer, fastened to a door, to be used in seeking for admittance. Shut, shut the door, good John ! fatigued, knocker; say I'm sick, I'm dead. Pope.
knocking |A beating; a rap; a series of raps. The . . . repeated knockings of the head upon the ground by the Chinese worshiper. H. Spencer.
knockings |Large lumps picked out of the sieve, in dressing ore.
knockstone |A block upon which ore is broken up.
knoll |A little round hill; a mound; a small elevation of earth; the top or crown of a hill. On knoll or hillock rears his crest, Lonely and huge, the giant oak. Sir W. Scott.\n\nTo ring, as a bell; to strike a knell upon; to toll; to proclaim, or summon, by ringing. \"Knolled to church.\" Shak. Heavy clocks knolling the drowsy hours. Tennyson.\n\nTo sound, as a bell; to knell. Shak. For a departed being's soul The death hymn peals, and the hollow bells knoll. Byron.\n\nThe tolling of a bell; a knell. [R.] Byron.
knoller |One who tolls a bell. [Obs.] Sherwood.
knop |1. A knob; a bud; a bunch; a button. Four bowls made like unto almonds, with their knops and their flowers. Ex. xxv. 21. 2. (Arch.)  Any boldly projecting sculptured ornament; esp., the ornamental termination of a pinnacle, and then synonymous with finial; -- called also knob, and knosp. Knop sedge (Bot.), the bur reed (Sparganium); - - so called from its globular clusters of seed vessels. Prior.
knopped |Having knops or knobs; fastened as with buttons. [Obs.] Rom. of R.
knoppern |A kind of gall produced by a gallfly on the cup of an acorn, -- used in tanning and dyeing.
knopweed |Same as Knapweed.
knor |See Knur. [Obs.]
knosp |Same as Knop,2. Milman.
knot |1. (a) A fastening together of the pars or ends of one or more threads, cords, ropes, etc., by any one of various ways of tying or entangling. (b) A lump or loop formed in a thread, cord, rope. etc., as at the end, by tying or interweaving it upon itself. (c) An ornamental tie, as of a ribbon. Note: The names of knots vary according to the manner of their making, or the use for which they are intended; as, dowknot, reef knot, stopper knot, diamond knot, etc. 2. A bond of union; a connection; a tie. \"With nuptial knot.\" Shak. Ere we knit the knot that can never be loosed. Bp. Hall. 3. Something not easily solved; an intricacy; a difficulty; a perplexity; a problem. Knots worthy of solution. Cowper. A man shall be perplexed with knots, and problems of business, and contrary affairs. South. 4. A figure the lines of which are interlaced or intricately interwoven, as in embroidery, gardening, etc. \"Garden knots.\" Bacon. Flowers worthy of paradise, which, not nice art In beds and curious knots, but nature boon Poured forth profuse on hill, and dale, and plain. Milton. 5. A cluster of persons or things; a collection; a group; a hand; a clique; as, a knot of politicians. \"Knots of talk.\" Tennyson. His ancient knot of dangerous adversaries. Shak. Palms in cluster, knots of Paradise. Tennyson. As they sat together in small, separate knots, they discussed doctrinal and metaphysical points of belief. Sir W. Scott. 6. A portion of a branch of a tree that forms a mass of woody fiber running at an angle with the grain of the main stock and making a hard place in the timber. A loose knot is generally the remains of a dead branch of a tree covered by later woody growth. 7. A knob, lump, swelling, or protuberance. With lips serenely placid, felt the knot Climb in her throat. Tennyson. 8. A protuberant joint in a plant. 9. The point on which the action of a story depends; the gist of a matter. [Obs.] I shoulde to the knotte condescend, And maken of her walking soon an end. Chaucer. 10. (Mech.)  See Node. 11. (Naut.) (a) A division of the log line, serving to measure the rate of the vessel's motion. Each knot on the line bears the same proportion to a mile that thirty seconds do to an hour. The number of knots which run off from the reel in half a minute, therefore, shows the number of miles the vessel sails in an hour. Hence: (b) A nautical mile, or 6080.27 feet; as, when a ship goes eight miles an hour, her speed is said to be eight knots. 12. A kind of epaulet. See Shoulder knot. 13. (Zoöl.)  A sandpiper (Tringa canutus), found in the northern parts of all the continents, in summer. It is grayish or ashy above, with the rump and upper tail coverts white, barred with dusky. The lower parts are pale brown, with the flanks and under tail coverts white. When fat it is prized by epicures. Called also dunne. Note: The name is said to be derived from King Canute, this bird being a favorite article of food with him. The knot that called was Canutus' bird of old, Of that great king of Danes his name that still doth hold, His appetite to please that far and near was sought. Drayton.\n\n1. To tie in or with, or form into, a knot or knots; to form a knot on, as a rope; to entangle. \"Knotted curls.\" Drayton. As tight as I could knot the noose. Tennyson. 2. To unite closely; to knit together. Bacon. 3. To entangle or perplex; to puzzle. [Obs. or R.]\n\n1. To form knots or joints, as in a cord, a plant, etc.; to become entangled. Cut hay when it begins to knot. Mortimer. 2. To knit knots for fringe or trimming. 3. To copulate; -- said of toads. [R.] Shak.
knotberry |The cloudberry (Rudus Chamæmorus); -- so called from its knotted stems.
knotgrass |(a) a common weed with jointed stems (Polygonum aviculare); knotweed. (b) The dog grass. See under Dog. Note: An infusion of Polygonum aviculare was once supposed to have the effect of stopping the growth of an animal, and hence it was called, as by Shakespeare, \"hindering knotgrass.\" We want a boy extremely for this function, Kept under for a year with milk and knotgrass. Beau. & Fl.
knotless |Free from knots; without knots. \"Silver firs with knotless trunks.\" Congreve.
knotted |1. Full of knots; having knots knurled; as, a knotted cord; the knotted oak. Dryden. 2. Interwoven; matted; entangled. Make . . . thy knotted and combined locks to part. Shak. 3. Having intersecting lines or figures. The west corner of thy curious knotted garden. Shak. 4. (Geol.)  Characterized by small, detached points, chiefly composed of mica, less decomposable than the mass of the rock, and forming knots in relief on the weathered surface; as, knotted rocks. Percival. 5. Entangled; puzzling; knotty. [R.] They're catched in knotted lawlike nets. Hudibras.
knottiness |1. The quality or state of being knotty or full of knots. 2. Difficulty of solution; intricacy; complication. \" Knottiness of his style.\" Hare.
knotty |1. Full of knots; knotted; having many knots; as, knotty timber; a knotty rope. 2. Hard; rugged; as, a knotty head.[R.] Rewe. 3. Difficult; intricate; perplexed. A knotty point to which we now proceed Pope.
knotweed |See Knot.
knotwort |A small, herbaceous, trailing plant, of the genus Illecebrum (I. verticillatum.)
knout |A kind of whip for flogging criminals, formerly much used in Russia. The last is a tapering bundle of leather thongs twisted with wire and hardened, so that it mangles the flesh.\n\nTo punish with the knout Brougham.
know |Knee. [Obs.] Chaucer.\n\n1. To perceive or apprehend clearly and certainly; to understand; to have full information of; as, to know one's duty. O, that a man might know The end of this day's business ere it come! Shak. There is a certainty in the proposition, and we know it. Dryden. Know how sublime a thing it is To suffer and be strong. Longfellow. 2. To be convinced of the truth of; to be fully assured of; as, to know things from information. 3. To be acquainted with; to be no stranger to; to be more or less familiar with the person, character, etc., of; to possess experience of; as, to know an author; to know the rules of an organization. He hath made him to be sin for us, who knew no sin. 2 Cor. v. 21. Not to know me argues yourselves unknown. Milton. 4. To recognize; to distinguish; to discern the character of; as, to know a person's face or figure. Ye shall know them by their fruits. Matt. vil. 16. And their eyes were opened, and they knew him. Luke xxiv. 31. To know Faithful friend from flattering foe. Shak. At nearer view he thought he knew the dead. Flatman. 5. To have sexual commerce with. And Adam knew Eve his wife. Gen. iv. 1. Note: Know is often followed by an objective and an infinitive (with or without to) or a participle, a dependent sentence, etc. And I knew that thou hearest me always. John xi. 42. The monk he instantly knew to be the prior. Sir W. Scott. In other hands I have known money do good. Dickens. To know how, to understand the manner, way, or means; to have requisite information, intelligence, or sagacity. How is sometimes omitted. \" If we fear to die, or know not to be patient.\" Jer. Taylor.\n\n1. To have knowledge; to have a clear and certain perception; to possess wisdom, instruction, or information; -- often with of. Israel doth not know, my people doth not consider. Is. i. 3. If any man will do his will, he shall know of the doctrine, whether it be of God, or whether I speak of myself. John vii. 17. The peasant folklore of Europe still knows of willows that bleed and weep and speak when hewn. Tylor. 2. To be assured; to feel confident. To know of,to ask, to inquire. [Obs.] \" Know of your youth, examine well your blood.\" Shak.
know-all |One who knows everything; hence, one who makes pretension to great knowledge; a wiseacre; -- usually ironical. [Colloq. or R.]
know-nothing |A member of a secret political organization in the United States, the chief objects of which were the proscription of foreigners by the repeal of the naturalization laws, and the exclusive choice of native Americans for office. Note: The party originated in 1853, and existed for about three years. The members of it were called Know-nothings, because they replied \"I don't know,\" to any questions asked them in reference to the party.
know-nothingism |The doctrines, principles, or practices, of the Know-nothings.
knowable |That may be known; capable of being discovered, understood, or ascertained. Thus mind and matter, as known or knowable, are only two different series of phenomena or qualities. Sir W. Hamilton.
knowableness |The state or quality of being knowable. Locke.
knower |One who knows. Shak.
knowing |1. Skilful; well informed; intelligent; as, a knowing man; a knowing dog. The knowing and intelligent part of the world. South. 2. Artful; cunning; as, a knowing rascal. [Colloq.]\n\nKnowledge; hence, experience. \" In my knowing.\" Shak. This sore night Hath trifled former knowings. Shak.
knowingly |1. With knowledge; in a knowing manner; intelligently; consciously; deliberately; as, he would not knowingly offend. Strype. 2. By experience. [Obs.] Shak.
knowingness |The state or quality of being knowing or intelligent; shrewdness; skillfulness.
knowleche |See Knowl, edge. We consider and knowleche that we have offended. Chaucer.
knowleching |Knowledge. [Obs.] Chaucer.
knowledge |1. The act or state of knowing; clear perception of fact, truth, or duty; certain apprehension; familiar cognizance; cognition. Knowledge, which is the highest degree of the speculative faculties, consists in the perception of the truth of affirmative or negative propositions. Locke. 2. That which is or may be known; the object of an act of knowing; a cognition; -- chiefly used in the plural. There is a great difference in the delivery of the mathematics, which are the most abstracted of knowledges. Bacon. Knowledges is a term in frequent use by Bacon, and, though now obsolete, should be revived, as without it we are compelled to borrow \"cognitions\" to express its import. Sir W. Hamilton. To use a word of Bacon's, now unfortunately obsolete, we must determine the relative value of knowledges. H. Spencer. 3. That which is gained and preserved by knowing; instruction; acquaintance; enlightenment; learning; scholarship; erudition. Knowledge puffeth up, but charity edifieth. 1 Cor. viii. 1. Ignorance is the curse of God; -Knowledge, the wing wherewith we fly to heaven. Shak. 4. That familiarity which is gained by actual experience; practical skill; as, a knowledge of life. Shipmen that had knowledge of the sea. 1 Kings ix. 27. 5. Scope of information; cognizance; notice; as, it has not come to my knowledge. Why have I found grace in thine eyes, that thou shouldst take knowledge of me Ruth ii. 10. 6. Sexual intercourse; -- usually preceded by carnal; as, carnal knowledge. Syn. -- See Wisdom.\n\nTo acknowledge. [Obs.] \"Sinners which knowledge their sins.\" Tyndale.
known |of Know.
knubs |Waste silk formed in winding off the threads from a cocoon.
knuckle |1. The joint of a finger, particularly when made prominent by the closing of the fingers. Davenant. 2. The kneejoint, or middle joint, of either leg of a quadruped, especially of a calf; -- formerly used of the kneejoint of a human being. With weary knuckles on thy brim she kneeled sadly down. Golding. 3. The joint of a plant. [Obs.] Bacon. 4. (Mech.)  The joining pars of a hinge through which the pin or rivet passes; a knuckle joint. 5. (Shipbuilding)  A convex portion of a vessel's figure where a sudden change of shape occurs, as in a canal boat, where a nearly vertical side joins a nearly flat bottom. 6. A contrivance, usually of brass or iron, and furnished with points, worn to protect the hand, to add force to a blow, and to disfigure the person struck; as, brass knuckles; -- called also knuckle duster. [Slang.] Knuckle joint (Mach.), a hinge joint, in which a projection with an eye, on one piece, enters a jaw between two corresponding projections with eyes, on another piece, and is retained by a pin which passes through the eyes and forms the pivot. -- Knuckle of veal (Cookery), the lower part of a leg of veal, from the line of the body to the knuckle.\n\nTo yield; to submit; -- used with down, to, or under. To knuckle to. (a) To submit to in a contest; to yield to. [Colloq.] See To knock under, under Knock, v. i. (b) To apply one's self vigorously or earnestly to; as, to knuckle to work. [Colloq.]\n\nTo beat with the knuckles; to pommel. [R.] Horace Smith.
knuckled |Jointed. [Obs.] Bacon.
knuff |A lout; a clown. [Obs.] The country knuffs, Hob, Dick, and Hick, With clubs and clouted shoon. Hayward.
knur |A knurl. Woodward.
knurl |A contorted knot in wood; a crossgrained protuberance; a nodule; a boss or projection. 2. One who, or that which, is crossgrained.\n\nTo provide with ridges, to assist the grasp, as in the edge of a flat knob, or coin; to mill.
knurled |1. Full of knots; gnarled. 2. Milled, as the head of a screw, or the edge of a coin.
knurly |Full of knots; hard; tough; hence, capable of enduring or resisting much.
knurry |Full of knots. [Obs.] Drayton.
koaita |Same as Coaita.
koala |A tailless marsupial (Phascolarctos cinereus), found in Australia. The female carries her young on the back of her neck. Called also Australian bear, native bear, and native sloth.
kob |Any one of several species of African antelopes of the genus Kobus, esp. the species Kobus sing-sing.
koba |Any one of several species of African antelopes of the genus Kobus, esp. the species Kobus sing-sing.
kobalt |See Cobalt.
kobellite |A blackish gray mineral, a sulphide of antimony, bismuth, and lead.
kobold |A kind of domestic spirit in German mythology, corresponding to the Scottish brownie and the English Robin Goodfellow.
kodak |A kind of portable camera.
koel |Any one of several species of cuckoos of the genus Eudynamys, found in India, the East Indies, and Australia. They deposit their eggs in the nests of other birds.
koff |A two-masted Dutch vessel.
koftgari |Ornamental work produced by inlaying steel with gold, -- a variety of damascening much used in the arts of India.
kohinoor |A famous diamond, surrendered to the British crown on the annexation of the Punjab. According to Hindoo legends, it was found in a Golconda mine, and has been the property of various Hindoo and Persian rulers.
kohl |A mixture of soot and other ingredients, used by Egyptian and other Eastern women to darken the edges of the eyelids.
kohl-rabi |A variety of cabbage, in which the edible part is a large, turnip-shaped swelling of the stem, above the surface of the ground.
kohnur |A famous diamond, surrendered to the British crown on the annexation of the Punjab. According to Hindoo legends, it was found in a Golconda mine, and has been the property of various Hindoo and Persian rulers.
kokama |The gemsbok.
koklass |Any pheasant of the genus Pucrasia. The birds of this genus inhabit India and China, and are distinguished by having a long central and two lateral crests on the head. Called also pucras.
kokoon |The gnu.
kola |Same as Cola, Cola nut.
kola nut |Same as Cola, Cola nut.
kolarian |An individual of one of the races of aboriginal inhabitants which survive in Hindostan. -- a.  Of or pertaining to the Kolarians.
kolinsky |Among furriers, any of several Asiatic minks; esp., Putorius sibiricus, the yellowish brown pelt of which is valued, esp. for the tail, used for making artists' brushes. Trade names for the fur are red sable and Tatar sable.
koluschan |Designating, or pert. to, a linguistic stock of North American Indians comprising the Tlinkit tribes of the Alexander Archipelago of southeastern Alaska and adjacent coast lands. Their language bears some affinity to Mexican tongues.
kolushan |Designating, or pert. to, a linguistic stock of North American Indians comprising the Tlinkit tribes of the Alexander Archipelago of southeastern Alaska and adjacent coast lands. Their language bears some affinity to Mexican tongues.
komenic |Of or pertaining to, or designating, an acid derived from meconic acid. [Written also comenic.]
komtok |An African freshwater fish (Protopterus annectens), belonging to the Dipnoi. It can breathe air by means of its lungs, and when waters dry up, it encases itself in a nest of hard mud, where it remains till the rainy season. It is used as food.
kon |To know. See Can, and Con. [Obs.] Ye konnen thereon as much as any man. Chaucer.
konite |See Conite.
konseal |A form of capsule for inclosing a dose of medicine that is offensive, caustic, or the like.
konze |A large African antelope (Alcelaphus Lichtensteini), allied to the hartbeest, but having shorter and flatter horns, and lacking a black patch on the face.
koodoo |A large South African antelope (Strepsiceros kudu). The males have graceful spiral horns, sometimes four feet long. The general color is reddish or grayish brown, with eight or nine white bands on each side, and a pale dorsal stripe. The old males become dark bluish gray, due to the skin showing through the hair. The females are hornless. Called also nellut. [Written also kudu.]
kookoom |The oryx or gemsbok. [Written also kookaam.]
koolokamba |A west African anthropoid ape (Troglodytes koolokamba, or T. Aubryi), allied to the chimpanzee and gorilla, and, in some respects, intermediate between them.
koolslaa |See Coleslaw.
koord |See Kurd.
koordish |See Kurdish.
koorilian |Same as Kurilian.
kop |Hill; mountain. [South Africa]
kopeck |A small Russian coin. One hundred kopecks make a rouble, worth about sixty cents. [Written also kopek, copec, and copeck.]
kopje |A hillock; a small kop. [South Africa] The colloqual Dutch pronunciation as here given is the usual one in South Africa.
koran |The Scriptures of the Mohammedans, containing the professed revelations to Mohammed; -- called also Alcoran. [Written also Kuran or Quran.]
korin |The gazelle.
korrigum |A West African antelope (Damalis Senegalensis), allied to the sassaby. It is reddish gray, with a black face, and a black stripe on the outside of the legs above the knees.
kosher |Ceremonially clean, according to Jewish law; --applied to food, esp. to meat of animals slaughtered according to the requirements of Jewish law. Opposed to tref. Hence, designating a shop, store, house, etc., where such food is sold or used.\n\nKosher food; also, a kosher shop.\n\nTo prepare in conformity with the requirements of the Jewish law, as meat.
kosmos |See Cosmos. Gladstone.
kotow |The prostration made by mandarins and others to their superiors, either as homage or worship, by knocking the forehead on the ground. There are degrees in the rite, the highest being expressed by three knockings. [China]kowtow S. W. Williams.\n\nTo perform the kotow.kowtow
koulan |A wild horse (Equus, or Asinus, onager) inhabiting the plants of Central Asia; -- called also gour, khur, and onager. [Written also kulan.] Note: It is sometimes confounded with the dziggetai, to which it is closely related. It is gray in winter, but fulvous in summer. It has a well defined, dark, dorsal stripe, and a short, erect mane. In size, it is intermediate between the horse and ass.
koumiss |An intoxicating fermented or distilled liquor originally made by the Tartars from mare's or camel's milk. It can be obtained from any kind of milk, and is now largely made in Europe. [Written also koumyss, kumiss, kumish, and kumys.] Koumiss has from time immemorial served the Tartar instead of wine or spirits. J. H. Newman.
kousso |An Abyssinian rosaceous tree (Brayera anthelmintica), the flowers of which are used as a vermifuge. [Written also cusso and kosso.]
kowtow |The same as Kotow. I have salaamed and kowtowed to him. H. James.
kra |A long-tailed ape (Macacus cynomolgus) of India and Sumatra. It is reddish olive, spotted with black, and has a black tail.
kraal |1. A collection of huts within a stockade; a village; sometimes, a single hut. [South Africa] 2. An inclosure into which are driven wild elephants which are to be tamed and educated. [Ceylon]
krait |A very venomous snake of India (Bungarus coeruleus), allied to the cobra. Its upper parts are bluish or brownish black, often with narrow white streaks; the belly is whitish.
kraken |A fabulous Scandinavian sea monster, often represented as resembling an island, but sometimes as resembling an immense octopus. To believe all that has been said of the sea serpent or kraken, would be credulity; to reject the possibility of their existence, would be presumption. Goldsmith. Like a kraken huge and black. Longfellow.
krakowiak |A lively Polish dance. See Cracovienne.
krameria |A genus of spreading shrubs with many stems, from one species of which (K. triandra), found in Peru, rhatany root, used as a medicine, is obtained.
krameric |Pertaining to, or derived from, Krameria (rhatany); as, krameric acid, usually called ratanhia-tannic acid.
krang |The carcass of a whale after the blubber has been removed. [Written also crang and kreng.]
kranging hook |A hook for holding the blubber while cutting it away. [Written also cranging hook.]
kreatic |See Creatic.
kreatin |See Creatin.
kreatinin |See Creatinin.
kreel |See Creel.
kremlin |The citadel of a town or city; especially, the citadel of Moscow, a large inclosure which contains imperial palaces, cathedrals, churches, an arsenal, etc. [Russia]
krems |A variety of white lead. See Krems lead, under Lead, n.
kreng |See Krang.
kreosote |See Creosote.
kreutzer |A small copper coin formerly used in South Germany; also, a small Austrian copper coin. [Written also kreuzer.]
kriegsspiel |A game of war, played for practice, on maps. Farrow.
kris |A Malay dagger. See Creese.
krishna |The most popular of the Hindoo divinities, usually held to be the eighth incarnation of the god Vishnu.
kritarchy |The rule of the judges over Israel. Samson, Jephthah, Gideon, and other heroes of the kritarchy. Southey.
krokidolite |See Crocidolite.
krone |A coin of Denmark, Norway, and Sweden, of the value of about twenty-eight cents. See Crown, n., 9.
krooman |One of a negro tribe of Liberia and the adjacent coast, whose members are much employed on shipboard.
kruller |See Cruller.
krumhorn |(a) A reed instrument of music of the cornet kind, now obsolete (see Cornet, 1, a.) (b) A reed stop in the organ; -- sometimes called cremona.
krummhorn |(a) A reed instrument of music of the cornet kind, now obsolete (see Cornet, 1, a.) (b) A reed stop in the organ; -- sometimes called cremona.
krupp gun |. A breech-loading steel cannon manufactured at the works of Friedrich Krupp, at Essen in Prussia. Guns of over eight-inch bore are made up of several concentric cylinders; those of a smaller size are forged solid. Knight.
krupp process |(a) A process practiced by Friedrich Krupp,  Essen, Germany, for washing pig iron, differing from the Bell process in using manganese as well as iron oxide, and performed in a Pernot furnace. Called also the Bell-Krupp process. (b) A process for the manufacture of steel armor plates, invented or practiced by Krupp, the details of which are secret. It is understood to involve the addition of chromium as well as nickel to the metal, and to include a treatment like that of the Harvey process with unknown variations or additions. The product is mentioned by some authors, as improved Harvey, or Harvey-Krupp armor plate.
kruppize |To treat by, or subject to, the Krupp process.
kryolite |See Cryolite.
krypton |An inert gaseous element of the argon group, occurring in air to the extent of about one volume in a million. It was discovered by Ramsay and Travers in 1898. Liquefying point, -- 152º C.; symbol, Kr; atomic weight, 83.0.
ksar |See Czar.
kshatriya |The military caste, the second of the four great Hindoo castes; also, a member of that caste. See Caste. [India]
kshatruya |The military caste, the second of the four great Hindoo castes; also, a member of that caste. See Caste. [India]
kuda |The East Indian tapir. See Tapir.
kudos |Glory; fame; renown; praise. W. H. Russel.\n\nTo praise; to extol; to glorify. \"Kudos'd egregiously.\" [R.] Southey.
kudu |See Koodoo.
kufic |See Cufic.
kukang |The slow lemur. See Lemur.
kuklux |The name adopted in the southern part of the United States by a secret political organization, active for several years after the close of the Civil War, and having for its aim the repression of the political power of the freedmen; -- called also Kuklux Klan.
kulan |See Koulan.
kulturkampf |Lit., culture war; -- a name, originating with Virchow (1821 -- 1902), given to a struggle between the the Roman Catholic Church and the German government, chiefly over the latter's efforts to control educational and ecclesiastical appointments in the interest of the political policy of centralization. The struggle began with the passage by the Prussian Diet in May, 1873, of the so-called May laws, or Falk laws, aiming at the regulation of the clergy. Opposition eventually compelled the government to change its policy, and from 1880 to 1887 laws virtually nullifying the May laws were enacted.
kumish |See Koumiss.
kumiss |See Koumiss.
kummel |A Russian and German liqueur, consisting of a sweetened spirit flavored with caraway seeds.
kumquat |A small tree of the genus Citrus (C. Japonica) growing in China and Japan; also, its small acid, orange-colored fruit used for preserves.
kupfernickel |Copper-nickel; niccolite. See Niccolite.
kurd |A native or inhabitant of a mountainous region of Western Asia belonging to the Turkish and Persian monarchies. [Written also Koord.]
kurdish |Of or pertaining to the Kurds. [Written also Koordish.]
kurilian |Of or pertaining to the Kurile Islands, a chain of islands in the Pacific ocean, extending from the southern extremity of Kamschatka to Yesso. -- n.  A native or an inhabitant of the Kurile Islands. [Written also Koorilian.]
kuro-siwo |See Japan Current, above.
kursaal |A public hall or room, for the use of visitors at watering places and health resorts in Germany.
kusimanse |A carnivorous animal (Crossarchus obscurus) of tropical Africa. It its allied to the civets. Called also kusimansel, and mangue.
kuskus |See Vetiver.
kussier |(Mus.) A Turkish instrument of music, with a hollow body covered with skin, over which five strings are stretched. [Written also kussir.]
kutauss |The India civet (Viverra zibetha).
kutch |The packet of vellum leaves in which the gold is first beaten into thin sheets.\n\nSee Catechu.
ky |Kine. [Scot.] See Kee, Kie, and Kine.
kyaboca wood |(a) Amboyna wood. (b) Sandalwood (Santalum album).
kyack |A pack sack to be swung on either side of a packsaddle. [Western U. S.]
kyanite |See Cyanite.
kyanize |To render (wood) proof against decay by saturating with a solution of corrosive sublimate in open tanks, or under pressure.
kyanol |(a) Aniline. [Obs.] (b) A base obtained from coal tar. Ure.
kyanophyll |Same as Cyanophyll.
kyar |Cocoanut fiber, or the cordage made from it. See Coir.
kyaw |A daw. [Scot.]
kyd |p. p. of Kythe.
kydde |imp. of Kythe, to show. [Obs.] Chaucer. Note: Spenser erroneously uses kydst to mean \"knowest.\",
  "pillwort |Any plant of the genus Pilularia; minute aquatic cryptograms, with small pill-shaped fruit; -- sometimes called peppergrass.
kyke |To look steadfastly; to gaze. [Obs.] [Written also kike, keke.] This Nicholas sat ever gaping upright, As he had kyked on the newe moon. Chaucer.
kyley |A variety of the boomerang.
kyloes |The cattle of the Hebrides, or of the Highlands. [Scot.] Sir W. Scott.
kymnel |See Kimnel. [Obs.] Chapman.
kymograph |An instrument for measuring, and recording graphically, the pressure of the blood in any of the blood vessels of a living animal; -- called also kymographion.
kymographic |Of or pertaining to a kymograph; as, a kymographic tracing.
kymric |See Cymric, a. & n.
kymry |See Cymry.
kynrede |Kindred. [Obs.] Chaucer.
kynurenic |Pertaining to, or designating, an acid obtained from the urine of dogs. By decomposition the acid yields a nitrogenous base (called kynurin) and carbonic acid. [Written also cynurenic.]
kyrie |See Kyrie eleison.
kyrie eleison |1. (R. C. Ch.)  Greek words, meaning \"Lord, have mercy upon us,\" used in the Mass, the breviary offices, the litany of the saints, etc. Addis & Arnold. 2. The name given to the response to the Commandments, in the service of the Church of England and of the Protestant Episcopal Church.
kyrielle |A litany beginning with the words. \"Kyrie eleison.\" Shipley.
kyriolexy |The use of literal or simple expressions, as distinguished from the use of figurative or obscure ones. Krauth-Fleming.
kyriological |Serving to denote objects by conventional signs or alphabetical characters; as, the original Greek alphabet of sixteen letters was called kyriologic, because it represented the pure elementary sounds. See Curiologic. [Written also curiologic and kuriologic.] Note: The term is also applied, as by Warburton, to those Egyptian hieroglyphics, in which a part is put conventionally for the whole, as in depicting a battle by two hands, one holding a shield and the other a bow.
kyriology |The use of literal or simple expressions, as distinguished from the use of figurative or obscure ones. Krauth-Fleming.
kythe |To make known; to manifest; to show; to declare. [Obs: or Scot.] For gentle hearte kytheth gentilesse. Chaucer.\n\nTo come into view; to appear. [Scot.] It kythes bright . . . because all is dark around it. Sir W. Scott.
kytomiton |See Karyomiton.
kytoplasma |See Karyoplasma.
l |1. L is the twelfth letter of the English alphabet, and a vocal consonant. It is usually called a semivowel or liquid. Its form and value are from the Greek, through the Latin, the form of the Greek letter being from the Phoenician, and the ultimate origin prob. Egyptian. Etymologically, it is most closely related to r and u; as in pilgrim, peregrine, couch (fr. collocare), aubura (fr. LL. alburnus). Note: At the end of monosyllables containing a single vowel, it is often doubled, as in fall, full, bell; but not after digraphs, as in foul, fool, prowl, growl, foal. In English words, the terminating syllable le is unaccented, the e is silent, and l is preceded by a voice glide, as in able, eagle, pronounced a''b'l, ''g'l. See Guide to Pronunciation, § 241. 2. As a numeral, L stands for fifty in the English, as in the Latin language. For 50 the Romans used the Chalcidian chi, I. Taylor (The Alphabet).\n\n1. An extension at right angles to the length of a main building, giving to the ground plan a form resembling the letter L; sometimes less properly applied to a narrower, or lower, extension in the direction of the length of the main building; a wing. [Written also ell.] 2. (Mech.)  A short right-angled pipe fitting, used in connecting two pipes at right angles. [Written also ell.]
la |(a) A syllable applied to the sixth tone of the scale in music in solmization. (b) The tone A; -- so called among the French and Italians.\n\n1. Look; see; behold; -- sometimes followed by you. [Obs.] Shak. 2. An exclamation of surprise; -- commonly followed by me; as, La me! [Low]
la valliere |A neck ornament consisting of a chain and single pendant, or drop.
laager |A camp, esp. one with an inclosure of travelers' wagons for temporary defense. [South Africa] Wagons . . . can be readily formed into a laager, a camp, by being drawn into a circle, with the oxen placed inside and so kept safe from the attacks of wild beasts. James Bryce.\n\nTo form into, or camp in, a laager, or protected camp.
laas |A lace. See Lace. [Obs.] Chaucer.
lab |To prate; to gossip; to babble; to blab. [Obs.] Chaucer.\n\nA telltale; a prater; a blabber. [Obs.] \"I am no lab.\" Chaucer.
labadist |A follower of Jean de Labadie, a religious teacher of the 17th century, who left the Roman Catholic Church and taught a kind of mysticism, and the obligation of community of property among Christians. LABARRAQUE'S SOLUTION La`bar`raque's\" so*lu\"tion. Etym: [From Labarraque, a Parisian apothecary.] (Med.)  An aqueous solution of hypochlorite of sodium, extensively used as a disinfectant.
labarum |The standard adopted by the Emperor Constantine after his conversion to Christianity. It is described as a pike bearing a silk banner hanging from a crosspiece, and surmounted by a golden crown. It bore a monogram of the first two letters (CHR) of the name of Christ in its Greek form. Later, the name was given to various modifications of this standard.
labdanum |See Ladanum.
labefaction |The act of labefying or making weak; the state of being weakened; decay; ruin. There is in it such a labefaction of all principles as may be injurious to morality. Johnson.
labefy |To weaken or impair. [R.]
label |1. A tassel. [Obs.] Huloet. Fuller. 2. A slip of silk, paper, parchment, etc., affixed to anything, usually by an inscription, the contents, ownership, destination, etc.; as, the label of a bottle or a package. 3. A slip of ribbon, parchment, etc., attached to a document to hold the appended seal; also, the seal. 4. A writing annexed by way of addition, as a codicil added to a will. 5. (Her.)  A barrulet, or, rarely, a bendlet, with pendants, or points, usually three, especially used as a mark of cadency to distinguish an eldest or only son while his father is still living. 6. A brass rule with sights, formerly used, in connection with a circumferentor, to take altitudes. Knight. 7. (Gothic Arch.)  The name now generally given to the projecting molding by the sides, and over the tops, of openings in mediæval architecture. It always has a Arch. Pub. Soc. 8. In mediæval art, the representation of a band or scroll containing an inscription. Fairholt.\n\n1. To affix a label to; to mark with a name, etc.; as, to label a bottle or a package. 2. To affix in or on a label. [R.]
labeler |One who labels. [Written also labeller.]
labellum |1. (Bot.)  The lower or apparently anterior petal of an orchidaceous flower, often of a very curious shape. 2. (Zoöl.)  A small appendage beneath the upper lip or labrum of certain insects.
labent |Slipping; sliding; gliding. [R.]
labia |See Labium.
labial |1. Of or pertaining to the lips or labia; as, labial veins. 2. (Mus.)  Furnished with lips; as, a labial organ pipe. 3. (Phonetics) (a) Articulated, as a consonant, mainly by the lips, as b, p, m, w. (b) Modified, as a vowel, by contraction of the lip opening, as oo (food), o (old), etc., and as eu and u in French, and ö, ü in German. See Guide to Pronunciation, 4. (Zoöl.)  Of or pertaining to the labium; as, the labial palpi of insects. See Labium.\n\n1. (Phonetics)  A letter or character representing an articulation or sound formed or uttered chiefly with the lips, as b, p, w. 2. (Mus.)  An organ pipe that is furnished with lips; a flue pipe. 3. (Zoöl.)  One of the scales which border the mouth of a fish or reptile.
labialism |The quality of being labial; as, the labialism of an articulation; conversion into a labial, as of a sound which is different in another language. J. Peile.
labialization |The modification of an articulation by contraction of the lip opening.
labialize |To modify by contraction of the lip opening.
labially |In a labial manner; with, or by means of, the lips.
labiate |To labialize. Brewer.\n\n(a) Having the limb of a tubular corolla or calyx divided into two unequal parts, one projecting over the other like the lips of a mouth, as in the snapdragon, sage, and catnip. (b) Belonging to a natural order of plants (Labiatæ), of which the mint, sage, and catnip are examples. They are mostly aromatic herbs.\n\nA plant of the order Labiatæ.
labiated |Same as Labiate, a. (a).
labiatifloral |Having labiate flowers, as the snapdragon.\n\nHaving labiate flowers, as the snapdragon.
labidometer |A forceps with a measuring attachment for ascertaining the size of the fetal head.
labile |Liable to slip, err, fall, or apostatize. [Obs.] Cheyne.
lability |Liability to lapse, err, or apostatize. [Archaic] Coleridge.
labimeter |See Labidometer.
labiodental |Formed or pronounced by the cooperation of the lips and teeth, as f and v. -- n.  A labiodental sound or letter.
labionasal |Formed by the lips and the nose. -- n.  A labionasal sound or letter.
labioplasty |A plastic operation for making a new lip, or for replacing a lost tissue of a lip.
labiose |Having the appearance of being labiate; -- said of certain polypetalous corollas.
labipalp |A labial palp.
labipalpus |One of the labial palpi of an insect. See Illust. under Labium.
labium |1. A lip, or liplike organ. 2. The lip of an organ pipe. 3. pl. (Anat.)  The folds of integument at the opening of the vulva. 4. (Zoöl.) (a) The organ of insects which covers the mouth beneath, and serves as an under lip. It consists of the second pair of maxillæ, usually closely united in the middle line, but bearing a pair of palpi in most insects. It often consists of a thin anterior part (ligula or palpiger) and a firmer posterior plate (mentum). (b) Inner margin of the aperture of a shell.
lablab |an East Indian name for several twining leguminous plants related to the bean, but commonly applied to the hyacinth bean (Delichos Lablab).
labor |1. Physical toil or bodily exertion, especially when fatiguing, irksome, or unavoidable, in distinction from sportive exercise; hard, muscular effort directed to some useful end, as agriculture, manufactures, and like; servile toil; exertion; work. God hath set Labor and rest, as day and night, to men Successive. Milton. 2. Intellectual exertion; mental effort; as, the labor of compiling a history. 3. That which requires hard work for its accomplishment; that which demands effort. Being a labor of so great a difficulty, the exact performance thereof we may rather wish than look for. Hooker. 4. Travail; the pangs and efforts of childbirth. The queen's in labor, They say, in great extremity; and feared She'll with the labor end. Shak. 5. Any pang or distress. Shak. 6. (Naut.)  The pitching or tossing of a vessel which results in the straining of timbers and rigging. 7. Etym: [Sp.]  A measure of land in Mexico and Texas, equivalent to an area of 177 Bartlett. Syn. -- Work; toil; drudgery; task; exertion; effort; industry; painstaking. See Toll.\n\n1. To exert muscular strength; to exert one's strength with painful effort, particularly in servile occupations; to work; to toil. Adam, well may we labor still to dress This garden. Milton. 2. To exert one's powers of mind in the prosecution of any design; to strive; to take pains. 3. To be oppressed with difficulties or disease; to do one's work under conditions which make it especially hard, wearisome; to move slowly, as against opposition, or under a burden; to be burdened; -- often with under, and formerly with of. The stone that labors up the hill. Granville. The line too labors,and the words move slow. Pope. To cure the disorder under which he labored. Sir W. Scott. Come unto me, all ye that labor and are heavy laden, and I will give you rest. Matt. xi. 28 4. To be in travail; to suffer the pangs of childbirth. 5. (Naut.)  To pitch or roll heavily, as a ship in a turbulent sea. Totten.\n\n1. To work at; to work; to till; to cultivate by toil. The most excellent lands are lying fallow, or only labored by children. W. Tooke. 2. To form or fabricate with toil, exertion, or care. \"To labor arms for Troy.\" Dryden. 3. To prosecute, or perfect, with effort; to urge streas, to labor a point or argument. 4. To belabor; to beat. [Obs.] Dryden.
labor day |In most of the States and Territories of the United States, a day, usually the first Monday of September, set aside as a legal holiday, in honor of, or in the interest of, workingmen as a class. Also, a similar holiday in Canada, Australia, etc.
labor-saving |Saving labor; adapted to supersede or diminish the labor of men; as, laborsaving machinery.
laborant |A chemist. [Obs.] Boyle.
laboratory |The workroom of a chemist; also, a place devoted to experiments in any branch of natural science; as, a chemical, physical, or biological laboratory. Hence, by extension, a place where something is prepared, or some operation is performed; as, the liver is the laboratory of the bile.
labored |Bearing marks of labor and effort; elaborately wrought; not easy or natural; as, labored poetry; a labored style.
laboredly |In a labored manner; with labor.
laborer |One who labors in a toilsome occupation; a person who does work that requires strength rather than skill, as distinguished from that of an artisan.
laboring |1. That labors; performing labor; esp., performing coarse, heavy work, not requiring skill also, set apart for labor; as, laboring days. The sleep of a laboring man is sweet. eccl. v. 12. 2. Suffering pain or grief. Pope. Laboring oar, the oar which requires most strength and exertion; often used figuratively; as, to have, or pull, the laboring oar in some difficult undertaking.
laborious |1. Requiring labor, perseverance, or sacrifices; toilsome; tiresome. Dost thou love watchings, abstinence, or toil, Laborious virtues all Learn these from Cato. Addison. 2. Devoted to labor; diligent; industrious; as, a laborious mechanic. -- La*bo\"ri*ous*ly, adv. -- La*bo\"ri*ous*ness, n.
laborless |Not involving labor; not laborious; easy.
laborous |Laborious. [Obs.] Wyatt. -- La\"bor*ous*ly, adv. [Obs.] Sir T. Elyot.
laborsome |1. Made with, or requiring, great labor, pains, or diligence. [Obs.] Shak. 2. (Naut.)  Likely or inclined to roll or pitch, as a ship in a heavy sea; having a tendency to labor.
labrador |A region of British America on the Atlantic coast, north of Newfoundland. Labrador duck (Zoöl.), a sea duck (Camtolaimus Labradorius) allied to the eider ducks. It was formerly common on the coast of New England, but is now supposed to be extinct, no specimens having been reported since 1878. -- Labrador feldspar. See Labradorite. -- Labrador tea (Bot.), a name of two low, evergreen shrubs of the genus Ledum (L. palustre and L. latifolium), found in Northern Europe and America. They are used as tea in British America, and in Scandinavia as a substitute for hops.
labradorite |A kind of feldspar commonly showing a beautiful play of colors, and hence much used for ornamental purposes. The finest specimens come from Labrador. See Feldspar.
labras |Lips. [Obs. & R.] Shak.
labret |A piece of wood, shell, stone, or other substance, worn in a perforation of the lip or cheek by many savages.
labroid |Like the genus Labrus; belonging to the family Labridæ, an extensive family of marine fishes, often brilliantly colored, which are very abundant in the Indian and Pacific Oceans. The tautog and cunner are American examples.
labrose |Having thick lips.
labrum |1. A lip or edge, as of a basin. 2. (Zoöl.) (a) An organ in insects and crustaceans covering the upper part of the mouth, and serving as an upper lip. See Illust. of Hymenoptera. (b) The external margin of the aperture of a shell. See Univalve.
labrus |A genus of marine fishes, including the wrasses of Europe. See Wrasse.
laburnic |Of, pertaining to, or derived from, the laburnum.
laburnine |A poisonous alkaloid found in the unripe seeds of the laburnum.
laburnum |A small leguminous tree (Cytisus Laburnum), native of the Alps. The plant is reputed to be poisonous, esp. the bark and seeds. It has handsome racemes of yellow blossoms. Note: Scotch laburnum (Cytisus alpinus) is similar, but has smooth leaves; purple laburnum is C. purpureus.
labyrinth |1. An edifice or place full of intricate passageways which render it difficult to find the way from the interior to the entrance; as, the Egyptian and Cretan labyrinths. 2. Any intricate or involved inclosure; especially, an ornamental maze or inclosure in a park or garden. 3. Any object or arrangement of an intricate or involved form, or having a very complicated nature. The serpent . . . fast sleeping soon he found, In labyrinth of many a round self-rolled. Milton. The labyrinth of the mind. Tennyson. 4. An inextricable or bewildering difficulty. I' the maze and winding labyrinths o' the world. Denham. 5. (Anat.)  The internal ear. See Note under Ear. 6. (Metal.)  A series of canals through which a stream of water is directed for suspending, carrying off, and depositing at different distances, the ground ore of a metal. Ure. 7. (Arch.)  A pattern or design representing a maze, -- often inlaid in the tiled floor of a church, etc. Syn. -- Maze; confusion; intricacy; windings. -- Labyrinth, Maze. Labyrinth, originally; the name of an edifice or excavation, carries the idea of design, and construction in a permanent form, while maze is used of anything confused or confusing, whether fixed or shifting. Maze is less restricted in its figurative uses than labyrinth. We speak of the labyrinth of the ear, or of the mind, and of a labyrinth of difficulties; but of the mazes of the dance, the mazes of political intrigue, or of the mind being in a maze.
labyrinthal |Pertaining to, or resembling, a labyrinth; intricate; labyrinthian.
labyrinthian |Intricately winding; like a labyrinth; perplexed; labyrinthal.
labyrinthibranch |Of or pertaining to the Labyrinthici. -- n.  One of the Labyrinthici.
labyrinthic |Like or pertaining to a labyrinth.
labyrinthical |Like or pertaining to a labyrinth.
labyrinthici |An order of teleostean fishes, including the Anabas, or climbing perch, and other allied fishes. Note: They have, connected with the gill chamber, a special cavity in which a labyrinthiform membrane is arranged so as to retain water to supply the gills while the fish leaves the water and travels about on land, or even climbs trees.
labyrinthiform |Having the form of a labyrinth; intricate.
labyrinthine |Pertaining to, or like, a labyrinth; labyrinthal.
labyrinthodon |A genus of very large fossil amphibians, of the Triassic period, having bony plates on the under side of the body. It is the type of the order Labyrinthodonta. Called also Mastodonsaurus.
labyrinthodont |Of or pertaining to the Labyrinthodonta. -- n.  One of the Labyrinthodonta.
labyrinthodonta |An extinct order of Amphibia, including the typical genus Labyrinthodon, and many other allied forms, from the Carboniferous, Permian, and Triassic formations. By recent writers they are divided into two or more orders. See Stegocephala.
lac |One hundred thousand; also, a vaguely great number; as, a lac of rupees. [Written also lack.] [East Indies]\n\nA resinous substance produced mainly on the banyan tree, but to some extent on other trees, by the Coccus lacca, a scale-shaped insect, the female of which fixes herself on the bark, and exudes from the margin of her body this resinous substance. Note: Stick-lac is the substance in its natural state, incrusting small twigs. When broken off, and the coloring matter partly removed, the granular residuum is called seed-lac. When melted, and reduced to a thin crust, it is called shell-lac or shellac. Lac is an important ingredient in sealing wax, dyes, varnishes, and lacquers. Ceylon lac, a resinous exudation of the tree Croton lacciferum, resembling lac. -- Lac dye, a scarlet dye obtained from stick-lac. -- Lac lake, the coloring matter of lac dye when precipitated from its solutions by alum. -- Mexican lac, an exudation of the tree Croton Draco.
laccic |Pertaining to lac, or produced from it; as, laccic acid.
laccin |A yellow amorphous substance obtained from lac.
laccolite |A mass of igneous rock intruded between sedimentary beds and resulting in a mammiform bulging of the overlying strata. -- Lac`co*lit\"ic, a.
laccolith |A mass of igneous rock intruded between sedimentary beds and resulting in a mammiform bulging of the overlying strata. -- Lac`co*lit\"ic, a.
lace |1. That which binds or holds, especially by being interwoven; a string, cord, or band, usually one passing through eyelet or other holes, and used in drawing and holding together parts of a garment, of a shoe, of a machine belt, etc. His hat hung at his back down by a lace. Chaucer. For striving more, the more in laces strong Himself he tied. Spenser. 2. A snare or gin, especially one made of interwoven cords; a net. [Obs.] Fairfax. Vulcanus had caught thee [Venus] in his lace. Chaucer. 3. A fabric of fine threads of linen, silk, cotton, etc., often ornamented with figures; a delicate tissue of thread, much worn as an ornament of dress. Our English dames are much given to the wearing of costlylaces. Bacon. 4. Spirits added to coffee or some other beverage. [Old Slang] Addison. Alencon lace, a kind of point lace, entirely of needlework, first made at Alencon in France, in the 17th century. It is very durable and of great beauty and cost. -- Bone lace, Brussels lace, etc. See under Bone, Brussels, etc. -- Gold lace, or Silver lace, lace having warp threads of silk, or silk and cotton, and a weft of silk threads covered with gold (or silver), or with gilt. -- Lace leather, thin, oil-tanned leather suitable for cutting into lacings for machine belts. -- Lace lizard (Zoöl.), a large, aquatic, Australian lizard (Hydrosaurus giganteus), allied to the monitors. -- Lace paper, paper with an openwork design in imitation of lace. -- Lace piece (Shipbuilding), the main piece of timber which supports the beak or head projecting beyond the stem of a ship. -- Lace pillow, and Pillow lace. See under Pillow.\n\n1. To fasten with a lace; to draw together with a lace passed through eyelet holes; to unite with a lace or laces, or, figuratively. with anything resembling laces. Shak. When Jenny's stays are newly laced. Prior. 2. To adorn with narrow strips or braids of some decorative material; as, cloth laced with silver. Shak. 3. To beat; to lash; to make stripes on. [Colloq.] I'll lace your coat for ye. L'Estrange. 4. To add spirits to (a beverage). [Old Slang]\n\nTo be fastened with a lace, or laces; as, these boots lace.
lace-bark |A shrub in the West Indies (Lagetta Iintearia); -- so called from the lacelike layers of its inner bark.
lace-winged |Having thin, transparent, reticulated wings; as, the lace- winged flies.
laced |1. Fastened with a lace or laces; decorated with narrow strips or braid. See Lace, v. t. 2. Decorated with the fabric lace. A shirt with laced ruffles. Fielding. Laced mutton, a prostitute. [Old slang] -- Laced stocking, a strong stocking which can be tightly laced; -- used in cases of weak legs, varicose veins, etc. Dunglison.
lacedaemonian |Of or pertaining to Lacedæmon or Sparta, the chief city of Laconia in the Peloponnesus. -- n.  A Spartan. [Written also Lacedemonian.]
laceman |A man who deals in lace.
lacerable |That can be lacerated or torn.
lacerate |To tear; to rend; to separate by tearing; to mangle; as, to lacerate the flesh. Hence: To afflict; to torture; as, to lacerate the heart.\n\n1. Rent; torn; mangled; as, a lacerated wound. By each other's fury lacerate Southey. 2. (Bot. & Zoöl.)  Jagged, or slashed irregularly, at the end, or along the edge.
lacerated |1. Rent; torn; mangled; as, a lacerated wound. By each other's fury lacerate Southey. 2. (Bot. & Zoöl.)  Jagged, or slashed irregularly, at the end, or along the edge.
laceration |1. The act of lacerating. 2. A breach or wound made by lacerating. Arbuthnot.
lacerative |Lacerating, or having the power to lacerate; as, lacerative humors. Harvey.
lacert |A muscle of the human body. [Obs.] Chaucer.
lacerta |A fathom. [Obs.] Domesday Book.\n\n1. (Zoöl.)  A genus of lizards. See Lizard. Note: Formerly it included nearly all the known lizards. It is now restricted to certain diurnal Old World species, like the green lizard (Lacerta viridis) and the sand lizard (L. agilis), of Europe. 2. (Astron.)  The Lizard, a northern constellation.
lacertian |Like a lizard; of or pertaining to the Lacertilia. -- n.  One of the Lacertilia.
lacertilia |An order of Reptilia, which includes the lizards. Note: They are closely related to the snakes, and life the latter, usually have the body covered with scales or granules. They usually have eyelids, and most of then have well-formed legs; but in some groups (amphisbæna, glass-snake, etc.) the legs are wanting and the body is serpentlike. None are venomous, unless Heloderma be an exception. The order includes the chameleons, the Cionocrania, or typical lizards, and the amphisbænas. See Amphisbæna, Gecko, Gila monster, and Lizard.
lacertilian |Same as Lacertian.
lacertiloid |Like or belonging to the Lacertilia.
lacertine |Lacertian.
lacertus |A bundle or fascicle of muscular fibers.
lacewing |Any one of several species of neuropterous insects of the genus Chrysopa and allied genera. They have delicate, lacelike wings and brilliant eyes. Their larvæ are useful in destroying aphids. Called also lace-winged fly, and goldeneyed fly.
lache |Neglect; negligence; remissness; neglect to do a thing at the proper time; delay to assert a claim. It ill became him to take advantage of such a laches with the eagerness of a shrewd attorney. Macaulay.
laches |Neglect; negligence; remissness; neglect to do a thing at the proper time; delay to assert a claim. It ill became him to take advantage of such a laches with the eagerness of a shrewd attorney. Macaulay.
lachrymable |Lamentable. Martin Parker.
lachrymae christi |A rich, sweet, red Neapolitan wine.
lachrymal |1. Of or pertaining to tears; as, lachrymal effusions. 2. (Anat.) (a) Pertaining to, or secreting, tears; as, the lachrymal gland. (b) Pertaining to the lachrymal organs; as, lachrymal bone; lachrymal duct.\n\nSee Lachrymatory.
lachrymals |Tears; also, lachrymal feelings or organs. [Colloq.] People go to the theaters to have . . . their risibles and lachrymals set agoing. The Lutheran.
lachrymary |Containing, or intended to contain, tears; lachrymal. Addison.
lachrymate |To weep. [R.] Blount.
lachrymation |The act of shedding tears; weeping.
lachrymatory |A \"tear-bottle;\" a narrow-necked vessel found in sepulchers of the ancient Romans; -- so called from a former notion that the tears of the deceased person's friends were collected in it. Called also lachrymal or lacrymal.
lachrymiform |Having the form of a tear; tear-shaped.
lachrymose |Generating or shedding tears; given to shedding tears; suffused with tears; tearful. You should have seen his lachrymose visnomy. Lamb. -- Lach\"ry*mose`ly, adv.
lacing |1. The act of securing, fastening, or tightening, with a lace or laces. 2. A lace; specifically (Mach.), a thong of thin leather for uniting the ends of belts. 3. A rope or line passing through eyelet holes in the edge of a sail or an awning to attach it to a yard, gaff, etc. 4. (Bridge Building)  A system of bracing bars, not crossing each other in the middle, connecting the channel bars of a compound strut. Waddell.
lacinia |1. (Bot.) (a) One of the narrow, jagged, irregular pieces or divisions which form a sort of fringe on the borders of the petals of some flowers. (b) A narrow, slender portion of the edge of a monophyllous calyx, or of any irregularly incised leaf. 2. (Zoöl.)  The posterior, inner process of the stipes on the maxillæ of insects.
laciniate |1. Fringed; having a fringed border. 2. (Bot. & Zoöl.)  Cut into deep, narrow, irregular lobes; slashed.
laciniated |1. Fringed; having a fringed border. 2. (Bot. & Zoöl.)  Cut into deep, narrow, irregular lobes; slashed.
laciniolate |Consisting of, or abounding in, very minute laciniæ.
lacinula |A diminutive lacinia.
lack |1. Blame; cause of blame; fault; crime; offense. [Obs.] Chaucer. 2. Deficiency; want; need; destitution; failure; as, a lack of sufficient food. She swooneth now and now for lakke of blood. Chaucer. Let his lack of years be no impediment. Shak.\n\n1. To blame; to find fault with. [Obs.] Love them and lakke them not. Piers Plowman. 2. To be without or destitute of; to want; to need. If any of you lack wisdom, let him ask of God. James i. 5.\n\n1. To be wanting; often, impersonally, with of, meaning, to be less than, short, not quite, etc. What hour now I think it lacks of twelve. Shak. Peradventure there shall lack five of the fifty. Gen. xvii. 28. 2. To be in want. The young lions do lack, and suffer hunger. Ps. xxxiv. 10.\n\nExclamation of regret or surprise. [Prov. Eng.] Cowper.
lackadaisical |Affectedly pensive; languidly sentimental. -- Lack`a*dai\"si*cal*ly, adv.
lackadaisy |An expression of languor.\n\nLackadaisical.
lackaday |Alack the day; alas; -- an expression of sorrow, regret, dissatisfaction, or surprise.
lackbrain |One who is deficient in understanding; a witless person. Shak.
lacker |One who lacks or is in want.\n\nSee Lacquer.
lackey |An attending male servant; a footman; a servile follower. Like a Christian footboy or a gentleman's lackey. Shak. Lackey caterpillar (Zoöl.), the caterpillar, or larva, of any bombycid moth of the genus Clisiocampa; -- so called from its party- colored markings. The common European species (C. neustria) is striped with blue, yellow, and red, with a white line on the back. The American species (C. Americana and C. sylvatica) are commonly called tent caterpillars. See Tent caterpillar,under Tent. -- Lackey moth (Zoöl.), the moth which produces the lackey caterpillar.\n\nTo attend as a lackey; to wait upon. A thousand liveried angels lackey her. Milton.\n\nTo act or serve as lackey; to pay servile attendance.
lackluster |A want of luster. -- a.  Wanting luster or brightness. \"Lackluster eye.\" Shak.
lacklustre |A want of luster. -- a.  Wanting luster or brightness. \"Lackluster eye.\" Shak.
lacmus |See Litmus.
laconian |Of or pertaining to Laconia, a division of ancient Greece; Spartan. -- n.  An inhabitant of Laconia; esp., a Spartan.
laconic |1. Expressing much in few words, after the manner of the Laconians or Spartans; brief and pithy; brusque; epigrammatic. In this sense laconic is the usual form. I grow laconic even beyond laconicism; for sometimes I return only yes, or no, to questionary or petitionary epistles of half a yard long. Pope. His sense was strong and his style laconic. Welwood. 2. Laconian; characteristic of, or like, the Spartans; hence, stern or severe; cruel; unflinching. His head had now felt the razor, his back the rod; all that laconical discipline pleased him well. Bp. Hall. Syn. -- Short; brief; concise; succinct; sententious; pointed; pithy. -- Laconic, Concise. Concise means without irrelevant or superfluous matter; it is the opposite of diffuse. Laconic means concise with the additional quality of pithiness, sometimes of brusqueness.\n\nLaconism. [Obs.] Addison.
laconical |1. Expressing much in few words, after the manner of the Laconians or Spartans; brief and pithy; brusque; epigrammatic. In this sense laconic is the usual form. I grow laconic even beyond laconicism; for sometimes I return only yes, or no, to questionary or petitionary epistles of half a yard long. Pope. His sense was strong and his style laconic. Welwood. 2. Laconian; characteristic of, or like, the Spartans; hence, stern or severe; cruel; unflinching. His head had now felt the razor, his back the rod; all that laconical discipline pleased him well. Bp. Hall. Syn. -- Short; brief; concise; succinct; sententious; pointed; pithy. -- Laconic, Concise. Concise means without irrelevant or superfluous matter; it is the opposite of diffuse. Laconic means concise with the additional quality of pithiness, sometimes of brusqueness.\n\nSee Laconic, a.
laconically |In a laconic manner.
laconicism |Same as Laconism. Pope.
laconism |1. A vigorous, brief manner of expression; laconic style. 2. An instance of laconic style or expression.
laconize |To imitate the manner of the Laconians, especially in brief, pithy speech, or in frugality and austerity.
lacquer |A varnish, consisting of a solution of shell-lac in alcohol, often colored with gamboge, saffron, or the like; -- used for varnishing metals, papier-maché, and wood. The name is also given to varnishes made of other ingredients, esp. the tough, solid varnish of the Japanese, with which ornamental objects are made.\n\nTo cover with lacquer. \"Lacquer'd chair.\" Pope.
lacquerer |One who lacquers, especially one who makes a business of lacquering.
lacquering |The act or business of putting on lacquer; also, the coat of lacquer put on.
lacrimoso |Plaintive; -- a term applied to a mournful or pathetic movement or style. Moore.
lacrosse |A game of ball, originating among the North American Indians, now the popular field sport of Canada, and played also in England and the United States. Each player carries a long-handled racket, called a \"crosse\". The ball is not handled but caught with the crosse and carried on it, or tossed from it, the object being to carry it or throw it through one of the goals placed at opposite ends of the field.
lacrymal |See Lachrymatory, n., and Lachrymal, a.
lacrymary |See Lachrymary, Lachrymatory, Lachrymose.
lacrymose |See Lachrymary, Lachrymatory, Lachrymose.
lacrytory |See Lachrymary, Lachrymatory, Lachrymose.
lactage |The produce of animals yielding milk; milk and that which is made from it.
lactam |One of a series of anhydrides of an amido type, analogous to the lactones, as oxindol.
lactamic |Pertaining to, or designating, an amido acid related to lactic acid, and called also amido-propionic acid.
lactamide |An acid amide derived from lactic acid, and obtained as a white crystalline substance having a neutral reaction. It is metameric with alanine.
lactant |Suckling; giving suck.
lactarene |A preparation of casein from milk, used in printing calico.
lactary |Milky; full of white juice like milk. [Obs.] \"Lactary or milky plants.\" Sir T. Browne.\n\na dairyhouse. [R.]
lactate |A salt of lactic acid.
lactation |A giving suck; the secretion and yielding of milk by the mammary gland.
lacteal |1. Pertaining to, or resembling, milk; milky; as, the lacteal fluid. 2. (Anat. & Physiol.)  Pertaining to, or containing, chyle; as, the lacteal vessels.\n\nOne of the lymphatic vessels which convey chyle from the small intestine through the mesenteric glands to the thoracic duct; a chyliferous vessel.
lacteally |Milkily; in the manner of milk.
lactean |1. Milky; consisting of, or resembling, milk. \"This lactean whiteness.\" Moxon. 2. (Anat. & Physiol.)  Lacteal; conveying chyle.
lacteous |1. Milky; resembling milk. \"The lacteous circle.\" Sir T. Browne. 2. Lacteal; conveying chyle; as, lacteous vessels.
lacteously |In a lacteous manner; after the manner of milk.
lactescence |1. The state or quality of producing milk, or milklike juice; resemblance to milk; a milky color. This lactescence does commonly ensue when . . . fair water is suddenly poured upon the solution. Boyle. 2. (Bot.)  The latex of certain plants. See Latex.
lactescent |1. Having a milky look; becoming milky. [Obs.] 2. (Bot.)  Producing milk or a milklike juice or fluid, as the milkweed. See Latex.
lactic |Of or pertaining to milk; procured from sour milk or whey; as, lactic acid; lactic fermentation, etc. Lactic acid (Physiol. Chem.), a sirupy, colorless fluid, soluble in water, with an intensely sour taste and strong acid reaction. There are at least three isomeric modifications all having the formula C3H6O3. Sarcolactic or paralactic acid occurs chiefly in dead muscle tissue, while ordinary lactic acid results from fermentation. The two acids are alike in having the same constitution (expressed by the name ethylidene lactic acid), but the latter is optically inactive, while sarcolactic acid rotates the plane of polarization to the right. The third acid, ethylene lactic acid, accompanies sarcolactic acid in the juice of flesh, and is optically inactive. -- Lactic ferment, an organized ferment (Bacterium lacticum or lactis), which produces lactic fermentation, decomposing the sugar of milk into carbonic and lactic acids, the latter, of which renders the milk sour, and precipitates the casein, thus giving rise to the so- called spontaneous coagulation of milk. -- Lactic fermentation. See under Fermentation.
lactide |A white, crystalline substance, obtained from also, by extension, any similar substance.
lactiferous |Bearing or containing milk or a milky fluid; as, the lactiferous vessels, cells, or tissue of various vascular plants.
lactific |Producing or yielding milk.
lactifical |Producing or yielding milk.
lactifuge |A medicine to check the secretion of milk, or to dispel a supposed accumulation of milk in any part of the body.
lactim |One of a series of anhydrides resembling the lactams, but of an imido type; as, isatine is a lactim. Cf. Lactam.
lactimide |A white, crystalline substance obtained as an anhydride of alanine, and regarded as an imido derivative of lactic acid.
lactin |See Lactose.
lactoabumin |The albumin present on milk, apparently identical with ordinary serum albumin. It is distinct from the casein of milk.
lactobutyrometer |An instrument for determining the amount of butter fat contained in a given sample of milk.
lactodensimeter |A form of hydrometer, specially graduated, for finding the density of milk, and thus discovering whether it has been mixed with water or some of the cream has been removed.
lactometer |An instrument for estimating the purity or richness of milk, as a measuring glass, a specific gravity bulb, or other apparatus.
lactone |One of a series of organic compounds, regarded as anhydrides of certain hydroxy acids. In general, they are colorless liquids, having a weak aromatic odor. They are so called because the typical lactone is derived from lactic acid.
lactonic |Of, pertaining to, or derived from, lactone.\n\nPertaining to, or designating, an acid obtained by the oxidation of milk sugar (lactose).
lactoprotein |A peculiar albuminous body considered a normal constituent of milk.
lactory |Lactiferous. [Obs.] \"Lactory or milky plants.\" Sir T. Browne.
lactoscope |An instrument for estimating the amount of cream contained in milk by ascertaining its relative opacity.
lactose |1. (Physiol. Chem.)  Sugar of milk or milk sugar; a crystalline sugar present in milk, and separable from the whey by evaporation and crystallization. It has a slightly sweet taste, is dextrorotary, and is much less soluble in water than either cane sugar or glucose. Formerly called lactin. 2. (Chem.)  See Galactose.
lactuca |A genus of composite herbs, several of which are cultivated foe salad; lettuce.
lactucarium |The inspissated juice of the common lettuce, sometimes used as a substitute for opium.
lactucic |Pertaining to, or derived from, the juice of the Lactuca virosa; -- said of certain acids.
lactucin |A white, crystalline substance, having a bitter taste and a neutral reaction, and forming one of the essential ingredients of lactucarium.
lactucone |A white, crystalline, tasteless substance, found in the milky sap of species of Lactuca, and constituting an essential ingredient of lactucarium.
lacturamic |Pertaining to, or designating, an organic amido acid, which is regarded as a derivative of lactic acid and urea.
lactyl |An organic residue or radical derived from lactic acid.
lacuna |1. A small opening; a small pit or depression; a small blank space; a gap or vacancy; a hiatus. 2. (Biol.)  A small opening; a small depression or cavity; a space, as a vacant space between the cells of plants, or one of the spaces left among the tissues of the lower animals, which serve in place of vessels for the circulation of the body fluids, or the cavity or sac, usually of very small size, in a mucous membrane.
lacunal |Pertaining to, or having, lacunæ; as, a lacunar circulation.
lacunar |Pertaining to, or having, lacunæ; as, a lacunar circulation.\n\n(a) The ceiling or under surface of any part, especially when it consists of compartments, sunk or hollowed without spaces or bands between the panels. Gwilt (b) One of the sunken panels in such a ceiling.
lacune |A lacuna. [R.] Landor.
lacunose |Furrowed or pitted; having shallow cavities or lacunæ; as, a lacunose leaf.
lacunous |Furrowed or pitted; having shallow cavities or lacunæ; as, a lacunose leaf.
lacustral |Found in, or pertaining to, lakes or ponds, or growing in them; as, lacustrine flowers. Lacustrine deposits (Geol.), the deposits which have been accumulated in fresh-water areas. -- Lacustrine dwellings. See Lake dwellings, under Lake.
lacustrine |Found in, or pertaining to, lakes or ponds, or growing in them; as, lacustrine flowers. Lacustrine deposits (Geol.), the deposits which have been accumulated in fresh-water areas. -- Lacustrine dwellings. See Lake dwellings, under Lake.
lacwork |Ornamentation by means of lacquer painted or carved, or simply colored, sprinkled with gold or the like; -- said especially of Oriental work of this kind.
lad |of Lead, to guide Chaucer.\n\n1. A boy; a youth; a stripling. \"Cupid is a knavish lad.\" Shak. There is a lad here, which hath fire barley loaves and two small fishes. John vi. 9. 2. A companion; a comrade; a mate. Lad's love. (Bot.) See Boy's love, under Boy.
ladanum |A gum resin gathered from certain Oriental species of Cistus. It has a pungent odor and is chiefly used in making plasters, and for fumigation. [Written also labdanum.]
ladde |of Lead, to guide. Chaucer.
ladder |1. A frame usually portable, of wood, metal, or rope, for ascent and descent, consisting of two side pieces to which are fastened cross strips or rounds forming steps. Some the engines play, And some, more bold, mount ladders to the fire. Dryden. 2. That which resembles a ladder in form or use; hence, that by means of which one attains to eminence. Lowliness is young ambition's ladder. Shak. Fish ladder. See under Fish. -- Ladder beetle (Zoöl.), an American leaf beetle (Chrysomela scalaris). The elytra are silvery white, striped and spotted with green; the under wings are rose-colored. It feeds upon the linden tree. -- Ladder handle, an iron rail at the side of a vertical fixed ladder, to grasp with the hand in climbing. -- Ladder shell (Zoöl.), a spiral marine shell of the genus Scalaria. See Scalaria.
laddie |A lad; a male sweetheart. [Scot.]
lade |1. To load; to put a burden or freight on or in; -- generally followed by that which receives the load, as the direct object. And they laded their asses with the corn. Gen. xlii. 26. 2. To throw in out. with a ladle or dipper; to dip; as, to lade water out of a tub, or into a cistern. And chides the sea that sunders him from thence, Saying, he'll lade it dry to have his way. Shak. 3. (Plate Glass Manuf.)  To transfer (the molten glass) from the pot to the forming table.\n\n1. To draw water. [Obs.] 2. (Naut.)  To admit water by leakage, as a ship, etc.\n\n1. The mouth of a river. [Obs.] Bp. Gibson. 2. A passage for water; a ditch or drain. [Prov. Eng.]
lademan |One who leads a pack horse; a miller's servant. [Obs. or Local]
laden |Loaded; freighted; burdened; as, a laden vessel; a laden heart. Ah sinful nation, a people laden with iniquity. Is. i. 4. A ship laden with gold. Shak.
ladied |Ladylike; not rough; gentle. [Obs.] \"Stroked with a ladied land.\" Feltham. LADIES' EARDROPS La\"dies' ear`drops`. (Bot.)  The small-flowered Fuchsia (F. coccinea), and other closely related species.
ladify |To make a lady of; to make ladylike. [Obs.] Massinger.
ladin |A Romansch dialect spoken in some parts of Switzerland and the Tyrol.
lading |1. The act of loading. 2. That which lades or constitutes a load or cargo; freight; burden; as, the lading of a ship. Bill of lading. See under Bill.
ladino |One of the half-breed descendants of whites and Indians; a mestizo; -- so called throughout Central America. They are usually of a yellowish orange tinge. Am. Cyc.
ladkin |A little lad. [R.] Dr. H. More.
ladle |1. A cuplike spoon, often of large size, with a long handle, used in lading or dipping. When the materials of glass have been kept long in fusion, the mixture casts up the superfluous salt, which the workmen take off with ladles. Boyle. 2. (Founding)  A vessel to carry liquid metal from the furnace to the mold. 3. The float of a mill wheel; -- called also ladle board. 4. (Gun.) (a) An instrument for drawing the charge of a cannon. (b) A ring, with a handle or handles fitted to it, for carrying shot. Ladle wood (Bot.), the wood of a South African tree (Cassine Colpoon), used for carving.\n\nTo take up and convey in a ladle; to dip with, or as with, a ladle; as, to ladle out soup; to ladle oatmeal into a kettle.
ladleful |A quantity sufficient to fill a ladle.
ladrone |A robber; a pirate; hence, loosely, a rogue or rascal.
lady |1. A woman who looks after the domestic affairs of a family; a mistress; the female head of a household. Agar, the handmaiden of Sara, whence comest thou, and whither goest thou The which answered, Fro the face of Sara my lady. Wyclif (Gen. xvi. 8.). 2. A woman having proprietary rights or authority; mistress; -- a feminine correlative of lord. \"Lord or lady of high degree.\" Lowell. Of all these bounds, even from this line to this, . . . We make thee lady. Shak. 3. A woman to whom the particular homage of a knight was paid; a woman to whom one is devoted or bound; a sweetheart. The soldier here his wasted store supplies, And takes new valor from his lady's eyes. Waller. 4. A woman of social distinction or position. In England, a title prefixed to the name of any woman whose husband is not of lower rank than a baron, or whose father was a nobleman not lower than an earl. The wife of a baronet or knight has the title of Lady by courtesy, but not by right. 5. A woman of refined or gentle manners; a well-bred woman; -- the feminine correlative of gentleman. 6. A wife; -- not now in approved usage. Goldsmith. 7. (Zoöl.)  The triturating apparatus in the stomach of a lobster; -- so called from a fancied resemblance to a seated female figure. It consists of calcareous plates. Ladies' man, a man who affects the society of ladies. -- Lady altar, an altar in a lady chapel. Shipley. -- Lady chapel, a chapel dedicated to the Virgin Mary. -- Lady court, the court of a lady of the manor. -- Lady crab (Zoöl.), a handsomely spotted swimming crab (Platyonichus ocellatus) very common on the sandy shores of the Atlantic coast of the United States. -- Lady fern. (Bot.) See Female fern, under Female, and Illust. of Fern. -- Lady in waiting, a lady of the queen's household, appointed to wait upon or attend the queen. -- Lady Mass, a Mass said in honor of the Virgin Mary. Shipley. Lady of the manor, a lady having jurisdiction of a manor; also, the wife of a manor lord. Lady's maid, a maidservant who dresses and waits upon a lady. Thackeray. -- Our Lady, the Virgin Mary.\n\nBelonging or becoming to a lady; ladylike. \"Some lady trifles.\" Shak.
lady day |The day of the annunciation of the Virgin Mary, March 25. See Annunciation.\n\nThe day of the annunciation of the Virgin Mary, March 25. See Annunciation.
